PollN,ValidBallot,InvalBallot,TotalVote,EligVoter,TotalPop,PerEligVoter,PerActVote,"馬英九 Ma Ying-jeou,蕭萬長 Vincent Siew: Kuo.Min.Tang","謝長廷 Frank Hsieh,蘇貞昌 Su Tseng-chang: Dem.Prog.Party",AName,ANameE
0,13103963,117646,13221609,17321622,22925311,75.56,76.33,7659014,5444949,全國,National
0,2226334,21169,2247503,2878477,3789488,75.96,78.08,1359419,866915,臺北縣,Taipei County
0,1604802,12807,1617609,2042805,2625359,77.81,79.19,1011546,593256,臺北市,Taipei City
0,1073018,10330,1083348,1396390,1928968,72.39,77.58,693602,379416,桃園縣,Taoyuan County
0,909619,7112,916731,1163546,1518568,76.62,78.79,469252,440367,高雄市,Kaohsiung City
0,859404,8761,868165,1135237,1548435,73.32,76.47,505698,353706,臺中縣,Taichung County
0,728834,7558,736392,981262,1313709,74.69,75.05,419700,309134,彰化縣,Changhua County
0,727233,5859,733092,953610,1243944,76.66,76.88,353333,373900,高雄縣,Kaohsiung County
0,631160,5614,636774,854240,1105079,77.3,74.54,276751,354409,臺南縣,Tainan County
0,592730,5836,598566,769926,1052946,73.12,77.74,365979,226751,臺中市,Taichung City
0,497100,3823,500923,679205,889806,76.33,73.75,247305,249795,屏東縣,Pingtung County
0,439849,3843,443692,578159,763489,75.73,76.74,223034,216815,臺南市,Tainan City
0,387263,3451,390714,557704,725949,76.82,70.06,187705,199558,雲林縣,Yunlin County
0,326073,3290,329363,417756,546276,76.47,78.84,189109,136964,板橋市,Banqiao City
0,319864,2974,322838,420176,559802,75.06,76.83,227069,92795,苗栗縣,Miaoli County
0,306436,2936,309372,427808,551498,77.57,72.32,139603,166833,嘉義縣,Chiayi County
0,289585,2467,292052,404968,533494,75.91,72.12,179630,109955,南投縣,Nantou County
0,281623,2723,284346,358433,494225,72.52,79.33,208445,73178,新竹縣,Hsinchu County
0,257557,2674,260231,324162,409906,79.08,80.28,174613,82944,中和市,Zhonghe City
0,254651,1991,256642,346921,460193,75.39,73.98,130951,123700,宜蘭縣,Yilan County
0,229264,2434,231698,294531,383429,76.82,78.67,121441,107823,三重市,Mie City
0,225564,2036,227600,289862,397577,72.91,78.52,145930,79634,新竹市,Hsinchu City
0,224889,1701,226590,297794,390188,76.32,76.09,152327,72562,基隆市,Keelung City
0,223484,2036,225520,290054,395573,73.33,77.75,126440,97044,新莊市,Xinzhuang City
0,215895,1807,217702,279384,390216,71.6,77.92,136775,79120,桃園市,Taoyuan City
0,213665,1573,215238,271849,357069,76.13,79.18,105483,108182,三民區,Sanmin District
0,203776,1921,205697,261179,357587,73.04,78.76,140976,62800,中壢市,Zhongli City
0,200203,1530,201733,257041,338771,75.87,78.48,106274,93929,鳳山市,Fengshan City
0,189344,1509,190853,245273,313866,78.15,77.81,129870,59474,大安區,Daan District
0,180048,1509,181557,229334,290244,79.01,79.17,130218,49830,新店市,Xindian City
0,177607,1970,179577,260820,343610,75.91,68.85,137604,40003,花蓮縣,Hualien County
0,176749,1409,178158,224545,286770,78.3,79.34,99112,77637,士林區,Shilin District
0,159853,1152,161005,198943,261258,76.15,80.93,115486,44367,文山區,Wenshan District
0,158442,1127,159569,197472,265317,74.43,80.81,103929,54513,內湖區,Neihu District
0,152155,1154,153309,200834,272804,73.62,76.34,79713,72442,嘉義市,Chiayi City
0,151867,1212,153079,193237,249593,77.42,79.22,89102,62765,北投區,Beitou District
0,144968,1217,146185,182163,236151,77.14,80.25,104558,40410,永和市,Yonghe City
0,143392,1193,144585,181366,228970,79.21,79.72,95552,47840,信義區,Xinyi District
0,135227,1375,136602,175110,239040,73.26,78.01,84956,50271,北屯區,Beibei District
0,134703,1195,135898,175176,218067,80.33,77.58,79864,54839,中山區,Zhongshan Area
0,134155,1275,135430,174582,237231,73.59,77.57,81127,53028,土城市,Tucheng
0,133485,1333,134818,172639,235682,73.25,78.09,80305,53180,彰化市,Changhua City
0,126812,1072,127884,161885,210117,77.05,79,83015,43797,松山區,Songshan District
0,123587,828,124415,162507,215989,75.24,76.56,69064,54523,屏東市,Pingtung City
0,121871,1010,122881,155735,192733,80.8,78.9,70880,50991,萬華區,Wanhua District
0,121135,998,122133,154843,200258,77.32,78.88,58718,62417,前鎮區,Former town area
0,117876,1005,118881,156539,210147,74.49,75.94,60711,57165,永康市,Yongkang City
0,116393,996,117389,148815,188255,79.05,78.88,61506,54887,苓雅區,Yuya District
0,112708,1219,113927,145236,202064,71.88,78.44,76368,36340,平鎮市,Pingzhen City
0,111382,977,112359,177843,233954,76.02,63.18,81668,29714,臺東縣,Taitung County
0,108938,748,109686,136977,185331,73.91,80.08,65870,43068,左營區,Zuoying District
0,108773,880,109653,140135,193513,72.42,78.25,62345,46428,東區,Eastern District
0,108448,1019,109467,140672,197421,71.25,77.82,69233,39215,西屯區,Xitun District
0,108145,909,109054,141119,180428,78.21,77.28,69863,38282,汐止市,Yushi City
0,106302,1050,107352,138458,191500,72.3,77.53,56097,50205,蘆洲市,Luzhou City
0,105596,925,106521,134147,189360,70.84,79.41,72946,32650,東區,Eastern District
0,105279,1018,106297,138002,192089,71.84,77.03,61381,43898,大里市,Dali City
0,98035,989,99024,126888,172066,73.74,78.04,65749,32286,八德市,Bade City
0,97896,761,98657,123998,168163,73.74,79.56,52383,45513,楠梓區,Nanxun District
0,95964,859,96823,129884,173743,74.76,74.55,42416,53548,安南區,Annan District
0,95198,973,96171,125727,171454,73.33,76.49,56947,38251,太平市,Taiping City
0,94269,735,95004,121326,159074,76.27,78.3,62472,31797,中正區,Zhongzheng District
0,92610,1041,93651,119903,164362,72.95,78.11,51229,41381,豐原市,Fengyuan City
0,91362,982,92344,120105,164002,73.23,76.89,52285,39077,樹林市,Wood City
0,86691,694,87385,113829,151446,75.16,76.77,41439,45252,小港區,Xiaogang District
0,84520,768,85288,111776,147236,75.92,76.3,53358,31162,北區,North District
0,80463,643,81106,106353,144242,73.73,76.26,40470,39993,西區,West District
0,80338,750,81088,103916,138523,75.02,78.03,50027,30311,北區,North District
0,79409,792,80201,101582,145461,69.83,78.95,49542,29867,南屯區,Nanxun District
0,77511,657,78168,99729,126188,79.03,78.38,38230,39281,大同區,Datong District
0,77143,794,77937,101723,142450,71.41,76.62,52999,24144,楊梅鎮,Yangmei Town
0,77064,700,77764,101177,127775,79.18,76.86,36330,40734,南區,South area
0,76791,686,77477,99715,128169,77.8,77.7,40716,36075,北區,North District
0,76788,656,77444,101249,131603,76.94,76.49,48182,28606,淡水鎮,Tamsui Town
0,74908,589,75497,95502,121845,78.38,79.05,40363,34545,鼓山區,Gushan District
0,74240,737,74977,98141,131141,74.84,76.4,46802,27438,龜山鄉,Guishan Township
0,71692,511,72203,94481,128562,73.49,76.42,39243,32449,東區,Eastern District
0,70087,673,70760,91644,131056,69.93,77.21,41032,29055,蘆竹鄉,Luzhu Township
0,70033,682,70715,92319,126027,73.25,76.6,42101,27932,員林鎮,Lin Linzhen
0,69968,573,70541,87779,124990,70.23,80.36,49264,20704,竹北市,Zhubei
0,69989,536,70525,88118,113406,77.7,80.03,44034,25955,南港區,Nangang District
0,66016,641,66657,85879,116392,73.78,77.62,39746,26270,西區,West District
0,64026,487,64513,83765,109316,76.63,77.02,29944,34082,大寮鄉,Datun Township
0,63341,637,63978,82116,109926,74.7,77.91,38019,25322,南區,South area
0,62886,609,63495,81686,112601,72.54,77.73,44475,18411,龍潭鄉,Longtan Township
0,58443,435,58878,77733,105625,73.59,75.74,37596,20847,南投市,Nantou City
0,58275,561,58836,80008,109724,72.92,73.54,44134,14141,花蓮市,Hualien City
0,57884,500,58384,77208,105322,73.31,75.62,33574,24310,斗六市,Douliu City
0,56326,397,56723,71756,95993,74.75,79.05,29648,26678,岡山鎮,Okayama Town
0,55617,466,56083,74488,99737,74.68,75.29,34482,21135,草屯鎮,Caojing Town
0,54735,534,55269,70976,97110,73.09,77.87,32076,22659,潭子鄉,Tanzi Township
0,54657,471,55128,80643,110254,73.14,68.36,38381,16276,台東市,Taitung City
0,54365,507,54872,68592,96451,71.12,80,43311,11054,竹東鎮,Zhudong Town
0,53929,433,54362,68867,94374,72.97,78.94,42573,11356,頭份鎮,Head town
0,53483,547,54030,68164,91062,74.85,79.26,41749,11734,苗栗市,Miaoli City
0,52496,383,52879,69839,95989,72.76,75.72,30124,22372,宜蘭市,Yilan City
0,50717,516,51233,67834,94541,71.75,75.53,30067,20650,三峽鎮,Three Gorges Town
0,50579,489,51068,65951,90117,73.18,77.43,29255,21324,大溪鎮,Daxi Town
0,50170,510,50680,66081,88994,74.25,76.69,29930,20240,和美鎮,Hemei Town
0,48722,450,49172,63914,81212,78.7,76.93,23916,24806,中西區,Central and Western District
0,48717,338,49055,63749,85184,74.84,76.95,33206,15511,安樂區,Anle District
0,47279,483,47762,63639,85861,74.12,75.05,26432,20847,清水鎮,Qingshui Town
0,47126,496,47622,62523,85254,73.34,76.17,24660,22466,鹿港鎮,Lugang Town
0,47054,458,47512,62218,85477,72.79,76.36,27178,19876,鶯歌鎮,Yingge Town
0,47053,435,47488,61899,87653,70.62,76.72,29062,17991,大雅鄉,Daya Township
0,45656,411,46067,65132,86447,75.34,70.73,29223,16433,埔里鎮,Puli Town
0,43846,475,44321,56723,73594,77.08,78.14,24431,19415,東區,Eastern District
0,43681,469,44150,61252,79004,77.53,72.08,33112,10569,吉安鄉,Ji'an Township
0,43340,408,43748,58777,78912,74.48,74.43,21782,21558,新營市,Xinying City
0,43258,368,43626,56364,77046,73.16,77.4,24139,19119,五股鄉,Wuxiang Township
0,43218,363,43581,72170,92157,78.31,60.39,25037,18181,澎湖縣,Wuhu County
0,42887,437,43324,57008,78239,72.86,76,26203,16684,沙鹿鎮,Shalu Town
0,42552,453,43005,56896,79484,71.58,75.59,23613,18939,大園鄉,Dayuan Township
0,42164,386,42550,54860,74202,73.93,77.56,25096,17068,泰山鄉,Taishan Township
0,42049,429,42478,56969,79272,71.87,74.56,24704,17345,大甲鎮,Dajia Town
0,41795,450,42245,54361,75021,72.46,77.71,27563,14232,竹南鎮,Zhunan Town
0,41560,465,42025,53154,74047,71.78,79.06,31629,9931,湖口鄉,Hukou Township
0,41118,342,41460,53846,67777,79.45,77,19608,21510,仁德鄉,Rende Township
0,40160,358,40518,51765,67499,76.69,78.27,17727,22433,仁武鄉,Renwu Township
0,40139,371,40510,54469,72669,74.95,74.37,19221,20918,民雄鄉,Minxiong Township
0,39630,361,39991,51799,69694,74.32,77.2,22957,16673,香山區,Xiangshan District
0,39677,302,39979,53067,71332,74.39,75.34,16958,22719,林園鄉,Linyuan Township
0,39410,285,39695,52331,74221,70.51,75.85,20285,19125,羅東鎮,Luodong Town
0,38376,367,38743,51880,71550,72.51,74.68,23032,15344,龍井鄉,Longjing Township
0,38334,406,38740,49489,67301,73.53,78.28,22249,16085,烏日鄉,Wuri Township
0,37561,318,37879,51994,69368,74.95,72.85,20764,16797,虎尾鎮,Huwei Town
0,37411,352,37763,48656,64434,75.51,77.61,21876,15535,霧峰鄉,Wufeng Township
0,36929,345,37274,48983,65452,74.84,76.1,16012,20917,歸仁鄉,Guiren Township
0,36336,248,36584,47048,66067,71.21,77.76,22155,14181,林口鄉,Linkou Township
0,36133,379,36512,47593,64173,74.16,76.72,18878,17255,神岡鄉,Shengang Township
0,35668,270,35938,46035,57454,80.12,78.07,18170,17498,新興區,Emerging area
0,35094,172,35266,65572,80191,81.77,53.78,33384,1710,金門縣,Jinmen County
0,33726,273,33999,45473,59243,76.76,74.77,13827,19899,佳里鎮,Jiali Town
0,33119,248,33367,44980,57642,78.03,74.18,22654,10465,中正區,Zhongzheng District
0,33006,302,33308,45490,59466,76.5,73.22,14947,18059,內埔鄉,Neipu Township
0,32535,268,32803,43334,59077,73.35,75.7,17311,15224,安平區,Anping District
0,32039,239,32278,45552,59330,76.78,70.86,17787,14252,竹山鎮,Zhushan Town
0,31794,344,32138,42860,59591,71.92,74.98,16039,15755,觀音鄉,Guanyin Township
0,31717,247,31964,41765,55155,75.72,76.53,20752,10965,七堵區,Seven blocks
0,31553,210,31763,42993,56965,75.47,73.88,15332,16221,潮州鎮,Chaozhou Town
0,31376,348,31724,42053,54851,76.67,75.44,19808,11568,東勢鎮,Dongshi Town
0,31329,333,31662,41280,55891,73.86,76.7,19124,12205,大肚鄉,Dadu Township
0,31341,265,31606,40898,54479,75.07,77.28,14023,17318,萬丹鄉,Wandan Township
0,31088,297,31385,41852,53602,78.08,74.99,15420,15668,水上鄉,Water township
0,31083,269,31352,40620,54550,74.46,77.18,15344,15739,路竹鄉,Luzhu Township
0,30826,315,31141,40523,54572,74.26,76.85,18092,12734,后里鄉,Houlixiang
0,30507,234,30741,39870,51094,78.03,77.1,21966,8541,信義區,Xinyi District
0,30223,293,30516,40937,56532,72.41,74.54,18010,12213,溪湖鎮,Xihu Town
0,30169,242,30411,40428,52424,77.12,75.22,20022,10147,中山區,Zhongshan Area
0,29376,353,29729,41610,55111,75.5,71.45,18187,11189,二林鎮,Erlin Town
0,29170,246,29416,39671,51260,77.39,74.15,12561,16609,冬山鄉,Dongshan Township
0,29171,224,29395,38439,50232,76.52,76.47,18508,10663,仁愛區,Renai District
0,29071,305,29376,39162,54096,72.39,75.01,17356,11715,梧棲鎮,Qiqi Town
0,28337,294,28631,36604,51582,70.96,78.22,20360,7977,新豐鄉,Xinfeng Township
0,27822,233,28055,36870,49964,73.79,76.09,15077,12745,新屋鄉,Xinwu Township
0,27548,214,27762,36083,46382,77.8,76.94,8389,19159,麻豆鎮,Madou Town
0,26958,191,27149,36604,50490,72.5,74.17,11756,15202,東港鎮,Donggang Town
0,26918,204,27122,41589,54398,76.45,65.21,16278,10640,馬公市,Magong City
0,26800,284,27084,36321,48841,74.37,74.57,14228,12572,福興鄉,Fuxing Township
0,26794,242,27036,36661,49291,74.38,73.75,11253,15541,西螺鎮,Xiluo Town
0,26813,222,27035,36408,49013,74.28,74.26,13955,12858,苑裡鎮,Yuanli Town
0,26794,229,27023,36067,47761,75.52,74.92,13721,13073,斗南鎮,Dounan Town
0,26410,197,26607,34306,44929,76.36,77.56,10913,15497,大樹鄉,Dashu Township
0,26305,258,26563,37101,48073,77.18,71.6,12775,13530,中埔鄉,Zhongpu Township
0,26231,246,26477,34690,46135,75.19,76.32,16049,10182,花壇鄉,Huatan Township
0,25981,188,26169,33075,41177,80.32,79.12,12678,13303,鳥松鄉,Bird pine township
0,25522,266,25788,33908,45470,74.57,76.05,13830,11692,社頭鄉,Shetou Township
0,25331,231,25562,34262,44596,76.83,74.61,12743,12588,新化鎮,Xinhua Town
0,25168,210,25378,35096,44180,79.44,72.31,13476,11692,美濃鎮,Mino Town
0,24863,241,25104,34271,45059,76.06,73.25,14375,10488,田中鎮,Tanaka Town
0,24713,221,24934,34199,43538,78.55,72.91,15707,9006,瑞芳鎮,Ruifang Town
0,24271,252,24523,32714,42492,76.99,74.96,10067,14204,善化鎮,Shanhua Town
0,23935,198,24133,33429,42899,77.92,72.19,12097,11838,蘇澳鎮,Suao Town
0,23892,233,24125,32956,44306,74.38,73.2,10177,13715,朴子市,Puzi City
0,23792,211,24003,33847,44459,76.13,70.92,9965,13827,北港鎮,Beigang Town
0,23490,241,23731,32210,41137,78.3,73.68,11052,12438,旗山鎮,Qishan Town
0,23067,210,23277,32180,41596,77.36,72.33,11583,11484,名間鄉,Mingxiang Township
0,22730,182,22912,28591,36731,77.84,80.14,9020,13710,橋頭鄉,Qiaotou Township
0,22449,172,22621,29036,37279,77.89,77.91,9450,12999,梓官鄉,Yuguan Township
0,22338,248,22586,30778,40492,76.01,73.38,14257,8081,後龍鎮,Houlong Town
0,22433,147,22580,30033,39603,75.84,75.18,8528,13905,新園鄉,Xinyuan Township
0,22110,280,22390,29861,39776,75.07,74.98,12729,9381,永靖鄉,Yongjing Township
0,21953,212,22165,29072,37069,78.43,76.24,9471,12482,關廟鄉,Guanmiao Township
0,21934,189,22123,30151,39291,76.74,73.37,12785,9149,通霄鎮,Tongyu Town
0,21856,198,22054,30800,39466,78.04,71.6,10074,11782,竹崎鄉,Zhuqi Township
0,21816,226,22042,27771,36107,76.91,79.37,14877,6939,新埔鎮,Xinpu Town
0,21724,231,21955,28403,38787,73.23,77.3,11868,9856,秀水鄉,Xiushui Township
0,21706,168,21874,29850,37750,79.07,73.28,9551,12155,五結鄉,Wujie Township
0,21489,168,21657,28563,38457,74.27,75.82,15219,6270,暖暖區,Warm zone
0,20610,186,20796,27544,36455,75.56,75.5,12149,8461,大村鄉,Da Village Township
0,20355,244,20599,27205,35513,76.61,75.72,10908,9447,埔心鄉,Puxin Township
0,20414,151,20565,27784,35893,77.41,74.02,10177,10237,礁溪鄉,Jiaoxi Township
0,19765,200,19965,25305,32662,77.48,78.9,8424,11341,大社鄉,Dashe Township
0,19710,224,19934,25883,34627,74.75,77.02,14582,5128,公館鄉,Gongguan Township
0,19674,188,19862,26580,34786,76.41,74.73,12355,7319,埔鹽鄉,Puyan Township
0,19608,229,19837,29476,37087,79.48,67.3,10225,9383,芳苑鄉,Fangyuan Township
0,19608,147,19755,26029,35526,73.27,75.9,8254,11354,新市鄉,Xinshi Township
0,19504,183,19687,26528,34435,77.04,74.21,9367,10137,大林鎮,Dalin Town
0,19280,226,19506,26856,35344,75.98,72.63,6897,12383,新港鄉,Xingang Township
0,19165,199,19364,26026,35640,73.02,74.4,11834,7331,伸港鄉,Shengang Township
0,19087,207,19294,24766,32704,75.73,77.91,13492,5595,關西鎮,Kansai Town
0,18997,187,19184,25889,35624,72.67,74.1,8967,10030,太保市,Taibao City
0,18908,157,19065,24873,30045,82.79,76.65,9634,9274,前金區,Former gold district
0,18826,211,19037,26732,35000,76.38,71.21,8595,10231,古坑鄉,Gukeng Township
0,18920,100,19020,24310,0,0,78.24,11482,7438,福山里,NULL
0,18442,189,18631,24879,33538,74.18,74.89,10362,8080,北斗鎮,Beidou Town
0,18452,176,18628,24560,32657,75.21,75.85,11074,7378,八里鄉,Bali Township
0,18373,202,18575,26014,32426,80.23,71.4,7371,11002,白河鎮,Baihe Town
0,18388,177,18565,24377,31269,77.96,76.16,8634,9754,燕巢鄉,Yanchao Township
0,18172,150,18322,23263,28682,81.11,78.76,8403,9769,鹽埕區,Yancheng District
0,18046,144,18190,24894,31982,77.84,73.07,8062,9984,茄萣鄉,Township
0,17940,147,18087,25077,32421,77.35,72.13,8126,9814,員山鄉,Yuanshan Township
0,17835,137,17972,24105,30962,77.85,74.56,8572,9263,長治鄉,Changzhi Township
0,17631,170,17801,23887,31866,74.96,74.52,11474,6157,外埔鄉,Waipu Township
0,17457,205,17662,24951,32234,77.41,70.79,8035,9422,溪州鄉,Xizhou Township
0,17417,168,17585,23219,30012,77.37,75.74,7112,10305,安定鄉,Anding Township
0,17311,159,17470,23814,30858,77.17,73.36,7226,10085,莿桐鄉,Wutong Township
0,17268,178,17446,24999,31366,79.7,69.79,8303,8965,布袋鎮,Budai Town
0,17245,176,17421,23562,30020,78.49,73.94,7283,9962,旗津區,Qijin District
0,17236,149,17385,22867,30902,74,76.03,7330,9906,阿蓮鄉,Alian Township
0,17233,136,17369,24182,31667,76.36,71.83,10826,6407,頭城鎮,Head town
0,17041,145,17186,22543,28659,78.66,76.24,7631,9410,湖內鄉,Lake Township
0,16955,212,17167,24400,32076,76.07,70.36,8926,8029,埤頭鄉,Shantou Township
0,16793,140,16933,24095,30648,78.62,70.28,6139,10654,二崙鄉,Erlun Township
0,16541,117,16658,20902,0,0,79.7,9519,7022,菜公里,NULL
0,16417,130,16547,23982,31144,77,69,7619,8798,土庫鎮,Turku Town
0,16424,115,16539,20569,0,0,80.41,9034,7390,新上里,NULL
0,16372,115,16487,22426,28615,78.37,73.52,5703,10669,學甲鎮,Xuejia Town
0,16055,149,16204,24940,33210,75.1,64.97,9581,6474,麥寮鄉,Maixiao Township
0,15996,168,16164,23573,28765,81.95,68.57,7068,8928,東石鄉,Dongshi Township
0,15834,149,15983,24891,31074,80.1,64.21,6082,9752,口湖鄉,Kouhu Township
0,15802,174,15976,21883,29204,74.93,73.01,8935,6867,田尾鄉,Tianwei Township
0,15790,152,15942,24251,29792,81.4,65.74,5092,10698,水林鄉,Shuilin Township
0,15754,151,15905,21938,27902,78.63,72.5,5895,9859,鹽水鎮,Salt water town
0,15682,151,15833,21623,26568,81.39,73.22,5641,10041,後壁鄉,Houbi Township
0,15673,153,15826,22183,27558,80.5,71.34,5823,9850,高樹鄉,Gaoshu Township
0,15543,149,15692,21247,26815,79.24,73.86,6323,9220,下營鄉,Xiaying Township
0,15518,141,15659,24213,29781,81.3,64.67,6625,8893,元長鄉,Yuanchang Township
0,15391,137,15528,20264,26501,76.47,76.63,6103,9288,里港鄉,Ligang Township
0,15332,160,15492,22372,27321,81.89,69.25,5562,9770,六腳鄉,Liujiao Township
0,15314,107,15421,21576,27437,78.64,71.47,7339,7975,枋寮鄉,Fangliao Township
0,15256,129,15385,21318,27751,76.82,72.17,8160,7096,鹽埔鄉,Yanpu Township
0,14994,168,15162,23390,31270,74.8,64.82,7986,7008,恆春鎮,Hengchun Town
0,14990,110,15100,22024,28149,78.24,68.56,7125,7865,崙背鄉,Lunbei Township
0,14913,172,15085,19929,25858,77.07,75.69,8574,6339,新社鄉,Xinshe Township
0,14682,126,14808,19674,25568,76.95,75.27,5305,9377,西港鄉,Xigang Township
0,14603,139,14742,19687,25358,77.64,74.88,7655,6948,芬園鄉,Fenyuan Township
0,14260,147,14407,19978,25244,79.14,72.11,4932,9328,七股鄉,Qixiang Township
0,14214,118,14332,19458,25282,76.96,73.66,6504,7710,壯圍鄉,Zhuangwei Township
0,13759,82,13841,17057,0,0,81.15,8030,5729,鼎泰里,NULL
0,13578,116,13694,22127,27456,80.59,61.89,8052,5526,台西鄉,Taixi Township
0,13430,125,13555,18553,24411,76,73.06,5254,8176,六甲鄉,Liujia Township
0,13421,134,13555,17834,22683,78.62,76.01,4704,8717,官田鄉,Guantian Township
0,13445,99,13544,17635,23230,75.91,76.8,4889,8556,九如鄉,Jiuru Township
0,13405,127,13532,22565,27650,81.61,59.97,6481,6924,四湖鄉,Sihu Township
0,13299,120,13419,18316,23260,78.74,73.26,5281,8018,柳營鄉,Liuying Township
0,13179,119,13298,17053,22221,76.74,77.98,8224,4955,深坑鄉,Shenkeng Township
0,12934,212,13146,22037,28214,78.11,59.65,9910,3024,玉里鎮,Yuli Town
0,12965,140,13105,17859,22752,78.49,73.38,5223,7742,萬巒鄉,Wanxiang Township
0,12875,116,12991,17871,23566,75.83,72.69,8440,4435,三芝鄉,Sanzhi Township
0,12866,114,12980,18343,22116,82.94,70.76,4261,8605,將軍鄉,General army
0,12653,117,12770,17844,21900,81.48,71.56,5397,7256,義竹鄉,Yizhu Township
0,12659,109,12768,19270,23795,80.98,66.26,5547,7112,東山鄉,Dongshan Township
0,12634,107,12741,17395,21792,79.82,73.25,5244,7390,佳冬鄉,Jiadong Township
0,12616,111,12727,17543,22323,78.59,72.55,6035,6581,梅山鄉,Meishan Township
0,12570,106,12676,15984,20797,76.86,79.3,6249,6321,彌陀鄉,Mito Township
0,12480,122,12602,15636,20777,75.26,80.6,9474,3006,芎林鄉,Yulin Township
0,12426,92,12518,16774,21330,78.64,74.63,5287,7139,林邊鄉,Linbian Township
0,12232,101,12333,16843,22160,76.01,73.22,7217,5015,金山鄉,Jinshan Township
0,12075,96,12171,17088,21934,77.91,71.23,5543,6532,大埤鄉,Datun Township
0,11923,129,12052,16068,23876,67.3,75.01,6694,5229,中區,Central District
0,11920,117,12037,16975,21208,80.04,70.91,5115,6805,三星鄉,Samsung Township
0,11971,61,12032,22073,27505,80.25,54.51,11342,629,金城鎮,Golden town
0,11831,101,11932,15487,0,0,77.05,7662,4169,新興里,NULL
0,11713,111,11824,16317,20523,79.51,72.46,7203,4510,萬里鄉,Wanli Township
0,11592,117,11709,15707,20750,75.7,74.55,6757,4835,大安鄉,Daan Township
0,11398,87,11485,15208,19837,76.66,75.52,8912,2486,銅鑼鄉,Tonglu Township
0,11340,77,11417,14854,18528,80.17,76.86,4832,6508,竹田鄉,Zhutian Township
0,11283,109,11392,17000,21532,78.95,67.01,7497,3786,國姓鄉,Country name
0,11245,126,11371,16567,20982,78.96,68.64,6962,4283,水里鄉,Shuili Township
0,11179,119,11298,15411,20577,74.89,73.31,5967,5212,林內鄉,Linnei Township
0,11018,103,11121,15727,19583,80.31,70.71,6611,4407,鹿谷鄉,Lugu Township
0,10812,135,10947,15715,20568,76.41,69.66,8562,2250,新城鄉,New urban and rural
0,10827,106,10933,14521,18574,78.18,75.29,6095,4732,卓蘭鎮,Zhuolan Town
0,10733,73,10806,13247,0,0,81.57,8042,2691,十興里,NULL
0,10478,82,10560,13250,17705,74.84,79.7,7890,2588,三義鄉,Sanyi Township
0,10437,115,10552,13918,0,0,75.82,7029,3408,南興村,NULL
0,10457,75,10532,13191,0,0,79.84,6499,3958,明誠里,NULL
0,10319,113,10432,15382,19306,79.67,67.82,7570,2749,壽豐鄉,Shoufeng Township
0,10259,103,10362,13700,17141,79.93,75.64,5414,4845,二水鄉,Ershui Township
0,10250,87,10337,13073,0,0,79.07,5035,5215,清豐里,NULL
0,10198,84,10282,14251,17513,81.37,72.15,4179,6019,鹿草鄉,Lucao Township
0,9932,112,10044,15629,19294,81,64.27,6019,3913,大城鄉,Dacheng
0,9593,78,9671,13472,16862,79.9,71.79,3343,6250,溪口鄉,Xikou Township
0,9438,78,9516,12747,16996,75,74.65,6324,3114,線西鄉,Line Xixiang
0,9408,74,9482,13373,16571,80.7,70.9,4856,4552,內門鄉,Inner gate township
0,9377,94,9471,14687,18517,79.32,64.49,6312,3065,卑南鄉,Beinan Township
0,9373,85,9458,13489,16613,81.2,70.12,5319,4054,中寮鄉,Zhongyu Township
0,9351,90,9441,12241,16187,75.62,77.13,5834,3517,石岡鄉,Shigang Township
0,9172,70,9242,12547,16240,77.26,73.66,6890,2282,大湖鄉,Dahu Township
0,9075,102,9177,12690,15864,79.99,72.32,5107,3968,玉井鄉,Yujing Township
0,9008,84,9092,13842,17306,79.98,65.68,5134,3874,魚池鄉,Yuchi Township
0,8957,80,9037,11407,14634,77.95,79.22,6991,1966,橫山鄉,Hengshan Township
0,8871,85,8956,12992,16719,77.71,68.93,4287,4584,竹塘鄉,Zhutang Township
0,8869,74,8943,14276,17650,80.88,62.64,4509,4360,東勢鄉,Dongshi Township
0,8870,53,8923,11579,0,0,77.06,5666,3204,鄧公里,NULL
0,8799,65,8864,11453,0,0,77.39,5700,3099,翠屏里,NULL
0,8615,68,8683,11548,16989,67.97,75.19,3574,5041,崁頂鄉,Yuding Township
0,8469,62,8531,10484,0,0,81.37,4789,3680,新光里,NULL
0,8463,54,8517,10603,0,0,80.33,4983,3480,新下里,NULL
0,8345,94,8439,10829,0,0,77.93,4846,3499,北陽里,NULL
0,8278,62,8340,10668,13851,77.02,78.18,6336,1942,造橋鄉,Bridge township
0,8252,82,8334,10818,0,0,77.04,5344,2908,龍埔里,NULL
0,8253,80,8333,12319,17222,71.53,67.64,6222,2031,信義鄉,Xinyi Township
0,8231,52,8283,10903,14224,76.65,75.97,3973,4258,永安鄉,Yongan Township
0,8197,74,8271,10433,13779,75.72,79.28,6009,2188,寶山鄉,Baoshan Township
0,8209,54,8263,10164,0,0,81.3,5754,2455,萬興里,NULL
0,8010,95,8105,12441,15695,79.27,65.15,3709,4301,六龜鄉,Liugui Township
0,7957,74,8031,10274,0,0,78.17,4678,3279,九德村,NULL
0,7958,60,8018,11496,15395,74.67,69.75,7202,756,仁愛鄉,Renai Township
0,7838,85,7923,11545,13932,82.87,68.63,3529,4309,貢寮鄉,Gongga Township
0,7866,36,7902,14631,17933,81.59,54.01,7422,444,金湖鎮,Jinhu Town
0,7798,78,7876,11518,14825,77.69,68.38,3792,4006,褒忠鄉,Qi Zhongxiang
0,7619,59,7678,9722,0,0,78.98,3807,3812,八卦村,NULL
0,7603,60,7663,9439,0,0,81.18,5384,2219,樟新里,NULL
0,7548,63,7611,9630,0,0,79.03,4214,3334,東寶村,NULL
0,7549,57,7606,10215,0,0,74.46,4872,2677,湖興里,NULL
0,7501,74,7575,9917,0,0,76.38,4935,2566,水碓里,NULL
0,7419,65,7484,9801,0,0,76.36,4448,2971,瑞城里,NULL
0,7401,69,7470,11730,14731,79.63,63.68,5993,1408,光復鄉,Guangfu Township
0,7383,51,7434,9495,0,0,78.29,4090,3293,正興里,NULL
0,7300,62,7362,9439,11702,80.66,78,3074,4226,麟洛鄉,Linluo Township
0,7285,74,7359,9345,11923,78.38,78.75,5637,1648,頭屋鄉,Tou Township
0,7283,65,7348,9741,0,0,75.43,3326,3957,安西里,NULL
0,7255,46,7301,9255,0,0,78.89,4573,2682,大連里,NULL
0,7192,48,7240,10412,12670,82.18,69.54,2918,4274,北門鄉,Beimen Township
0,7169,58,7227,9209,0,0,78.48,3991,3178,龍子里,NULL
0,7149,53,7202,13056,16420,79.51,55.16,5847,1302,成功鎮,Successful town
0,7102,69,7171,9300,0,0,77.11,4350,2752,溪福里,NULL
0,7096,61,7157,9356,0,0,76.5,4132,2964,潭陽村,NULL
0,7069,87,7156,10295,14946,68.88,69.51,6325,744,秀林鄉,Xiulin Township
0,7087,64,7151,9775,12159,80.39,73.16,3145,3942,南州鄉,Nanzhou Township
0,7058,49,7107,9316,0,0,76.29,3513,3545,保安里,NULL
0,6989,94,7083,9082,0,0,77.99,3747,3242,豐田里,NULL
0,7024,53,7077,8974,0,0,78.86,4733,2291,橋東里,NULL
0,6947,34,6981,8982,0,0,77.72,4628,2319,崇蘭里,NULL
0,6882,53,6935,9389,11370,82.58,73.86,2646,4236,大內鄉,Da Nei Xiang
0,6842,64,6906,8800,0,0,78.48,4046,2796,關渡里,NULL
0,6830,65,6895,10104,12517,80.72,68.24,5254,1576,鳳林鎮,Fenglin Town
0,6843,50,6893,8916,0,0,77.31,3173,3670,中庄村,NULL
0,6783,52,6835,9386,11819,79.41,72.82,3239,3544,番路鄉,Fanlu Township
0,6702,48,6750,9138,11771,77.63,73.87,4325,2377,石門鄉,Shimen Township
0,6643,66,6709,8833,0,0,75.95,2916,3727,草衙里,NULL
0,6625,59,6684,9443,12126,77.87,70.78,4012,2613,集集鎮,Jiji Town
0,6634,35,6669,8546,0,0,78.04,4106,2528,龍水里,NULL
0,6604,47,6651,8949,11470,78.02,74.32,5299,1305,南庄鄉,Nanzhuang Township
0,6581,53,6634,8841,0,0,75.04,4571,2010,潭墘里,NULL
0,6582,51,6633,8325,0,0,79.68,3560,3022,成德里,NULL
0,6578,49,6627,8123,0,0,81.58,3498,3080,大華村,NULL
0,6574,45,6619,8552,0,0,77.4,3300,3274,鳥松村,NULL
0,6495,44,6539,8064,0,0,81.09,5669,826,自強里,NULL
0,6464,48,6512,8045,0,0,80.94,5773,691,自立里,NULL
0,6431,78,6509,10537,13432,78.45,61.77,4882,1549,瑞穗鄉,Ruisui Township
0,6451,44,6495,7980,0,0,81.39,4687,1764,葫洲里,NULL
0,6407,63,6470,8274,0,0,78.2,3849,2558,南陽里,NULL
0,6404,35,6439,12011,14423,83.28,53.61,6065,339,金寧鄉,Jinning Township
0,6360,49,6409,7938,0,0,80.74,4939,1421,員山村,NULL
0,6279,74,6353,8322,0,0,76.34,3673,2606,社皮里,NULL
0,6302,51,6353,8980,11103,80.88,70.75,3138,3164,新埤鄉,Xinyi Township
0,6298,49,6347,8054,0,0,78.81,4296,2002,羊稠村,NULL
0,6288,45,6333,7858,0,0,80.59,4040,2248,東新里,NULL
0,6267,61,6328,10313,12816,80.47,61.36,3040,3227,湖西鄉,Huxi Township
0,6270,33,6303,8970,11038,81.26,70.27,3949,2321,楠西鄉,Nanxi Township
0,6252,44,6296,8406,0,0,74.9,3685,2567,金城里,NULL
0,6212,71,6283,7931,10347,76.65,79.22,4644,1568,北埔鄉,Beipu Township
0,6213,53,6266,7959,0,0,78.73,3614,2599,水景里,NULL
0,6205,47,6252,8259,0,0,75.7,2808,3397,山明里,NULL
0,6191,47,6238,7777,0,0,80.21,4091,2100,大直里,NULL
0,6173,62,6235,8049,0,0,77.46,3861,2312,福仁村,NULL
0,6171,61,6232,7741,0,0,80.51,4796,1375,二重里,NULL
0,6176,55,6231,9452,11406,82.87,65.92,3196,2980,杉林鄉,Shanlin Township
0,6190,39,6229,7842,0,0,79.43,3660,2530,奇岩里,NULL
0,6131,47,6178,7723,0,0,79.99,4767,1364,龍田里,NULL
0,6128,47,6175,7827,0,0,78.89,4329,1799,公崙里,NULL
0,6124,49,6173,7599,0,0,81.23,4265,1859,樟腳里,NULL
0,6103,46,6149,7687,0,0,79.99,5032,1071,上舘里,NULL
0,6109,35,6144,9643,12247,78.74,63.71,4356,1753,太麻里鄉,Taima Lixiang
0,6091,43,6134,7613,0,0,80.57,2930,3161,本館里,NULL
0,6074,50,6124,7529,0,0,81.34,3720,2354,忠翠里,NULL
0,6080,38,6118,7651,0,0,79.96,2976,3104,雙連里,NULL
0,6076,41,6117,7476,0,0,81.82,4559,1517,興豐里,NULL
0,6063,54,6117,7642,0,0,80.04,4233,1830,三張里,NULL
0,6067,43,6110,7573,0,0,80.68,4564,1503,竹仁里,NULL
0,6060,37,6097,7892,0,0,77.26,2945,3115,仁義村,NULL
0,6043,43,6086,7412,0,0,82.11,4959,1084,新和里,NULL
0,6027,55,6082,7723,0,0,78.75,3869,2158,竹圍里,NULL
0,5999,81,6080,7813,0,0,77.82,3375,2624,軍功里,NULL
0,6008,57,6065,7865,0,0,77.11,4033,1975,永安里,NULL
0,5990,73,6063,7688,0,0,78.86,3706,2284,樹義里,NULL
0,5991,66,6057,7583,0,0,79.88,4159,1832,后庄里,NULL
0,5971,57,6028,8714,10866,80.2,69.18,4610,1361,和平鄉,Peace township
0,5911,40,5951,7358,0,0,80.88,3613,2298,港富里,NULL
0,5869,49,5918,7765,0,0,76.21,3564,2305,吉峰村,NULL
0,5815,43,5858,7243,0,0,80.88,3708,2107,中研里,NULL
0,5818,33,5851,7420,0,0,78.85,3209,2609,寶玉里,NULL
0,5812,38,5850,7616,0,0,76.81,2777,3035,湖內里,NULL
0,5783,32,5815,7270,0,0,79.99,3579,2204,五分里,NULL
0,5751,58,5809,7236,0,0,80.28,3752,1999,平河里,NULL
0,5754,53,5807,7541,0,0,77.01,3298,2456,豐樂里,NULL
0,5730,50,5780,7424,0,0,77.86,2958,2772,過埤里,NULL
0,5728,51,5779,7282,0,0,79.36,3494,2234,蘭雅里,NULL
0,5730,48,5778,8292,9952,83.32,69.68,3292,2438,雙溪鄉,Shuangxi Township
0,5738,30,5768,10563,12878,82.02,54.61,5533,205,金沙鎮,Jinsha Town
0,5694,43,5737,7058,0,0,81.28,3250,2444,立農里,NULL
0,5692,44,5736,7535,0,0,76.12,3602,2090,大興里,NULL
0,5668,52,5720,7233,0,0,79.08,3380,2288,民有里,NULL
0,5668,49,5717,7010,0,0,81.55,4189,1479,保順里,NULL
0,5665,50,5715,7105,0,0,80.44,3904,1761,龍淵里,NULL
0,5669,39,5708,7830,0,0,72.9,3094,2575,清江里,NULL
0,5645,52,5697,7640,0,0,74.57,2629,3016,龍潭里,NULL
0,5626,56,5682,7221,0,0,78.69,3408,2218,舊莊里,NULL
0,5611,70,5681,9633,12103,79.59,58.97,4324,1287,富里鄉,Fuli Township
0,5624,43,5667,7001,0,0,80.95,3767,1857,南福里,NULL
0,5618,40,5658,7119,0,0,79.48,3567,2051,永安里,NULL
0,5613,42,5655,7124,0,0,79.38,3813,1800,木新里,NULL
0,5604,41,5645,7035,0,0,80.24,3775,1829,安康里,NULL
0,5573,52,5625,7444,0,0,75.56,3341,2232,東湖里,NULL
0,5554,48,5602,7160,0,0,78.24,3561,1993,甘蔗村,NULL
0,5532,62,5594,7031,0,0,79.56,3302,2230,永和里,NULL
0,5568,26,5594,6939,0,0,80.62,2974,2594,寶國里,NULL
0,5532,44,5576,7119,0,0,78.33,3300,2232,中正里,NULL
0,5523,44,5567,6798,0,0,81.89,3796,1727,西康里,NULL
0,5501,62,5563,7932,10631,74.61,70.13,4442,1059,復興鄉,Fuxing Township
0,5524,33,5557,7137,0,0,77.86,3155,2369,大武里,NULL
0,5519,32,5551,6847,0,0,81.07,3001,2518,本揚里,NULL
0,5510,40,5550,7007,0,0,79.21,3020,2490,華江里,NULL
0,5493,55,5548,7401,0,0,74.96,3191,2302,新里里,NULL
0,5488,60,5548,7187,0,0,77.19,2816,2672,西湳里,NULL
0,5506,40,5546,7060,0,0,78.56,3558,1948,吉祥里,NULL
0,5477,47,5524,7325,0,0,75.41,3359,2118,復華里,NULL
0,5483,36,5519,6755,0,0,81.7,4038,1445,樟林里,NULL
0,5478,38,5516,6749,0,0,81.73,3881,1597,新南里,NULL
0,5454,47,5501,7308,0,0,75.27,2469,2985,後壁村,NULL
0,5425,51,5476,7388,8597,85.94,74.12,2028,3397,田寮鄉,Tian Yi Township
0,5421,54,5475,7059,0,0,77.56,3199,2222,員林村,NULL
0,5420,55,5475,6839,0,0,80.06,3095,2325,安平里,NULL
0,5422,41,5463,6974,0,0,78.33,3376,2046,天玉里,NULL
0,5424,35,5459,7132,0,0,76.54,2896,2528,水湳里,NULL
0,5396,44,5440,6647,0,0,81.84,3432,1964,紫星里,NULL
0,5370,65,5435,6809,0,0,79.82,2681,2689,東信里,NULL
0,5388,40,5428,6872,0,0,78.99,3467,1921,東榮里,NULL
0,5389,29,5418,6795,0,0,79.74,3526,1863,加昌里,NULL
0,5383,30,5413,6944,0,0,77.95,2500,2883,社新里,NULL
0,5359,38,5397,6660,0,0,81.04,3260,2099,中行里,NULL
0,5344,49,5393,6837,0,0,78.88,3343,2001,延平里,NULL
0,5332,49,5381,6936,0,0,77.58,3299,2033,重慶里,NULL
0,5325,54,5379,6715,0,0,80.1,2888,2437,行仁里,NULL
0,5326,37,5363,6796,0,0,78.91,3219,2107,南瑶里,NULL
0,5303,51,5354,6816,0,0,78.55,3201,2102,大林里,NULL
0,5314,38,5352,6617,0,0,80.88,3904,1410,新營里,NULL
0,5319,33,5352,6502,0,0,82.31,3359,1960,港華里,NULL
0,5301,33,5334,9953,12676,78.52,53.59,3667,1634,琉球鄉,Ryukyu Township
0,5294,37,5331,6631,0,0,80.4,3310,1984,樂康里,NULL
0,5291,39,5330,6347,0,0,83.98,4035,1256,瑞陽里,NULL
0,5273,46,5319,6671,0,0,79.73,3319,1954,長榮里,NULL
0,5290,27,5317,6465,0,0,82.24,3904,1386,斗崙里,NULL
0,5261,51,5312,6720,0,0,79.05,2961,2300,烏日村,NULL
0,5270,41,5311,6651,0,0,79.85,2715,2555,後港里,NULL
0,5267,43,5310,7172,0,0,74.04,2979,2288,塗城里,NULL
0,5278,28,5306,6284,0,0,84.44,3915,1363,萬芳里,NULL
0,5260,36,5296,7115,0,0,74.43,2598,2662,頂碩里,NULL
0,5234,46,5280,6718,0,0,78.59,3199,2035,立廷里,NULL
0,5244,35,5279,6481,0,0,81.45,3364,1880,福志里,NULL
0,5225,54,5279,6729,0,0,78.45,2328,2897,文武村,NULL
0,5204,59,5263,6898,0,0,76.3,2764,2440,水河里,NULL
0,5235,26,5261,6765,0,0,77.77,3121,2114,文德里,NULL
0,5225,35,5260,6972,0,0,75.44,2431,2794,塩行里,NULL
0,5207,45,5252,6639,0,0,79.11,3006,2201,中原里,NULL
0,5201,48,5249,6422,0,0,81.73,3590,1611,黎孝里,NULL
0,5205,37,5242,6685,0,0,78.41,3585,1620,新埔里,NULL
0,5200,42,5242,6625,0,0,79.12,3526,1674,泰和里,NULL
0,5200,41,5241,7391,8982,82.29,70.91,3009,2191,南化鄉,Nanhua Township
0,5161,64,5225,6872,0,0,76.03,3072,2089,崑崙里,NULL
0,5193,30,5223,6703,0,0,77.92,3540,1653,大學里,NULL
0,5178,42,5220,6605,0,0,79.03,2928,2250,中信里,NULL
0,5162,53,5215,6652,0,0,78.4,2378,2784,桂林里,NULL
0,5162,45,5207,6425,0,0,81.04,3329,1833,文華里,NULL
0,5162,37,5199,6462,0,0,80.45,3199,1963,振華里,NULL
0,5156,27,5183,6891,0,0,75.21,2387,2769,興東里,NULL
0,5142,39,5181,6414,0,0,80.78,2954,2188,新翠里,NULL
0,5142,31,5173,6440,0,0,80.33,3546,1596,康寧里,NULL
0,5140,32,5172,6298,0,0,82.12,3894,1246,木柵里,NULL
0,5129,36,5165,6292,0,0,82.09,3180,1949,西湖里,NULL
0,5110,41,5151,6353,0,0,81.08,3221,1889,東湖里,NULL
0,5104,46,5150,6448,0,0,79.87,3163,1941,新聚里,NULL
0,5085,60,5145,7954,10142,78.43,64.68,2221,2864,車城鄉,Car and urban
0,5105,36,5141,6472,0,0,79.43,2875,2230,江山里,NULL
0,5075,35,5110,6300,0,0,81.11,2915,2160,福佳里,NULL
0,5071,38,5109,6792,0,0,75.22,2882,2189,仁化里,NULL
0,5065,43,5108,6803,0,0,75.08,2961,2104,瑞光里,NULL
0,5054,46,5100,6636,0,0,76.85,2996,2058,永昌里,NULL
0,5046,46,5092,6281,0,0,81.07,3196,1850,埤林里,NULL
0,5038,50,5088,6515,0,0,78.1,3242,1796,阿夷里,NULL
0,5015,50,5065,6665,0,0,75.99,2212,2803,北灣里,NULL
0,5011,49,5060,6420,0,0,78.82,3375,1636,新興里,NULL
0,5016,43,5059,6476,0,0,78.12,3310,1706,光信里,NULL
0,5007,43,5050,6742,0,0,74.9,3313,1694,光武里,NULL
0,5005,41,5046,6759,0,0,74.66,2153,2852,建南里,NULL
0,5016,29,5045,6180,0,0,81.63,3463,1553,清白里,NULL
0,5005,38,5043,6447,0,0,78.22,3198,1807,三愛里,NULL
0,5006,31,5037,6378,0,0,78.97,2963,2043,文福里,NULL
0,4989,43,5032,6326,0,0,79.54,2404,2585,至聖里,NULL
0,4981,43,5024,6348,0,0,79.14,3324,1657,文化里,NULL
0,4988,35,5023,6546,0,0,76.73,3286,1702,復國里,NULL
0,4977,33,5010,6118,0,0,81.89,2770,2207,葫蘆里,NULL
0,4961,41,5002,6297,0,0,79.43,3405,1556,柴埕里,NULL
0,4969,29,4998,6261,0,0,79.83,3116,1853,天和里,NULL
0,4944,49,4993,6474,0,0,77.12,3080,1864,民炤里,NULL
0,4948,43,4991,6210,0,0,80.37,3426,1522,廣居里,NULL
0,4944,44,4988,6394,0,0,78.01,4084,860,五豐里,NULL
0,4951,34,4985,6233,0,0,79.98,3060,1891,榮華里,NULL
0,4943,40,4983,6643,0,0,75.01,2161,2782,埔園里,NULL
0,4952,26,4978,6138,0,0,81.1,3741,1211,興家里,NULL
0,4932,46,4978,6023,0,0,82.65,3598,1334,萬隆里,NULL
0,4931,47,4978,6501,0,0,76.57,2806,2125,二王里,NULL
0,4918,53,4971,6691,0,0,74.29,2956,1962,鳶山里,NULL
0,4908,56,4964,6383,0,0,77.77,3768,1140,重興村,NULL
0,4923,39,4962,6142,0,0,80.79,2810,2113,下埤里,NULL
0,4912,41,4953,6142,0,0,80.64,3302,1610,國業里,NULL
0,4921,28,4949,6156,0,0,80.39,3565,1356,華興里,NULL
0,4879,45,4924,7033,0,0,70.01,2336,2543,永康里,NULL
0,4852,65,4917,6373,0,0,77.15,2763,2089,福山里,NULL
0,4891,25,4916,6369,0,0,77.19,3388,1503,山腳里,NULL
0,4873,40,4913,5998,0,0,81.91,3421,1452,雙和里,NULL
0,4868,40,4908,6128,0,0,80.09,2544,2324,本和里,NULL
0,4850,51,4901,6210,0,0,78.92,2780,2070,舊社里,NULL
0,4839,60,4899,6460,0,0,75.84,2488,2351,豐洲村,NULL
0,4875,23,4898,6050,0,0,80.96,3183,1692,紫陽里,NULL
0,4850,45,4895,6166,0,0,79.39,2215,2635,鼎西里,NULL
0,4847,47,4894,6235,0,0,78.49,2492,2355,鼎盛里,NULL
0,4843,43,4886,6022,0,0,81.14,3398,1445,湖濱里,NULL
0,4831,52,4883,6138,0,0,79.55,3155,1676,惠來里,NULL
0,4849,32,4881,5870,0,0,83.15,4368,481,海勝里,NULL
0,4840,41,4881,6645,0,0,73.45,2486,2354,永安里,NULL
0,4834,42,4876,6234,0,0,78.22,2800,2034,山頂村,NULL
0,4827,38,4865,5930,0,0,82.04,3951,876,榮華里,NULL
0,4810,55,4865,6394,0,0,76.09,2749,2061,新仁里,NULL
0,4814,43,4857,6468,0,0,75.09,3538,1276,北昌村,NULL
0,4811,37,4848,6458,7987,80.86,75.07,3770,1041,西湖鄉,Xihu Township
0,4806,40,4846,5963,0,0,81.27,3011,1795,名山里,NULL
0,4812,33,4845,6007,0,0,80.66,4034,778,群英里,NULL
0,4789,55,4844,6263,0,0,77.34,3036,1753,內新里,NULL
0,4810,27,4837,6213,0,0,77.85,2539,2271,寶安里,NULL
0,4800,34,4834,5988,0,0,80.73,2980,1820,芝山里,NULL
0,4804,27,4831,6053,0,0,79.81,3376,1428,中興村,NULL
0,4793,38,4831,6020,0,0,80.25,2913,1880,裕民里,NULL
0,4802,28,4830,5909,0,0,81.74,3364,1438,金湖里,NULL
0,4789,37,4826,6198,0,0,77.86,3315,1474,東海村,NULL
0,4784,40,4824,5990,0,0,80.53,3592,1192,五峰里,NULL
0,4746,70,4816,6111,0,0,78.81,2929,1817,水湳里,NULL
0,4779,35,4814,6171,0,0,78.01,2028,2751,老爺里,NULL
0,4769,44,4813,5988,0,0,80.38,2791,1978,東興里,NULL
0,4786,27,4813,5953,0,0,80.85,2173,2613,社園里,NULL
0,4765,45,4810,5887,0,0,81.71,3697,1068,興旺里,NULL
0,4771,39,4810,6038,0,0,79.66,2354,2417,和平里,NULL
0,4768,39,4807,6323,7854,80.51,76.02,2251,2517,石碇鄉,Shijie Township
0,4751,47,4798,5951,0,0,80.63,2165,2586,永倫里,NULL
0,4760,35,4795,6142,0,0,78.07,2508,2252,中央里,NULL
0,4753,40,4793,6105,0,0,78.51,3117,1636,東光里,NULL
0,4747,44,4791,6947,0,0,68.97,3607,1140,豐榮里,NULL
0,4754,34,4788,6210,0,0,77.1,3230,1524,五福村,NULL
0,4741,43,4784,6327,0,0,75.61,3350,1391,復興里,NULL
0,4742,39,4781,6066,0,0,78.82,2182,2560,永芳村,NULL
0,4740,40,4780,6291,0,0,75.98,2293,2447,正強里,NULL
0,4733,38,4771,6427,8081,79.53,74.23,2032,2701,山上鄉,Shanshang Township
0,4720,50,4770,6037,0,0,79.01,3665,1055,松林村,NULL
0,4735,35,4770,5814,0,0,82.04,2991,1744,永隆里,NULL
0,4734,35,4769,6006,0,0,79.4,3145,1589,永欣里,NULL
0,4710,56,4766,5999,0,0,79.45,2486,2224,溪美里,NULL
0,4729,29,4758,6090,0,0,78.13,2824,1905,清水里,NULL
0,4738,19,4757,5797,0,0,82.06,3348,1390,保安里,NULL
0,4714,40,4754,6326,0,0,75.15,2884,1830,雙鳳里,NULL
0,4703,41,4744,5908,0,0,80.3,2414,2289,百齡里,NULL
0,4705,27,4732,5953,0,0,79.49,2974,1731,中平里,NULL
0,4701,29,4730,5983,0,0,79.06,3123,1578,文祥里,NULL
0,4683,44,4727,7621,10014,76.1,62.03,3431,1252,關山鎮,Guanshan Town
0,4683,44,4727,6019,0,0,78.53,3012,1671,樹德里,NULL
0,4679,42,4721,5925,0,0,79.68,2752,1927,海山里,NULL
0,4675,41,4716,5952,0,0,79.23,3154,1521,松竹里,NULL
0,4656,48,4704,6084,0,0,77.32,3726,930,至善里,NULL
0,4671,27,4698,6043,0,0,77.74,3291,1380,莊敬里,NULL
0,4644,51,4695,6441,0,0,72.89,2876,1768,永寧里,NULL
0,4659,36,4695,5807,0,0,80.85,2875,1784,合成里,NULL
0,4647,48,4695,5790,0,0,81.09,2799,1848,敦化里,NULL
0,4657,30,4687,6242,0,0,75.09,2302,2355,福全里,NULL
0,4632,51,4683,6113,0,0,76.61,2544,2088,南社里,NULL
0,4629,45,4674,6155,0,0,75.94,2965,1664,漳和里,NULL
0,4620,47,4667,6284,0,0,74.27,2506,2114,橋頭里,NULL
0,4627,38,4665,6109,0,0,76.36,2924,1703,竹林里,NULL
0,4619,42,4661,5734,0,0,81.29,3157,1462,黎平里,NULL
0,4623,36,4659,5750,0,0,81.03,3343,1280,三和里,NULL
0,4629,30,4659,5703,0,0,81.69,3173,1456,順興里,NULL
0,4599,49,4648,5890,7514,78.39,78.91,3459,1140,三灣鄉,Sanwan Township
0,4610,38,4648,5953,0,0,78.08,2109,2501,西灣里,NULL
0,4600,39,4639,6071,0,0,76.41,2291,2309,後庄村,NULL
0,4602,35,4637,5833,0,0,79.5,2708,1894,南屯里,NULL
0,4590,46,4636,5577,0,0,83.13,3519,1071,科園里,NULL
0,4589,47,4636,5923,0,0,78.27,2890,1699,吉龍里,NULL
0,4583,52,4635,5835,0,0,79.43,3513,1070,華新里,NULL
0,4592,30,4622,5726,0,0,80.72,3426,1166,明興里,NULL
0,4574,43,4617,5676,0,0,81.34,3242,1332,信義里,NULL
0,4580,36,4616,5836,0,0,79.1,2806,1774,仁德村,NULL
0,4580,35,4615,5891,0,0,78.34,3590,990,香坡里,NULL
0,4579,35,4614,5764,0,0,80.05,2757,1822,榮光里,NULL
0,4562,49,4611,5778,0,0,79.8,3401,1161,六合里,NULL
0,4559,46,4605,5852,0,0,78.69,2911,1648,同安里,NULL
0,4567,35,4602,5657,0,0,81.35,2214,2353,寶興里,NULL
0,4560,37,4597,5940,0,0,77.39,2313,2247,和德里,NULL
0,4565,29,4594,5614,0,0,81.83,3466,1099,景東里,NULL
0,4543,50,4593,6627,8259,80.24,69.31,2646,1897,甲仙鄉,Jiaxian Township
0,4542,48,4590,5936,0,0,77.32,2872,1670,三光里,NULL
0,4544,45,4589,6026,0,0,76.15,2311,2233,頂厝里,NULL
0,4537,47,4584,5822,0,0,78.74,2510,2027,新光里,NULL
0,4550,32,4582,6173,0,0,74.23,2395,2155,和美村,NULL
0,4549,19,4568,7860,9878,79.57,58.12,4329,220,連江縣,Lianjiang County
0,4536,30,4566,5638,0,0,80.99,3001,1535,安湖里,NULL
0,4526,38,4564,5917,0,0,77.13,2686,1840,峯廷里,NULL
0,4522,39,4561,5615,0,0,81.23,3361,1161,中正里,NULL
0,4516,41,4557,5715,0,0,79.74,2783,1733,忠福里,NULL
0,4513,41,4554,5554,0,0,81.99,2626,1887,福興里,NULL
0,4522,28,4550,5839,0,0,77.92,1946,2576,仁美村,NULL
0,4504,36,4540,5945,0,0,76.37,2422,2082,社口村,NULL
0,4495,39,4534,5532,0,0,81.96,3184,1311,惠安里,NULL
0,4499,34,4533,5634,0,0,80.46,3325,1174,萬美里,NULL
0,4493,40,4533,5630,0,0,80.52,2710,1783,豐林里,NULL
0,4486,44,4530,5878,0,0,77.07,2879,1607,何成里,NULL
0,4490,37,4527,5730,0,0,79.01,3004,1486,三民里,NULL
0,4451,59,4510,5689,0,0,79.28,2922,1529,忠勤里,NULL
0,4455,34,4489,6248,0,0,71.85,2750,1705,仁和里,NULL
0,4435,37,4472,6454,0,0,69.29,2915,1520,枇杷里,NULL
0,4425,44,4469,5784,0,0,77.26,2756,1669,文山里,NULL
0,4415,50,4465,5818,0,0,76.74,2430,1985,西盛里,NULL
0,4427,36,4463,5673,0,0,78.67,2622,1805,江寧里,NULL
0,4431,29,4460,5598,0,0,79.67,3122,1309,湖光里,NULL
0,4420,37,4457,5514,0,0,80.83,2960,1460,成福里,NULL
0,4417,39,4456,5873,0,0,75.87,2551,1866,勝利里,NULL
0,4417,37,4454,5690,0,0,78.28,3175,1242,新社里,NULL
0,4415,34,4449,5627,0,0,79.07,3253,1162,張北里,NULL
0,4408,29,4437,5689,0,0,77.99,2808,1600,天山里,NULL
0,4400,28,4428,5615,0,0,78.86,2853,1547,思源里,NULL
0,4398,24,4422,5426,0,0,81.5,3407,991,試院里,NULL
0,4369,51,4420,7087,8967,79.03,62.37,2867,1502,鹿野鄉,Luye Township
0,4391,28,4419,5824,0,0,75.88,1940,2451,大寮村,NULL
0,4382,36,4418,7534,9490,79.39,58.64,3020,1362,池上鄉,Chishang Township
0,4377,31,4408,5371,0,0,82.07,2462,1915,正義里,NULL
0,4360,46,4406,5523,0,0,79.78,2792,1568,義興里,NULL
0,4368,38,4406,5600,0,0,78.68,2444,1924,福華里,NULL
0,4359,38,4397,5592,0,0,78.63,2731,1628,南興里,NULL
0,4351,37,4388,5547,0,0,79.11,2852,1499,水尾里,NULL
0,4340,48,4388,5662,0,0,77.5,2513,1827,新起里,NULL
0,4341,43,4384,5765,0,0,76.05,2657,1684,大庄里,NULL
0,4347,36,4383,5802,0,0,75.54,2800,1547,民輝里,NULL
0,4339,40,4379,5413,0,0,80.9,3213,1126,秀景里,NULL
0,4346,29,4375,5483,0,0,79.79,2866,1480,碧山里,NULL
0,4336,37,4373,5534,0,0,79.02,2483,1853,平和里,NULL
0,4331,39,4370,5630,0,0,77.62,1809,2522,正義里,NULL
0,4325,42,4367,5599,0,0,78,2311,2014,和平里,NULL
0,4326,37,4363,5361,0,0,81.38,3024,1302,景慶里,NULL
0,4334,27,4361,5502,0,0,79.26,3371,963,興昌里,NULL
0,4318,40,4358,5496,0,0,79.29,2794,1524,何源里,NULL
0,4314,44,4358,5587,0,0,78,2502,1812,健行里,NULL
0,4338,19,4357,5573,0,0,78.18,3138,1200,麗林村,NULL
0,4316,39,4355,5729,0,0,76.02,2489,1827,橫峰村,NULL
0,4308,45,4353,5590,0,0,77.87,1959,2349,崑山里,NULL
0,4316,33,4349,5719,0,0,76.04,2609,1707,丹鳳里,NULL
0,4304,44,4348,5406,0,0,80.43,3021,1283,民福里,NULL
0,4298,50,4348,5807,0,0,74.88,2966,1332,寶山里,NULL
0,4306,41,4347,5755,0,0,75.53,2739,1567,頂街村,NULL
0,4322,25,4347,5815,0,0,74.75,2247,2075,三共里,NULL
0,4290,43,4333,5398,0,0,80.27,3117,1173,綠水里,NULL
0,4296,34,4330,5554,0,0,77.96,2851,1445,古莊里,NULL
0,4293,35,4328,5418,0,0,79.88,2920,1373,松友里,NULL
0,4277,39,4316,5443,0,0,79.29,2631,1646,大道里,NULL
0,4285,30,4315,5512,0,0,78.28,2961,1324,內興里,NULL
0,4274,35,4309,5312,0,0,81.12,2570,1704,德翠里,NULL
0,4283,24,4307,5527,0,0,77.93,3342,941,義村里,NULL
0,4252,55,4307,5435,0,0,79.25,2425,1827,光明里,NULL
0,4279,26,4305,5830,7784,74.9,73.84,4104,175,來義鄉,Laiyixiang
0,4268,36,4304,5330,0,0,80.75,2803,1465,復盛里,NULL
0,4261,39,4300,5664,0,0,75.92,2744,1517,敦和里,NULL
0,4253,46,4299,5914,8170,72.39,72.69,3703,550,尖石鄉,Jianshi Township
0,4249,48,4297,5796,0,0,74.14,3061,1188,會稽里,NULL
0,4265,31,4296,5298,0,0,81.09,2761,1504,西安里,NULL
0,4260,30,4290,5738,0,0,74.76,2480,1780,育平里,NULL
0,4266,23,4289,5409,0,0,79.29,2916,1350,自強里,NULL
0,4267,20,4287,5400,0,0,79.39,3015,1252,和安里,NULL
0,4254,27,4281,5839,0,0,73.32,2199,2055,永春里,NULL
0,4244,35,4279,8121,9747,83.32,52.69,3295,949,東河鄉,Donghe Township
0,4256,21,4277,5383,0,0,79.45,3343,913,新龍里,NULL
0,4243,31,4274,5305,0,0,80.57,2799,1444,吉利里,NULL
0,4235,36,4271,5229,0,0,81.68,3287,948,營北里,NULL
0,4228,43,4271,5189,0,0,82.31,3045,1183,湳中里,NULL
0,4237,30,4267,5352,0,0,79.73,2432,1805,忠孝里,NULL
0,4225,37,4262,5420,0,0,78.63,2666,1559,天母里,NULL
0,4209,53,4262,5602,0,0,76.08,2327,1882,祥興里,NULL
0,4223,37,4260,5515,0,0,77.24,2956,1267,龍圖里,NULL
0,4225,34,4259,5335,0,0,79.83,2299,1926,舊佳里,NULL
0,4204,50,4254,5516,0,0,77.12,2800,1404,忠孝里,NULL
0,4218,33,4251,5422,0,0,78.4,1973,2245,文山里,NULL
0,4207,41,4248,5476,0,0,77.57,2759,1448,清溪里,NULL
0,4202,46,4248,5342,0,0,79.52,2164,2038,太平里,NULL
0,4215,26,4241,5433,0,0,78.06,2360,1855,後港里,NULL
0,4208,33,4241,5450,0,0,77.82,2142,2066,和順里,NULL
0,4199,41,4240,5376,0,0,78.87,2350,1849,三村里,NULL
0,4185,39,4224,5355,0,0,78.88,2897,1288,新安里,NULL
0,4190,33,4223,5256,0,0,80.35,2410,1780,行善里,NULL
0,4176,47,4223,5533,0,0,76.32,2326,1850,裕民里,NULL
0,4179,40,4219,5541,0,0,76.14,2713,1466,車層里,NULL
0,4183,32,4215,5443,0,0,77.44,2359,1824,水碓村,NULL
0,4179,33,4212,5258,0,0,80.11,2789,1390,雲林里,NULL
0,4171,40,4211,5225,0,0,80.59,2451,1720,仁美里,NULL
0,4180,31,4211,5406,0,0,77.89,2429,1751,永館里,NULL
0,4164,43,4207,5371,0,0,78.33,2461,1703,大智里,NULL
0,4165,41,4206,5412,0,0,77.72,2376,1789,立德里,NULL
0,4169,32,4201,5146,0,0,81.64,2440,1729,蘭興里,NULL
0,4171,29,4200,5193,0,0,80.88,2516,1655,崇文里,NULL
0,4149,51,4200,5264,0,0,79.79,1942,2207,東門里,NULL
0,4160,39,4199,5464,0,0,76.85,2125,2035,鹿寮里,NULL
0,4157,34,4191,5426,0,0,77.24,1912,2245,新和村,NULL
0,4154,36,4190,5393,0,0,77.69,2773,1381,六寶村,NULL
0,4155,35,4190,5306,0,0,78.97,2211,1944,一德里,NULL
0,4165,20,4185,5114,0,0,81.83,3159,1006,興安里,NULL
0,4156,27,4183,5295,0,0,79,2884,1272,福德里,NULL
0,4144,35,4179,5380,0,0,77.68,2637,1507,安溪里,NULL
0,4139,39,4178,5214,0,0,80.13,3265,874,三重里,NULL
0,4147,30,4177,5229,0,0,79.88,2676,1471,金瑞里,NULL
0,4136,35,4171,6915,8649,79.95,60.32,2120,2016,滿州鄉,Manzhou Township
0,4128,42,4170,5277,0,0,79.02,2827,1301,芳和里,NULL
0,4141,28,4169,5298,0,0,78.69,2560,1581,開明里,NULL
0,4136,32,4168,5337,0,0,78.1,2570,1566,華德里,NULL
0,4136,31,4167,5367,0,0,77.64,2722,1414,高峰里,NULL
0,4104,52,4156,5596,0,0,74.27,2223,1881,二橋里,NULL
0,4129,26,4155,5199,0,0,79.92,2760,1369,中華里,NULL
0,4120,34,4154,5116,0,0,81.2,2833,1287,連城里,NULL
0,4114,40,4154,5218,0,0,79.61,2488,1626,新路村,NULL
0,4112,40,4152,5284,0,0,78.58,2336,1776,溫泉里,NULL
0,4129,23,4152,5447,0,0,76.23,1970,2159,店鎮里,NULL
0,4116,34,4150,5364,0,0,77.37,1815,2301,福興里,NULL
0,4113,30,4143,5151,0,0,80.43,2137,1976,華中里,NULL
0,4111,31,4142,5510,0,0,75.17,2879,1232,寶安里,NULL
0,4097,32,4129,5162,0,0,79.99,2937,1160,龍生里,NULL
0,4104,20,4124,5170,0,0,79.77,2854,1250,九如里,NULL
0,4088,36,4124,5477,0,0,75.3,2382,1706,中興里,NULL
0,4076,47,4123,5365,0,0,76.85,2500,1576,龜山村,NULL
0,4079,43,4122,5173,0,0,79.68,1915,2164,鄰江里,NULL
0,4072,40,4112,5421,0,0,75.85,2594,1478,松和里,NULL
0,4058,51,4109,5542,0,0,74.14,2519,1539,草湳里,NULL
0,4075,32,4107,5089,0,0,80.7,2529,1546,天福里,NULL
0,4074,33,4107,5373,0,0,76.44,2464,1610,北興里,NULL
0,4064,39,4103,5401,0,0,75.97,2799,1265,忠義里,NULL
0,4088,15,4103,5547,0,0,73.97,2580,1508,平和里,NULL
0,4074,28,4102,5409,0,0,75.84,2798,1276,厚德里,NULL
0,4041,59,4100,5322,0,0,77.04,2245,1796,大園村,NULL
0,4056,39,4095,5069,0,0,80.79,2169,1887,光陽里,NULL
0,4036,49,4085,5047,0,0,80.94,3006,1030,寶福里,NULL
0,4042,43,4085,5107,0,0,79.99,2240,1802,松江里,NULL
0,4053,30,4083,5171,0,0,78.96,2556,1497,同榮里,NULL
0,4054,28,4082,5061,0,0,80.66,2878,1176,德和里,NULL
0,4053,28,4081,5116,0,0,79.77,2408,1645,永功里,NULL
0,4033,42,4075,5254,0,0,77.56,2322,1711,宜欣里,NULL
0,4035,40,4075,5115,0,0,79.67,2206,1829,東英里,NULL
0,4040,34,4074,5270,0,0,77.31,2229,1811,義仁村,NULL
0,4035,36,4071,5025,0,0,81.01,2209,1826,田安里,NULL
0,4039,29,4068,5313,0,0,76.57,2484,1555,建興里,NULL
0,4041,27,4068,5136,0,0,79.21,1950,2091,社子里,NULL
0,4022,41,4063,5324,0,0,76.31,2409,1613,忠誠里,NULL
0,4042,20,4062,5586,7250,77.05,72.72,3562,480,三地門鄉,Sandimen Township
0,4017,37,4054,5434,0,0,74.6,2527,1490,沙崙里,NULL
0,4013,40,4053,5223,0,0,77.6,2579,1434,永興里,NULL
0,4020,33,4053,5080,0,0,79.78,2387,1633,埤頂里,NULL
0,4017,35,4052,7384,9147,80.73,54.88,2255,1762,白沙鄉,Baisha Township
0,4018,33,4051,5050,0,0,80.22,2677,1341,復興里,NULL
0,4012,38,4050,4976,0,0,81.39,2613,1399,金泰里,NULL
0,4012,38,4050,5212,0,0,77.71,2555,1457,長青里,NULL
0,4007,43,4050,5156,0,0,78.55,2332,1675,保安里,NULL
0,4012,34,4046,5017,0,0,80.65,2912,1100,興得里,NULL
0,4016,29,4045,5319,0,0,76.05,2276,1740,頂庄里,NULL
0,4010,30,4040,5032,0,0,80.29,2994,1016,新生里,NULL
0,3999,38,4037,6052,0,0,66.71,2150,1849,慈祐里,NULL
0,3992,41,4033,5024,0,0,80.27,2440,1552,廣德里,NULL
0,3988,40,4028,5187,0,0,77.66,2072,1916,集英里,NULL
0,3997,30,4027,5072,0,0,79.4,2240,1757,民權里,NULL
0,4006,19,4025,5169,0,0,77.87,2907,1099,群賢里,NULL
0,3994,31,4025,5158,0,0,78.03,2540,1454,本堂村,NULL
0,3991,32,4023,5216,0,0,77.13,1839,2152,南保村,NULL
0,3980,41,4021,5182,0,0,77.6,2349,1631,何仁里,NULL
0,3966,51,4017,5530,0,0,72.64,2906,1060,慶豐村,NULL
0,3971,34,4005,5069,0,0,79.01,2271,1700,通化里,NULL
0,3970,33,4003,5529,6620,83.52,72.4,1644,2326,坪林鄉,Pinglin Township
0,3965,32,3997,5030,0,0,79.46,2586,1379,大業里,NULL
0,3952,41,3993,5196,0,0,76.85,2094,1858,劉厝里,NULL
0,3949,37,3986,4990,0,0,79.88,2507,1442,舊社里,NULL
0,3951,28,3979,4870,0,0,81.7,3256,695,忠純里,NULL
0,3952,27,3979,4944,0,0,80.48,2563,1389,東門里,NULL
0,3943,31,3974,5133,0,0,77.42,2026,1917,成功里,NULL
0,3942,30,3972,5041,0,0,78.79,2399,1543,南門里,NULL
0,3942,30,3972,5011,0,0,79.27,2122,1820,大同里,NULL
0,3943,28,3971,4959,0,0,80.08,2079,1864,和興里,NULL
0,3943,24,3967,5563,0,0,71.31,2686,1257,大城里,NULL
0,3937,27,3964,4944,0,0,80.18,2802,1135,三義里,NULL
0,3924,40,3964,5150,0,0,76.97,2464,1460,山腳村,NULL
0,3934,29,3963,4921,0,0,80.53,2691,1243,秀湖里,NULL
0,3927,33,3960,5382,0,0,73.58,2584,1343,大東村,NULL
0,3929,30,3959,5899,0,0,67.11,2964,965,中興里,NULL
0,3911,47,3958,5059,0,0,78.24,2185,1726,港嘴里,NULL
0,3922,34,3956,4867,0,0,81.28,1882,2040,田中里,NULL
0,3927,27,3954,5963,0,0,66.31,2666,1261,龍福里,NULL
0,3932,21,3953,4854,0,0,81.44,2495,1437,智仁里,NULL
0,3922,28,3950,5777,0,0,68.37,2893,1029,新生里,NULL
0,3915,33,3948,4948,0,0,79.79,2616,1299,惠中里,NULL
0,3918,26,3944,4736,0,0,83.28,2743,1175,興福里,NULL
0,3897,47,3944,4879,0,0,80.84,2502,1395,三厝里,NULL
0,3914,29,3943,4923,0,0,80.09,2578,1336,興雅里,NULL
0,3906,37,3943,5117,0,0,77.06,2199,1707,仁德里,NULL
0,3923,20,3943,5009,0,0,78.72,2021,1902,竹圍里,NULL
0,3889,51,3940,5007,0,0,78.69,1976,1913,中福村,NULL
0,3907,32,3939,4940,0,0,79.74,2648,1259,華東里,NULL
0,3888,44,3932,4826,0,0,81.48,2869,1019,鵬程里,NULL
0,3887,34,3921,4891,0,0,80.17,2269,1618,復勢里,NULL
0,3883,37,3920,6504,0,0,60.27,2251,1632,社後里,NULL
0,3878,40,3918,5250,0,0,74.63,2532,1346,三和里,NULL
0,3886,28,3914,5323,0,0,73.53,2357,1529,御史里,NULL
0,3879,35,3914,4836,0,0,80.93,2241,1638,中興里,NULL
0,3876,37,3913,5368,0,0,72.89,3001,875,仁里村,NULL
0,3868,43,3911,5072,0,0,77.11,2260,1608,昇平里,NULL
0,3877,33,3910,4737,0,0,82.54,2066,1811,重慶里,NULL
0,3874,32,3906,5003,6160,81.22,78.07,2471,1403,峨眉鄉,Emei Township
0,3874,31,3905,4997,0,0,78.15,2156,1718,田心里,NULL
0,3870,34,3904,5332,0,0,73.22,2630,1240,和慶里,NULL
0,3873,31,3904,5245,0,0,74.43,1955,1918,仁德村,NULL
0,3850,52,3902,5162,0,0,75.59,2594,1256,建倫里,NULL
0,3877,24,3901,5126,0,0,76.1,2103,1774,平林里,NULL
0,3871,22,3893,4828,0,0,80.63,2413,1458,福林里,NULL
0,3849,44,3893,6028,0,0,64.58,2401,1448,過田里,NULL
0,3851,41,3892,4885,0,0,79.67,2383,1468,公正里,NULL
0,3870,20,3890,4868,0,0,79.91,2443,1427,華山里,NULL
0,3853,36,3889,4691,0,0,82.9,2874,979,紫雲里,NULL
0,3850,36,3886,4834,0,0,80.39,2351,1499,積穗里,NULL
0,3863,21,3884,4893,0,0,79.38,2188,1675,西安里,NULL
0,3847,35,3882,4983,0,0,77.9,2531,1316,敦煌里,NULL
0,3834,47,3881,4986,0,0,77.84,2036,1798,懷翠里,NULL
0,3844,36,3880,4863,0,0,79.79,2265,1579,中港里,NULL
0,3830,48,3878,4906,0,0,79.05,2053,1777,溪頭里,NULL
0,3840,35,3875,4917,0,0,78.81,1695,2145,南成里,NULL
0,3841,32,3873,5597,0,0,69.2,2665,1176,龍鳳里,NULL
0,3843,29,3872,4758,0,0,81.38,2999,844,龍昌里,NULL
0,3833,38,3871,5158,0,0,75.05,2228,1605,菓林村,NULL
0,3847,23,3870,5115,0,0,75.66,2515,1332,敦安里,NULL
0,3837,32,3869,4953,0,0,78.11,2050,1787,菜園里,NULL
0,3832,34,3866,5043,0,0,76.66,2325,1507,慈文里,NULL
0,3829,37,3866,4909,0,0,78.75,1871,1958,富光里,NULL
0,3835,29,3864,5412,0,0,71.4,2697,1138,埔坪村,NULL
0,3828,34,3862,4942,0,0,78.15,2666,1162,龍鳳里,NULL
0,3829,33,3862,5018,0,0,76.96,2156,1673,長安里,NULL
0,3830,32,3862,4970,0,0,77.71,2118,1712,力行里,NULL
0,3827,31,3858,4880,0,0,79.06,2680,1147,龍坡里,NULL
0,3818,38,3856,4984,0,0,77.37,2329,1489,延和里,NULL
0,3833,22,3855,4757,0,0,81.04,2759,1074,景華里,NULL
0,3811,40,3851,4913,0,0,78.38,2306,1505,朱馥里,NULL
0,3810,34,3844,4834,0,0,79.52,2457,1353,頂東里,NULL
0,3810,34,3844,5125,0,0,75,2310,1500,南港里,NULL
0,3809,32,3841,4917,0,0,78.12,2401,1408,龍源村,NULL
0,3803,37,3840,5270,0,0,72.87,1842,1961,新街里,NULL
0,3801,38,3839,4903,0,0,78.3,2449,1352,三和里,NULL
0,3797,42,3839,5105,0,0,75.2,2272,1525,中心里,NULL
0,3802,34,3836,4939,0,0,77.67,2182,1620,公館里,NULL
0,3789,44,3833,4885,0,0,78.46,2516,1273,德安里,NULL
0,3796,32,3828,4858,0,0,78.8,2241,1555,立基里,NULL
0,3808,20,3828,4902,0,0,78.09,1926,1882,鎮西里,NULL
0,3791,36,3827,4631,0,0,82.64,2595,1196,力行里,NULL
0,3792,35,3827,5450,0,0,70.22,1883,1909,寶珠里,NULL
0,3788,35,3823,4740,0,0,80.65,2240,1548,瑞竹里,NULL
0,3789,32,3821,7321,8866,82.57,52.19,3010,779,長濱鄉,Changbin Township
0,3797,22,3819,4714,0,0,81.01,1981,1816,本元里,NULL
0,3781,37,3818,4982,0,0,76.64,2412,1369,百福里,NULL
0,3787,31,3818,4857,0,0,78.61,1995,1792,興東里,NULL
0,3787,30,3817,4799,0,0,79.54,2411,1376,中山里,NULL
0,3777,38,3815,5037,0,0,75.74,2119,1658,清和里,NULL
0,3786,26,3812,4685,0,0,81.37,2753,1033,忠誠里,NULL
0,3776,35,3811,4815,0,0,79.15,2040,1736,德華里,NULL
0,3777,33,3810,4660,0,0,81.76,1951,1826,瑞祥里,NULL
0,3776,31,3807,4909,0,0,77.55,2286,1490,惠來里,NULL
0,3786,20,3806,4998,0,0,76.15,2061,1725,會社村,NULL
0,3755,50,3805,5291,0,0,71.91,1836,1919,和興村,NULL
0,3765,38,3803,5075,0,0,74.94,2214,1551,新庄村,NULL
0,3763,40,3803,4697,0,0,80.97,2198,1565,四育里,NULL
0,3775,26,3801,4633,0,0,82.04,2334,1441,港墘里,NULL
0,3773,27,3800,4761,0,0,79.82,2527,1246,莊敬里,NULL
0,3755,39,3794,4678,0,0,81.1,2650,1105,復興里,NULL
0,3763,29,3792,4911,0,0,77.21,2405,1358,平德里,NULL
0,3753,38,3791,4838,0,0,78.36,2541,1212,安和里,NULL
0,3756,35,3791,4735,0,0,80.06,2107,1649,中陽里,NULL
0,3746,42,3788,4884,0,0,77.56,1953,1793,永康里,NULL
0,3758,28,3786,4763,0,0,79.49,1798,1960,老師里,NULL
0,3741,44,3785,4906,0,0,77.15,1918,1823,埔心村,NULL
0,3762,21,3783,4677,0,0,80.89,2412,1350,東光里,NULL
0,3749,30,3779,4607,0,0,82.03,2226,1523,盛昌里,NULL
0,3757,21,3778,4770,0,0,79.2,1881,1876,文元里,NULL
0,3743,31,3774,4913,0,0,76.82,2160,1583,忠明里,NULL
0,3746,26,3772,4653,0,0,81.07,2276,1470,景行里,NULL
0,3732,27,3759,4871,0,0,77.17,2269,1463,進士里,NULL
0,3725,32,3757,4753,0,0,79.04,2697,1028,西平里,NULL
0,3728,24,3752,4670,0,0,80.34,2878,850,玫瑰里,NULL
0,3707,41,3748,4873,0,0,76.91,2411,1296,振興里,NULL
0,3701,42,3743,4667,0,0,80.2,2203,1498,田心里,NULL
0,3709,33,3742,4664,0,0,80.23,2901,808,金山里,NULL
0,3719,23,3742,4708,0,0,79.48,2484,1235,內湖里,NULL
0,3718,24,3742,5059,0,0,73.97,1572,2146,鎮山里,NULL
0,3710,31,3741,4894,0,0,76.44,1977,1733,大橋里,NULL
0,3710,30,3740,4693,0,0,79.69,2782,928,寶安里,NULL
0,3694,45,3739,4698,0,0,79.59,3145,549,中興村,NULL
0,3707,30,3737,4649,0,0,80.38,2249,1458,三玉里,NULL
0,3707,29,3736,4776,0,0,78.22,2277,1430,崙平里,NULL
0,3708,27,3735,4696,0,0,79.54,2293,1415,中德里,NULL
0,3697,36,3733,4752,0,0,78.56,2418,1279,通安里,NULL
0,3703,29,3732,5752,0,0,64.88,2453,1250,龍安里,NULL
0,3696,35,3731,4735,0,0,78.8,2025,1671,糖廍里,NULL
0,3708,22,3730,5079,0,0,73.44,2246,1462,富寮里,NULL
0,3697,33,3730,4761,0,0,78.34,2005,1692,中美里,NULL
0,3688,39,3727,4766,0,0,78.2,1755,1933,大港里,NULL
0,3689,36,3725,4972,0,0,74.92,2308,1381,全興村,NULL
0,3687,37,3724,4702,0,0,79.2,2129,1558,文元里,NULL
0,3705,18,3723,4842,0,0,76.89,1988,1717,新生里,NULL
0,3677,45,3722,4707,0,0,79.07,2237,1440,土庫里,NULL
0,3684,38,3722,4705,0,0,79.11,1538,2146,觀音村,NULL
0,3695,25,3720,4790,0,0,77.66,2195,1500,後協里,NULL
0,3680,36,3716,4933,0,0,75.33,2498,1182,高山里,NULL
0,3671,41,3712,4555,0,0,81.49,2518,1153,自強里,NULL
0,3679,31,3710,4858,0,0,76.37,2557,1122,德安里,NULL
0,3675,34,3709,4775,0,0,77.68,1826,1849,金華里,NULL
0,3681,27,3708,4588,0,0,80.82,1438,2243,新中里,NULL
0,3666,41,3707,5918,0,0,62.64,2090,1576,行政里,NULL
0,3669,34,3703,4787,0,0,77.36,2141,1528,溪洲里,NULL
0,3675,27,3702,4906,0,0,75.46,1946,1729,車店里,NULL
0,3650,51,3701,5016,0,0,73.78,2240,1410,龍泉村,NULL
0,3665,36,3701,5035,0,0,73.51,2202,1463,舊城村,NULL
0,3662,35,3697,4902,0,0,75.42,2059,1603,尖山里,NULL
0,3674,21,3695,4948,0,0,74.68,2913,761,興業里,NULL
0,3671,24,3695,4715,0,0,78.37,1852,1819,永清里,NULL
0,3668,26,3694,4749,0,0,77.78,2389,1279,平田里,NULL
0,3647,44,3691,4716,0,0,78.27,1861,1786,瓊林里,NULL
0,3650,40,3690,4861,0,0,75.91,2509,1141,曲溪里,NULL
0,3657,31,3688,4677,0,0,78.85,1938,1719,竹南里,NULL
0,3646,41,3687,5008,0,0,73.62,2448,1198,春社里,NULL
0,3651,34,3685,4937,0,0,74.64,1824,1827,開南里,NULL
0,3657,27,3684,4621,0,0,79.72,2458,1199,四維里,NULL
0,3650,32,3682,4848,0,0,75.95,2369,1281,文雅村,NULL
0,3639,42,3681,4808,0,0,76.56,2333,1306,宜佳里,NULL
0,3650,30,3680,4569,0,0,80.54,2413,1237,黎元里,NULL
0,3639,41,3680,4973,0,0,74,2335,1304,新坪里,NULL
0,3652,27,3679,4507,0,0,81.63,2733,919,江陵里,NULL
0,3647,32,3679,4787,0,0,76.85,1798,1849,善美里,NULL
0,3645,33,3678,4674,0,0,78.69,2055,1590,樓厝里,NULL
0,3647,30,3677,4605,0,0,79.85,1682,1965,瑞南里,NULL
0,3658,17,3675,4551,0,0,80.75,2132,1526,光興里,NULL
0,3639,35,3674,4638,0,0,79.22,2463,1176,福住里,NULL
0,3636,35,3671,4752,0,0,77.25,2303,1333,雙城里,NULL
0,3640,30,3670,4602,0,0,79.75,2289,1351,深丘里,NULL
0,3628,41,3669,4846,0,0,75.71,2043,1585,恆德里,NULL
0,3621,47,3668,4870,0,0,75.32,1981,1640,虎山里,NULL
0,3635,31,3666,4917,0,0,74.56,2761,874,主權里,NULL
0,3643,22,3665,4791,0,0,76.5,2090,1553,建安里,NULL
0,3622,40,3662,4756,0,0,77,2315,1307,平興里,NULL
0,3625,36,3661,4942,0,0,74.08,1953,1672,五王里,NULL
0,3620,36,3656,6647,8177,81.29,55,2047,1573,西嶼鄉,Xiyu Township
0,3628,28,3656,4806,0,0,76.07,1623,2005,西勢里,NULL
0,3632,23,3655,4695,0,0,77.85,1641,1991,塩洲里,NULL
0,3612,38,3650,4790,0,0,76.2,1832,1780,網寮里,NULL
0,3624,25,3649,4493,0,0,81.22,2509,1115,南山里,NULL
0,3619,30,3649,4569,0,0,79.86,2371,1248,金龍里,NULL
0,3613,36,3649,4595,0,0,79.41,1980,1633,海山里,NULL
0,3620,28,3648,4509,0,0,80.9,2620,1000,仁福里,NULL
0,3612,35,3647,4754,0,0,76.71,2220,1392,文武里,NULL
0,3620,26,3646,4605,0,0,79.17,2571,1049,義安里,NULL
0,3618,28,3646,4555,0,0,80.04,1756,1862,福中里,NULL
0,3611,32,3643,4676,0,0,77.91,2056,1555,龍鳳里,NULL
0,3611,31,3642,4552,0,0,80.01,2192,1419,承德里,NULL
0,3603,38,3641,4830,0,0,75.38,1939,1664,福樂村,NULL
0,3616,24,3640,4892,0,0,74.41,2594,1022,中和里,NULL
0,3607,32,3639,4541,0,0,80.14,2410,1197,逢福里,NULL
0,3620,18,3638,5060,6515,77.67,71.9,3232,388,瑪家鄉,Majia Township
0,3620,18,3638,4503,0,0,80.79,2352,1268,螢圃里,NULL
0,3596,40,3636,4550,0,0,79.91,1995,1601,埔墘里,NULL
0,3606,30,3636,4549,0,0,79.93,1954,1652,錦德里,NULL
0,3591,43,3634,4782,0,0,75.99,2179,1412,迴龍村,NULL
0,3595,36,3631,4860,0,0,74.71,1998,1597,平通里,NULL
0,3587,43,3630,4602,0,0,78.88,2144,1443,磐石里,NULL
0,3608,22,3630,4722,0,0,76.87,1894,1714,青山里,NULL
0,3596,30,3626,4568,0,0,79.38,2517,1079,金竹里,NULL
0,3608,17,3625,4767,0,0,76.04,2271,1337,大華村,NULL
0,3594,31,3625,4769,0,0,76.01,1694,1900,五常里,NULL
0,3584,40,3624,4856,0,0,74.63,2255,1329,春日里,NULL
0,3597,26,3623,4758,0,0,76.15,2165,1432,西岐里,NULL
0,3596,26,3622,4517,0,0,80.19,1249,2347,富洲里,NULL
0,3591,26,3617,4804,0,0,75.29,1863,1728,安寮里,NULL
0,3595,18,3613,4446,0,0,81.26,2528,1067,四維里,NULL
0,3574,39,3613,4968,0,0,72.73,2087,1487,光華里,NULL
0,3581,29,3610,4567,0,0,79.05,2012,1569,南鶯里,NULL
0,3571,38,3609,4379,0,0,82.42,2669,902,安平里,NULL
0,3575,34,3609,4491,0,0,80.36,1939,1636,桃源里,NULL
0,3581,27,3608,4735,0,0,76.2,2088,1493,西榮里,NULL
0,3581,27,3608,4704,0,0,76.7,2082,1499,正大里,NULL
0,3574,29,3603,4488,0,0,80.28,2797,777,北苗里,NULL
0,3567,34,3601,4621,0,0,77.93,2086,1481,五權里,NULL
0,3569,32,3601,4390,0,0,82.03,2069,1500,本上里,NULL
0,3576,24,3600,4364,0,0,82.49,2198,1378,全泰里,NULL
0,3578,22,3600,4573,0,0,78.72,2193,1385,新昌里,NULL
0,3558,38,3596,4296,0,0,83.71,3325,233,武陵里,NULL
0,3573,23,3596,4456,0,0,80.7,1921,1652,寶盛里,NULL
0,3565,29,3594,4689,0,0,76.65,2009,1556,田心村,NULL
0,3558,28,3586,4553,0,0,78.76,1736,1822,寶德里,NULL
0,3555,29,3584,4506,0,0,79.54,2065,1490,成功里,NULL
0,3554,30,3584,4846,0,0,73.96,1607,1947,華勝里,NULL
0,3551,29,3580,4452,0,0,80.41,2027,1524,壽德里,NULL
0,3537,42,3579,4428,0,0,80.83,1964,1573,楓樹里,NULL
0,3550,27,3577,4499,0,0,79.51,2264,1286,中正里,NULL
0,3524,51,3575,4617,0,0,77.43,2012,1512,福平里,NULL
0,3545,29,3574,4453,0,0,80.26,2399,1146,萬年里,NULL
0,3528,46,3574,4654,0,0,76.79,2087,1441,山德村,NULL
0,3541,25,3566,4576,0,0,77.93,2301,1240,東勢村,NULL
0,3528,38,3566,4563,0,0,78.15,2027,1501,信義里,NULL
0,3539,26,3565,4608,0,0,77.37,2065,1474,裕生里,NULL
0,3544,20,3564,4898,0,0,72.76,2042,1502,聖湖里,NULL
0,3534,29,3563,4385,0,0,81.25,2705,829,中央里,NULL
0,3527,36,3563,4587,0,0,77.68,2052,1475,永成里,NULL
0,3518,43,3561,4488,0,0,79.34,2265,1253,員林里,NULL
0,3524,33,3557,4457,0,0,79.81,2708,816,忠孝里,NULL
0,3534,23,3557,4424,0,0,80.4,2143,1391,松光里,NULL
0,3519,38,3557,4544,0,0,78.28,1916,1603,內定里,NULL
0,3519,35,3554,4636,0,0,76.66,2084,1435,茄苳里,NULL
0,3529,24,3553,4312,0,0,82.4,2430,1099,東山里,NULL
0,3518,35,3553,4421,0,0,80.37,2086,1432,華江里,NULL
0,3511,36,3547,4759,0,0,74.53,2584,927,國富里,NULL
0,3514,33,3547,4423,0,0,80.19,2173,1341,明德里,NULL
0,3503,43,3546,4301,0,0,82.45,2520,983,景安里,NULL
0,3492,53,3545,4495,0,0,78.87,2115,1377,平安里,NULL
0,3506,36,3542,4535,0,0,78.1,1826,1680,永樂里,NULL
0,3514,26,3540,4633,0,0,76.41,2131,1383,延平里,NULL
0,3520,20,3540,4593,0,0,77.07,1920,1600,光路里,NULL
0,3505,32,3537,4528,0,0,78.11,1688,1817,柳鄉里,NULL
0,3496,38,3534,4666,0,0,75.74,2069,1427,建國里,NULL
0,3506,26,3532,4599,0,0,76.8,2570,936,湖興里,NULL
0,3500,32,3532,4461,0,0,79.18,2321,1179,網溪里,NULL
0,3501,30,3531,4265,0,0,82.79,3052,449,龍東里,NULL
0,3508,22,3530,4277,0,0,82.53,2282,1226,聯成里,NULL
0,3505,21,3526,4457,0,0,79.11,2652,853,中山里,NULL
0,3487,39,3526,4471,0,0,78.86,2187,1300,永福里,NULL
0,3503,22,3525,4661,0,0,75.63,1941,1562,明昌里,NULL
0,3498,27,3525,4587,0,0,76.85,1876,1622,福民里,NULL
0,3494,30,3524,4479,0,0,78.68,1679,1815,六福里,NULL
0,3497,26,3523,4364,0,0,80.73,2263,1234,北山里,NULL
0,3485,37,3522,4671,0,0,75.4,2094,1391,竹營里,NULL
0,3500,21,3521,4581,0,0,76.86,2167,1333,建國里,NULL
0,3492,28,3520,4350,0,0,80.92,2449,1043,德行里,NULL
0,3484,34,3518,4710,0,0,74.69,1862,1622,草漯村,NULL
0,3491,26,3517,4560,0,0,77.13,2003,1488,信光里,NULL
0,3495,20,3515,4478,0,0,78.49,2489,1006,福林里,NULL
0,3484,31,3515,4689,0,0,74.96,2081,1403,虎溪里,NULL
0,3482,33,3515,4896,0,0,71.79,1776,1706,灣橋村,NULL
0,3491,21,3512,4494,0,0,78.15,1816,1675,安吉里,NULL
0,3484,28,3512,4367,0,0,80.42,1726,1758,新強里,NULL
0,3471,40,3511,4543,0,0,77.28,1931,1540,聚安里,NULL
0,3478,30,3508,4393,0,0,79.85,2357,1121,光明里,NULL
0,3471,35,3506,4365,0,0,80.32,2538,933,內南里,NULL
0,3470,35,3505,4530,0,0,77.37,2784,686,福麗里,NULL
0,3479,26,3505,4648,0,0,75.41,2329,1150,仁善里,NULL
0,3479,25,3504,4216,0,0,83.11,2490,989,永元里,NULL
0,3468,36,3504,4543,0,0,77.13,2044,1424,東陽里,NULL
0,3468,34,3502,4472,0,0,78.31,1890,1578,日和里,NULL
0,3485,16,3501,4665,0,0,75.05,1925,1560,三星里,NULL
0,3472,28,3500,4323,0,0,80.96,2497,975,美潭里,NULL
0,3461,39,3500,4658,0,0,75.14,2180,1281,新盛里,NULL
0,3478,22,3500,4628,0,0,75.63,1432,2046,安慶里,NULL
0,3470,29,3499,4501,0,0,77.74,2282,1188,幸福里,NULL
0,3479,19,3498,4319,0,0,80.99,2777,702,龍洲里,NULL
0,3467,31,3498,4522,0,0,77.36,1744,1723,永豐里,NULL
0,3472,25,3497,4372,0,0,79.99,2551,921,福和里,NULL
0,3470,26,3496,4521,0,0,77.33,1604,1866,鎮北里,NULL
0,3468,27,3495,4469,0,0,78.21,1683,1785,永樂里,NULL
0,3468,26,3494,4395,0,0,79.5,2403,1065,錦安里,NULL
0,3464,30,3494,4445,0,0,78.61,1844,1620,中庄里,NULL
0,3461,31,3492,4301,0,0,81.19,2625,836,忠貞里,NULL
0,3461,31,3492,4289,0,0,81.42,1936,1525,五全里,NULL
0,3453,35,3488,4869,5642,86.3,71.64,1639,1814,左鎮鄉,Zuozhen Township
0,3448,38,3486,4833,0,0,72.13,2344,1104,仁愛里,NULL
0,3452,34,3486,4400,0,0,79.23,1823,1629,純翠里,NULL
0,3457,27,3484,4569,0,0,76.25,2058,1399,忠政里,NULL
0,3461,22,3483,4507,0,0,77.28,2673,788,金溪里,NULL
0,3456,26,3482,4343,0,0,80.17,1584,1872,建南里,NULL
0,3450,28,3478,4504,0,0,77.22,1675,1775,新順里,NULL
0,3438,38,3476,4379,0,0,79.38,2045,1393,公民里,NULL
0,3441,34,3475,4385,0,0,79.25,1715,1726,富民里,NULL
0,3442,33,3475,4452,0,0,78.05,1299,2143,太子村,NULL
0,3452,22,3474,4253,0,0,81.68,2035,1417,麗山里,NULL
0,3448,25,3473,4305,0,0,80.67,2247,1201,廣福里,NULL
0,3447,25,3472,4435,0,0,78.29,1814,1633,泉南里,NULL
0,3433,37,3470,4444,0,0,78.08,2430,1003,湧光里,NULL
0,3441,28,3469,4337,0,0,79.99,2601,840,竹北里,NULL
0,3443,26,3469,4289,0,0,80.88,1851,1592,石牌里,NULL
0,3437,30,3467,4452,0,0,77.88,1782,1655,思源里,NULL
0,3443,24,3467,4402,0,0,78.76,1764,1679,仁德里,NULL
0,3435,31,3466,4262,0,0,81.32,2134,1301,前峰里,NULL
0,3423,40,3463,4558,0,0,75.98,1626,1797,群英村,NULL
0,3429,32,3461,4566,0,0,75.8,2264,1165,營盤村,NULL
0,3431,30,3461,4402,0,0,78.62,1977,1454,自強里,NULL
0,3429,28,3457,4556,0,0,75.88,2022,1407,上楓村,NULL
0,3434,19,3453,4359,0,0,79.22,2170,1264,永昌里,NULL
0,3411,35,3446,4914,5651,86.96,70.13,1821,1590,平溪鄉,Pingxi Township
0,3417,28,3445,4357,0,0,79.07,2102,1315,國光里,NULL
0,3431,14,3445,4382,0,0,78.62,1821,1610,安發里,NULL
0,3407,37,3444,4193,0,0,82.14,2398,1009,秀福里,NULL
0,3410,34,3444,4379,0,0,78.65,1775,1635,新福里,NULL
0,3411,32,3443,4430,0,0,77.72,1979,1432,玉山里,NULL
0,3412,30,3442,4247,0,0,81.05,2202,1210,錦和里,NULL
0,3415,27,3442,4457,0,0,77.23,2135,1280,民生里,NULL
0,3412,29,3441,4227,0,0,81.41,2325,1087,中溪里,NULL
0,3404,37,3441,4418,0,0,77.89,2072,1332,新福里,NULL
0,3387,53,3440,4514,0,0,76.21,2228,1159,日興里,NULL
0,3409,31,3440,4392,0,0,78.32,2006,1403,員福里,NULL
0,3412,26,3438,4408,0,0,77.99,2421,991,竹義里,NULL
0,3409,29,3438,4469,0,0,76.93,1635,1774,斯文里,NULL
0,3400,35,3435,4495,0,0,76.42,2371,1029,新平里,NULL
0,3406,28,3434,4301,0,0,79.84,1680,1726,瑞華里,NULL
0,3395,34,3429,4177,0,0,82.09,2677,718,龍岡里,NULL
0,3392,37,3429,4327,0,0,79.25,2038,1354,大豐里,NULL
0,3411,17,3428,4353,0,0,78.75,1809,1602,寶業里,NULL
0,3393,35,3428,4336,0,0,79.06,1634,1759,福順里,NULL
0,3397,28,3425,4317,0,0,79.34,1809,1588,青溪里,NULL
0,3396,28,3424,4537,0,0,75.47,2250,1146,三興里,NULL
0,3387,37,3424,4433,0,0,77.24,2123,1264,員仁里,NULL
0,3386,38,3424,4314,0,0,79.37,2046,1340,樹西里,NULL
0,3395,28,3423,4206,0,0,81.38,2510,885,新莊里,NULL
0,3389,32,3421,4599,0,0,74.39,2001,1388,中湖里,NULL
0,3385,34,3419,4190,0,0,81.6,2311,1074,新崙里,NULL
0,3397,22,3419,4193,0,0,81.54,2296,1101,博嘉里,NULL
0,3385,33,3418,4381,0,0,78.02,2107,1278,廣興里,NULL
0,3388,29,3417,4319,0,0,79.12,2351,1037,大德里,NULL
0,3380,37,3417,4450,0,0,76.79,1783,1597,華中里,NULL
0,3384,33,3417,4655,0,0,73.4,1439,1945,安富里,NULL
0,3372,44,3416,4452,0,0,76.73,2134,1238,福星里,NULL
0,3383,32,3415,4323,0,0,79,1836,1547,鷺江里,NULL
0,3373,40,3413,4307,0,0,79.24,2271,1102,富錦里,NULL
0,3379,34,3413,4346,0,0,78.53,1968,1411,福德里,NULL
0,3386,26,3412,4405,0,0,77.46,2317,1069,住安里,NULL
0,3378,33,3411,4142,0,0,82.35,2342,1036,秀和里,NULL
0,3393,18,3411,4341,0,0,78.58,2304,1089,青潭里,NULL
0,3381,30,3411,4383,0,0,77.82,2246,1135,金城里,NULL
0,3380,31,3411,4266,0,0,79.96,2013,1367,永春里,NULL
0,3376,35,3411,4561,0,0,74.79,2012,1364,中山里,NULL
0,3364,43,3407,4295,0,0,79.32,2184,1180,瓦磘里,NULL
0,3383,24,3407,4340,0,0,78.5,2107,1276,小東里,NULL
0,3385,20,3405,4782,0,0,71.2,2264,1121,勝利里,NULL
0,3379,26,3405,4445,0,0,76.6,1958,1421,國平里,NULL
0,3365,40,3405,4299,0,0,79.2,1691,1674,文南里,NULL
0,3384,19,3403,4239,0,0,80.28,2159,1225,湖元里,NULL
0,3368,33,3401,4424,0,0,76.88,2185,1183,大湖里,NULL
0,3369,32,3401,4407,0,0,77.17,1816,1553,大忠里,NULL
0,3366,33,3399,4207,0,0,80.79,2360,1006,中興里,NULL
0,3360,38,3398,4376,0,0,77.65,2051,1309,樂利里,NULL
0,3351,46,3397,4239,0,0,80.14,2620,731,秀明里,NULL
0,3357,40,3397,4287,0,0,79.24,2430,927,景平里,NULL
0,3363,31,3394,4345,0,0,78.11,2312,1051,松茂里,NULL
0,3355,34,3389,4658,0,0,72.76,2231,1124,南和里,NULL
0,3363,26,3389,4123,0,0,82.2,2131,1232,港都里,NULL
0,3364,25,3389,4356,0,0,77.8,1518,1846,灣中里,NULL
0,3355,33,3388,4447,0,0,76.19,2228,1127,家興村,NULL
0,3360,28,3388,4366,0,0,77.6,1377,1983,仁武村,NULL
0,3354,33,3387,4296,0,0,78.84,1886,1468,立賢里,NULL
0,3356,28,3384,4338,0,0,78.01,1758,1598,星明里,NULL
0,3357,25,3382,4233,0,0,79.9,2347,1010,三犁里,NULL
0,3356,26,3382,4176,0,0,80.99,1916,1440,福祉里,NULL
0,3338,42,3380,4257,0,0,79.4,2020,1318,民安里,NULL
0,3350,29,3379,4202,0,0,80.41,1976,1374,崇德里,NULL
0,3348,31,3379,4206,0,0,80.34,1593,1755,光能里,NULL
0,3360,18,3378,4371,0,0,77.28,2453,907,碇安里,NULL
0,3349,29,3378,4219,0,0,80.07,2260,1089,新榮里,NULL
0,3352,26,3378,4423,0,0,76.37,1676,1676,一德里,NULL
0,3354,21,3375,4191,0,0,80.53,2518,836,潭安里,NULL
0,3349,26,3375,4412,0,0,76.5,2053,1296,江北里,NULL
0,3352,23,3375,4114,0,0,82.04,1837,1515,吉慶里,NULL
0,3350,25,3375,4270,0,0,79.04,1696,1654,永福里,NULL
0,3344,30,3374,4291,0,0,78.63,1856,1488,玉光里,NULL
0,3345,28,3373,4473,0,0,75.41,2190,1155,竿蓁里,NULL
0,3344,29,3373,4239,0,0,79.57,1937,1407,天祿里,NULL
0,3341,28,3369,4222,0,0,79.8,2054,1287,新興里,NULL
0,3346,23,3369,4527,0,0,74.42,1802,1544,員山村,NULL
0,3328,37,3365,4349,0,0,77.37,2472,856,大和里,NULL
0,3337,28,3365,4212,0,0,79.89,1910,1427,楓樹村,NULL
0,3318,46,3364,4312,0,0,78.01,1723,1595,南村里,NULL
0,3344,19,3363,6022,0,0,55.85,3167,177,西門里,NULL
0,3345,18,3363,4209,0,0,79.9,1762,1583,鳳東里,NULL
0,3339,22,3361,4148,0,0,81.03,2256,1083,聖山里,NULL
0,3325,36,3361,4567,0,0,73.59,1834,1491,彭興里,NULL
0,3336,24,3360,4292,0,0,78.29,1722,1614,中吉里,NULL
0,3320,40,3360,4438,0,0,75.71,1704,1616,光文里,NULL
0,3336,21,3357,4303,0,0,78.02,2078,1258,長億里,NULL
0,3318,38,3356,4672,0,0,71.83,2715,603,東昌村,NULL
0,3322,31,3353,4206,0,0,79.72,2257,1065,錦華里,NULL
0,3316,34,3350,4250,0,0,78.82,1419,1897,大社村,NULL
0,3328,21,3349,4979,0,0,67.26,2775,553,西村里,NULL
0,3309,39,3348,4300,0,0,77.86,1891,1418,港尾里,NULL
0,3309,37,3346,4245,0,0,78.82,2342,967,永平里,NULL
0,3306,39,3345,4146,0,0,80.68,2351,955,景福里,NULL
0,3323,22,3345,4265,0,0,78.43,2298,1025,仁愛村,NULL
0,3308,37,3345,4137,0,0,80.86,2174,1134,佳和里,NULL
0,3321,23,3344,4155,0,0,80.48,2031,1290,百福里,NULL
0,3322,21,3343,4076,0,0,82.02,2107,1215,溝墘里,NULL
0,3307,34,3341,4316,0,0,77.41,1748,1559,南港里,NULL
0,3311,29,3340,4528,0,0,73.76,2141,1170,平山里,NULL
0,3313,26,3339,4202,0,0,79.46,2167,1146,松勇里,NULL
0,3313,26,3339,4337,0,0,76.99,1792,1521,虎尾里,NULL
0,3304,33,3337,4346,0,0,76.78,1732,1572,府南里,NULL
0,3316,18,3334,4316,0,0,77.25,2448,868,孝忠里,NULL
0,3291,40,3331,4542,0,0,73.34,2063,1228,新港村,NULL
0,3297,33,3330,4066,0,0,81.9,1821,1476,本安里,NULL
0,3302,27,3329,4234,0,0,78.63,2376,926,寶慶里,NULL
0,3297,32,3329,4293,0,0,77.54,1955,1342,墩東村,NULL
0,3298,30,3328,4259,0,0,78.14,1772,1526,栗林村,NULL
0,3304,23,3327,4252,0,0,78.25,2660,644,銅鑼村,NULL
0,3291,35,3326,4184,0,0,79.49,1943,1348,自強里,NULL
0,3291,34,3325,4455,0,0,74.64,2206,1085,永寧里,NULL
0,3287,35,3322,4395,0,0,75.59,1628,1659,社南村,NULL
0,3300,21,3321,4134,0,0,80.33,1721,1579,週美里,NULL
0,3298,22,3320,4217,0,0,78.73,1779,1519,新喜里,NULL
0,3287,29,3316,4419,0,0,75.04,1462,1825,阿蓮村,NULL
0,3280,31,3311,4059,0,0,81.57,2036,1244,福美里,NULL
0,3274,35,3309,4258,0,0,77.71,2130,1144,南勢里,NULL
0,3280,27,3307,4045,0,0,81.76,2447,833,民樂里,NULL
0,3277,28,3305,4104,0,0,80.53,2306,971,黎明里,NULL
0,3275,30,3305,4182,0,0,79.03,2167,1108,埔新村,NULL
0,3271,34,3305,4302,0,0,76.82,2058,1213,大同村,NULL
0,3266,37,3303,4266,0,0,77.43,2089,1177,光華里,NULL
0,3276,27,3303,4175,0,0,79.11,1913,1363,立言里,NULL
0,3274,28,3302,4055,0,0,81.43,2167,1107,保平里,NULL
0,3275,26,3301,4187,0,0,78.84,1980,1295,中成里,NULL
0,3255,45,3300,4885,0,0,67.55,2383,872,中城里,NULL
0,3266,34,3300,4279,0,0,77.12,2124,1142,長沙村,NULL
0,3268,31,3299,4436,0,0,74.37,1751,1517,東崎里,NULL
0,3275,24,3299,4856,0,0,67.94,1478,1797,溪心里,NULL
0,3268,29,3297,4112,0,0,80.18,2190,1078,金華里,NULL
0,3277,20,3297,4526,0,0,72.85,1981,1296,延和里,NULL
0,3270,25,3295,4110,0,0,80.17,1524,1746,大有里,NULL
0,3268,26,3294,4060,0,0,81.13,2195,1073,黎忠里,NULL
0,3263,31,3294,4115,0,0,80.05,2084,1179,新東里,NULL
0,3266,26,3292,4167,0,0,79,2020,1246,中和里,NULL
0,3262,27,3289,3914,0,0,84.03,2946,316,武功里,NULL
0,3267,22,3289,4129,0,0,79.66,2453,814,仁美里,NULL
0,3260,29,3289,4464,0,0,73.68,2007,1253,大村里,NULL
0,3260,29,3289,4294,0,0,76.6,1594,1666,成州村,NULL
0,3262,27,3289,4264,0,0,77.13,1524,1738,鎮南里,NULL
0,3262,26,3288,4157,0,0,79.1,1774,1488,八仙里,NULL
0,3253,32,3285,4246,0,0,77.37,2114,1139,文北里,NULL
0,3252,33,3285,4223,0,0,77.79,1777,1475,正道里,NULL
0,3251,32,3283,4709,0,0,69.72,1907,1344,何安里,NULL
0,3250,33,3283,4245,0,0,77.34,1694,1556,仁愛里,NULL
0,3263,19,3282,4059,0,0,80.86,2398,865,寶興里,NULL
0,3243,39,3282,4120,0,0,79.66,1882,1361,西安里,NULL
0,3249,32,3281,4178,0,0,78.53,2209,1040,振興里,NULL
0,3237,44,3281,4202,0,0,78.08,1922,1315,崇倫里,NULL
0,3249,30,3279,4207,0,0,77.94,2090,1159,松強里,NULL
0,3234,43,3277,4029,0,0,81.34,2234,1000,和平里,NULL
0,3257,18,3275,4352,0,0,75.25,1915,1342,六合里,NULL
0,3227,44,3271,4362,0,0,74.99,1857,1370,東勢里,NULL
0,3238,31,3269,4120,0,0,79.34,2033,1205,下廍里,NULL
0,3243,25,3268,4896,6246,78.39,66.75,1529,1714,枋山鄉,Lushan Township
0,3240,27,3267,4242,0,0,77.02,1840,1400,興亞里,NULL
0,3240,27,3267,4484,0,0,72.86,1492,1748,內坑村,NULL
0,3226,39,3265,4143,0,0,78.81,1735,1491,江翠里,NULL
0,3232,32,3264,4263,0,0,76.57,2238,994,建安里,NULL
0,3238,25,3263,4503,0,0,72.46,1445,1793,船頭里,NULL
0,3233,29,3262,4057,0,0,80.4,2228,1005,復興里,NULL
0,3229,33,3262,4145,0,0,78.7,1688,1541,明翠里,NULL
0,3209,51,3260,4326,0,0,75.36,1696,1513,南興里,NULL
0,3237,23,3260,4299,0,0,75.83,1367,1870,上崙村,NULL
0,3233,26,3259,4320,0,0,75.44,2052,1181,二和村,NULL
0,3230,28,3258,4076,0,0,79.93,2223,1007,大湖里,NULL
0,3223,35,3258,4293,0,0,75.89,2192,1031,瑞塘里,NULL
0,3228,30,3258,4429,0,0,73.56,1748,1480,龍津村,NULL
0,3231,26,3257,4157,0,0,78.35,1933,1298,南港里,NULL
0,3220,36,3256,4157,0,0,78.33,2282,938,平南里,NULL
0,3241,12,3253,4135,0,0,78.67,2162,1079,敦厚里,NULL
0,3219,33,3252,4150,0,0,78.36,1745,1474,玉清里,NULL
0,3232,18,3250,4113,0,0,79.02,2149,1083,龍雲里,NULL
0,3213,37,3250,4194,0,0,77.49,2066,1147,同心里,NULL
0,3227,23,3250,4116,0,0,78.96,1838,1389,忠義里,NULL
0,3208,41,3249,4043,0,0,80.36,2000,1208,福祥里,NULL
0,3233,16,3249,4000,0,0,81.23,1742,1491,銘德里,NULL
0,3208,38,3246,4236,0,0,76.63,1673,1535,自立里,NULL
0,3230,15,3245,4413,5662,77.94,73.53,2883,347,泰安鄉,Tai'an Township
0,3217,26,3243,4201,0,0,77.2,1915,1302,民安里,NULL
0,3216,26,3242,4077,0,0,79.52,2508,708,合興里,NULL
0,3224,18,3242,4100,0,0,79.07,2314,910,景新里,NULL
0,3222,20,3242,4137,0,0,78.37,2089,1133,新吉里,NULL
0,3213,28,3241,4111,0,0,78.84,1789,1424,新庄里,NULL
0,3212,28,3240,4136,0,0,78.34,1589,1623,武漢里,NULL
0,3219,20,3239,4189,0,0,77.32,1869,1350,西林村,NULL
0,3213,25,3238,4111,0,0,78.76,1990,1223,甲寅村,NULL
0,3205,33,3238,4285,0,0,75.57,1878,1327,成和里,NULL
0,3210,27,3237,4053,0,0,79.87,1584,1626,博惠里,NULL
0,3201,36,3237,4164,0,0,77.74,1515,1686,興珍村,NULL
0,3201,34,3235,4204,0,0,76.95,1594,1607,九曲村,NULL
0,3184,50,3234,4093,0,0,79.01,1732,1452,中和里,NULL
0,3206,27,3233,3966,0,0,81.52,2223,983,景美里,NULL
0,3200,32,3232,4133,0,0,78.2,2182,1018,永安里,NULL
0,3200,31,3231,4036,0,0,80.05,1636,1564,龍翠里,NULL
0,3208,22,3230,4001,0,0,80.73,1714,1494,西賢里,NULL
0,3187,43,3230,4112,0,0,78.55,1679,1508,新生里,NULL
0,3195,32,3227,4075,0,0,79.19,1806,1389,光華里,NULL
0,3198,29,3227,4068,0,0,79.33,1582,1616,寶龍里,NULL
0,3190,34,3224,4031,0,0,79.98,1612,1578,永德里,NULL
0,3198,25,3223,4023,0,0,80.11,2157,1041,日祥里,NULL
0,3203,20,3223,4092,0,0,78.76,1675,1528,和平里,NULL
0,3187,35,3222,4128,0,0,78.05,1859,1328,湳興里,NULL
0,3179,38,3217,4071,0,0,79.02,1728,1451,大豐村,NULL
0,3191,26,3217,4476,0,0,71.87,1348,1843,順安村,NULL
0,3180,36,3216,4137,0,0,77.74,1508,1672,臺上里,NULL
0,3190,26,3216,4100,0,0,78.44,1467,1723,大豐里,NULL
0,3185,29,3214,4086,0,0,78.66,1727,1458,中原里,NULL
0,3189,24,3213,4297,0,0,74.77,1954,1235,上雅村,NULL
0,3180,32,3212,4315,5159,83.64,74.44,2434,746,獅潭鄉,Shitan Township
0,3196,15,3211,3972,0,0,80.84,2344,852,錦泰里,NULL
0,3187,24,3211,3989,0,0,80.5,2112,1075,東明里,NULL
0,3170,38,3208,4447,0,0,72.14,2154,1016,幸福村,NULL
0,3179,29,3208,3968,0,0,80.85,1803,1376,林榮里,NULL
0,3183,22,3205,3949,0,0,81.16,2436,747,廣盛村,NULL
0,3188,17,3205,4047,0,0,79.19,2007,1181,太平里,NULL
0,3176,29,3205,4097,0,0,78.23,1733,1443,港德里,NULL
0,3175,29,3204,4056,0,0,78.99,1596,1579,北門里,NULL
0,3170,32,3202,3951,0,0,81.04,2155,1015,景聯里,NULL
0,3165,37,3202,4447,0,0,72,1964,1201,海湖村,NULL
0,3172,29,3201,4108,0,0,77.92,1733,1439,東埔里,NULL
0,3156,44,3200,4076,0,0,78.51,2565,591,大鄉里,NULL
0,3178,22,3200,3956,0,0,80.89,2078,1100,復中里,NULL
0,3182,18,3200,4096,0,0,78.13,2037,1145,中信里,NULL
0,3175,25,3200,4518,0,0,70.83,1815,1360,中山里,NULL
0,3172,27,3199,3986,0,0,80.26,1894,1278,雅祥里,NULL
0,3166,32,3198,4207,0,0,76.02,2098,1068,忠孝里,NULL
0,3179,19,3198,4114,0,0,77.73,2017,1162,鎮東里,NULL
0,3169,28,3197,4088,0,0,78.2,1696,1473,明勝里,NULL
0,3180,16,3196,4115,0,0,77.67,2068,1112,仁慈里,NULL
0,3166,29,3195,4297,0,0,74.35,1936,1230,建成里,NULL
0,3154,40,3194,4182,0,0,76.37,1860,1294,瑞井村,NULL
0,3166,28,3194,4172,0,0,76.56,1327,1839,三隆村,NULL
0,3170,23,3193,3860,0,0,82.72,1946,1224,民權里,NULL
0,3155,38,3193,4403,0,0,72.52,1861,1294,日南里,NULL
0,3157,34,3191,4174,0,0,76.45,2013,1144,南興里,NULL
0,3153,37,3190,4015,0,0,79.45,1823,1330,延和里,NULL
0,3162,26,3188,4192,0,0,76.05,1751,1411,民富里,NULL
0,3150,37,3187,4000,0,0,79.68,2081,1069,中山村,NULL
0,3159,25,3184,4133,0,0,77.04,2415,744,裕成里,NULL
0,3153,29,3182,4047,0,0,78.63,2153,1000,健行里,NULL
0,3156,24,3180,4344,0,0,73.2,1831,1325,山腳村,NULL
0,3159,20,3179,3937,0,0,80.75,2007,1152,瑞興里,NULL
0,3144,33,3177,4157,0,0,76.43,2125,1019,大華里,NULL
0,3151,26,3177,4083,0,0,77.81,2096,1055,大鵬里,NULL
0,3141,36,3177,4119,0,0,77.13,2080,1061,油車里,NULL
0,3144,31,3175,4067,0,0,78.07,1969,1175,境福里,NULL
0,3148,25,3173,4253,5790,73.45,74.61,2713,435,大同鄉,Datong Township
0,3142,31,3173,3961,0,0,80.11,2395,747,雙溪村,NULL
0,3148,25,3173,4860,0,0,65.29,1978,1170,朝陽里,NULL
0,3149,21,3170,4007,0,0,79.11,2196,953,同德里,NULL
0,3144,26,3170,3925,0,0,80.76,1946,1198,三民里,NULL
0,3135,33,3168,4161,0,0,76.14,2181,954,正聲里,NULL
0,3137,31,3168,4066,0,0,77.91,1913,1224,山犁里,NULL
0,3132,35,3167,4026,0,0,78.66,2464,668,仁福里,NULL
0,3131,36,3167,4000,0,0,79.17,1905,1226,天壽里,NULL
0,3141,26,3167,3986,0,0,79.45,1677,1464,興德里,NULL
0,3140,27,3167,4093,0,0,77.38,1546,1594,田心里,NULL
0,3142,24,3166,4129,0,0,76.68,1834,1308,新東里,NULL
0,3143,23,3166,4003,0,0,79.09,1695,1448,崇善里,NULL
0,3130,35,3165,4059,0,0,77.97,1912,1218,淡溝里,NULL
0,3135,29,3164,4245,0,0,74.53,1986,1149,金美村,NULL
0,3131,33,3164,4128,0,0,76.65,1850,1281,西德里,NULL
0,3140,23,3163,3963,0,0,79.81,2340,800,文山里,NULL
0,3132,28,3160,4243,0,0,74.48,1990,1142,金龍里,NULL
0,3138,21,3159,3766,0,0,83.88,2321,817,瑞光里,NULL
0,3135,24,3159,4233,0,0,74.63,1343,1792,海東里,NULL
0,3130,28,3158,4129,0,0,76.48,1686,1444,民安里,NULL
0,3118,39,3157,4194,0,0,75.27,2392,726,鳳凰村,NULL
0,3122,34,3156,4187,0,0,75.38,1979,1143,永富里,NULL
0,3130,26,3156,3971,0,0,79.48,1973,1157,橫科里,NULL
0,3124,32,3156,4175,0,0,75.59,1669,1455,鹿峰里,NULL
0,3127,27,3154,4070,0,0,77.49,1462,1665,鎮海里,NULL
0,3127,26,3153,4201,0,0,75.05,1981,1146,富岡里,NULL
0,3125,28,3153,4068,0,0,77.51,1615,1510,九芎里,NULL
0,3115,37,3152,3881,0,0,81.22,1934,1181,大仁里,NULL
0,3115,36,3151,3981,0,0,79.15,2228,887,泰和里,NULL
0,3119,31,3150,3998,0,0,78.79,1937,1182,復興里,NULL
0,3122,28,3150,4099,0,0,76.85,1813,1309,賴村里,NULL
0,3127,23,3150,3932,0,0,80.11,1653,1474,久堂村,NULL
0,3119,30,3149,4046,0,0,77.83,1898,1221,中興村,NULL
0,3120,28,3148,3919,0,0,80.33,2290,830,民族里,NULL
0,3123,24,3147,3866,0,0,81.4,2199,924,萬有里,NULL
0,3124,22,3146,3850,0,0,81.71,2153,971,文華里,NULL
0,3108,36,3144,4261,0,0,73.79,1370,1738,州南里,NULL
0,3115,28,3143,3909,0,0,80.4,2338,777,民權里,NULL
0,3116,26,3142,3984,0,0,78.87,1943,1173,成功村,NULL
0,3103,38,3141,3999,0,0,78.54,2160,943,雙連里,NULL
0,3116,25,3141,3842,0,0,81.75,1612,1504,竹西里,NULL
0,3108,33,3141,4200,0,0,74.79,1436,1672,東寧村,NULL
0,3102,38,3140,4082,0,0,76.92,1963,1139,福順里,NULL
0,3098,42,3140,4034,0,0,77.84,1764,1334,中原里,NULL
0,3118,20,3138,3950,0,0,79.44,1919,1199,萬安里,NULL
0,3116,21,3137,4192,0,0,74.83,1600,1516,順苓里,NULL
0,3103,33,3136,3937,0,0,79.65,2309,794,正和里,NULL
0,3094,42,3136,3975,0,0,78.89,1887,1207,大同里,NULL
0,3110,25,3135,3873,0,0,80.95,2136,974,秀山里,NULL
0,3111,24,3135,4292,0,0,73.04,1833,1278,南寮里,NULL
0,3112,22,3134,3824,0,0,81.96,2108,1004,萬祥里,NULL
0,3103,31,3134,3986,0,0,78.63,1794,1309,三和村,NULL
0,3091,42,3133,4018,0,0,77.97,1834,1257,文林里,NULL
0,3106,27,3133,4059,0,0,77.19,1523,1583,永順里,NULL
0,3105,26,3131,4088,0,0,76.59,2034,1071,圳頭里,NULL
0,3085,45,3130,3983,0,0,78.58,1956,1129,松安里,NULL
0,3105,24,3129,4189,0,0,74.7,1799,1306,短竹里,NULL
0,3105,22,3127,3976,0,0,78.65,2244,861,龍岡里,NULL
0,3102,25,3127,4073,0,0,76.77,1264,1838,光明里,NULL
0,3113,13,3126,3773,0,0,82.85,2023,1090,東華里,NULL
0,3100,26,3126,3845,0,0,81.3,1942,1158,中坡里,NULL
0,3095,30,3125,4144,0,0,75.41,1955,1140,保長里,NULL
0,3105,18,3123,3898,0,0,80.12,1534,1571,忠正里,NULL
0,3099,22,3121,3805,0,0,82.02,2283,816,得和里,NULL
0,3098,22,3120,3913,0,0,79.73,2182,916,復華里,NULL
0,3090,30,3120,3985,0,0,78.29,1910,1180,大豐里,NULL
0,3091,28,3119,3852,0,0,80.97,1879,1212,協和里,NULL
0,3094,25,3119,4014,0,0,77.7,1597,1497,富強里,NULL
0,3083,35,3118,3910,0,0,79.74,2303,780,愛勢村,NULL
0,3088,30,3118,3919,0,0,79.56,2074,1014,安泰里,NULL
0,3099,19,3118,3891,0,0,80.13,1939,1160,大福里,NULL
0,3093,25,3118,3831,0,0,81.39,1904,1189,鴻福里,NULL
0,3088,30,3118,3843,0,0,81.13,1748,1340,新生里,NULL
0,3094,23,3117,3850,0,0,80.96,1632,1462,東丘里,NULL
0,3087,29,3116,3907,0,0,79.75,2226,861,復旦里,NULL
0,3094,22,3116,3935,0,0,79.19,1959,1135,復興里,NULL
0,3074,42,3116,4059,0,0,76.77,1840,1234,東光里,NULL
0,3082,33,3115,3865,0,0,80.6,2258,824,萬盛里,NULL
0,3085,29,3114,4046,0,0,76.96,1955,1130,稻香里,NULL
0,3073,40,3113,3845,0,0,80.96,1723,1350,博愛里,NULL
0,3082,31,3113,4260,0,0,73.08,1570,1512,富福里,NULL
0,3086,26,3112,4679,6147,76.12,66.51,2428,658,阿里山鄉,Alishan Township
0,3085,26,3111,4013,0,0,77.52,1845,1240,貴和村,NULL
0,3085,26,3111,4142,0,0,75.11,1651,1434,忠和村,NULL
0,3086,25,3111,3942,0,0,78.92,1551,1535,永安里,NULL
0,3076,34,3110,3923,0,0,79.28,2113,963,新國里,NULL
0,3085,25,3110,3964,0,0,78.46,1386,1699,大德里,NULL
0,3074,36,3110,4078,0,0,76.26,1362,1712,理想里,NULL
0,3094,15,3109,3906,0,0,79.6,1886,1208,德音村,NULL
0,3073,34,3107,3948,0,0,78.7,864,2209,福安里,NULL
0,3082,24,3106,4039,0,0,76.9,1719,1363,西湖里,NULL
0,3076,29,3105,4056,5367,75.57,76.55,2124,952,烏來鄉,Wulai Township
0,3091,14,3105,3867,0,0,80.29,1740,1351,玉成里,NULL
0,3077,28,3105,3971,0,0,78.19,1649,1428,大有里,NULL
0,3086,18,3104,3767,0,0,82.4,1855,1231,漢生里,NULL
0,3076,28,3104,4074,0,0,76.19,1851,1225,文化村,NULL
0,3072,30,3102,3797,0,0,81.7,2670,402,東南里,NULL
0,3062,40,3102,4288,0,0,72.34,2293,769,吉安村,NULL
0,3079,22,3101,3931,0,0,78.89,1556,1523,蓬萊里,NULL
0,3087,13,3100,4252,0,0,72.91,1658,1429,光華里,NULL
0,3065,33,3098,4336,0,0,71.45,1730,1335,介壽里,NULL
0,3068,29,3097,3871,0,0,80.01,2031,1037,明德里,NULL
0,3071,26,3097,3873,0,0,79.96,1960,1111,工學里,NULL
0,3067,30,3097,3877,0,0,79.88,1529,1538,文昌里,NULL
0,3069,27,3096,4015,0,0,77.11,1506,1563,溪頂里,NULL
0,3063,32,3095,3988,0,0,77.61,1605,1458,廣興村,NULL
0,3059,35,3094,3974,0,0,77.86,2109,950,義民里,NULL
0,3068,26,3094,4078,0,0,75.87,1847,1221,豐田里,NULL
0,3068,25,3093,3909,0,0,79.13,1559,1509,雙園里,NULL
0,3064,27,3091,3967,0,0,77.92,1785,1279,安和里,NULL
0,3059,32,3091,4151,0,0,74.46,1731,1328,立仁里,NULL
0,3062,27,3089,3936,0,0,78.48,1806,1256,立泰里,NULL
0,3068,20,3088,4304,0,0,71.75,1875,1193,慈安里,NULL
0,3069,18,3087,3927,0,0,78.61,1808,1261,盧厝里,NULL
0,3068,19,3087,3963,0,0,77.9,1703,1365,新雅里,NULL
0,3060,25,3085,3901,0,0,79.08,1618,1442,民主里,NULL
0,3065,17,3082,4072,5813,70.05,75.69,2872,193,南澳鄉,South Australia Township
0,3060,22,3082,3710,0,0,83.07,1990,1070,明湖里,NULL
0,3052,30,3082,3990,0,0,77.24,1816,1236,頂福里,NULL
0,3058,23,3081,3877,0,0,79.47,2115,943,柴橋里,NULL
0,3055,26,3081,3991,0,0,77.2,2080,975,福雅里,NULL
0,3051,30,3081,4043,0,0,76.21,1256,1795,海佃里,NULL
0,3045,35,3080,3887,0,0,79.24,2250,795,信勢村,NULL
0,3044,31,3075,3847,0,0,79.93,1637,1407,尊賢里,NULL
0,3051,23,3074,3772,0,0,81.5,1944,1107,華豐里,NULL
0,3030,44,3074,3862,0,0,79.6,1894,1136,廟美里,NULL
0,3035,38,3073,3909,0,0,78.61,1895,1140,頭家村,NULL
0,3045,25,3070,4336,0,0,70.8,2176,869,新富里,NULL
0,3038,30,3068,3760,0,0,81.6,2154,884,和興里,NULL
0,3034,34,3068,3975,0,0,77.18,1918,1116,公平里,NULL
0,3033,34,3067,5513,7127,77.35,55.63,2413,620,大武鄉,Dawu Township
0,3039,28,3067,3835,0,0,79.97,2403,636,莊敬里,NULL
0,3043,24,3067,3942,0,0,77.8,2177,866,林興里,NULL
0,3041,25,3066,3702,0,0,82.82,2211,830,安順里,NULL
0,3043,22,3065,3907,0,0,78.45,2254,789,中聖里,NULL
0,3042,22,3064,3848,0,0,79.63,2376,666,海光里,NULL
0,3032,31,3063,3824,0,0,80.1,1402,1630,永發里,NULL
0,3040,20,3060,4131,0,0,74.07,1805,1235,東村里,NULL
0,3035,24,3059,3854,0,0,79.37,2409,626,富仁里,NULL
0,3043,15,3058,3839,0,0,79.66,1675,1368,興仁里,NULL
0,3038,20,3058,3717,0,0,82.27,1660,1378,文林里,NULL
0,3026,31,3057,3795,0,0,80.55,1795,1231,員山里,NULL
0,3033,24,3057,4015,0,0,76.14,1663,1370,華平里,NULL
0,3036,21,3057,4209,0,0,72.63,971,2065,鹽埔村,NULL
0,3025,31,3056,3880,0,0,78.76,1547,1478,中泰里,NULL
0,3021,32,3053,3799,0,0,80.36,1830,1191,何福里,NULL
0,3030,21,3051,3716,0,0,82.1,1917,1113,永明里,NULL
0,3020,30,3050,3947,0,0,77.27,2062,958,河堤里,NULL
0,3017,33,3050,3821,0,0,79.82,1953,1064,豐年里,NULL
0,3015,35,3050,3864,0,0,78.93,1694,1321,溪埧村,NULL
0,3022,25,3047,3757,0,0,81.1,1533,1489,忠德里,NULL
0,3012,34,3046,3691,0,0,82.53,2355,657,壽德里,NULL
0,3033,13,3046,3845,0,0,79.22,1874,1159,新益里,NULL
0,3024,21,3045,3922,0,0,77.64,1709,1315,日新里,NULL
0,3024,20,3044,3960,0,0,76.87,1412,1612,二甲里,NULL
0,3012,30,3042,3777,0,0,80.54,2360,652,維新里,NULL
0,3018,24,3042,3985,0,0,76.34,1543,1475,建功里,NULL
0,3004,37,3041,3841,0,0,79.17,1772,1232,安穗里,NULL
0,3019,21,3040,3719,0,0,81.74,2287,732,中安里,NULL
0,3010,28,3038,3713,0,0,81.82,2123,887,景仁里,NULL
0,3020,18,3038,4087,0,0,74.33,1377,1643,梅北村,NULL
0,3016,20,3036,3898,0,0,77.89,1636,1380,國華里,NULL
0,3007,28,3035,3848,0,0,78.87,1582,1425,中和里,NULL
0,3008,25,3033,3919,0,0,77.39,1652,1356,一心里,NULL
0,3012,20,3032,3773,0,0,80.36,1978,1034,明德里,NULL
0,2998,34,3032,3862,0,0,78.51,1770,1228,斗抵里,NULL
0,3006,24,3030,3768,0,0,80.41,1668,1338,忠孝里,NULL
0,2989,41,3030,3898,0,0,77.73,1445,1544,崙坪村,NULL
0,2999,30,3029,3714,0,0,81.56,1836,1163,民生里,NULL
0,3017,10,3027,3881,0,0,78,1348,1669,安泰里,NULL
0,2992,34,3026,4933,7135,69.14,61.34,2761,231,萬榮鄉,Wanrong Township
0,2999,27,3026,4061,0,0,74.51,2053,946,內寮里,NULL
0,2998,27,3025,3668,0,0,82.47,2248,750,仙水里,NULL
0,3003,22,3025,3796,0,0,79.69,2183,820,黎和里,NULL
0,3003,22,3025,4101,0,0,73.76,1999,1004,軍功里,NULL
0,2988,35,3023,4023,0,0,75.14,1450,1538,竹圍里,NULL
0,3000,22,3022,3829,0,0,78.92,1747,1253,綠堤里,NULL
0,2992,28,3020,3961,0,0,76.24,1934,1058,逢甲里,NULL
0,2995,24,3019,3974,0,0,75.97,2045,950,暖西里,NULL
0,2993,25,3018,3844,0,0,78.51,1835,1158,大雅村,NULL
0,2984,32,3016,3787,0,0,79.64,1633,1351,五福里,NULL
0,2975,38,3013,3714,0,0,81.13,2393,582,建功里,NULL
0,2986,27,3013,3878,0,0,77.69,1931,1055,南榮村,NULL
0,2992,21,3013,4160,0,0,72.43,1775,1217,新興里,NULL
0,2985,27,3012,3960,0,0,76.06,1905,1080,金龍里,NULL
0,2973,39,3012,3852,0,0,78.19,1375,1598,五權村,NULL
0,2989,21,3010,3724,0,0,80.83,2344,645,頭重里,NULL
0,2974,34,3008,3827,0,0,78.6,2058,916,仁美里,NULL
0,2988,20,3008,3907,0,0,76.99,1362,1626,新富里,NULL
0,2989,18,3007,3881,0,0,77.48,2111,878,富泰里,NULL
0,2966,39,3005,3702,0,0,81.17,1921,1045,福善里,NULL
0,2979,26,3005,3836,0,0,78.34,1771,1208,中正里,NULL
0,2966,38,3004,3799,0,0,79.07,2293,673,關東里,NULL
0,2983,21,3004,3713,0,0,80.9,1839,1144,德穗里,NULL
0,2975,28,3003,3941,0,0,76.2,2023,952,瑞慶里,NULL
0,2981,22,3003,3713,0,0,80.88,1531,1450,振興里,NULL
0,2972,29,3001,3836,0,0,78.23,1968,1004,平陽里,NULL
0,2979,21,3000,3646,0,0,82.28,2109,870,大同里,NULL
0,2976,23,2999,3842,0,0,78.06,1769,1207,永吉里,NULL
0,2969,29,2998,3812,0,0,78.65,2151,818,德盛村,NULL
0,2963,35,2998,3928,0,0,76.32,1995,968,台鳳里,NULL
0,2962,33,2995,3816,0,0,78.49,1532,1430,幸福里,NULL
0,2967,28,2995,3908,0,0,76.64,1214,1753,灣內村,NULL
0,2961,33,2994,4095,0,0,73.11,1429,1532,民榮里,NULL
0,2984,9,2993,5959,7014,84.96,50.23,2897,87,烈嶼鄉,Lieyu Township
0,2966,26,2992,3848,0,0,77.75,1790,1176,新生里,NULL
0,2962,30,2992,3910,0,0,76.52,1715,1247,成德里,NULL
0,2968,23,2991,3713,0,0,80.55,1901,1067,螢雪里,NULL
0,2949,41,2990,3979,0,0,75.14,2269,680,大信里,NULL
0,2956,34,2990,3891,0,0,76.84,1524,1432,永安里,NULL
0,2966,23,2989,3938,0,0,75.9,1925,1041,白沙村,NULL
0,2948,40,2988,3845,0,0,77.71,1925,1023,平昌里,NULL
0,2957,24,2981,3829,0,0,77.85,1619,1338,文平里,NULL
0,2959,21,2980,3693,0,0,80.69,1362,1597,瑞平里,NULL
0,2959,21,2980,3749,0,0,79.49,1170,1789,光榮里,NULL
0,2962,15,2977,3847,0,0,77.38,1856,1106,中正里,NULL
0,2946,31,2977,3990,0,0,74.61,1719,1227,健民里,NULL
0,2933,44,2977,3819,0,0,77.95,1380,1553,東湳里,NULL
0,2958,18,2976,3864,0,0,77.02,1543,1415,國泰里,NULL
0,2951,24,2975,3792,0,0,78.45,1989,962,正義里,NULL
0,2948,26,2974,3817,0,0,77.91,1430,1518,成功里,NULL
0,2939,34,2973,3650,0,0,81.45,2293,646,福南里,NULL
0,2946,27,2973,4352,0,0,68.31,1885,1061,山頂村,NULL
0,2939,32,2971,3841,0,0,77.35,1557,1382,中原里,NULL
0,2946,21,2967,3607,0,0,82.26,2139,807,永安里,NULL
0,2940,24,2964,3716,0,0,79.76,2114,826,法治里,NULL
0,2938,23,2961,3713,0,0,79.75,1426,1512,保安里,NULL
0,2930,29,2959,3686,0,0,80.28,1769,1161,德光里,NULL
0,2946,12,2958,3689,0,0,80.18,2098,848,六合里,NULL
0,2939,19,2958,3788,0,0,78.09,1894,1045,幸福里,NULL
0,2930,28,2958,3744,0,0,79.01,1880,1050,仁和里,NULL
0,2930,26,2956,3786,0,0,78.08,1816,1114,介壽里,NULL
0,2928,28,2956,3622,0,0,81.61,1810,1118,學士里,NULL
0,2928,27,2955,3686,0,0,80.17,1620,1308,全安里,NULL
0,2932,21,2953,3757,0,0,78.6,1353,1579,赤山村,NULL
0,2927,24,2951,3806,0,0,77.54,1786,1141,平和里,NULL
0,2922,29,2951,3629,0,0,81.32,1682,1240,明穗里,NULL
0,2925,26,2951,3954,0,0,74.63,1523,1402,成功村,NULL
0,2925,25,2950,3801,0,0,77.61,1627,1298,福興里,NULL
0,2928,19,2947,3796,0,0,77.63,1723,1205,南平里,NULL
0,2921,24,2945,3724,0,0,79.08,2197,724,合作里,NULL
0,2918,24,2942,4029,0,0,73.02,1427,1491,北斗村,NULL
0,2917,24,2941,3590,0,0,81.92,2195,722,潭墘里,NULL
0,2916,25,2941,3701,0,0,79.47,1360,1556,新興村,NULL
0,2915,24,2939,3824,0,0,76.86,1883,1032,仁昌里,NULL
0,2918,21,2939,3675,0,0,79.97,1711,1207,恆安里,NULL
0,2917,21,2938,3734,0,0,78.68,1871,1046,上德里,NULL
0,2908,28,2936,3823,0,0,76.8,1671,1237,大安里,NULL
0,2908,27,2935,4728,0,0,62.08,1733,1175,福德里,NULL
0,2909,23,2932,3748,0,0,78.23,2035,874,全安里,NULL
0,2897,33,2930,3873,0,0,75.65,1901,996,頂埔里,NULL
0,2891,38,2929,3773,0,0,77.63,1413,1478,慈祐里,NULL
0,2900,27,2927,3905,0,0,74.96,1468,1432,中榮里,NULL
0,2893,33,2926,3884,0,0,75.33,2056,837,梅溪里,NULL
0,2903,21,2924,3666,0,0,79.76,2250,653,勝利里,NULL
0,2893,31,2924,3886,0,0,75.24,1682,1211,王田村,NULL
0,2900,24,2924,3893,0,0,75.11,1563,1337,正苓里,NULL
0,2901,23,2924,3874,0,0,75.48,1486,1415,長安里,NULL
0,2904,19,2923,3685,0,0,79.32,1794,1110,東勢里,NULL
0,2883,40,2923,3923,0,0,74.51,1610,1273,彭福里,NULL
0,2897,24,2921,3879,4421,87.74,75.3,1258,1639,龍崎鄉,Longqixiang Township
0,2887,32,2919,4057,0,0,71.95,1978,909,砂子里,NULL
0,2892,27,2919,3677,0,0,79.39,1784,1108,錦興村,NULL
0,2902,17,2919,3918,0,0,74.5,1514,1388,榴中里,NULL
0,2898,20,2918,3785,0,0,77.09,1809,1089,和東里,NULL
0,2898,19,2917,3842,0,0,75.92,1133,1765,東寧村,NULL
0,2889,27,2916,3897,0,0,74.83,2109,780,勝安村,NULL
0,2881,35,2916,3677,0,0,79.3,1567,1314,汴洲里,NULL
0,2882,32,2914,3675,0,0,79.29,1720,1162,新民里,NULL
0,2894,20,2914,3582,0,0,81.35,1621,1273,仁德里,NULL
0,2888,26,2914,3693,0,0,78.91,1489,1399,西新里,NULL
0,2892,21,2913,3674,0,0,79.29,1647,1245,宏翠里,NULL
0,2883,28,2911,3639,0,0,79.99,2334,549,華安里,NULL
0,2884,27,2911,4476,0,0,65.04,2158,726,豐谷里,NULL
0,2888,23,2911,3885,0,0,74.93,1630,1258,德隆里,NULL
0,2879,30,2909,3607,0,0,80.65,1698,1181,莊敬里,NULL
0,2879,30,2909,3753,0,0,77.51,1487,1392,永安里,NULL
0,2880,28,2908,4090,0,0,71.1,1679,1201,玉田村,NULL
0,2871,37,2908,3904,0,0,74.49,1542,1329,四維里,NULL
0,2891,16,2907,3913,0,0,74.29,1952,939,埔頭村,NULL
0,2869,38,2907,3640,0,0,79.86,1751,1118,北興里,NULL
0,2884,20,2904,3987,0,0,72.84,1391,1493,鳳凰里,NULL
0,2874,29,2903,3723,0,0,77.97,1855,1019,中新里,NULL
0,2869,33,2902,3901,0,0,74.39,1769,1100,正義里,NULL
0,2880,22,2902,3977,0,0,72.97,1588,1292,仁和里,NULL
0,2881,21,2902,3698,0,0,78.47,1391,1490,內厝里,NULL
0,2873,29,2902,3916,0,0,74.11,1213,1660,塭南里,NULL
0,2874,26,2900,4010,0,0,72.32,1775,1099,晴光里,NULL
0,2873,27,2900,3894,0,0,74.47,1675,1198,湖東里,NULL
0,2867,33,2900,3617,0,0,80.18,1485,1382,大元里,NULL
0,2883,16,2899,4040,0,0,71.76,2139,744,新豐里,NULL
0,2877,20,2897,3586,0,0,80.79,2063,814,明德里,NULL
0,2876,21,2897,3575,0,0,81.03,2017,859,信義里,NULL
0,2873,23,2896,3727,0,0,77.7,2039,834,武崙里,NULL
0,2864,30,2894,3589,0,0,80.64,2013,851,景勤里,NULL
0,2873,21,2894,3537,0,0,81.82,1992,881,民生里,NULL
0,2864,30,2894,3662,0,0,79.03,1670,1194,五權里,NULL
0,2860,33,2893,3725,0,0,77.66,1429,1431,永吉里,NULL
0,2874,19,2893,3857,0,0,75.01,1329,1545,太平里,NULL
0,2844,48,2892,3708,0,0,77.99,1238,1606,神農村,NULL
0,2869,22,2891,3790,0,0,76.28,1933,936,大同村,NULL
0,2871,19,2890,3591,0,0,80.48,1625,1246,光田里,NULL
0,2854,35,2889,3733,0,0,77.39,1771,1083,建安里,NULL
0,2864,24,2888,3591,0,0,80.42,2025,839,三民里,NULL
0,2868,19,2887,3826,0,0,75.46,1383,1485,岡山里,NULL
0,2863,20,2883,3472,0,0,83.04,1954,909,萬福里,NULL
0,2854,29,2883,3826,0,0,75.35,1456,1398,王公里,NULL
0,2855,27,2882,3739,0,0,77.08,1652,1203,惠豐里,NULL
0,2864,18,2882,3731,0,0,77.24,1195,1669,明正里,NULL
0,2833,47,2880,4807,6551,73.38,59.91,2661,172,卓溪鄉,Zhuoxi Township
0,2858,22,2880,3800,0,0,75.79,1931,927,黃唐村,NULL
0,2852,22,2874,3621,0,0,79.37,2303,549,吉祥里,NULL
0,2845,29,2874,3557,0,0,80.8,1304,1541,保安里,NULL
0,2862,11,2873,3580,0,0,80.25,2380,482,軍功里,NULL
0,2848,25,2873,3645,0,0,78.82,1541,1307,國光里,NULL
0,2849,23,2872,3765,0,0,76.28,1920,929,精忠里,NULL
0,2856,16,2872,3539,0,0,81.15,1787,1069,內溝里,NULL
0,2836,35,2871,3813,0,0,75.3,1496,1340,光明里,NULL
0,2845,25,2870,3733,0,0,76.88,1498,1347,幸福里,NULL
0,2839,30,2869,3838,0,0,74.75,1713,1126,碧峰里,NULL
0,2850,19,2869,3686,0,0,77.84,1696,1154,後庄里,NULL
0,2837,30,2867,3673,0,0,78.06,1647,1190,長德里,NULL
0,2838,29,2867,3615,0,0,79.31,1556,1282,中庸里,NULL
0,2847,20,2867,3803,0,0,75.39,1404,1443,竹圍里,NULL
0,2837,29,2866,3620,0,0,79.17,1743,1094,信和里,NULL
0,2836,30,2866,3767,0,0,76.08,1613,1223,福安村,NULL
0,2831,34,2865,4897,0,0,58.51,2021,810,外南里,NULL
0,2850,15,2865,3671,0,0,78.04,1783,1067,福安里,NULL
0,2848,17,2865,3710,0,0,77.22,1781,1067,誠安里,NULL
0,2836,28,2864,3808,0,0,75.21,1201,1635,慶安村,NULL
0,2838,25,2863,3739,0,0,76.57,1723,1115,內湖里,NULL
0,2847,16,2863,3652,0,0,78.4,1675,1172,豐源里,NULL
0,2826,35,2861,3879,0,0,73.76,1832,994,新城里,NULL
0,2828,30,2858,3600,0,0,79.39,1944,884,聯興里,NULL
0,2838,19,2857,3650,0,0,78.27,1550,1288,正心里,NULL
0,2831,25,2856,3544,0,0,80.59,2082,749,水源里,NULL
0,2823,33,2856,3778,0,0,75.6,1848,975,賴旺里,NULL
0,2827,29,2856,3549,0,0,80.47,1603,1224,全德里,NULL
0,2829,27,2856,3513,0,0,81.3,1486,1343,興昌里,NULL
0,2833,22,2855,3565,0,0,80.08,1779,1054,成功里,NULL
0,2837,17,2854,3678,0,0,77.6,2084,753,北斗里,NULL
0,2833,21,2854,3713,0,0,76.87,1589,1244,彭厝里,NULL
0,2829,24,2853,3648,0,0,78.21,1935,894,華聲里,NULL
0,2832,21,2853,3709,0,0,76.92,1909,923,長興里,NULL
0,2829,24,2853,3560,0,0,80.14,1625,1204,長春里,NULL
0,2816,36,2852,3506,0,0,81.35,1632,1184,長安里,NULL
0,2826,24,2850,3708,0,0,76.86,1450,1376,社南村,NULL
0,2808,41,2849,3820,0,0,74.58,1876,932,廣仁里,NULL
0,2806,42,2848,3544,0,0,80.36,2140,666,華南里,NULL
0,2812,35,2847,3662,0,0,77.74,1625,1187,北峰里,NULL
0,2823,24,2847,3802,0,0,74.88,1598,1225,大楓村,NULL
0,2821,26,2847,3635,0,0,78.32,1450,1371,民生里,NULL
0,2821,25,2846,3720,0,0,76.51,1861,960,中平里,NULL
0,2814,31,2845,3602,0,0,78.98,2070,744,東門里,NULL
0,2820,24,2844,3664,0,0,77.62,1222,1598,東石里,NULL
0,2818,24,2842,3367,0,0,84.41,2295,523,忠誠里,NULL
0,2824,18,2842,3618,0,0,78.55,2000,824,富民里,NULL
0,2819,22,2841,3522,0,0,80.66,1835,984,臨江里,NULL
0,2816,23,2839,3614,0,0,78.56,2202,614,中正里,NULL
0,2808,31,2839,3797,0,0,74.77,1697,1111,中正里,NULL
0,2811,26,2837,3762,0,0,75.41,1581,1230,新北里,NULL
0,2808,28,2836,3669,0,0,77.3,1912,896,平和里,NULL
0,2805,30,2835,3658,0,0,77.5,1548,1257,鎌村里,NULL
0,2813,22,2835,3614,0,0,78.44,1345,1468,南勢里,NULL
0,2811,23,2834,3962,0,0,71.53,1993,818,新富里,NULL
0,2811,23,2834,3667,0,0,77.28,1692,1119,復興里,NULL
0,2795,39,2834,3675,0,0,77.12,1232,1563,二苓里,NULL
0,2785,47,2832,3683,0,0,76.89,1566,1219,鳳鳴里,NULL
0,2807,25,2832,3690,0,0,76.75,1280,1527,埔崙里,NULL
0,2805,26,2831,3856,0,0,73.42,2113,692,國裕里,NULL
0,2810,21,2831,3540,0,0,79.97,1485,1325,前港里,NULL
0,2801,29,2830,3613,0,0,78.33,1538,1263,香社里,NULL
0,2809,20,2829,3578,0,0,79.07,2208,601,福星里,NULL
0,2809,20,2829,3821,0,0,74.04,2012,797,興寮里,NULL
0,2807,22,2829,3607,0,0,78.43,1934,873,復華里,NULL
0,2799,30,2829,3681,0,0,76.85,1826,973,頂厝里,NULL
0,2807,22,2829,3622,0,0,78.11,1694,1113,幸市里,NULL
0,2802,26,2828,3526,0,0,80.2,2254,548,新華里,NULL
0,2802,22,2824,3792,0,0,74.47,1637,1165,合鳳里,NULL
0,2807,14,2821,3699,0,0,76.26,1822,985,龍泉里,NULL
0,2792,29,2821,3740,0,0,75.43,1622,1170,秀水里,NULL
0,2803,17,2820,3576,0,0,78.86,1832,971,龍安里,NULL
0,2788,31,2819,3504,0,0,80.45,2263,525,福民里,NULL
0,2781,37,2818,3606,0,0,78.15,1610,1171,大安里,NULL
0,2796,22,2818,3626,0,0,77.72,1199,1597,新厝里,NULL
0,2791,26,2817,3738,0,0,75.36,1747,1044,新東村,NULL
0,2782,35,2817,3663,0,0,76.9,1509,1273,永定里,NULL
0,2791,26,2817,3807,0,0,74,1487,1304,東榮里,NULL
0,2795,20,2815,3408,0,0,82.6,2138,657,文化里,NULL
0,2774,40,2814,3552,0,0,79.22,1554,1220,文翠里,NULL
0,2793,21,2814,3579,0,0,78.63,1449,1344,新樂里,NULL
0,2792,22,2814,3760,0,0,74.84,1158,1634,頂厝村,NULL
0,2785,26,2811,3525,0,0,79.74,1784,1001,中正里,NULL
0,2786,23,2809,3449,0,0,81.44,1787,999,成功里,NULL
0,2789,20,2809,3790,0,0,74.12,1251,1538,安邦里,NULL
0,2795,13,2808,3502,0,0,80.18,2120,675,富臺里,NULL
0,2795,13,2808,3804,0,0,73.82,1930,865,自強里,NULL
0,2788,20,2808,3557,0,0,78.94,1867,921,上安里,NULL
0,2787,20,2807,3629,0,0,77.35,1646,1141,廷寮里,NULL
0,2781,25,2806,3932,0,0,71.36,1996,785,明義里,NULL
0,2776,30,2806,3726,0,0,75.31,1808,968,林頭里,NULL
0,2777,29,2806,3561,0,0,78.8,1712,1065,嘉慶里,NULL
0,2775,31,2806,3712,0,0,75.59,1693,1082,中興里,NULL
0,2774,31,2805,3684,0,0,76.14,1595,1179,中山里,NULL
0,2767,38,2805,3571,0,0,78.55,1494,1273,延吉里,NULL
0,2771,33,2804,3539,0,0,79.23,1576,1195,日新里,NULL
0,2773,30,2803,3672,0,0,76.33,1773,1000,溝墘里,NULL
0,2790,13,2803,3914,0,0,71.61,1316,1474,崎漏村,NULL
0,2781,19,2800,3776,0,0,74.15,2044,737,碇祥里,NULL
0,2779,20,2799,3396,0,0,82.42,2284,495,建林村,NULL
0,2765,34,2799,3428,0,0,81.65,2089,676,秀峰里,NULL
0,2778,20,2798,3562,0,0,78.55,1830,948,何南里,NULL
0,2766,32,2798,3638,0,0,76.91,1556,1210,延壽里,NULL
0,2785,12,2797,4690,5893,79.59,59.64,2648,137,南竿鄉,Nanxun Township
0,2782,14,2796,3747,0,0,74.62,1071,1711,仁得里,NULL
0,2774,19,2793,3493,0,0,79.96,2084,690,安昌里,NULL
0,2766,25,2791,3525,0,0,79.18,2095,671,東信里,NULL
0,2753,37,2790,3443,0,0,81.03,2121,632,秀水里,NULL
0,2771,18,2789,3519,0,0,79.26,1990,781,五福里,NULL
0,2763,25,2788,3597,0,0,77.51,1605,1158,鳳福里,NULL
0,2769,17,2786,3535,0,0,78.81,1898,871,復建里,NULL
0,2755,31,2786,3754,0,0,74.21,1462,1293,蔗廍村,NULL
0,2755,28,2783,3518,0,0,79.11,1679,1076,永光里,NULL
0,2762,20,2782,3668,0,0,75.85,1680,1082,林口村,NULL
0,2754,27,2781,3483,0,0,79.84,1837,917,中原里,NULL
0,2761,20,2781,3539,0,0,78.58,1404,1357,振義里,NULL
0,2745,35,2780,3554,0,0,78.22,1814,931,陳平里,NULL
0,2761,18,2779,3642,0,0,76.3,1724,1037,公德里,NULL
0,2755,24,2779,3453,0,0,80.48,1680,1075,大興里,NULL
0,2752,26,2778,3550,0,0,78.25,1996,756,公明里,NULL
0,2745,33,2778,3811,0,0,72.89,1398,1347,糠榔里,NULL
0,2756,19,2775,3659,0,0,75.84,1701,1055,新民里,NULL
0,2754,19,2773,3294,0,0,84.18,2233,521,國光里,NULL
0,2761,12,2773,3523,0,0,78.71,1561,1200,菁湖村,NULL
0,2750,23,2773,3613,0,0,76.75,1288,1462,尚頂里,NULL
0,2736,33,2769,3973,0,0,69.7,2151,585,仁和村,NULL
0,2737,32,2769,3608,0,0,76.75,1567,1170,山佳里,NULL
0,2749,20,2769,3635,0,0,76.18,1245,1504,州北里,NULL
0,2737,30,2767,3507,0,0,78.9,2272,465,東興村,NULL
0,2743,24,2767,3471,0,0,79.72,1913,830,龍興里,NULL
0,2734,32,2766,3487,0,0,79.32,1380,1354,崇德里,NULL
0,2724,42,2766,3452,0,0,80.13,1374,1350,五常里,NULL
0,2741,24,2765,3486,0,0,79.32,1631,1110,信義里,NULL
0,2748,17,2765,3580,0,0,77.23,1541,1207,東林村,NULL
0,2741,24,2765,3713,0,0,74.47,1533,1208,頂店里,NULL
0,2747,17,2764,3438,0,0,80.4,1541,1206,德行里,NULL
0,2733,31,2764,3717,0,0,74.36,1435,1298,新庄村,NULL
0,2732,32,2764,3798,0,0,72.78,1409,1323,新街村,NULL
0,2745,18,2763,3487,0,0,79.24,2087,658,福德里,NULL
0,2742,21,2763,3570,0,0,77.39,1466,1276,建平里,NULL
0,2740,22,2762,3429,0,0,80.55,1954,786,雙和里,NULL
0,2745,17,2762,3481,0,0,79.35,1712,1033,崇明里,NULL
0,2741,21,2762,3535,0,0,78.13,1693,1048,四德村,NULL
0,2738,24,2762,3546,0,0,77.89,1638,1100,新店里,NULL
0,2740,22,2762,3447,0,0,80.13,1450,1290,仁勇里,NULL
0,2738,24,2762,3508,0,0,78.73,1402,1336,新莊村,NULL
0,2736,25,2761,3543,0,0,77.93,1631,1105,新明里,NULL
0,2736,25,2761,3486,0,0,79.2,1320,1416,瑞屏里,NULL
0,2722,35,2757,3440,0,0,80.15,1625,1097,福真里,NULL
0,2742,14,2756,3605,0,0,76.45,1907,835,外寮里,NULL
0,2730,25,2755,3711,0,0,74.24,1740,990,北勢里,NULL
0,2733,18,2751,3334,0,0,82.51,2024,709,鹿場里,NULL
0,2724,26,2750,3510,0,0,78.35,1732,992,新勢里,NULL
0,2715,34,2749,3457,0,0,79.52,1469,1246,大河里,NULL
0,2714,35,2749,3628,0,0,75.77,1451,1263,西寶村,NULL
0,2730,18,2748,3397,0,0,80.89,1511,1219,西山里,NULL
0,2723,25,2748,3640,0,0,75.49,960,1763,大社村,NULL
0,2723,24,2747,3550,0,0,77.38,1029,1694,琉球村,NULL
0,2729,16,2745,3188,0,0,86.1,2648,81,陸光村,NULL
0,2725,20,2745,3443,0,0,79.73,1838,887,秀朗里,NULL
0,2722,23,2745,3643,0,0,75.35,1290,1432,莿桐村,NULL
0,2720,22,2742,3288,0,0,83.39,2012,708,建和里,NULL
0,2714,27,2741,3386,0,0,80.95,2058,656,百忍里,NULL
0,2716,24,2740,3600,0,0,76.11,1695,1021,五權里,NULL
0,2718,22,2740,3807,0,0,71.97,1491,1227,安康里,NULL
0,2717,22,2739,3700,0,0,74.03,1527,1190,獇寮里,NULL
0,2714,23,2737,3467,0,0,78.94,1377,1337,寶獅里,NULL
0,2712,25,2737,3739,0,0,73.2,1308,1404,寬士村,NULL
0,2704,32,2736,3577,0,0,76.49,1832,872,員潭里,NULL
0,2703,33,2736,3550,0,0,77.07,1777,926,明正里,NULL
0,2711,25,2736,3498,0,0,78.22,1667,1044,西川里,NULL
0,2713,23,2736,3465,0,0,78.96,1209,1504,鼎強里,NULL
0,2710,25,2735,3553,0,0,76.98,1750,960,平心里,NULL
0,2715,19,2734,3411,0,0,80.15,1678,1037,豐年里,NULL
0,2710,24,2734,3363,0,0,81.3,1073,1637,仕和村,NULL
0,2711,22,2733,3411,0,0,80.12,2189,522,鷄林里,NULL
0,2700,33,2733,3779,0,0,72.32,1586,1114,三興里,NULL
0,2697,35,2732,3626,0,0,75.34,1809,888,大庄里,NULL
0,2714,18,2732,3506,0,0,77.92,1686,1028,濟南里,NULL
0,2705,27,2732,3434,0,0,79.56,1584,1121,樹南里,NULL
0,2706,26,2732,3451,0,0,79.17,1448,1258,田心里,NULL
0,2708,20,2728,3580,0,0,76.2,1766,942,立仁里,NULL
0,2691,33,2724,3635,0,0,74.94,1933,758,後寮里,NULL
0,2710,14,2724,3413,0,0,79.81,1360,1350,夢裡村,NULL
0,2698,25,2723,3356,0,0,81.14,2159,539,玉華里,NULL
0,2701,22,2723,3642,0,0,74.77,1649,1052,礁溪里,NULL
0,2697,26,2723,3402,0,0,80.04,1614,1083,文雅里,NULL
0,2683,38,2721,3407,0,0,79.86,1800,883,大厝里,NULL
0,2686,34,2720,3549,0,0,76.64,1671,1015,平鎮里,NULL
0,2707,12,2719,3502,0,0,77.64,1509,1198,客庄里,NULL
0,2703,16,2719,3411,0,0,79.71,1307,1396,建民里,NULL
0,2692,26,2718,3525,0,0,77.11,1713,979,福興里,NULL
0,2687,31,2718,3431,0,0,79.22,1258,1429,東橋里,NULL
0,2694,23,2717,3498,0,0,77.67,2117,577,中山里,NULL
0,2701,16,2717,3523,0,0,77.12,1457,1244,國光里,NULL
0,2698,18,2716,3547,0,0,76.57,1721,977,崇德里,NULL
0,2688,27,2715,3495,0,0,77.68,1050,1638,月眉里,NULL
0,2692,21,2713,3695,0,0,73.42,1484,1208,芳草里,NULL
0,2687,26,2713,3475,0,0,78.07,1254,1433,瑞隆里,NULL
0,2687,25,2712,3456,0,0,78.47,1526,1161,福興里,NULL
0,2692,19,2711,3425,0,0,79.15,1822,870,龍門里,NULL
0,2694,17,2711,3415,0,0,79.39,1266,1428,鼎力里,NULL
0,2683,27,2710,3344,0,0,81.04,1965,718,上山村,NULL
0,2688,21,2709,3447,0,0,78.59,1966,722,忠孝里,NULL
0,2690,19,2709,3568,0,0,75.92,1525,1165,新豐里,NULL
0,2685,23,2708,3399,0,0,79.67,2013,672,文莊里,NULL
0,2689,19,2708,3500,0,0,77.37,1417,1272,寶泰里,NULL
0,2680,24,2704,3367,0,0,80.31,1798,882,下溪里,NULL
0,2684,19,2703,3390,0,0,79.73,2142,542,瑞德里,NULL
0,2667,36,2703,3661,0,0,73.83,1472,1195,溪海村,NULL
0,2676,26,2702,3398,0,0,79.52,1299,1377,惠民里,NULL
0,2693,7,2700,3719,4908,75.77,72.6,2441,252,泰武鄉,Taiwu Township
0,2672,28,2700,3466,0,0,77.9,1760,912,向陽里,NULL
0,2668,30,2698,3464,0,0,77.89,1768,900,古風里,NULL
0,2686,12,2698,3336,0,0,80.88,1385,1301,海洋里,NULL
0,2670,26,2696,3394,0,0,79.43,1975,695,竹林里,NULL
0,2671,25,2696,3400,0,0,79.29,1572,1099,藍興里,NULL
0,2658,37,2695,3423,0,0,78.73,1497,1161,金華里,NULL
0,2659,35,2694,3526,0,0,76.4,2012,647,中興村,NULL
0,2670,22,2692,3675,0,0,73.25,1802,868,拱北里,NULL
0,2659,33,2692,3421,0,0,78.69,1708,951,平安里,NULL
0,2654,38,2692,3405,0,0,79.06,1591,1063,明德里,NULL
0,2666,26,2692,3680,0,0,73.15,1548,1118,鳳祥里,NULL
0,2673,18,2691,3432,0,0,78.41,1777,896,福恩里,NULL
0,2673,17,2690,3480,0,0,77.3,1474,1199,行孝里,NULL
0,2669,21,2690,3656,0,0,73.58,1207,1462,漢光里,NULL
0,2674,16,2690,3541,0,0,75.97,966,1708,南灣里,NULL
0,2661,27,2688,3478,0,0,77.29,1457,1204,西墩里,NULL
0,2662,25,2687,3748,0,0,71.69,1776,886,三湖里,NULL
0,2662,25,2687,3665,0,0,73.32,1525,1137,南埔里,NULL
0,2659,26,2685,3582,0,0,74.96,1354,1305,安招村,NULL
0,2661,21,2682,3622,0,0,74.05,1619,1042,嘉和里,NULL
0,2651,30,2681,3522,0,0,76.12,1832,819,普仁里,NULL
0,2661,19,2680,3296,0,0,81.31,1633,1028,中和里,NULL
0,2654,25,2679,3956,0,0,67.72,1410,1244,崇信里,NULL
0,2652,27,2679,3376,0,0,79.35,1326,1326,華美村,NULL
0,2641,37,2678,3519,0,0,76.1,1530,1111,大明里,NULL
0,2651,26,2677,3412,0,0,78.46,1778,873,仁和里,NULL
0,2658,18,2676,3542,0,0,75.55,1697,961,實踐里,NULL
0,2657,19,2676,3375,0,0,79.29,1481,1176,中興里,NULL
0,2662,13,2675,3372,0,0,79.33,1528,1134,程香里,NULL
0,2645,30,2675,3500,0,0,76.43,1516,1129,安東村,NULL
0,2649,25,2674,3490,0,0,76.62,1620,1029,爪峯里,NULL
0,2648,25,2673,3404,0,0,78.53,1506,1142,幸福里,NULL
0,2649,21,2670,3219,0,0,82.95,2259,390,精忠村,NULL
0,2649,21,2670,3330,0,0,80.18,1635,1014,大竹村,NULL
0,2653,17,2670,3825,0,0,69.8,1194,1459,隆山村,NULL
0,2632,35,2667,3461,0,0,77.06,1691,941,龍壽里,NULL
0,2641,25,2666,3541,0,0,75.29,1457,1184,協和里,NULL
0,2643,22,2665,3249,0,0,82.03,1803,840,廣隆里,NULL
0,2647,17,2664,3528,0,0,75.51,1624,1023,自強里,NULL
0,2635,29,2664,3350,0,0,79.52,1594,1041,大忠里,NULL
0,2639,23,2662,3407,0,0,78.13,1724,915,中路里,NULL
0,2639,23,2662,3386,0,0,78.62,1555,1084,港口里,NULL
0,2643,19,2662,3309,0,0,80.45,949,1694,錦屏里,NULL
0,2643,18,2661,3374,0,0,78.87,2146,497,蟠桃里,NULL
0,2647,13,2660,3343,0,0,79.57,1831,816,中原里,NULL
0,2631,29,2660,3268,0,0,81.4,1639,992,大成里,NULL
0,2638,21,2659,3236,0,0,82.17,2108,530,佳安村,NULL
0,2635,23,2658,3378,0,0,78.69,1945,690,凌霄里,NULL
0,2634,23,2657,3408,0,0,77.96,1705,929,員信里,NULL
0,2630,26,2656,3452,0,0,76.94,1492,1138,橫山村,NULL
0,2641,14,2655,3303,0,0,80.38,1123,1518,平和里,NULL
0,2637,17,2654,3484,0,0,76.18,1716,921,水美里,NULL
0,2636,18,2654,3361,0,0,78.96,1088,1548,大舍村,NULL
0,2635,17,2652,3324,0,0,79.78,1468,1167,城隍里,NULL
0,2627,25,2652,3485,0,0,76.1,1422,1205,朱園里,NULL
0,2626,26,2652,3503,0,0,75.71,1003,1623,幸福里,NULL
0,2633,18,2651,3224,0,0,82.23,1315,1318,裕昌里,NULL
0,2626,24,2650,3288,0,0,80.6,2308,318,劍潭里,NULL
0,2623,27,2650,3946,0,0,67.16,1653,970,興仁里,NULL
0,2622,28,2650,3425,0,0,77.37,1582,1040,三福里,NULL
0,2627,20,2647,3222,0,0,82.15,1616,1011,關聖里,NULL
0,2618,26,2644,3352,0,0,78.88,1577,1041,華興里,NULL
0,2614,29,2643,3320,0,0,79.61,2266,348,忠義村,NULL
0,2625,18,2643,3164,0,0,83.53,1562,1063,慶昌里,NULL
0,2608,35,2643,3305,0,0,79.97,1446,1162,思賢里,NULL
0,2617,23,2640,3279,0,0,80.51,2065,552,維祥里,NULL
0,2615,24,2639,3350,0,0,78.78,1862,753,成功里,NULL
0,2613,25,2638,3579,0,0,73.71,1227,1386,中民里,NULL
0,2618,19,2637,3354,0,0,78.62,1965,653,東興村,NULL
0,2612,25,2637,3736,0,0,70.58,1390,1222,潭底里,NULL
0,2618,19,2637,3400,0,0,77.56,1193,1425,天興里,NULL
0,2612,23,2635,3337,0,0,78.96,1847,765,忠平里,NULL
0,2601,33,2634,3337,0,0,78.93,1614,987,同榮村,NULL
0,2598,36,2634,3457,0,0,76.19,1401,1197,保庄里,NULL
0,2615,19,2634,3460,0,0,76.13,1222,1393,安順里,NULL
0,2607,25,2632,3401,0,0,77.39,1532,1075,圳福里,NULL
0,2607,24,2631,3251,0,0,80.93,1505,1102,民族里,NULL
0,2598,32,2630,3353,0,0,78.44,1654,944,北富里,NULL
0,2609,21,2630,3328,0,0,79.03,1253,1356,正順里,NULL
0,2604,26,2630,3382,0,0,77.76,1224,1380,香洋村,NULL
0,2611,17,2628,3260,0,0,80.61,1963,648,安和里,NULL
0,2583,45,2628,3541,0,0,74.22,1690,893,中山里,NULL
0,2602,25,2627,3408,0,0,77.08,1649,953,仁愛里,NULL
0,2603,24,2627,3294,0,0,79.75,1465,1138,國昌里,NULL
0,2608,19,2627,3443,0,0,76.3,1431,1177,賢文里,NULL
0,2602,24,2626,3173,0,0,82.76,2058,544,忠順里,NULL
0,2607,19,2626,3317,0,0,79.17,1870,737,平興里,NULL
0,2609,17,2626,3380,0,0,77.69,1785,824,黎順里,NULL
0,2603,23,2626,3443,0,0,76.27,1695,908,三平里,NULL
0,2603,23,2626,3371,0,0,77.9,1318,1285,國慶里,NULL
0,2603,22,2625,3340,0,0,78.59,2006,597,嘉盛里,NULL
0,2604,20,2624,3514,0,0,74.67,1628,976,萬里村,NULL
0,2604,20,2624,3314,0,0,79.18,1552,1052,大仁里,NULL
0,2591,33,2624,3333,0,0,78.73,1544,1047,延祿里,NULL
0,2595,29,2624,3411,0,0,76.93,1382,1213,延平里,NULL
0,2598,25,2623,3331,0,0,78.75,1643,955,錦盛里,NULL
0,2596,26,2622,3311,0,0,79.19,1134,1462,大和里,NULL
0,2593,28,2621,3444,0,0,76.1,1755,838,泰安里,NULL
0,2582,39,2621,3371,0,0,77.75,1750,832,三和村,NULL
0,2591,29,2620,3265,0,0,80.25,1643,948,福和里,NULL
0,2595,24,2619,3242,0,0,80.78,1605,990,錦中里,NULL
0,2585,34,2619,3461,0,0,75.67,1131,1454,明亮里,NULL
0,2598,20,2618,3243,0,0,80.73,1807,791,泰安里,NULL
0,2588,29,2617,3415,0,0,76.63,1893,695,烏林村,NULL
0,2591,25,2616,3441,0,0,76.02,1253,1338,孔宅里,NULL
0,2582,33,2615,3218,0,0,81.26,1576,1006,國光里,NULL
0,2597,18,2615,3427,0,0,76.31,1286,1311,美源里,NULL
0,2602,13,2615,3143,0,0,83.2,1152,1450,鼎中里,NULL
0,2592,22,2614,3380,0,0,77.34,1558,1034,東南里,NULL
0,2599,13,2612,3135,0,0,83.32,1969,630,北崙里,NULL
0,2582,30,2612,3243,0,0,80.54,1756,826,景新里,NULL
0,2589,23,2612,3336,0,0,78.3,1591,998,后里村,NULL
0,2597,14,2611,3239,0,0,80.61,1860,737,民本里,NULL
0,2591,20,2611,3293,0,0,79.29,1503,1088,清和里,NULL
0,2593,17,2610,3276,0,0,79.67,1976,617,新安里,NULL
0,2581,27,2608,3221,0,0,80.97,1348,1233,榮德里,NULL
0,2582,25,2607,3372,0,0,77.31,1766,816,上石里,NULL
0,2572,34,2606,3335,0,0,78.14,1901,671,新安里,NULL
0,2573,33,2606,3404,0,0,76.56,1815,758,金星里,NULL
0,2586,18,2604,3773,0,0,69.02,1544,1042,秀峰里,NULL
0,2571,32,2603,3384,0,0,76.92,1529,1042,福山村,NULL
0,2569,33,2602,3259,0,0,79.84,1666,903,吉仁里,NULL
0,2582,20,2602,3291,0,0,79.06,1362,1220,仁壽里,NULL
0,2582,20,2602,3332,0,0,78.09,1144,1438,鼎金里,NULL
0,2580,21,2601,3361,0,0,77.39,1879,701,店街里,NULL
0,2557,44,2601,3326,0,0,78.2,1360,1197,十甲里,NULL
0,2585,16,2601,3386,0,0,76.82,1318,1267,朝陽里,NULL
0,2572,28,2600,3312,0,0,78.5,1538,1034,家福村,NULL
0,2570,30,2600,3178,0,0,81.81,1318,1252,吉翠里,NULL
0,2580,19,2599,3776,4952,76.25,68.83,2340,240,獅子鄉,Lion Township
0,2581,18,2599,3228,0,0,80.51,1857,724,大豐里,NULL
0,2559,40,2599,3407,0,0,76.28,1713,846,龍山里,NULL
0,2585,14,2599,3217,0,0,80.79,1545,1040,隆昌里,NULL
0,2577,21,2598,3435,0,0,75.63,1898,679,明湖里,NULL
0,2569,29,2598,3316,0,0,78.35,1307,1262,田寮里,NULL
0,2580,17,2597,3405,0,0,76.27,1749,831,大湖村,NULL
0,2577,19,2596,3343,0,0,77.65,2057,520,橫山村,NULL
0,2566,30,2596,3282,0,0,79.1,1379,1187,和平里,NULL
0,2577,18,2595,3207,0,0,80.92,1587,990,中崙里,NULL
0,2560,35,2595,3302,0,0,78.59,1324,1236,仁華里,NULL
0,2574,19,2593,3201,0,0,81.01,1995,579,中華里,NULL
0,2571,22,2593,3473,0,0,74.66,1134,1437,山中村,NULL
0,2563,29,2592,3280,0,0,79.02,1475,1088,大恩里,NULL
0,2569,21,2590,3282,0,0,78.92,1735,834,至善里,NULL
0,2563,27,2590,3264,0,0,79.35,1361,1202,公館里,NULL
0,2567,21,2588,3308,0,0,78.23,1323,1244,和平里,NULL
0,2567,20,2587,3360,0,0,76.99,1481,1086,義學村,NULL
0,2557,30,2587,3314,0,0,78.06,1143,1414,頭前里,NULL
0,2568,17,2585,3234,0,0,79.93,2193,375,新忠里,NULL
0,2561,24,2585,3229,0,0,80.06,1939,622,桂林里,NULL
0,2564,21,2585,3577,0,0,72.27,1931,633,永安村,NULL
0,2559,26,2585,3306,0,0,78.19,1489,1070,貴子村,NULL
0,2569,16,2585,3305,0,0,78.21,1342,1227,福德里,NULL
0,2548,34,2582,3501,0,0,73.75,1601,947,中正里,NULL
0,2558,23,2581,3405,0,0,75.8,1629,929,大埔里,NULL
0,2556,24,2580,3289,0,0,78.44,1501,1055,東明里,NULL
0,2563,16,2579,3206,0,0,80.44,1049,1514,灣利里,NULL
0,2554,24,2578,3549,0,0,72.64,1781,773,華崙里,NULL
0,2554,24,2578,3323,0,0,77.58,1623,931,白雲里,NULL
0,2562,16,2578,3399,0,0,75.85,1209,1353,六安里,NULL
0,2553,25,2578,3473,0,0,74.23,1028,1525,溪州村,NULL
0,2551,26,2577,3364,0,0,76.61,1383,1168,嘉仁村,NULL
0,2551,25,2576,3159,0,0,81.54,1951,600,崇南里,NULL
0,2560,15,2575,3421,0,0,75.27,1826,734,過港里,NULL
0,2549,25,2574,3295,0,0,78.12,1565,984,建德里,NULL
0,2559,13,2572,3388,0,0,75.91,1709,850,賴明里,NULL
0,2552,19,2571,3471,0,0,74.07,1633,919,德陽村,NULL
0,2549,22,2571,3382,0,0,76.02,1401,1148,五股村,NULL
0,2541,30,2571,3340,0,0,76.98,1394,1147,新南里,NULL
0,2553,17,2570,3326,0,0,77.27,1695,858,德安里,NULL
0,2556,14,2570,3445,0,0,74.6,1492,1064,廖厝里,NULL
0,2551,19,2570,3152,0,0,81.54,1409,1142,日善里,NULL
0,2555,13,2568,3349,0,0,76.68,1432,1123,興仁里,NULL
0,2549,18,2567,3235,0,0,79.35,1865,684,中正村,NULL
0,2539,28,2567,3214,0,0,79.87,1457,1082,北柳村,NULL
0,2545,21,2566,3379,0,0,75.94,1687,858,康福里,NULL
0,2551,15,2566,3237,0,0,79.27,1380,1171,新泰里,NULL
0,2549,17,2566,3378,0,0,75.96,1017,1532,檨腳村,NULL
0,2545,20,2565,3155,0,0,81.3,1672,873,新南里,NULL
0,2528,36,2564,3243,0,0,79.06,1894,634,新和里,NULL
0,2538,26,2564,3325,0,0,77.11,1319,1219,信義里,NULL
0,2538,26,2564,3198,0,0,80.18,1310,1228,立志里,NULL
0,2539,24,2563,3110,0,0,82.41,1097,1442,安宜里,NULL
0,2539,23,2562,3279,0,0,78.13,1641,898,頂福里,NULL
0,2535,27,2562,3206,0,0,79.91,1011,1524,蘆竹村,NULL
0,2538,23,2561,3247,0,0,78.87,1318,1220,復興里,NULL
0,2542,18,2560,3691,0,0,69.36,1709,833,麥豐村,NULL
0,2536,22,2558,3087,0,0,82.86,1473,1063,莊敬里,NULL
0,2530,27,2557,3551,0,0,72.01,1691,839,上湖里,NULL
0,2536,21,2557,3293,0,0,77.65,1652,884,瑞泰里,NULL
0,2534,23,2557,3329,0,0,76.81,1345,1189,福隆里,NULL
0,2523,34,2557,3170,0,0,80.66,1330,1193,文聖里,NULL
0,2517,39,2556,3290,0,0,77.69,1628,889,北貴里,NULL
0,2538,17,2555,3288,0,0,77.71,1935,603,東明里,NULL
0,2529,24,2553,3389,0,0,75.33,1832,697,泰昌里,NULL
0,2533,20,2553,3255,0,0,78.43,1388,1145,平和里,NULL
0,2527,24,2551,3301,0,0,77.28,1464,1063,堂春里,NULL
0,2534,17,2551,3349,0,0,76.17,1037,1497,東灣里,NULL
0,2523,27,2550,3199,0,0,79.71,1846,677,東社里,NULL
0,2533,17,2550,3282,0,0,77.7,1619,914,鎮南里,NULL
0,2521,28,2549,3263,0,0,78.12,1438,1083,五福里,NULL
0,2529,20,2549,3232,0,0,78.87,1425,1104,高雙里,NULL
0,2527,21,2548,3191,0,0,79.85,1449,1078,新富里,NULL
0,2529,18,2547,3173,0,0,80.27,1674,855,新光里,NULL
0,2527,20,2547,3203,0,0,79.52,901,1626,嘉興里,NULL
0,2528,18,2546,3445,0,0,73.9,1416,1112,林中村,NULL
0,2528,17,2545,3684,4997,73.72,69.08,2392,136,春日鄉,Chunri Township
0,2519,26,2545,3250,0,0,78.31,1425,1094,瑞源里,NULL
0,2515,29,2544,3429,0,0,74.19,1493,1022,大社村,NULL
0,2522,22,2544,3246,0,0,78.37,1447,1075,南門里,NULL
0,2517,26,2543,3443,4477,76.9,73.86,2220,297,五峰鄉,Wufeng Township
0,2527,16,2543,3231,0,0,78.71,1676,851,北屯里,NULL
0,2526,16,2542,3234,0,0,78.6,1628,898,萬年里,NULL
0,2516,26,2542,3281,0,0,77.48,1551,965,新光里,NULL
0,2513,28,2541,4093,0,0,62.08,1744,769,賴厝里,NULL
0,2518,23,2541,3133,0,0,81.1,1682,836,秀林里,NULL
0,2515,26,2541,3212,0,0,79.11,1546,969,泰山里,NULL
0,2509,31,2540,3301,0,0,76.95,1210,1299,山腳村,NULL
0,2512,27,2539,3450,0,0,73.59,972,1540,長安里,NULL
0,2509,29,2538,3278,0,0,77.43,1725,784,湧安里,NULL
0,2511,27,2538,3357,0,0,75.6,1606,905,上林村,NULL
0,2505,32,2537,3324,0,0,76.32,1762,743,山佳里,NULL
0,2522,15,2537,3305,0,0,76.76,1305,1217,貨饒里,NULL
0,2509,27,2536,3277,0,0,77.39,1608,901,頭家東村,NULL
0,2505,31,2536,3187,0,0,79.57,1534,971,貴賢村,NULL
0,2524,12,2536,3346,0,0,75.79,1367,1157,漢民里,NULL
0,2512,23,2535,3219,0,0,78.75,1546,966,南埔里,NULL
0,2505,29,2534,3193,0,0,79.36,1634,871,福祿里,NULL
0,2499,35,2534,3312,0,0,76.51,1628,871,八德村,NULL
0,2500,33,2533,3529,0,0,71.78,1906,594,宜昌村,NULL
0,2505,28,2533,3173,0,0,79.83,1318,1187,六合里,NULL
0,2514,18,2532,4032,0,0,62.8,1857,657,豫溪里,NULL
0,2508,24,2532,3176,0,0,79.72,1583,925,後埔里,NULL
0,2508,23,2531,3259,0,0,77.66,1781,727,大義里,NULL
0,2516,14,2530,3082,0,0,82.09,1997,519,建國里,NULL
0,2503,27,2530,3098,0,0,81.67,1881,622,安樂里,NULL
0,2497,33,2530,3145,0,0,80.45,1739,758,永貞里,NULL
0,2510,20,2530,3265,0,0,77.49,1679,831,賴興里,NULL
0,2509,21,2530,3288,0,0,76.95,1403,1106,清溪里,NULL
0,2496,32,2528,3225,0,0,78.39,1241,1255,慈愛里,NULL
0,2510,17,2527,3259,0,0,77.54,982,1528,永樂村,NULL
0,2496,28,2524,3161,0,0,79.85,1456,1040,香丘里,NULL
0,2499,24,2523,3213,0,0,78.52,1619,880,中央里,NULL
0,2505,18,2523,3330,0,0,75.77,1590,915,新榮里,NULL
0,2494,28,2522,3204,0,0,78.71,1854,640,東安里,NULL
0,2492,30,2522,3245,0,0,77.72,1363,1129,中南里,NULL
0,2508,13,2521,3315,0,0,76.05,1672,836,北埔里,NULL
0,2506,15,2521,3293,0,0,76.56,1536,970,高原村,NULL
0,2493,28,2521,3425,0,0,73.61,1402,1091,孟春里,NULL
0,2497,24,2521,3188,0,0,79.08,1381,1116,永安里,NULL
0,2494,27,2521,3239,0,0,77.83,1230,1264,南芳里,NULL
0,2496,25,2521,3318,0,0,75.98,1123,1373,高松里,NULL
0,2507,13,2520,3085,0,0,81.69,1321,1186,開平里,NULL
0,2495,24,2519,3195,0,0,78.84,1992,503,光明里,NULL
0,2505,14,2519,3333,0,0,75.58,1237,1268,磚磘里,NULL
0,2501,17,2518,3165,0,0,79.56,1320,1181,林中里,NULL
0,2491,25,2516,3350,0,0,75.1,1986,505,國興里,NULL
0,2499,16,2515,3336,0,0,75.39,1680,819,新崙里,NULL
0,2484,31,2515,3310,0,0,75.98,1585,899,高明里,NULL
0,2499,15,2514,3177,0,0,79.13,1368,1131,文衡里,NULL
0,2482,32,2514,3264,0,0,77.02,1331,1151,永德里,NULL
0,2497,16,2513,3266,0,0,76.94,1466,1031,永平里,NULL
0,2488,25,2513,3135,0,0,80.16,1358,1130,建國里,NULL
0,2488,25,2513,3155,0,0,79.65,1328,1160,水源里,NULL
0,2491,21,2512,3286,0,0,76.45,1470,1021,育英里,NULL
0,2490,21,2511,3230,0,0,77.74,1558,932,嘉新里,NULL
0,2478,33,2511,3138,0,0,80.02,1346,1132,雙玉里,NULL
0,2495,15,2510,3183,0,0,78.86,2031,464,大西村,NULL
0,2488,21,2509,3086,0,0,81.3,1766,722,福林里,NULL
0,2495,14,2509,3257,0,0,77.03,1630,865,南勢村,NULL
0,2479,30,2509,3309,0,0,75.82,1345,1134,福和里,NULL
0,2474,34,2508,3074,0,0,81.59,1940,534,富林村,NULL
0,2491,16,2507,2989,0,0,83.87,1589,902,裕聖里,NULL
0,2482,25,2507,3329,0,0,75.31,1437,1045,中平里,NULL
0,2487,20,2507,3311,0,0,75.72,1197,1290,萬全村,NULL
0,2497,10,2507,3158,0,0,79.39,799,1698,翁園村,NULL
0,2480,26,2506,3303,0,0,75.87,1391,1089,福德里,NULL
0,2481,25,2506,3126,0,0,80.17,1167,1314,五華里,NULL
0,2479,26,2505,3209,0,0,78.06,1889,590,勝興村,NULL
0,2481,24,2505,3162,0,0,79.22,1768,713,瑞發里,NULL
0,2480,25,2505,3228,0,0,77.6,1206,1274,成泰村,NULL
0,2487,16,2503,3217,0,0,77.81,1663,824,岩山里,NULL
0,2485,18,2503,3072,0,0,81.48,1500,985,冠穗里,NULL
0,2476,27,2503,3288,0,0,76.13,1261,1215,水上村,NULL
0,2485,18,2503,3261,0,0,76.76,1134,1351,郡南里,NULL
0,2476,24,2500,3226,0,0,77.5,1513,963,湖南村,NULL
0,2480,20,2500,3224,0,0,77.54,1221,1259,王公村,NULL
0,2476,23,2499,3549,0,0,70.41,1632,844,清新里,NULL
0,2483,16,2499,3152,0,0,79.28,1158,1325,葫東里,NULL
0,2479,19,2498,3194,0,0,78.21,1467,1012,松基里,NULL
0,2476,21,2497,3093,0,0,80.73,1600,876,湖濱里,NULL
0,2472,25,2497,3290,0,0,75.9,1155,1317,振興里,NULL
0,2472,24,2496,3081,0,0,81.01,1822,650,普強里,NULL
0,2478,16,2494,3888,4894,79.44,64.15,2236,242,牡丹鄉,Peony Township
0,2473,21,2494,3065,0,0,81.37,1704,769,秀成里,NULL
0,2477,17,2494,3204,0,0,77.84,1508,969,何明里,NULL
0,2477,16,2493,3123,0,0,79.83,1557,920,五常里,NULL
0,2468,24,2492,3071,0,0,81.15,1797,671,智光里,NULL
0,2468,24,2492,3069,0,0,81.2,1748,720,東山里,NULL
0,2473,19,2492,3122,0,0,79.82,1399,1074,埤墘里,NULL
0,2461,28,2489,3164,0,0,78.67,1573,888,麗園村,NULL
0,2453,36,2489,3141,0,0,79.24,1425,1028,廣達里,NULL
0,2459,30,2489,3043,0,0,81.79,1137,1322,安東里,NULL
0,2457,31,2488,3250,0,0,76.55,1376,1081,僑中里,NULL
0,2474,14,2488,3274,0,0,75.99,1297,1177,後湖里,NULL
0,2464,23,2487,3266,0,0,76.15,1416,1048,嘉仁里,NULL
0,2472,15,2487,3231,0,0,76.97,1415,1057,後紅里,NULL
0,2466,21,2487,3022,0,0,82.3,1247,1219,福田里,NULL
0,2467,19,2486,3301,0,0,75.31,1333,1134,興村里,NULL
0,2469,16,2485,3123,0,0,79.57,1377,1092,壽天里,NULL
0,2472,12,2484,3153,0,0,78.78,1894,578,上林里,NULL
0,2453,30,2483,2993,0,0,82.96,2362,91,陸光里,NULL
0,2463,20,2483,3097,0,0,80.17,1724,739,楊梅里,NULL
0,2457,26,2483,3181,0,0,78.06,1379,1078,東昇里,NULL
0,2454,29,2483,3595,0,0,69.07,1335,1119,浮洲里,NULL
0,2454,29,2483,3212,0,0,77.3,1318,1136,五順里,NULL
0,2454,29,2483,3200,0,0,77.59,1317,1137,聚興村,NULL
0,2460,23,2483,3131,0,0,79.3,1165,1295,文華里,NULL
0,2470,12,2482,3200,0,0,77.56,1551,919,新生村,NULL
0,2449,32,2481,3119,0,0,79.54,1565,884,光鎮里,NULL
0,2471,10,2481,3192,0,0,77.73,1266,1205,碧紅里,NULL
0,2463,17,2480,3087,0,0,80.34,1600,863,龍興里,NULL
0,2458,22,2480,3144,0,0,78.88,1460,998,昌隆里,NULL
0,2459,21,2480,3197,0,0,77.57,1333,1126,豐年里,NULL
0,2446,33,2479,3326,0,0,74.53,1472,974,恆安里,NULL
0,2453,24,2477,3103,0,0,79.83,1665,788,自強村,NULL
0,2442,33,2475,3166,0,0,78.17,1621,821,仁文里,NULL
0,2466,9,2475,3054,0,0,81.04,1539,927,文聖里,NULL
0,2452,21,2473,3229,0,0,76.59,1720,732,光明里,NULL
0,2453,20,2473,3081,0,0,80.27,1573,880,西勢里,NULL
0,2451,22,2473,3237,0,0,76.4,1459,992,新美里,NULL
0,2456,17,2473,3134,0,0,78.91,1371,1085,龍山里,NULL
0,2448,23,2471,3156,0,0,78.3,1600,848,宋屋里,NULL
0,2440,30,2470,3052,0,0,80.93,1801,639,光華里,NULL
0,2446,24,2470,3379,0,0,73.1,1683,763,龍星村,NULL
0,2446,24,2470,3378,0,0,73.12,1601,845,瑞原里,NULL
0,2449,21,2470,3205,0,0,77.07,1379,1070,廣福里,NULL
0,2450,19,2469,3106,0,0,79.49,1920,530,清華里,NULL
0,2445,24,2469,3146,0,0,78.48,1623,822,秀山里,NULL
0,2440,28,2468,3015,0,0,81.86,1374,1066,廣昌里,NULL
0,2451,16,2467,3104,0,0,79.48,1778,673,中泰里,NULL
0,2443,23,2466,3192,0,0,77.26,1460,983,聯翠里,NULL
0,2439,27,2466,3237,0,0,76.18,1448,991,茄苳里,NULL
0,2454,12,2466,3373,0,0,73.11,1174,1280,內埔村,NULL
0,2451,15,2466,3093,0,0,79.73,770,1681,金田里,NULL
0,2446,19,2465,3066,0,0,80.4,1673,773,東勢里,NULL
0,2440,25,2465,3418,0,0,72.12,1451,989,兔坑村,NULL
0,2415,49,2464,3136,0,0,78.57,1829,586,正南里,NULL
0,2443,21,2464,3100,0,0,79.48,1637,806,四座里,NULL
0,2447,16,2463,3130,0,0,78.69,1381,1066,中西里,NULL
0,2444,17,2461,3110,0,0,79.13,2021,423,成功里,NULL
0,2436,25,2461,3131,0,0,78.6,1491,945,興漢里,NULL
0,2436,25,2461,3238,0,0,76,1454,982,東平里,NULL
0,2436,25,2461,3192,0,0,77.1,1372,1064,金寮里,NULL
0,2442,19,2461,3042,0,0,80.9,1327,1115,福音里,NULL
0,2439,21,2460,3071,0,0,80.1,1586,853,枋寮里,NULL
0,2441,18,2459,3233,0,0,76.06,1478,963,德泰村,NULL
0,2439,20,2459,3272,0,0,75.15,1357,1082,圓山里,NULL
0,2440,18,2458,3183,0,0,77.22,1521,919,堵北里,NULL
0,2434,24,2458,3134,0,0,78.43,1361,1073,大里里,NULL
0,2433,24,2457,3159,0,0,77.78,1905,528,興隆里,NULL
0,2433,24,2457,3205,0,0,76.66,1018,1415,一甲里,NULL
0,2441,15,2456,3144,0,0,78.12,1668,773,復興里,NULL
0,2429,27,2456,3088,0,0,79.53,1415,1014,樹德里,NULL
0,2434,22,2456,3180,0,0,77.23,1413,1021,寶山里,NULL
0,2433,23,2456,3061,0,0,80.24,1258,1175,培德里,NULL
0,2438,16,2454,3130,0,0,78.4,1303,1135,新生里,NULL
0,2423,31,2454,3072,0,0,79.88,1242,1181,福樂里,NULL
0,2421,31,2452,3200,0,0,76.63,1647,774,福隆里,NULL
0,2419,30,2449,4387,5379,81.56,55.82,2116,303,豐濱鄉,Fengbin Township
0,2434,14,2448,3164,0,0,77.37,1076,1358,平安里,NULL
0,2419,28,2447,3007,0,0,81.38,1939,480,瑞祥里,NULL
0,2436,11,2447,3136,0,0,78.03,1526,910,昌平里,NULL
0,2427,19,2446,3019,0,0,81.02,1804,623,興泰里,NULL
0,2413,33,2446,3176,0,0,77.02,1570,843,大崗村,NULL
0,2421,23,2444,3206,0,0,76.23,1424,997,香山里,NULL
0,2419,24,2443,3066,0,0,79.68,1503,916,牛埔里,NULL
0,2419,22,2441,3280,0,0,74.42,1395,1024,清華村,NULL
0,2412,28,2440,3230,0,0,75.54,1520,892,大埔里,NULL
0,2419,20,2439,3110,0,0,78.42,1829,590,楊明里,NULL
0,2411,28,2439,3191,0,0,76.43,1004,1407,正覺里,NULL
0,2420,17,2437,3058,0,0,79.69,1669,751,坪林里,NULL
0,2418,19,2437,3036,0,0,80.27,1482,936,碧河里,NULL
0,2422,15,2437,3166,0,0,76.97,1276,1146,保佑里,NULL
0,2418,19,2437,3335,0,0,73.07,1077,1341,淵東里,NULL
0,2421,15,2436,3076,0,0,79.19,1551,870,福安里,NULL
0,2421,14,2435,3061,0,0,79.55,1918,503,國豐里,NULL
0,2408,26,2434,3365,0,0,72.33,1321,1087,嶺頂村,NULL
0,2418,15,2433,3195,0,0,76.15,987,1431,明興里,NULL
0,2412,20,2432,2968,0,0,81.94,1396,1016,六藝里,NULL
0,2410,21,2431,3096,0,0,78.52,1022,1388,坔埔村,NULL
0,2420,10,2430,2957,0,0,82.18,1673,747,北華里,NULL
0,2408,21,2429,2890,0,0,84.05,2072,336,龍平里,NULL
0,2408,21,2429,3101,0,0,78.33,1126,1282,後市村,NULL
0,2406,23,2429,3258,0,0,74.55,866,1540,昭明村,NULL
0,2406,22,2428,3382,0,0,71.79,1937,469,南昌村,NULL
0,2405,23,2428,3046,0,0,79.71,1501,904,錦村里,NULL
0,2406,22,2428,3035,0,0,80,1384,1022,彰安里,NULL
0,2416,10,2426,2955,0,0,82.1,2156,260,自治里,NULL
0,2414,12,2426,3422,0,0,70.89,1414,1000,桂林里,NULL
0,2410,16,2426,3208,0,0,75.62,975,1435,大灣里,NULL
0,2385,36,2421,3130,0,0,77.35,1594,791,豐野里,NULL
0,2402,19,2421,3117,0,0,77.67,1509,893,光復里,NULL
0,2389,31,2420,3048,0,0,79.4,1575,814,糖友里,NULL
0,2397,23,2420,3128,0,0,77.37,1336,1061,立功里,NULL
0,2398,22,2420,3242,0,0,74.65,1122,1276,南興村,NULL
0,2393,26,2419,3194,0,0,75.74,1431,962,中山里,NULL
0,2396,23,2419,3181,0,0,76.05,1329,1067,沛陂里,NULL
0,2395,24,2419,3037,0,0,79.65,1251,1144,中路里,NULL
0,2398,20,2418,3192,0,0,75.75,1423,975,光榮里,NULL
0,2394,24,2418,3070,0,0,78.76,1321,1073,松翠里,NULL
0,2392,22,2414,3181,0,0,75.89,1344,1048,後龍里,NULL
0,2393,18,2411,3116,0,0,77.37,1160,1233,溪東里,NULL
0,2398,12,2410,3416,0,0,70.55,1825,573,光榮里,NULL
0,2382,28,2410,3306,0,0,72.9,1604,778,西門里,NULL
0,2389,21,2410,3190,0,0,75.55,1393,996,永和里,NULL
0,2379,30,2409,3002,0,0,80.25,1968,411,勝利村,NULL
0,2383,26,2409,2992,0,0,80.51,1478,905,文聖里,NULL
0,2398,11,2409,3138,0,0,76.77,1112,1286,港明里,NULL
0,2389,19,2408,3113,0,0,77.35,1414,975,明志村,NULL
0,2384,23,2407,3195,0,0,75.34,1891,493,民政里,NULL
0,2383,24,2407,3306,0,0,72.81,1473,910,新嶺村,NULL
0,2386,21,2407,3176,0,0,75.79,1322,1064,光明里,NULL
0,2389,18,2407,2985,0,0,80.64,1056,1333,光賢里,NULL
0,2395,11,2406,3152,0,0,76.33,1620,775,中寧里,NULL
0,2371,33,2404,3069,0,0,78.33,1505,866,和西里,NULL
0,2390,14,2404,3123,0,0,76.98,1377,1013,長安里,NULL
0,2382,20,2402,2962,0,0,81.09,1961,421,東寧里,NULL
0,2382,20,2402,2999,0,0,80.09,1628,754,福山里,NULL
0,2380,21,2401,2887,0,0,83.17,2121,259,莊敬里,NULL
0,2391,10,2401,3030,0,0,79.24,1525,866,廈安里,NULL
0,2377,24,2401,3113,0,0,77.13,1266,1111,南燕村,NULL
0,2379,21,2400,3060,0,0,78.43,1528,851,福林里,NULL
0,2376,23,2399,3239,0,0,74.07,1358,1018,宜昌里,NULL
0,2378,21,2399,3243,0,0,73.97,1351,1027,中政里,NULL
0,2384,14,2398,3022,0,0,79.35,1647,737,光明里,NULL
0,2369,28,2397,3325,0,0,72.09,2008,361,嘉里村,NULL
0,2368,28,2396,3033,0,0,79,1322,1046,柏翠里,NULL
0,2373,21,2394,3263,0,0,73.37,939,1434,六甲村,NULL
0,2366,26,2392,3152,0,0,75.89,1448,918,北京里,NULL
0,2373,18,2391,3045,0,0,78.52,1252,1121,竹東村,NULL
0,2375,16,2391,3183,0,0,75.12,1142,1233,灣復里,NULL
0,2370,20,2390,3047,0,0,78.44,1222,1148,中興里,NULL
0,2365,25,2390,3221,0,0,74.2,1190,1175,麻寮里,NULL
0,2356,32,2388,3230,0,0,73.93,1471,885,頂番里,NULL
0,2365,22,2387,3033,0,0,78.7,1329,1036,重陽里,NULL
0,2369,17,2386,2970,0,0,80.34,1280,1089,竹中里,NULL
0,2375,10,2385,3213,0,0,74.23,1122,1253,烏林村,NULL
0,2370,14,2384,3231,0,0,73.79,1070,1300,岸內里,NULL
0,2361,22,2383,3023,0,0,78.83,1745,616,永興里,NULL
0,2361,22,2383,3134,0,0,76.04,1109,1252,灣子里,NULL
0,2358,24,2382,3154,0,0,75.52,1765,593,主農里,NULL
0,2353,28,2381,2956,0,0,80.55,1844,509,仁愛里,NULL
0,2362,19,2381,3283,0,0,72.53,1349,1013,雲林里,NULL
0,2361,19,2380,3113,0,0,76.45,1231,1130,三合里,NULL
0,2362,17,2379,3191,0,0,74.55,1607,755,茄明里,NULL
0,2359,19,2378,2954,0,0,80.5,1571,788,平福里,NULL
0,2365,13,2378,3349,0,0,71.01,1062,1303,橋南里,NULL
0,2349,29,2378,3063,0,0,77.64,924,1425,頂安里,NULL
0,2354,23,2377,2976,0,0,79.87,1669,685,福德里,NULL
0,2348,29,2377,3089,0,0,76.95,1086,1262,朴子里,NULL
0,2347,26,2373,3066,0,0,77.4,1456,891,北興里,NULL
0,2351,21,2372,3000,0,0,79.07,1439,912,中興里,NULL
0,2351,18,2369,3349,0,0,70.74,1315,1036,延祥里,NULL
0,2356,13,2369,3086,0,0,76.77,704,1652,油車里,NULL
0,2338,30,2368,2887,0,0,82.02,1972,366,華勛里,NULL
0,2342,26,2368,3622,0,0,65.38,1362,980,山脚里,NULL
0,2347,18,2365,3069,0,0,77.06,1283,1064,新海里,NULL
0,2345,20,2365,3082,0,0,76.74,1115,1230,西安村,NULL
0,2347,17,2364,2915,0,0,81.1,1763,584,豐功里,NULL
0,2355,9,2364,2971,0,0,79.57,1237,1118,文英里,NULL
0,2339,25,2364,3247,0,0,72.81,1041,1298,梅花里,NULL
0,2331,32,2363,3031,0,0,77.96,1199,1132,中興里,NULL
0,2343,20,2363,3027,0,0,78.06,1155,1188,文成里,NULL
0,2336,27,2363,3240,0,0,72.93,1024,1312,大安里,NULL
0,2338,24,2362,2968,0,0,79.58,1145,1193,樹王里,NULL
0,2347,14,2361,3004,0,0,78.6,1371,976,新興里,NULL
0,2345,14,2359,3108,0,0,75.9,1734,611,國風里,NULL
0,2332,27,2359,3096,0,0,76.2,1276,1056,三多里,NULL
0,2338,20,2358,3075,0,0,76.68,1695,643,虎嘯里,NULL
0,2339,19,2358,3010,0,0,78.34,1428,911,埤頭里,NULL
0,2338,19,2357,2949,0,0,79.93,1712,626,百和里,NULL
0,2330,27,2357,3053,0,0,77.2,1416,914,何德里,NULL
0,2325,32,2357,3089,0,0,76.3,1307,1018,甲南村,NULL
0,2336,20,2356,3132,0,0,75.22,1347,989,聚葉里,NULL
0,2323,33,2356,3123,0,0,75.44,1196,1127,宏亮里,NULL
0,2333,21,2354,2955,0,0,79.66,1223,1110,朝陽里,NULL
0,2332,20,2352,3041,0,0,77.34,1253,1079,協和里,NULL
0,2324,28,2352,3029,0,0,77.65,926,1398,山東里,NULL
0,2333,18,2351,3182,0,0,73.88,1591,742,北安里,NULL
0,2332,19,2351,3040,0,0,77.34,1549,783,三元里,NULL
0,2334,17,2351,2946,0,0,79.8,1373,961,寶華里,NULL
0,2325,25,2350,3070,0,0,76.55,1191,1134,坐駕里,NULL
0,2331,17,2348,2858,0,0,82.16,1828,503,小城里,NULL
0,2326,22,2348,2931,0,0,80.11,1230,1096,華翠里,NULL
0,2326,20,2346,3065,0,0,76.54,1672,654,大有里,NULL
0,2330,16,2346,2964,0,0,79.15,1328,1002,樹林里,NULL
0,2322,24,2346,3018,0,0,77.73,1291,1031,東門村,NULL
0,2324,22,2346,3143,0,0,74.64,1236,1088,協興里,NULL
0,2321,25,2346,3160,0,0,74.24,1029,1292,小新里,NULL
0,2333,11,2344,2860,0,0,81.96,1740,593,長樂里,NULL
0,2321,22,2343,3281,0,0,71.41,1535,786,光華里,NULL
0,2325,18,2343,2933,0,0,79.88,1113,1212,林華里,NULL
0,2318,24,2342,3052,0,0,76.74,1660,658,凌雲村,NULL
0,2324,18,2342,2990,0,0,78.33,1407,917,中央里,NULL
0,2315,27,2342,3194,0,0,73.32,1268,1047,福興村,NULL
0,2312,29,2341,3021,0,0,77.49,1446,866,廣興里,NULL
0,2325,16,2341,3181,0,0,73.59,1122,1203,荖藤里,NULL
0,2317,23,2340,2907,0,0,80.5,1699,618,龍山里,NULL
0,2322,18,2340,3047,0,0,76.8,1049,1273,清溝村,NULL
0,2324,15,2339,3010,0,0,77.71,1423,901,五福村,NULL
0,2311,28,2339,2994,0,0,78.12,1289,1022,墩北村,NULL
0,2319,19,2338,3012,0,0,77.62,1173,1146,延平里,NULL
0,2310,28,2338,3176,0,0,73.61,1123,1187,民生里,NULL
0,2322,14,2336,2887,0,0,80.91,1451,871,裕興里,NULL
0,2312,22,2334,3027,0,0,77.11,1768,544,館南村,NULL
0,2308,26,2334,2978,0,0,78.37,1316,992,廣新里,NULL
0,2317,17,2334,2947,0,0,79.2,1077,1240,福誠里,NULL
0,2311,23,2334,3038,0,0,76.83,1015,1296,廣應村,NULL
0,2310,23,2333,2959,0,0,78.84,1448,862,賴福里,NULL
0,2314,19,2333,3074,0,0,75.89,977,1337,港墘村,NULL
0,2316,16,2332,3049,0,0,76.48,1080,1236,西燕村,NULL
0,2306,25,2331,3007,0,0,77.52,1215,1091,頭洲村,NULL
0,2306,23,2329,2902,0,0,80.25,1802,504,文山里,NULL
0,2308,21,2329,3190,0,0,73.01,1260,1048,南紙里,NULL
0,2313,15,2328,2926,0,0,79.56,1252,1061,普天里,NULL
0,2311,16,2327,3102,0,0,75.02,1529,782,錦祥里,NULL
0,2309,18,2327,2973,0,0,78.27,1209,1100,華堂里,NULL
0,2309,16,2325,2943,0,0,79,1785,524,田寮里,NULL
0,2285,40,2325,2924,0,0,79.51,1435,850,新社村,NULL
0,2300,24,2324,3244,0,0,71.64,1419,881,聚盛里,NULL
0,2310,14,2324,2898,0,0,80.19,1058,1252,尾北里,NULL
0,2299,24,2323,2920,0,0,79.55,1589,710,大平里,NULL
0,2297,26,2323,2944,0,0,78.91,1375,922,鄉雲里,NULL
0,2303,20,2323,3201,0,0,72.57,1231,1072,新庄里,NULL
0,2306,17,2323,2943,0,0,78.93,974,1332,瑞北里,NULL
0,2306,13,2319,3015,0,0,76.92,954,1352,溪墘里,NULL
0,2290,28,2318,3107,0,0,74.61,1208,1082,南簡里,NULL
0,2304,12,2316,2967,0,0,78.06,1284,1020,永祥里,NULL
0,2301,14,2315,2779,0,0,83.3,2117,184,忠孝里,NULL
0,2295,20,2315,3039,0,0,76.18,1571,724,龍陣里,NULL
0,2288,27,2315,2977,0,0,77.76,1411,877,新高里,NULL
0,2297,18,2315,2959,0,0,78.24,1214,1083,裕農里,NULL
0,2274,41,2315,2969,0,0,77.97,1167,1107,南田里,NULL
0,2289,25,2314,2957,0,0,78.25,1051,1238,建泰里,NULL
0,2288,25,2313,2986,0,0,77.46,1410,878,樹興里,NULL
0,2298,13,2311,3049,0,0,75.8,1447,851,崎頂里,NULL
0,2301,9,2310,2888,0,0,79.99,1414,887,林南里,NULL
0,2286,24,2310,2821,0,0,81.89,1190,1096,厚德里,NULL
0,2291,19,2310,2935,0,0,78.71,1179,1112,盛豐里,NULL
0,2284,25,2309,2998,0,0,77.02,1429,855,八勢里,NULL
0,2284,24,2308,2984,0,0,77.35,1377,907,大明里,NULL
0,2289,19,2308,3114,0,0,74.12,1192,1097,海埔里,NULL
0,2288,19,2307,2926,0,0,78.84,1382,906,花壇村,NULL
0,2295,11,2306,3005,0,0,76.74,1140,1155,仁愛里,NULL
0,2291,14,2305,2884,0,0,79.92,1674,617,孝賢里,NULL
0,2281,24,2305,3009,0,0,76.6,1669,612,學府里,NULL
0,2271,34,2305,2981,0,0,77.32,1477,794,秀才里,NULL
0,2286,19,2305,2928,0,0,78.72,1458,828,向心里,NULL
0,2286,19,2305,2909,0,0,79.24,1381,905,黎明村,NULL
0,2276,27,2303,2973,0,0,77.46,1413,863,竹園里,NULL
0,2279,24,2303,3028,0,0,76.06,1308,971,成功里,NULL
0,2296,7,2303,2978,0,0,77.33,1177,1119,藥王里,NULL
0,2286,16,2302,2867,0,0,80.29,1673,613,新仁里,NULL
0,2284,18,2302,2785,0,0,82.66,1078,1206,宏毅里,NULL
0,2277,24,2301,3013,0,0,76.37,1334,943,東芳里,NULL
0,2281,18,2299,2828,0,0,81.29,1846,435,山下里,NULL
0,2281,18,2299,2969,0,0,77.43,1522,759,智慧里,NULL
0,2282,17,2299,2887,0,0,79.63,1158,1124,賢北里,NULL
0,2275,24,2299,3335,0,0,68.94,1007,1268,大隱村,NULL
0,2282,16,2298,2940,0,0,78.16,1420,862,崇德里,NULL
0,2275,22,2297,2862,0,0,80.26,1240,1035,昌明里,NULL
0,2272,24,2296,3013,0,0,76.2,1320,952,光興里,NULL
0,2274,21,2295,2969,0,0,77.3,1350,924,頂竹里,NULL
0,2264,30,2294,3094,0,0,74.14,1463,801,新庄里,NULL
0,2277,17,2294,3110,0,0,73.76,1454,823,美田村,NULL
0,2276,17,2293,2977,0,0,77.02,1664,612,立人里,NULL
0,2275,17,2292,2825,0,0,81.13,1628,647,忠山里,NULL
0,2263,28,2291,2931,0,0,78.16,1645,618,興南里,NULL
0,2263,27,2290,3035,0,0,75.45,1491,772,水美村,NULL
0,2275,15,2290,2869,0,0,79.82,1460,815,文心里,NULL
0,2273,17,2290,2847,0,0,80.44,1435,838,漳和里,NULL
0,2273,17,2290,2995,0,0,76.46,993,1280,中厝里,NULL
0,2264,25,2289,3006,0,0,76.15,1634,630,龍祥里,NULL
0,2278,10,2288,2865,0,0,79.86,1457,821,國泰里,NULL
0,2270,18,2288,2902,0,0,78.84,975,1295,五和村,NULL
0,2258,29,2287,3072,0,0,74.45,1259,999,怡平里,NULL
0,2264,22,2286,3048,0,0,75,1914,350,民孝里,NULL
0,2274,12,2286,2945,0,0,77.62,1594,680,三民里,NULL
0,2261,24,2285,2994,0,0,76.32,1445,816,橋頭村,NULL
0,2267,18,2285,3007,0,0,75.99,1071,1196,林園村,NULL
0,2268,16,2284,3010,0,0,75.88,1422,846,北路里,NULL
0,2269,13,2282,2893,0,0,78.88,1714,555,壯觀里,NULL
0,2272,9,2281,2863,0,0,79.67,1619,653,大同里,NULL
0,2256,22,2278,2897,0,0,78.63,1344,912,豐圳里,NULL
0,2261,15,2276,2876,0,0,79.14,1249,1012,永安里,NULL
0,2250,24,2274,2989,0,0,76.08,1376,874,草中里,NULL
0,2252,20,2272,2926,0,0,77.65,1377,875,山福村,NULL
0,2237,35,2272,2974,0,0,76.4,1187,1050,興中里,NULL
0,2251,20,2271,3137,0,0,72.39,1091,1160,永和里,NULL
0,2248,22,2270,3095,0,0,73.34,1137,1111,大宏里,NULL
0,2239,30,2269,2896,0,0,78.35,1436,803,忠權里,NULL
0,2250,19,2269,2913,0,0,77.89,1370,880,文化里,NULL
0,2250,19,2269,3167,0,0,71.65,1350,900,鎮西里,NULL
0,2246,23,2269,2849,0,0,79.64,1198,1048,福民里,NULL
0,2255,13,2268,2805,0,0,80.86,1638,617,河濱里,NULL
0,2254,14,2268,3069,0,0,73.9,1393,861,西安里,NULL
0,2244,24,2268,2851,0,0,79.55,1345,899,西興里,NULL
0,2251,17,2268,3005,0,0,75.47,1270,981,新潭村,NULL
0,2249,17,2266,2736,0,0,82.82,1577,672,景文里,NULL
0,2245,21,2266,2931,0,0,77.31,1055,1190,國宅里,NULL
0,2250,16,2266,2895,0,0,78.27,929,1321,美華里,NULL
0,2247,18,2265,2950,0,0,76.78,1398,849,中正里,NULL
0,2241,22,2263,2881,0,0,78.55,1300,941,富民里,NULL
0,2231,30,2261,2968,0,0,76.18,1688,543,瑞坪里,NULL
0,2244,17,2261,2775,0,0,81.48,1268,976,福星里,NULL
0,2237,23,2260,2885,0,0,78.34,1163,1074,大觀里,NULL
0,2235,25,2260,2951,0,0,76.58,1101,1134,山崙里,NULL
0,2239,20,2259,2785,0,0,81.11,1429,810,嘉興里,NULL
0,2244,15,2259,2857,0,0,79.07,1411,833,長庚村,NULL
0,2235,23,2258,2975,0,0,75.9,1361,874,民有里,NULL
0,2230,27,2257,2914,0,0,77.45,1245,985,光正里,NULL
0,2232,24,2256,2929,0,0,77.02,1362,870,育德里,NULL
0,2236,18,2254,2877,0,0,78.35,1144,1092,永盛里,NULL
0,2235,19,2254,2903,0,0,77.64,1100,1135,文北村,NULL
0,2227,26,2253,2951,0,0,76.35,1423,804,大福里,NULL
0,2233,20,2253,3060,0,0,73.63,1322,911,六路里,NULL
0,2236,17,2253,3074,0,0,73.29,1026,1210,龍德里,NULL
0,2225,27,2252,2962,0,0,76.03,1074,1151,仁義里,NULL
0,2231,19,2250,2942,0,0,76.48,1618,613,九龍村,NULL
0,2233,17,2250,2780,0,0,80.94,1576,657,秀元里,NULL
0,2238,11,2249,2993,0,0,75.14,878,1360,西溪村,NULL
0,2222,26,2248,2853,0,0,78.79,1235,987,大強里,NULL
0,2228,19,2247,2847,0,0,78.93,1311,917,溪北里,NULL
0,2231,16,2247,3141,0,0,71.54,1151,1080,新二村,NULL
0,2233,13,2246,2897,0,0,77.53,1383,850,秀山里,NULL
0,2227,19,2246,2899,0,0,77.47,1177,1050,隆本村,NULL
0,2220,24,2244,2922,0,0,76.8,1309,911,福隆里,NULL
0,2219,25,2244,2990,0,0,75.05,830,1389,鳳源里,NULL
0,2222,21,2243,2886,0,0,77.72,1340,882,學府里,NULL
0,2226,17,2243,2965,0,0,75.65,1122,1104,中全里,NULL
0,2230,12,2242,2795,0,0,80.21,1794,436,華愛里,NULL
0,2221,20,2241,2809,0,0,79.78,1348,873,福壽里,NULL
0,2219,22,2241,2875,0,0,77.95,1300,919,大竹里,NULL
0,2217,24,2241,2862,0,0,78.3,1226,991,南靖里,NULL
0,2224,17,2241,2807,0,0,79.84,1021,1203,寶中里,NULL
0,2224,17,2241,2938,0,0,76.28,868,1356,西港村,NULL
0,2203,37,2240,2849,0,0,78.62,1727,476,高苗里,NULL
0,2229,11,2240,3089,0,0,72.52,1342,887,意誠里,NULL
0,2220,19,2239,2854,0,0,78.45,1464,756,板溪里,NULL
0,2221,18,2239,3002,0,0,74.58,998,1223,東勢村,NULL
0,2212,26,2238,2881,0,0,77.68,1754,458,福安里,NULL
0,2217,21,2238,2872,0,0,77.92,1393,824,文化里,NULL
0,2209,29,2238,2947,0,0,75.94,1305,904,磚磘里,NULL
0,2209,29,2238,2940,0,0,76.12,1146,1063,集賢村,NULL
0,2228,9,2237,2828,0,0,79.1,1847,381,百年村,NULL
0,2210,27,2237,3058,0,0,73.15,1410,800,雅楓村,NULL
0,2215,22,2237,2977,0,0,75.14,1348,867,興隆里,NULL
0,2207,29,2236,2862,0,0,78.13,1501,706,義里村,NULL
0,2208,27,2235,2861,0,0,78.12,1854,354,民勤里,NULL
0,2218,17,2235,2732,0,0,81.81,1182,1036,重明里,NULL
0,2220,14,2234,2866,0,0,77.95,1770,450,達觀里,NULL
0,2213,21,2234,3008,0,0,74.27,876,1337,坪頂里,NULL
0,2211,23,2234,3057,0,0,73.08,838,1373,二甲村,NULL
0,2214,19,2233,2779,0,0,80.35,1102,1112,立德里,NULL
0,2218,14,2232,2793,0,0,79.91,1493,725,永康里,NULL
0,2197,35,2232,3040,0,0,73.42,1486,711,三鹿里,NULL
0,2206,26,2232,2924,0,0,76.33,1247,959,月眉里,NULL
0,2216,15,2231,2928,0,0,76.2,1095,1121,湖內村,NULL
0,2211,19,2230,2765,0,0,80.65,1027,1184,享平里,NULL
0,2215,15,2230,2973,0,0,75.01,862,1353,厚生里,NULL
0,2210,18,2228,2780,0,0,80.14,1319,891,景星里,NULL
0,2207,21,2228,2944,0,0,75.68,1250,957,中庄里,NULL
0,2214,14,2228,2776,0,0,80.26,893,1321,厚生里,NULL
0,2212,15,2227,2838,0,0,78.47,1457,755,錦洲里,NULL
0,2205,22,2227,2881,0,0,77.3,1240,965,中隆里,NULL
0,2210,17,2227,2893,0,0,76.98,935,1275,安康里,NULL
0,2209,16,2225,2875,0,0,77.39,1138,1071,大湖村,NULL
0,2203,21,2224,2908,0,0,76.48,1665,538,朝棟里,NULL
0,2213,11,2224,2974,0,0,74.78,1130,1083,大同里,NULL
0,2205,18,2223,2786,0,0,79.79,1569,636,東香里,NULL
0,2193,29,2222,2856,0,0,77.8,1399,794,營盤里,NULL
0,2199,23,2222,2888,0,0,76.94,1271,928,萬安里,NULL
0,2204,17,2221,2803,0,0,79.24,1521,683,龍光里,NULL
0,2210,11,2221,2931,0,0,75.78,1271,939,楓樹村,NULL
0,2202,19,2221,2827,0,0,78.56,1125,1077,得勝里,NULL
0,2203,17,2220,2793,0,0,79.48,1138,1065,福地里,NULL
0,2197,22,2219,2782,0,0,79.76,1287,910,清穗里,NULL
0,2206,13,2219,2820,0,0,78.69,1217,989,中宏里,NULL
0,2198,19,2217,2772,0,0,79.98,1005,1193,復國里,NULL
0,2205,12,2217,2796,0,0,79.29,989,1216,同德里,NULL
0,2193,22,2215,2780,0,0,79.68,1025,1168,福居里,NULL
0,2190,25,2215,2951,0,0,75.06,928,1262,許厝村,NULL
0,2202,12,2214,3012,0,0,73.51,1016,1186,永榮里,NULL
0,2185,28,2213,2983,0,0,74.19,1445,740,東寮里,NULL
0,2201,11,2212,2803,0,0,78.92,1374,827,三和里,NULL
0,2198,14,2212,2807,0,0,78.8,1155,1043,東寧里,NULL
0,2188,22,2210,2783,0,0,79.41,1648,540,龍德里,NULL
0,2196,14,2210,2782,0,0,79.44,1137,1059,東興里,NULL
0,2189,20,2209,2765,0,0,79.89,1185,1004,公益里,NULL
0,2194,13,2207,2787,0,0,79.19,1791,403,頭份里,NULL
0,2177,29,2206,2830,0,0,77.95,1865,312,仁義里,NULL
0,2178,28,2206,2701,0,0,81.67,1567,611,仁愛里,NULL
0,2191,15,2206,2964,0,0,74.43,1481,710,南光里,NULL
0,2188,18,2206,2759,0,0,79.96,1026,1162,西埔里,NULL
0,2185,20,2205,2850,0,0,77.37,1240,945,田中村,NULL
0,2186,18,2204,2618,0,0,84.19,1987,199,長榮里,NULL
0,2171,33,2204,3218,0,0,68.49,1507,664,中山里,NULL
0,2190,14,2204,3255,0,0,67.71,1036,1154,長南村,NULL
0,2180,23,2203,2777,0,0,79.33,1612,568,景南里,NULL
0,2170,32,2202,2721,0,0,80.93,1732,438,嘉新里,NULL
0,2184,18,2202,2840,0,0,77.54,1694,490,斗煥里,NULL
0,2190,12,2202,2859,0,0,77.02,1051,1139,三苓里,NULL
0,2181,20,2201,2802,0,0,78.55,1410,771,新厝里,NULL
0,2181,20,2201,2758,0,0,79.8,1225,956,樹德里,NULL
0,2175,26,2201,2861,0,0,76.93,1066,1109,南嵩里,NULL
0,2176,25,2201,2702,0,0,81.46,894,1282,民強里,NULL
0,2178,22,2200,3168,0,0,69.44,1722,456,北埔村,NULL
0,2174,26,2200,2730,0,0,80.59,1333,841,民有里,NULL
0,2178,20,2198,2841,0,0,77.37,1025,1153,建明里,NULL
0,2176,21,2197,2758,0,0,79.66,1261,915,德生里,NULL
0,2175,21,2196,3021,0,0,72.69,1219,956,中正村,NULL
0,2166,30,2196,2817,0,0,77.96,1132,1034,富貴里,NULL
0,2171,25,2196,2967,0,0,74.01,965,1206,灣愛里,NULL
0,2171,23,2194,2843,0,0,77.17,1412,759,坑口村,NULL
0,2171,23,2194,3041,0,0,72.15,1342,829,合興村,NULL
0,2182,12,2194,3001,0,0,73.11,932,1250,保定村,NULL
0,2173,20,2193,2841,0,0,77.19,1007,1166,復興里,NULL
0,2174,18,2192,2729,0,0,80.32,1678,496,自強里,NULL
0,2179,13,2192,2771,0,0,79.11,1476,703,六福村,NULL
0,2158,33,2191,2974,0,0,73.67,1281,877,樂善村,NULL
0,2174,16,2190,3081,0,0,71.08,1391,783,西門里,NULL
0,2162,28,2190,2780,0,0,78.78,1307,855,新貴里,NULL
0,2182,8,2190,2762,0,0,79.29,960,1222,五福里,NULL
0,2169,20,2189,2843,0,0,77,1296,873,頂埔里,NULL
0,2159,30,2189,2782,0,0,78.68,1243,916,西安里,NULL
0,2163,26,2189,2809,0,0,77.93,1227,936,東昇里,NULL
0,2159,28,2187,3113,0,0,70.25,1547,612,太昌村,NULL
0,2168,18,2186,2676,0,0,81.69,1771,397,忠孝里,NULL
0,2170,16,2186,2991,0,0,73.09,1566,604,東海里,NULL
0,2171,15,2186,2945,0,0,74.23,1052,1119,五結村,NULL
0,2168,18,2186,2814,0,0,77.68,1020,1148,忠誠里,NULL
0,2172,12,2184,2796,0,0,78.11,1410,762,復興里,NULL
0,2164,19,2183,2829,0,0,77.17,1425,739,七賢里,NULL
0,2172,11,2183,2728,0,0,80.02,894,1278,瑞昌里,NULL
0,2159,23,2182,2780,0,0,78.49,1014,1145,新田村,NULL
0,2161,20,2181,2703,0,0,80.69,1597,564,頂南里,NULL
0,2165,13,2178,2836,0,0,76.8,1364,801,梅花里,NULL
0,2155,21,2176,2791,0,0,77.96,1291,864,龍華村,NULL
0,2148,26,2174,2762,0,0,78.71,1104,1044,三民里,NULL
0,2149,25,2174,2756,0,0,78.88,1044,1105,溪墘里,NULL
0,2150,23,2173,2702,0,0,80.42,1154,996,後甲里,NULL
0,2160,11,2171,2806,0,0,77.37,1026,1134,白樹村,NULL
0,2152,17,2169,3274,0,0,66.25,1362,790,水頭里,NULL
0,2153,16,2169,2746,0,0,78.99,1021,1132,瑞豐里,NULL
0,2148,20,2168,2712,0,0,79.94,1251,897,同興村,NULL
0,2140,27,2167,3027,0,0,71.59,1333,807,萬壽里,NULL
0,2148,19,2167,2886,0,0,75.09,1182,966,正興里,NULL
0,2150,17,2167,2920,0,0,74.21,986,1164,大吉村,NULL
0,2147,20,2167,2839,0,0,76.33,971,1176,維新村,NULL
0,2152,14,2166,2780,0,0,77.91,1527,625,普忠里,NULL
0,2148,18,2166,2637,0,0,82.14,1511,637,協和里,NULL
0,2147,19,2166,2861,0,0,75.71,1243,904,八德里,NULL
0,2149,17,2166,2801,0,0,77.33,1154,995,秀山村,NULL
0,2146,20,2166,2943,0,0,73.6,1090,1056,東安里,NULL
0,2154,12,2166,2728,0,0,79.4,1031,1123,泰山里,NULL
0,2130,33,2163,2707,0,0,79.9,1569,561,長嶺村,NULL
0,2151,12,2163,2742,0,0,78.88,1124,1027,龍濱里,NULL
0,2148,14,2162,2778,0,0,77.83,1261,887,三重里,NULL
0,2142,20,2162,2896,0,0,74.65,1135,1007,下湳里,NULL
0,2144,17,2161,2662,0,0,81.18,1632,512,後庄里,NULL
0,2134,26,2160,2831,0,0,76.3,1019,1115,五甲村,NULL
0,2141,19,2160,2864,0,0,75.42,912,1229,永安里,NULL
0,2138,21,2159,2691,0,0,80.23,1663,475,忠孝里,NULL
0,2148,11,2159,2702,0,0,79.9,1567,581,光明里,NULL
0,2143,16,2159,2781,0,0,77.63,980,1163,中里村,NULL
10,2142,16,2158,2671,0,0,80.79,1610,532,十興里,NULL
0,2147,11,2158,2690,0,0,80.22,1338,809,良和里,NULL
0,2137,20,2157,2702,0,0,79.83,1731,406,仁祥里,NULL
0,2137,19,2156,2960,0,0,72.84,962,1175,嘉賜村,NULL
0,2140,14,2154,2658,0,0,81.04,1197,943,中正里,NULL
0,2128,24,2152,2768,0,0,77.75,1073,1055,正言里,NULL
0,2118,32,2150,2788,0,0,77.12,1770,348,鳳山村,NULL
0,2137,13,2150,2688,0,0,79.99,1716,421,明城里,NULL
0,2128,22,2150,2766,0,0,77.73,1328,800,双龍里,NULL
0,2122,25,2147,2710,0,0,79.23,1358,764,中興里,NULL
0,2132,13,2145,2761,0,0,77.69,1207,925,集福村,NULL
0,2125,20,2145,2852,0,0,75.21,1107,1018,民生村,NULL
0,2137,7,2144,2620,0,0,81.83,1526,611,騰雲里,NULL
0,2122,22,2144,2821,0,0,76,1134,988,東山里,NULL
0,2119,25,2144,2717,0,0,78.91,1036,1083,滿翠里,NULL
0,2119,23,2142,2683,0,0,79.84,1377,742,樹人里,NULL
0,2118,24,2142,2727,0,0,78.55,1095,1023,福隆里,NULL
0,2123,19,2142,2841,0,0,75.4,1013,1110,辜厝村,NULL
0,2127,14,2141,3450,4782,72.15,62.06,1907,220,桃源鄉,Taoyuan Township
0,2126,15,2141,2801,0,0,76.44,1323,803,公安里,NULL
0,2123,18,2141,2943,0,0,72.75,1154,969,武鹿里,NULL
0,2127,14,2141,2730,0,0,78.42,985,1142,隆和里,NULL
0,2120,20,2140,2931,0,0,73.01,1501,619,中平村,NULL
0,2117,23,2140,2707,0,0,79.05,1413,704,東園里,NULL
0,2128,12,2140,2869,0,0,74.59,1308,820,眉山村,NULL
0,2110,29,2139,2737,0,0,78.15,1252,858,義信里,NULL
0,2109,30,2139,2629,0,0,81.36,1229,880,文德里,NULL
0,2118,21,2139,2615,0,0,81.8,1148,970,正泰里,NULL
0,2113,25,2138,2761,0,0,77.44,1228,885,柑井里,NULL
0,2124,14,2138,2650,0,0,80.68,1015,1109,孝德里,NULL
0,2120,18,2138,3236,0,0,66.07,1007,1113,揚雅里,NULL
0,2122,15,2137,2808,0,0,76.1,1322,800,何厝里,NULL
0,2121,16,2137,2718,0,0,78.62,1143,978,崇學里,NULL
0,2118,19,2137,2749,0,0,77.74,1045,1073,南蓮村,NULL
0,2108,28,2136,3017,0,0,70.8,1483,625,主和里,NULL
0,2112,23,2135,2762,0,0,77.3,1544,568,普義里,NULL
0,2117,18,2135,2808,0,0,76.03,1110,1007,西橋里,NULL
0,2112,22,2134,2741,0,0,77.85,1133,979,鶴鳴村,NULL
0,2113,20,2133,2782,0,0,76.67,1244,869,新明村,NULL
0,2115,18,2133,2773,0,0,76.92,1210,905,神岡村,NULL
0,2110,23,2133,2744,0,0,77.73,1200,910,林厝里,NULL
0,2120,13,2133,2663,0,0,80.1,1180,940,學成里,NULL
0,2114,18,2132,2942,0,0,72.47,1439,675,鶯歌里,NULL
0,2118,14,2132,2712,0,0,78.61,1272,846,福興村,NULL
0,2112,19,2131,2722,0,0,78.29,1265,847,美仁里,NULL
0,2104,26,2130,2684,0,0,79.36,1417,687,大昌里,NULL
0,2112,18,2130,2834,0,0,75.16,907,1205,五房村,NULL
0,2115,15,2130,2821,0,0,75.51,895,1220,忠仁里,NULL
0,2113,16,2129,2728,0,0,78.04,1232,881,南崁村,NULL
0,2110,19,2129,2690,0,0,79.14,966,1144,岸裡村,NULL
0,2116,12,2128,2760,0,0,77.1,1259,857,昌隆里,NULL
0,2108,19,2127,2669,0,0,79.69,1565,543,太平里,NULL
0,2114,13,2127,2658,0,0,80.02,1000,1114,仁和村,NULL
0,2113,13,2126,2873,0,0,74,879,1234,前進里,NULL
0,2095,30,2125,2909,0,0,73.05,728,1367,東勢村,NULL
0,2108,16,2124,2683,0,0,79.17,1596,512,民治里,NULL
0,2103,21,2124,2699,0,0,78.7,1190,913,尚德里,NULL
0,2105,18,2123,2681,0,0,79.19,1401,704,崇誨里,NULL
0,2098,25,2123,2718,0,0,78.11,956,1142,仁翠里,NULL
0,2088,34,2122,2718,0,0,78.07,1205,883,國華里,NULL
0,2107,15,2122,2637,0,0,80.47,1195,912,介壽里,NULL
0,2100,22,2122,2852,0,0,74.4,896,1204,大鄉里,NULL
0,2092,27,2119,2584,0,0,82,1461,631,安和里,NULL
0,2097,21,2118,2741,0,0,77.27,1315,782,民龍里,NULL
0,2095,21,2116,2620,0,0,80.76,1468,627,秀仁里,NULL
0,2097,17,2114,2740,0,0,77.15,1606,491,興仁里,NULL
0,2092,22,2114,2590,0,0,81.62,1450,642,民富里,NULL
0,2096,18,2114,2709,0,0,78.04,1374,722,新榮里,NULL
0,2084,30,2114,2771,0,0,76.29,1206,878,香山里,NULL
0,2097,16,2113,2675,0,0,78.99,1497,600,中興里,NULL
0,2091,21,2112,2828,0,0,74.68,1326,765,海口里,NULL
0,2097,15,2112,2704,0,0,78.11,1134,963,寶民里,NULL
0,2101,11,2112,2807,0,0,75.24,1094,1007,信義里,NULL
0,2092,18,2110,2798,0,0,75.41,1472,620,林泉里,NULL
0,2082,28,2110,2639,0,0,79.95,1123,959,過嶺里,NULL
0,2088,21,2109,2784,0,0,75.75,809,1279,龍潭村,NULL
0,2088,20,2108,2681,0,0,78.63,1531,557,大漢里,NULL
0,2084,22,2106,2668,0,0,78.94,1234,850,民全里,NULL
0,2082,24,2106,2621,0,0,80.35,953,1129,豐裕里,NULL
0,2089,17,2106,2588,0,0,81.38,816,1273,安和里,NULL
0,2091,14,2105,2824,0,0,74.54,916,1175,六甲村,NULL
0,2079,24,2103,2759,0,0,76.22,1281,798,東勢里,NULL
0,2086,17,2103,3484,0,0,60.36,1209,877,埤塘里,NULL
0,2079,24,2103,2721,0,0,77.29,1178,901,墩南村,NULL
0,2093,9,2102,2886,0,0,72.83,1218,875,復興里,NULL
0,2076,24,2100,2652,0,0,79.19,1294,782,廣興里,NULL
0,2083,17,2100,2749,0,0,76.39,947,1136,竹滬村,NULL
0,2073,26,2099,2822,0,0,74.38,1201,872,大湳里,NULL
0,2078,19,2097,2587,0,0,81.06,1517,561,永福里,NULL
0,2087,10,2097,2994,0,0,70.04,1394,693,民生里,NULL
0,2084,13,2097,2744,0,0,76.42,1222,862,溝美里,NULL
0,2062,35,2097,2635,0,0,79.58,922,1140,龍成里,NULL
0,2073,23,2096,2520,0,0,83.17,1984,89,鵬程里,NULL
0,2075,20,2095,2784,0,0,75.25,1028,1047,竹林里,NULL
0,2085,9,2094,2799,0,0,74.81,1298,787,訊塘村,NULL
0,2068,26,2094,2711,0,0,77.24,1126,942,仁忠里,NULL
0,2075,18,2093,2662,0,0,78.63,1144,931,光復里,NULL
0,2072,19,2091,2602,0,0,80.36,1529,543,東海里,NULL
0,2074,17,2091,2788,0,0,75,1216,858,興安里,NULL
0,2064,25,2089,2669,0,0,78.27,1079,985,三民里,NULL
1809,2075,13,2088,2639,0,0,79.12,1455,620,龍埔里,NULL
0,2064,24,2088,2669,0,0,78.23,1292,772,大興里,NULL
0,2073,15,2088,2748,0,0,75.98,1050,1023,德高里,NULL
0,2081,6,2087,2689,0,0,77.61,1491,590,鶯安里,NULL
0,2056,30,2086,2611,0,0,79.89,1681,375,龍恩里,NULL
0,2067,17,2084,2669,0,0,78.08,1490,577,東安里,NULL
0,2073,11,2084,2700,0,0,77.19,1046,1027,公正里,NULL
0,2056,27,2083,2605,0,0,79.96,1420,636,聖福里,NULL
0,2064,19,2083,2623,0,0,79.41,1277,787,愛國里,NULL
0,2068,15,2083,2697,0,0,77.23,1176,892,陽明里,NULL
0,2055,28,2083,2882,0,0,72.28,1065,990,復興里,NULL
0,2058,24,2082,2644,0,0,78.74,1355,703,上林里,NULL
0,2052,30,2082,2886,0,0,72.14,1349,703,竹興里,NULL
0,2067,15,2082,2743,0,0,75.9,1292,775,和平里,NULL
0,2058,24,2082,2642,0,0,78.8,1104,954,瑞興里,NULL
0,2060,21,2081,2645,0,0,78.68,1364,696,明德里,NULL
0,2058,21,2079,2657,0,0,78.25,1173,885,大安里,NULL
0,2066,12,2078,2580,0,0,80.54,1610,456,建國里,NULL
0,2059,18,2077,3034,0,0,68.46,1340,719,西衛里,NULL
0,2058,19,2077,2768,0,0,75.04,1247,811,吉仁里,NULL
0,2057,20,2077,2566,0,0,80.94,762,1295,瑞西里,NULL
0,2061,15,2076,2726,0,0,76.16,1240,821,美港村,NULL
0,2066,10,2076,2862,0,0,72.54,1176,890,新吉里,NULL
0,2057,18,2075,2573,0,0,80.65,1452,605,秀成里,NULL
0,2061,14,2075,2593,0,0,80.02,1096,965,文化里,NULL
0,2061,14,2075,2637,0,0,78.69,684,1377,潮寮村,NULL
0,2060,14,2074,2634,0,0,78.74,1243,817,水田里,NULL
0,2049,25,2074,2607,0,0,79.56,1122,927,居仁里,NULL
0,2048,25,2073,2730,0,0,75.93,1176,872,八張里,NULL
0,2055,17,2072,2785,0,0,74.4,1349,706,吉安里,NULL
0,2061,11,2072,2694,0,0,76.91,862,1199,仁愛村,NULL
0,2050,21,2071,2637,0,0,78.54,1347,703,復源里,NULL
0,2044,27,2071,2934,0,0,70.59,940,1104,廉使里,NULL
0,2060,11,2071,2553,0,0,81.12,841,1219,保安村,NULL
0,2056,13,2069,2614,0,0,79.15,820,1236,中陽里,NULL
0,2049,19,2068,2573,0,0,80.37,1621,428,三元里,NULL
0,2045,23,2068,2820,0,0,73.33,1309,736,埔子里,NULL
0,2045,23,2068,2683,0,0,77.08,1222,823,和平里,NULL
0,2048,17,2065,2638,0,0,78.28,1308,740,三愛里,NULL
0,2057,8,2065,2571,0,0,80.32,1130,927,文昌里,NULL
0,2049,16,2065,2578,0,0,80.1,1121,928,福東里,NULL
0,2049,15,2064,2542,0,0,81.2,1306,743,光輝里,NULL
0,2044,20,2064,2865,0,0,72.04,1288,756,東門里,NULL
0,2034,29,2063,2668,0,0,77.32,1280,754,建國里,NULL
0,2033,30,2063,2739,0,0,75.32,1207,826,鎮興里,NULL
0,2038,23,2061,2889,0,0,71.34,998,1040,和睦村,NULL
0,2012,48,2060,2719,0,0,75.76,1605,407,商華里,NULL
0,2045,15,2060,2808,0,0,73.36,982,1063,內田村,NULL
0,2037,22,2059,2611,0,0,78.86,1387,650,永興村,NULL
0,2043,16,2059,2606,0,0,79.01,1238,805,港正里,NULL
0,2042,17,2059,2582,0,0,79.74,1235,807,中埔里,NULL
0,2048,10,2058,2608,0,0,78.91,1135,913,中湖村,NULL
0,2040,18,2058,2698,0,0,76.28,1023,1017,牛埔里,NULL
0,2041,16,2057,2623,0,0,78.42,1109,932,積善里,NULL
0,2028,28,2056,2731,0,0,75.28,1189,839,新興里,NULL
0,2046,9,2055,2686,0,0,76.51,1084,962,埔前里,NULL
0,2043,11,2054,2591,0,0,79.27,1175,868,潮洋里,NULL
0,2039,12,2051,2558,0,0,80.18,1282,757,宏昌里,NULL
0,2034,16,2050,2594,0,0,79.03,1249,785,文中里,NULL
0,2029,21,2050,3302,0,0,62.08,1225,804,榮和里,NULL
0,2030,20,2050,2715,0,0,75.51,966,1064,永源村,NULL
0,2033,16,2049,2475,0,0,82.79,1859,174,新生里,NULL
0,2030,19,2049,2530,0,0,80.99,1170,860,崇成里,NULL
0,2030,18,2048,2589,0,0,79.1,1195,835,民義村,NULL
0,2030,18,2048,2583,0,0,79.29,910,1120,竹內里,NULL
0,2030,18,2048,2603,0,0,78.68,849,1181,國順里,NULL
0,2026,20,2046,2651,0,0,77.18,1218,808,仁美里,NULL
0,2028,18,2046,2545,0,0,80.39,863,1165,瑞興里,NULL
0,2028,17,2045,2567,0,0,79.66,1452,576,興光里,NULL
0,2016,29,2045,2633,0,0,77.67,1040,976,福安里,NULL
0,2029,15,2044,2930,0,0,69.76,783,1246,新圍村,NULL
0,2028,16,2044,2719,0,0,75.17,706,1322,省躬里,NULL
0,2024,17,2041,2704,0,0,75.48,1272,752,桃源里,NULL
0,2027,14,2041,2530,0,0,80.67,857,1170,三奶村,NULL
0,2027,13,2040,2565,0,0,79.53,1039,988,普照里,NULL
0,2027,13,2040,2654,0,0,76.87,1014,1013,新興里,NULL
0,2024,16,2040,2770,0,0,73.65,959,1065,維新里,NULL
0,2028,11,2039,2708,0,0,75.3,1273,755,正得里,NULL
0,2019,20,2039,2579,0,0,79.06,1253,766,福林里,NULL
0,2025,14,2039,2686,0,0,75.91,1160,865,玉泉里,NULL
0,2022,17,2039,2509,0,0,81.27,1117,905,光仁里,NULL
0,2020,19,2039,2647,0,0,77.03,1060,960,社頭村,NULL
0,2015,23,2038,2752,0,0,74.06,1067,948,光隆里,NULL
0,2022,15,2037,2556,0,0,79.69,1213,809,昌信里,NULL
0,2024,13,2037,2665,0,0,76.44,1097,927,維揚里,NULL
0,2023,14,2037,2554,0,0,79.76,1078,945,興和里,NULL
0,2013,22,2035,2585,0,0,78.72,1370,643,義德村,NULL
0,2015,20,2035,3375,0,0,60.3,1254,761,和豐村,NULL
0,2019,16,2035,2661,0,0,76.48,889,1130,國隆里,NULL
0,2015,19,2034,2552,0,0,79.7,1144,871,長榮里,NULL
0,2017,17,2034,2620,0,0,77.63,688,1329,大埕里,NULL
0,2009,24,2033,2638,0,0,77.07,1280,729,東門里,NULL
0,2022,10,2032,2570,0,0,79.07,1353,669,智仁里,NULL
0,2004,28,2032,2616,0,0,77.68,1041,963,西雅里,NULL
0,2015,15,2030,2534,0,0,80.11,1535,480,百福里,NULL
0,2004,25,2029,2602,0,0,77.98,1097,907,莒光里,NULL
0,2014,15,2029,2863,0,0,70.87,994,1020,東和村,NULL
0,2012,17,2029,2562,0,0,79.2,924,1088,新甲里,NULL
0,2013,15,2028,2502,0,0,81.06,1439,574,中興里,NULL
0,1999,27,2026,2613,0,0,77.54,1055,944,鎮平里,NULL
0,2009,17,2026,2686,0,0,75.43,1052,957,圳安里,NULL
0,2008,16,2024,2621,0,0,77.22,1547,461,仁和里,NULL
0,2007,16,2023,2531,0,0,79.93,1144,863,正仁里,NULL
0,2011,12,2023,2610,0,0,77.51,1064,947,竹南村,NULL
0,2001,21,2022,2611,0,0,77.44,1204,797,三橋里,NULL
0,2003,19,2022,2704,0,0,74.78,1033,970,三仙里,NULL
0,2010,12,2022,2590,0,0,78.07,963,1047,溪北里,NULL
0,1999,22,2021,2653,0,0,76.18,1494,505,龍祥村,NULL
0,2004,16,2020,2640,0,0,76.52,1289,715,大東村,NULL
0,2004,15,2019,2590,0,0,77.95,1283,721,榮泉村,NULL
0,2007,12,2019,2457,0,0,82.17,1011,996,正義里,NULL
0,1995,23,2018,3014,0,0,66.95,1061,934,漢寶村,NULL
0,2011,7,2018,2537,0,0,79.54,1034,977,前峰里,NULL
198,1998,16,2014,2431,0,0,82.85,1841,157,精忠村,NULL
0,1994,20,2014,2678,0,0,75.21,1098,896,竹林村,NULL
0,1985,29,2014,2641,0,0,76.26,991,994,民本里,NULL
0,1994,19,2013,2476,0,0,81.3,1394,600,宜興里,NULL
0,1991,22,2013,2609,0,0,77.16,1265,726,仁義里,NULL
0,1996,17,2013,2615,0,0,76.98,1233,763,永豐里,NULL
0,1993,20,2013,2641,0,0,76.22,1206,787,民生里,NULL
0,1995,17,2012,2571,0,0,78.26,1060,935,中華里,NULL
0,1998,12,2010,2627,0,0,76.51,1234,764,莿桐里,NULL
0,1992,18,2010,2505,0,0,80.24,1204,788,陽明里,NULL
0,1978,32,2010,2557,0,0,78.61,1097,881,碧華里,NULL
0,1992,18,2010,2761,0,0,72.8,1008,984,東海村,NULL
0,1994,15,2009,2538,0,0,79.16,1360,634,公園里,NULL
0,1984,24,2008,2628,0,0,76.41,1255,729,東興里,NULL
0,1993,15,2008,2565,0,0,78.28,1243,750,臨溪里,NULL
0,1990,18,2008,2660,0,0,75.49,1241,749,高平村,NULL
0,1976,31,2007,2832,0,0,70.87,1216,760,北平里,NULL
0,1994,12,2006,2413,0,0,83.13,1711,283,貿商村,NULL
0,1990,16,2006,2647,0,0,75.78,1177,813,明新里,NULL
0,1991,14,2005,2779,0,0,72.15,1499,492,馬蘭里,NULL
0,1985,20,2005,2518,0,0,79.63,1292,693,和興村,NULL
0,1996,9,2005,2585,0,0,77.56,1169,827,中達里,NULL
0,1991,14,2005,2604,0,0,77,945,1046,灣華里,NULL
0,1991,13,2004,2456,0,0,81.6,1555,436,大智里,NULL
0,1983,21,2004,2855,0,0,70.19,1430,553,中心里,NULL
0,1994,10,2004,2684,0,0,74.66,1330,664,中興里,NULL
228,1991,13,2004,2556,0,0,78.4,1106,885,國平里,NULL
0,1982,22,2004,2662,0,0,75.28,1097,885,豐榮里,NULL
0,1977,25,2002,2568,0,0,77.96,956,1021,溪洲村,NULL
0,1986,15,2001,2766,0,0,72.34,1121,865,中東里,NULL
0,1973,28,2001,2582,0,0,77.5,879,1094,新坡村,NULL
0,1979,21,2000,2781,0,0,71.92,1248,731,義和里,NULL
0,1981,19,2000,2948,0,0,67.84,1227,754,南港村,NULL
0,1979,21,2000,2696,0,0,74.18,1051,928,中圍里,NULL
0,1974,24,1998,2555,0,0,78.2,1180,794,深坑村,NULL
0,1980,17,1997,2578,0,0,77.46,1088,892,安龍里,NULL
0,1987,9,1996,2453,0,0,81.37,1068,919,保德里,NULL
0,1986,10,1996,2549,0,0,78.31,976,1010,大苓里,NULL
0,1985,11,1996,2585,0,0,77.21,921,1064,智蚵村,NULL
0,1976,19,1995,2587,0,0,77.12,1449,527,中崙村,NULL
0,1982,12,1994,2455,0,0,81.22,1478,504,中勢村,NULL
0,1969,24,1993,2441,0,0,81.65,1211,758,民權里,NULL
0,1975,17,1992,2701,0,0,73.75,1095,880,埤頭村,NULL
0,1969,23,1992,2578,0,0,77.27,848,1121,西勢村,NULL
0,1965,26,1991,2541,0,0,78.35,1235,730,大誠里,NULL
0,1976,15,1991,2539,0,0,78.42,822,1154,福祥里,NULL
0,1964,26,1990,2566,0,0,77.55,1154,810,北湳里,NULL
0,1977,12,1989,2416,0,0,82.33,1256,721,誠義里,NULL
0,1965,22,1987,2466,0,0,80.58,1386,579,吉興里,NULL
0,1958,27,1985,2549,0,0,77.87,1179,779,柑林里,NULL
0,1973,12,1985,2616,0,0,75.88,894,1079,鳳鳴里,NULL
0,1961,23,1984,2560,0,0,77.5,1231,730,大同里,NULL
0,1957,27,1984,2510,0,0,79.04,1035,922,三石村,NULL
0,1968,14,1982,2580,0,0,76.82,1201,767,竹圍村,NULL
0,1957,24,1981,2738,0,0,72.35,1048,909,金興村,NULL
0,1968,12,1980,2563,0,0,77.25,930,1038,瑞誠里,NULL
0,1966,14,1980,2507,0,0,78.98,843,1123,瑞崗里,NULL
0,1960,19,1979,2662,0,0,74.34,1311,649,福興里,NULL
0,1967,10,1977,2538,0,0,77.9,1010,957,寶慶里,NULL
0,1960,16,1976,2684,0,0,73.62,1189,771,野柳村,NULL
0,1961,15,1976,2588,0,0,76.35,1133,828,八德里,NULL
0,1966,10,1976,2600,0,0,76,929,1037,中厝村,NULL
0,1955,20,1975,2569,0,0,76.88,1144,811,前溪里,NULL
0,1957,18,1975,2619,0,0,75.41,905,1052,梅洲里,NULL
0,1952,23,1975,2600,0,0,75.96,880,1072,東林村,NULL
0,1956,18,1974,2605,0,0,75.78,1232,724,大饒里,NULL
0,1961,13,1974,2857,0,0,69.09,771,1190,樹腳里,NULL
0,1951,22,1973,2921,0,0,67.55,1427,524,太平村,NULL
0,1960,13,1973,2638,0,0,74.79,1260,700,建軍里,NULL
0,1947,26,1973,2505,0,0,78.76,1150,797,鐵山里,NULL
0,1957,14,1971,2433,0,0,81.01,1448,509,田新里,NULL
0,1951,19,1970,2533,0,0,77.77,1125,826,白鷺里,NULL
0,1954,15,1969,2520,0,0,78.13,1606,348,富水里,NULL
0,1961,8,1969,2487,0,0,79.17,755,1206,明孝里,NULL
0,1940,28,1968,2581,0,0,76.25,990,950,青翠里,NULL
0,1954,13,1967,2713,0,0,72.5,905,1049,淵中里,NULL
0,1955,10,1965,2564,0,0,76.64,1127,828,仁雅村,NULL
0,1953,11,1964,2484,0,0,79.07,1124,829,建昌里,NULL
0,1943,20,1963,2565,0,0,76.53,1507,436,文聖里,NULL
0,1947,16,1963,2692,0,0,72.92,804,1143,鎮海里,NULL
0,1954,8,1962,2623,0,0,74.8,1139,815,福興里,NULL
0,1937,25,1962,2401,0,0,81.72,1079,858,長壽里,NULL
0,1945,17,1962,2624,0,0,74.77,1012,933,協成村,NULL
0,1942,19,1961,2500,0,0,78.44,1282,660,梅川里,NULL
0,1943,18,1961,2572,0,0,76.24,972,971,大美村,NULL
0,1946,14,1960,2554,0,0,76.74,719,1227,鳳林里,NULL
0,1943,16,1959,2920,0,0,67.09,1498,445,國盛里,NULL
0,1944,15,1959,2519,0,0,77.77,1140,804,盛興里,NULL
0,1935,24,1959,2615,0,0,74.91,714,1221,安東里,NULL
0,1937,21,1958,2508,0,0,78.07,1576,361,尖下里,NULL
0,1947,11,1958,2561,0,0,76.45,1375,572,興隆里,NULL
0,1931,25,1956,2466,0,0,79.32,1430,501,湖口村,NULL
0,1932,23,1955,3227,4592,70.27,60.58,1823,109,海端鄉,Haiduan Township
0,1941,13,1954,2544,0,0,76.81,1145,796,四張里,NULL
0,1944,10,1954,2792,0,0,69.99,959,985,延平里,NULL
0,1935,18,1953,2493,0,0,78.34,1556,379,翠山里,NULL
0,1924,29,1953,2511,0,0,77.78,1036,888,翁子里,NULL
0,1928,25,1953,2495,0,0,78.28,964,964,福安里,NULL
0,1935,17,1952,2597,0,0,75.16,857,1078,清蓮村,NULL
0,1934,17,1951,2425,0,0,80.45,1355,579,大宏里,NULL
0,1928,23,1951,2592,0,0,75.27,969,959,下坑村,NULL
0,1927,22,1949,2481,0,0,78.56,960,967,維德里,NULL
0,1932,17,1949,2559,0,0,76.16,922,1010,新光里,NULL
0,1935,12,1947,2421,0,0,80.42,1613,322,上埔里,NULL
0,1936,11,1947,2568,0,0,75.82,1159,777,山東里,NULL
0,1929,18,1947,2532,0,0,76.9,1109,820,朱崙里,NULL
0,1927,20,1947,2547,0,0,76.44,1004,923,大涼里,NULL
0,1925,22,1947,2432,0,0,80.06,967,958,永吉里,NULL
0,1928,18,1946,2353,0,0,82.7,1328,600,秀義里,NULL
0,1932,14,1946,2514,0,0,77.41,1199,733,新屋村,NULL
0,1936,10,1946,2519,0,0,77.25,871,1065,南和里,NULL
0,1928,17,1945,2438,0,0,79.78,1686,242,崇武里,NULL
0,1928,17,1945,2507,0,0,77.58,1515,413,中興里,NULL
0,1920,24,1944,2615,0,0,74.34,1184,736,大突里,NULL
0,1928,16,1944,2472,0,0,78.64,1172,756,德義里,NULL
0,1923,20,1943,2492,0,0,77.97,1482,441,上華村,NULL
0,1927,16,1943,2443,0,0,79.53,1116,811,上竹村,NULL
0,1924,18,1942,2492,0,0,77.93,1077,847,新東里,NULL
0,1922,20,1942,2491,0,0,77.96,906,1016,武松里,NULL
176,1923,18,1941,2429,0,0,79.91,1392,531,武崙里,NULL
0,1925,16,1941,2577,0,0,75.32,1214,711,頂寮里,NULL
0,1926,15,1941,2632,0,0,73.75,1059,867,溪洲里,NULL
0,1927,14,1941,2566,0,0,75.64,540,1387,二鎮村,NULL
0,1919,21,1940,2425,0,0,80,1057,862,陽明里,NULL
0,1915,24,1939,2468,0,0,78.57,1567,348,仁德里,NULL
0,1925,14,1939,2468,0,0,78.57,1556,369,中堅里,NULL
0,1913,25,1938,2440,0,0,79.43,1110,803,五福村,NULL
0,1913,24,1937,2530,0,0,76.56,1177,736,水源里,NULL
0,1919,18,1937,2686,0,0,72.11,976,943,長安里,NULL
0,1916,20,1936,2688,0,0,72.02,1052,864,三德村,NULL
0,1910,26,1936,2767,0,0,69.97,884,1026,富收村,NULL
0,1921,15,1936,2511,0,0,77.1,868,1053,典寶村,NULL
0,1919,16,1935,2464,0,0,78.53,1166,753,福泰村,NULL
0,1920,15,1935,2431,0,0,79.6,1148,772,照南里,NULL
0,1914,20,1934,2406,0,0,80.38,1568,346,頭屋村,NULL
0,1914,17,1931,2419,0,0,79.83,787,1127,廣州里,NULL
0,1906,24,1930,2483,0,0,77.73,1094,812,正守里,NULL
0,1920,10,1930,2722,0,0,70.9,952,968,仁里村,NULL
0,1908,21,1929,2421,0,0,79.68,1470,438,東安里,NULL
0,1912,17,1929,2288,0,0,84.31,1216,696,宏榮里,NULL
0,1905,23,1928,2501,0,0,77.09,1199,706,福中里,NULL
0,1911,14,1925,2366,0,0,81.36,1362,549,義幸里,NULL
0,1900,25,1925,2453,0,0,78.48,1171,729,青山里,NULL
0,1906,19,1925,2369,0,0,81.26,1147,759,樹福里,NULL
0,1911,14,1925,2411,0,0,79.84,1134,777,育英里,NULL
0,1918,7,1925,2440,0,0,78.89,1032,886,豐榮里,NULL
0,1915,9,1924,2435,0,0,79.01,1462,453,石潭村,NULL
0,1906,17,1923,2448,0,0,78.55,1087,819,興平里,NULL
0,1891,32,1923,2437,0,0,78.91,957,934,得仁里,NULL
0,1911,11,1922,2441,0,0,78.74,1319,592,新德里,NULL
0,1897,25,1922,2412,0,0,79.68,1106,791,華貴里,NULL
0,1907,14,1921,2500,0,0,76.84,1177,730,鎮北里,NULL
0,1909,12,1921,2553,0,0,75.24,929,980,北湖里,NULL
0,1906,13,1919,2380,0,0,80.63,1175,731,中山里,NULL
0,1905,14,1919,2514,0,0,76.33,796,1109,龍鳳里,NULL
0,1913,5,1918,2359,0,0,81.31,1428,485,忠誠里,NULL
0,1895,23,1918,2364,0,0,81.13,1360,535,秀得里,NULL
0,1900,18,1918,2692,0,0,71.25,1288,612,新峰里,NULL
0,1892,26,1918,2376,0,0,80.72,1283,609,佳興里,NULL
0,1898,19,1917,2622,0,0,73.11,1425,473,稻香村,NULL
0,1899,18,1917,2350,0,0,81.57,1027,872,藍田里,NULL
0,1898,18,1916,2399,0,0,79.87,1412,486,埔尾村,NULL
0,1889,27,1916,2382,0,0,80.44,1006,883,九如里,NULL
0,1892,23,1915,2482,0,0,77.16,910,982,景星里,NULL
0,1885,29,1914,2556,0,0,74.88,1204,681,建興里,NULL
0,1899,14,1913,2563,0,0,74.64,1124,775,永豐里,NULL
0,1890,22,1912,2438,0,0,78.42,1074,816,安祥里,NULL
0,1902,9,1911,2392,0,0,79.89,887,1015,德智里,NULL
0,1895,13,1908,2430,0,0,78.52,1177,718,後德里,NULL
0,1891,17,1908,2617,0,0,72.91,1157,734,通南里,NULL
0,1898,10,1908,2480,0,0,76.94,886,1012,大營村,NULL
0,1884,23,1907,2436,0,0,78.28,1234,650,平順里,NULL
0,1889,18,1907,2398,0,0,79.52,1224,665,中華里,NULL
0,1887,20,1907,2284,0,0,83.49,1079,808,民享里,NULL
0,1893,13,1906,2413,0,0,78.99,1328,565,仁愛里,NULL
0,1889,17,1906,2441,0,0,78.08,1111,778,福林里,NULL
0,1883,22,1905,2448,0,0,77.82,1163,720,大勇里,NULL
0,1888,16,1904,2417,0,0,78.78,813,1075,瑞文里,NULL
0,1886,17,1903,2412,0,0,78.9,911,975,化成里,NULL
0,1881,21,1902,2354,0,0,80.8,1251,630,普慶里,NULL
0,1882,19,1901,2333,0,0,81.48,1387,495,大新里,NULL
0,1880,20,1900,2389,0,0,79.53,1343,537,裕豐里,NULL
0,1880,20,1900,2512,0,0,75.64,929,951,瑞興里,NULL
0,1878,21,1899,2385,0,0,79.62,1050,828,自立里,NULL
0,1879,20,1899,2714,0,0,69.97,1000,879,高朗村,NULL
0,1877,21,1898,2373,0,0,79.98,1314,563,正行里,NULL
0,1888,9,1897,2455,0,0,77.27,1068,820,仁愛里,NULL
0,1885,11,1896,2421,0,0,78.31,890,995,松山里,NULL
0,1873,22,1895,2350,0,0,80.64,1339,534,福德里,NULL
826,1879,15,1894,2509,0,0,75.49,1301,578,家興村,NULL
0,1878,16,1894,2419,0,0,78.3,1255,623,公正里,NULL
0,1875,18,1893,2350,0,0,80.55,1570,305,龍興里,NULL
0,1870,23,1893,2257,0,0,83.87,1291,579,和平里,NULL
0,1865,27,1892,2542,0,0,74.43,848,1017,淵西里,NULL
0,1879,11,1890,2551,0,0,74.09,1286,593,黎明里,NULL
0,1869,21,1890,2582,0,0,73.2,1108,761,沙崙村,NULL
0,1869,21,1890,2567,0,0,73.63,1055,814,北投里,NULL
0,1874,16,1890,2608,0,0,72.47,633,1241,上竹里,NULL
0,1870,18,1888,2513,0,0,75.13,1126,744,負郭里,NULL
0,1870,18,1888,2463,0,0,76.65,1064,806,客雅里,NULL
12,1871,16,1887,2410,0,0,78.3,885,986,新順里,NULL
0,1866,20,1886,2476,0,0,76.17,888,978,文化村,NULL
0,1862,23,1885,2666,0,0,70.71,1282,580,孝深里,NULL
0,1866,18,1884,2337,0,0,80.62,1166,700,嘉穗里,NULL
0,1865,17,1882,2369,0,0,79.44,1146,719,埔頂里,NULL
0,1867,15,1882,2377,0,0,79.18,1068,799,忠孝里,NULL
0,1862,19,1881,2435,0,0,77.25,1147,715,指南里,NULL
0,1870,11,1881,2487,0,0,75.63,1147,723,文德村,NULL
0,1865,16,1881,2453,0,0,76.68,1024,841,仙草里,NULL
0,1865,16,1881,2494,0,0,75.42,844,1021,新市村,NULL
0,1856,24,1880,2598,0,0,72.36,1223,633,後厝里,NULL
0,1858,21,1879,2336,0,0,80.44,1163,695,光華里,NULL
0,1863,16,1879,2366,0,0,79.42,1086,777,錦中村,NULL
0,1862,17,1879,2409,0,0,78,996,866,龍安里,NULL
0,1854,25,1879,2390,0,0,78.62,822,1032,神洲村,NULL
0,1858,20,1878,2368,0,0,79.31,1379,479,河堤里,NULL
0,1858,20,1878,2361,0,0,79.54,895,963,考潭村,NULL
0,1850,26,1876,2283,0,0,82.17,1239,611,建寶里,NULL
0,1843,33,1876,2427,0,0,77.3,985,858,富華里,NULL
0,1856,20,1876,2590,0,0,72.43,941,915,九芎村,NULL
0,1852,23,1875,2505,0,0,74.85,1226,626,二鬮里,NULL
0,1845,30,1875,2359,0,0,79.48,973,872,民和里,NULL
0,1855,20,1875,2314,0,0,81.03,910,945,甲頂里,NULL
0,1859,16,1875,2351,0,0,79.75,793,1066,七甲村,NULL
0,1851,24,1875,2424,0,0,77.35,750,1101,大灣村,NULL
0,1862,12,1874,2396,0,0,78.21,1160,702,中正里,NULL
0,1857,16,1873,2391,0,0,78.34,1380,477,正砂里,NULL
0,1851,22,1873,2373,0,0,78.93,1016,835,永康里,NULL
0,1844,28,1872,2413,0,0,77.58,963,881,五福里,NULL
0,1862,9,1871,2215,0,0,84.47,1712,150,大鵬里,NULL
0,1850,20,1870,2451,0,0,76.3,1089,761,光復里,NULL
0,1857,13,1870,2309,0,0,80.99,813,1044,合作里,NULL
0,1850,20,1870,2573,0,0,72.68,713,1137,甲東村,NULL
0,1858,11,1869,2312,0,0,80.84,1392,466,三林村,NULL
0,1849,20,1869,2595,0,0,72.02,1043,806,北港村,NULL
0,1848,21,1869,2346,0,0,79.67,1000,848,光耀里,NULL
0,1846,23,1869,2479,0,0,75.39,1000,846,埔和村,NULL
0,1850,18,1868,2337,0,0,79.93,1609,241,中社里,NULL
0,1852,15,1867,2471,0,0,75.56,1179,673,聖德村,NULL
0,1849,18,1867,2413,0,0,77.37,774,1075,北勢村,NULL
0,1847,19,1866,2334,0,0,79.95,1373,474,信義村,NULL
0,1854,12,1866,2409,0,0,77.46,1115,739,法華里,NULL
0,1841,25,1866,2341,0,0,79.71,1039,802,青雲里,NULL
0,1850,16,1866,2347,0,0,79.51,1034,816,大湳里,NULL
0,1841,25,1866,2501,0,0,74.61,1012,829,大墩里,NULL
0,1850,16,1866,2411,0,0,77.4,907,943,松金里,NULL
0,1849,17,1866,2513,0,0,74.25,765,1084,東昇村,NULL
0,1849,16,1865,2500,0,0,74.6,821,1028,豐田村,NULL
0,1850,14,1864,2374,0,0,78.52,1156,694,土庫村,NULL
0,1844,20,1864,2942,0,0,63.36,921,923,仁義里,NULL
0,1851,13,1864,2310,0,0,80.69,570,1281,土庫村,NULL
0,1844,19,1863,2395,0,0,77.79,1428,416,碇和里,NULL
0,1842,21,1863,2343,0,0,79.51,1209,633,雙榮里,NULL
0,1847,16,1863,2501,0,0,74.49,1039,808,汴頭里,NULL
0,1853,9,1862,3419,0,0,54.46,1750,103,南門里,NULL
0,1848,13,1861,2301,0,0,80.88,1269,579,仁愛里,NULL
228,1851,10,1861,2403,0,0,77.44,1163,688,大華村,NULL
0,1846,15,1861,2345,0,0,79.36,1108,738,瑞興里,NULL
0,1846,15,1861,2352,0,0,79.12,924,922,東橋里,NULL
0,1843,17,1860,2525,0,0,73.66,1318,525,主力里,NULL
0,1846,14,1860,2303,0,0,80.76,1134,712,中華里,NULL
0,1846,14,1860,2420,0,0,76.86,831,1015,麟趾村,NULL
0,1850,9,1859,3238,3963,81.71,57.41,1151,699,大埔鄉,Tai Po Township
326,1849,10,1859,2297,0,0,80.93,1125,724,崇文里,NULL
0,1840,19,1859,2390,0,0,77.78,737,1103,信德里,NULL
0,1842,16,1858,2384,0,0,77.94,1464,378,東庄里,NULL
281,1847,11,1858,2343,0,0,79.3,1246,601,頂街村,NULL
0,1832,26,1858,2493,0,0,74.53,1059,773,溪東里,NULL
0,1841,17,1858,2348,0,0,79.13,845,996,宏竹村,NULL
0,1842,15,1857,2355,0,0,78.85,803,1039,港興里,NULL
0,1844,12,1856,2382,0,0,77.92,988,856,長竹里,NULL
803,1842,13,1855,2353,0,0,78.84,1382,460,四維里,NULL
0,1842,13,1855,2353,0,0,78.84,1382,460,四維里,NULL
0,1833,21,1854,2308,0,0,80.33,1139,694,北勢里,NULL
0,1845,9,1854,2402,0,0,77.19,1119,726,大村村,NULL
0,1837,16,1853,2312,0,0,80.15,1049,788,西安里,NULL
0,1835,15,1850,2556,0,0,72.38,974,861,福安里,NULL
0,1834,15,1849,2382,0,0,77.62,940,894,北勢里,NULL
0,1837,12,1849,2524,0,0,73.26,768,1069,協和村,NULL
0,1820,28,1848,2359,0,0,78.34,690,1130,中興里,NULL
0,1830,17,1847,2315,0,0,79.78,1110,720,廣德里,NULL
0,1828,18,1846,2344,0,0,78.75,1195,633,德義里,NULL
0,1826,20,1846,2328,0,0,79.3,1145,681,和調里,NULL
0,1826,19,1845,2538,0,0,72.7,1143,683,龍東村,NULL
0,1828,17,1845,2411,0,0,76.52,1036,792,漳興里,NULL
374,1825,19,1844,2398,0,0,76.9,1304,521,羊稠村,NULL
0,1824,20,1844,2273,0,0,81.13,1070,754,港尾里,NULL
0,1834,10,1844,2426,0,0,76.01,892,942,潭頭村,NULL
0,1825,18,1843,2370,0,0,77.76,696,1129,玉田村,NULL
0,1819,23,1842,2363,0,0,77.95,964,855,仁愛里,NULL
0,1831,11,1842,2370,0,0,77.72,837,994,角宿村,NULL
0,1829,13,1842,2545,0,0,72.38,798,1031,頂溪里,NULL
0,1825,16,1841,2240,0,0,82.19,1333,492,中正村,NULL
0,1818,23,1841,2764,0,0,66.61,1162,656,麥津村,NULL
0,1824,17,1841,2369,0,0,77.71,1026,798,觀音村,NULL
0,1824,16,1840,2275,0,0,80.88,1475,349,湖鏡村,NULL
0,1827,13,1840,2278,0,0,80.77,1445,382,玉清里,NULL
0,1824,16,1840,2369,0,0,77.67,1260,564,卦山里,NULL
0,1819,21,1840,2436,0,0,75.53,890,929,大同村,NULL
0,1818,21,1839,2261,0,0,81.34,1277,541,頂溪里,NULL
0,1820,19,1839,2306,0,0,79.75,788,1032,瑞東里,NULL
0,1820,18,1838,2546,0,0,72.19,1163,657,北梅里,NULL
0,1818,19,1837,2236,0,0,82.16,1219,599,金陵里,NULL
0,1826,11,1837,2388,0,0,76.93,1073,753,永安里,NULL
0,1831,5,1836,2149,0,0,85.44,1670,161,忠誠里,NULL
0,1819,15,1834,2291,0,0,80.05,1342,477,文化里,NULL
0,1819,14,1833,2481,0,0,73.88,990,829,祿興里,NULL
0,1815,16,1831,2337,0,0,78.35,1333,482,中山里,NULL
0,1818,13,1831,2252,0,0,81.31,1320,498,北安里,NULL
0,1809,21,1830,2592,0,0,70.6,949,860,牛眠里,NULL
0,1810,20,1830,2444,0,0,74.88,948,862,萬豐村,NULL
0,1793,35,1828,2444,0,0,74.8,1252,541,嘉添里,NULL
1461,1807,21,1828,2321,0,0,78.76,939,868,中原里,NULL
0,1814,14,1828,2224,0,0,82.19,862,952,建國里,NULL
0,1808,19,1827,2394,0,0,76.32,1243,565,興南里,NULL
0,1808,19,1827,2405,0,0,75.97,1002,806,大德里,NULL
0,1814,12,1826,2436,0,0,74.96,1077,737,明德里,NULL
0,1808,18,1826,2277,0,0,80.19,1002,806,江川里,NULL
0,1811,14,1825,2390,0,0,76.36,1125,686,東仁里,NULL
0,1807,18,1825,2241,0,0,81.44,1008,799,國隆里,NULL
0,1809,15,1824,2318,0,0,78.69,1138,671,粗坑里,NULL
0,1808,16,1824,2468,0,0,73.91,802,1006,永和里,NULL
0,1815,8,1823,2343,0,0,77.81,1144,671,王田里,NULL
0,1807,16,1823,2413,0,0,75.55,837,970,北新里,NULL
0,1803,20,1823,2378,0,0,76.66,715,1088,大廟村,NULL
0,1810,12,1822,2301,0,0,79.18,879,931,新興里,NULL
222,1799,22,1821,2328,0,0,78.22,1443,356,中興村,NULL
0,1789,32,1821,2335,0,0,77.99,1075,714,高榮里,NULL
220,1806,15,1821,2361,0,0,77.13,944,862,平通里,NULL
0,1806,14,1820,2453,0,0,74.19,797,1009,埒內里,NULL
0,1804,15,1819,2337,0,0,77.83,1064,740,柑園里,NULL
0,1797,22,1819,2290,0,0,79.43,954,843,忠義里,NULL
0,1810,8,1818,2331,0,0,77.99,1242,568,暖暖里,NULL
0,1801,17,1818,2284,0,0,79.6,1109,692,東昌里,NULL
0,1804,14,1818,2265,0,0,80.26,1070,734,立德里,NULL
0,1808,9,1817,2395,0,0,75.87,835,973,北成里,NULL
0,1800,15,1815,2148,0,0,84.5,1642,158,僑愛里,NULL
0,1797,18,1815,2378,0,0,76.32,1179,618,新興村,NULL
0,1800,15,1815,2331,0,0,77.86,1163,637,誠智里,NULL
235,1800,15,1815,2287,0,0,79.36,1137,663,後埔里,NULL
0,1806,8,1814,2477,0,0,73.23,1115,691,德興里,NULL
0,1802,12,1814,2447,0,0,74.13,796,1006,過溝里,NULL
0,1788,25,1813,2494,0,0,72.69,1172,616,龍潭村,NULL
0,1794,19,1813,2562,0,0,70.77,804,990,城南里,NULL
0,1798,14,1812,2408,0,0,75.25,1127,671,福德里,NULL
0,1793,19,1812,2241,0,0,80.86,1063,730,林圍里,NULL
0,1794,18,1812,2299,0,0,78.82,718,1076,福南里,NULL
0,1800,11,1811,2314,0,0,78.26,1181,619,大正里,NULL
0,1795,16,1811,2321,0,0,78.03,1092,703,大竹里,NULL
0,1799,11,1810,2314,0,0,78.22,1225,574,國校里,NULL
219,1789,21,1810,2499,0,0,72.43,1054,735,平通里,NULL
0,1797,12,1809,2611,0,0,69.28,890,907,惠楠里,NULL
0,1793,15,1808,2243,0,0,80.61,1372,421,文林村,NULL
0,1791,17,1808,2357,0,0,76.71,966,825,港坪里,NULL
0,1789,19,1808,2290,0,0,78.95,805,984,千秋里,NULL
0,1796,10,1806,2380,0,0,75.88,1323,473,主安里,NULL
0,1787,19,1806,2317,0,0,77.95,1117,670,茄南里,NULL
0,1784,22,1806,2303,0,0,78.42,1002,782,香雅里,NULL
0,1799,6,1805,2343,0,0,77.04,1127,672,光華里,NULL
0,1794,11,1805,2295,0,0,78.65,1094,700,中山里,NULL
0,1786,18,1804,2308,0,0,78.16,948,838,旱溪里,NULL
0,1782,21,1803,2160,0,0,83.47,1562,220,龍友里,NULL
0,1788,15,1803,2296,0,0,78.53,817,971,坑口村,NULL
0,1785,17,1802,2452,0,0,73.49,1128,657,竹坑村,NULL
0,1782,20,1802,2273,0,0,79.28,697,1085,鎮榮里,NULL
0,1794,7,1801,3443,0,0,52.31,1674,120,新湖里,NULL
0,1788,13,1801,2323,0,0,77.53,1108,680,民族里,NULL
0,1782,19,1801,2751,0,0,65.47,962,820,橋頭村,NULL
0,1781,19,1800,2461,0,0,73.14,1152,629,埔頂里,NULL
0,1781,19,1800,2368,0,0,76.01,1119,662,正南里,NULL
0,1782,18,1800,2454,0,0,73.35,1063,719,文昌里,NULL
0,1793,7,1800,2410,0,0,74.69,775,1018,仙吉村,NULL
0,1782,17,1799,2299,0,0,78.25,983,799,力行里,NULL
0,1782,17,1799,2315,0,0,77.71,964,818,三安里,NULL
0,1775,24,1799,2241,0,0,80.28,867,908,六股村,NULL
0,1786,11,1797,2423,0,0,74.16,1081,705,中華里,NULL
0,1780,17,1797,2248,0,0,79.94,1060,720,新庄里,NULL
0,1781,16,1797,2414,0,0,74.44,898,883,中寮里,NULL
0,1786,11,1797,2219,0,0,80.98,522,1264,玉屏里,NULL
0,1777,19,1796,2347,0,0,76.52,1184,593,興福里,NULL
0,1784,11,1795,2379,0,0,75.45,1009,775,民權里,NULL
0,1777,18,1795,2576,0,0,69.68,750,1027,季新村,NULL
0,1774,20,1794,2195,0,0,81.73,1333,441,三灣村,NULL
0,1779,15,1794,2372,0,0,75.63,1092,687,大鵬村,NULL
0,1778,16,1794,2311,0,0,77.63,1070,708,久昌里,NULL
0,1772,22,1794,2369,0,0,75.73,1024,748,米倉村,NULL
0,1784,10,1794,2366,0,0,75.82,806,978,保安村,NULL
0,1781,12,1793,2241,0,0,80.01,1575,206,樂英里,NULL
0,1785,8,1793,2257,0,0,79.44,1295,490,南門里,NULL
169,1780,13,1793,2414,0,0,74.28,1265,515,興寮里,NULL
0,1785,8,1793,2353,0,0,76.2,1073,712,南昌里,NULL
0,1775,16,1791,2335,0,0,76.7,1095,680,中庄村,NULL
0,1764,27,1791,2291,0,0,78.18,934,830,北庄村,NULL
0,1771,20,1791,2399,0,0,74.66,844,927,深水村,NULL
0,1773,17,1790,2211,0,0,80.96,796,977,教仁里,NULL
0,1770,19,1789,2443,0,0,73.23,1492,278,民享里,NULL
66,1771,16,1787,2479,0,0,72.09,790,981,安富里,NULL
0,1763,23,1786,2249,0,0,79.41,869,894,廣福里,NULL
0,1763,23,1786,2268,0,0,78.75,867,896,鳳雄村,NULL
0,1770,16,1786,2361,0,0,75.65,781,989,港口村,NULL
0,1773,12,1785,2465,0,0,72.41,1111,662,北鶯里,NULL
0,1774,11,1785,2215,0,0,80.59,974,800,國富里,NULL
0,1764,20,1784,2549,0,0,69.99,1376,388,永興村,NULL
0,1772,12,1784,2258,0,0,79.01,1113,659,文盛里,NULL
0,1774,9,1783,2160,0,0,82.55,1530,244,建功里,NULL
0,1769,14,1783,2412,0,0,73.92,892,877,自強里,NULL
0,1764,19,1783,2243,0,0,79.49,866,898,前竹村,NULL
0,1763,18,1781,2271,0,0,78.42,1286,477,信綠里,NULL
0,1756,25,1781,2268,0,0,78.53,1147,609,社腳村,NULL
0,1765,15,1780,2353,0,0,75.65,914,851,六甲里,NULL
0,1764,16,1780,2456,0,0,72.48,896,868,南華里,NULL
0,1765,14,1779,2266,0,0,78.51,1303,462,美城里,NULL
0,1758,21,1779,2374,0,0,74.94,957,801,橋頭村,NULL
0,1764,14,1778,2240,0,0,79.38,1210,554,自強里,NULL
0,1755,23,1778,2357,0,0,75.43,1090,665,振興里,NULL
0,1758,20,1778,2406,0,0,73.9,900,858,西安里,NULL
0,1763,14,1777,2308,0,0,76.99,1018,745,興仁里,NULL
0,1757,19,1776,2285,0,0,77.72,967,790,員富里,NULL
0,1767,9,1776,2242,0,0,79.21,857,910,竹寮村,NULL
0,1761,15,1776,2407,0,0,73.78,713,1048,成興村,NULL
0,1764,11,1775,2445,0,0,72.6,1076,688,中庄村,NULL
0,1738,37,1775,2259,0,0,78.57,960,778,長元里,NULL
0,1762,13,1775,2256,0,0,78.68,941,821,大庄里,NULL
0,1757,17,1774,2400,0,0,73.92,930,827,南興里,NULL
0,1767,7,1774,2231,0,0,79.52,872,895,六苓里,NULL
0,1759,15,1774,2329,0,0,76.17,544,1215,載興村,NULL
0,1755,18,1773,2275,0,0,77.93,1187,568,過溝村,NULL
0,1760,13,1773,2473,0,0,71.69,770,990,同樂村,NULL
0,1746,25,1771,2243,0,0,78.96,1070,676,福安里,NULL
0,1747,23,1770,2431,0,0,72.81,1030,717,東流里,NULL
0,1758,12,1770,2241,0,0,78.98,816,942,再興里,NULL
0,1755,14,1769,2184,0,0,81,1330,425,復興里,NULL
0,1753,16,1769,2402,0,0,73.65,826,927,獅山里,NULL
0,1751,17,1768,2360,0,0,74.92,1201,550,暖同里,NULL
0,1750,18,1768,2202,0,0,80.29,1197,553,信義里,NULL
0,1752,15,1767,2427,0,0,72.81,1216,536,北門里,NULL
125,1751,14,1765,2102,0,0,83.97,1290,461,德和里,NULL
0,1745,20,1765,2216,0,0,79.65,1268,477,館東村,NULL
0,1755,10,1765,2218,0,0,79.58,1115,640,東昇里,NULL
0,1747,18,1765,2288,0,0,77.14,1021,726,國聖里,NULL
0,1752,13,1765,2376,0,0,74.28,819,933,中興里,NULL
0,1748,17,1765,2365,0,0,74.63,782,966,海寮村,NULL
0,1750,14,1764,2231,0,0,79.07,1166,584,高城里,NULL
229,1757,7,1764,2364,0,0,74.62,1108,649,大華村,NULL
0,1750,14,1764,2264,0,0,77.92,803,947,保社村,NULL
0,1747,17,1764,2285,0,0,77.2,669,1078,赤東村,NULL
0,1745,18,1763,2432,0,0,72.49,1068,677,杷城里,NULL
0,1741,22,1763,2209,0,0,79.81,791,950,廈莊里,NULL
0,1751,11,1762,2936,3748,78.34,60.01,1622,129,達仁鄉,Daren Township
185,1753,9,1762,2185,0,0,80.64,941,812,西賢里,NULL
0,1744,18,1762,2500,0,0,70.48,770,974,北汕里,NULL
0,1746,15,1761,2157,0,0,81.64,767,979,甲南村,NULL
0,1752,9,1761,2280,0,0,77.24,729,1023,崙頂村,NULL
0,1742,19,1761,2244,0,0,78.48,657,1085,水安村,NULL
0,1752,8,1760,2247,0,0,78.33,1330,422,新英里,NULL
0,1731,28,1759,2305,0,0,76.31,1053,678,頭崙里,NULL
0,1745,14,1759,2315,0,0,75.98,1030,715,上田里,NULL
0,1743,16,1759,2366,0,0,74.34,955,788,林厝里,NULL
587,1741,16,1757,2165,0,0,81.15,1168,573,文化里,NULL
0,1737,20,1757,2144,0,0,81.95,1105,632,文明里,NULL
0,1739,18,1757,2294,0,0,76.59,1014,725,海濱里,NULL
0,1742,14,1756,2268,0,0,77.43,1043,699,成大里,NULL
0,1742,14,1756,2163,0,0,81.18,819,923,仕豐村,NULL
0,1742,13,1755,2143,0,0,81.89,1670,72,海風里,NULL
0,1737,18,1755,2228,0,0,78.77,1242,495,山峰里,NULL
0,1745,10,1755,2185,0,0,80.32,1177,568,龍山里,NULL
0,1736,19,1755,2256,0,0,77.79,898,838,西湖里,NULL
0,1741,13,1754,2239,0,0,78.34,924,817,中庄里,NULL
0,1744,10,1754,2379,0,0,73.73,834,910,佃東里,NULL
0,1736,17,1753,2178,0,0,80.49,1053,683,建華里,NULL
0,1738,15,1753,2337,0,0,75.01,588,1150,晋江里,NULL
0,1743,9,1752,2156,0,0,81.26,1114,629,同慶里,NULL
0,1736,16,1752,2330,0,0,75.19,1072,664,福德村,NULL
0,1735,17,1752,2443,0,0,71.72,959,776,龍泉村,NULL
0,1735,17,1752,2307,0,0,75.94,829,906,成德村,NULL
0,1733,18,1751,2077,0,0,84.3,1491,242,龍安里,NULL
0,1736,15,1751,2650,0,0,66.08,983,753,網紗里,NULL
0,1737,14,1751,2315,0,0,75.64,800,937,永就村,NULL
0,1741,10,1751,2266,0,0,77.27,607,1134,水寮村,NULL
337,1724,26,1750,2230,0,0,78.48,1058,666,中福村,NULL
0,1734,16,1750,2394,0,0,73.1,830,904,幸福里,NULL
0,1736,14,1750,2340,0,0,74.79,769,967,新港村,NULL
52,1735,15,1750,2312,0,0,75.69,761,974,海東里,NULL
21,1736,14,1750,2330,0,0,75.11,703,1033,安西里,NULL
0,1736,14,1750,2330,0,0,75.11,703,1033,安西里,NULL
0,1736,13,1749,2333,0,0,74.97,867,869,進興村,NULL
0,1731,18,1749,2151,0,0,81.31,772,959,明義里,NULL
0,1732,16,1748,2215,0,0,78.92,1088,644,福成里,NULL
0,1728,20,1748,2239,0,0,78.07,1012,716,犁盛里,NULL
0,1731,16,1747,2388,0,0,73.16,782,949,梅東村,NULL
0,1732,14,1746,2244,0,0,77.81,1101,631,光榮里,NULL
0,1734,12,1746,2405,0,0,72.6,867,867,興南村,NULL
0,1728,17,1745,2268,0,0,76.94,931,797,茄荖村,NULL
0,1736,8,1744,2337,0,0,74.63,838,898,和興村,NULL
0,1725,19,1744,2237,0,0,77.96,630,1095,後安村,NULL
0,1733,10,1743,2224,0,0,78.37,687,1046,東角里,NULL
0,1730,12,1742,2264,0,0,76.94,1162,568,崙雅里,NULL
0,1733,8,1741,2232,0,0,78,934,799,永安村,NULL
0,1729,12,1741,2206,0,0,78.92,688,1041,梓和村,NULL
0,1714,26,1740,2277,0,0,76.42,1034,680,三義里,NULL
0,1720,20,1740,2219,0,0,78.41,890,830,中和村,NULL
0,1717,21,1738,2127,0,0,81.71,1168,549,壽南里,NULL
0,1726,12,1738,2323,0,0,74.82,688,1038,大樹村,NULL
0,1716,21,1737,2266,0,0,76.65,1084,632,香村里,NULL
0,1723,14,1737,2251,0,0,77.17,1016,707,莊雅村,NULL
0,1713,24,1737,2264,0,0,76.72,963,750,社口村,NULL
0,1722,15,1737,2229,0,0,77.93,947,775,竹西村,NULL
0,1723,13,1736,2196,0,0,79.05,566,1157,東林村,NULL
264,1721,14,1735,2121,0,0,81.8,1244,477,廣隆里,NULL
96,1722,13,1735,2172,0,0,79.88,1240,482,寶慶里,NULL
0,1721,14,1735,2140,0,0,81.07,931,790,東安里,NULL
0,1713,22,1735,2291,0,0,75.73,792,921,新昌里,NULL
0,1719,13,1732,2110,0,0,82.09,888,831,和煦里,NULL
0,1715,15,1730,2163,0,0,79.98,1193,522,永樂里,NULL
371,1718,11,1729,2235,0,0,77.36,1194,524,五福村,NULL
243,1715,14,1729,2142,0,0,80.72,961,754,楓樹村,NULL
0,1710,19,1729,2177,0,0,79.42,815,895,武慶里,NULL
0,1710,18,1728,2131,0,0,81.09,954,756,百壽里,NULL
0,1706,22,1728,2328,0,0,74.23,761,945,永美村,NULL
0,1715,12,1727,2116,0,0,81.62,1333,382,長春里,NULL
0,1703,24,1727,2539,0,0,68.02,1129,574,蜈蚣里,NULL
0,1710,17,1727,2232,0,0,77.37,761,949,龍華里,NULL
0,1710,16,1726,2370,0,0,72.83,981,729,蘇西里,NULL
0,1706,19,1725,2147,0,0,80.34,898,808,興邦里,NULL
211,1713,10,1723,2254,0,0,76.44,1121,592,龍水里,NULL
327,1703,20,1723,2213,0,0,77.86,999,704,東智里,NULL
0,1703,20,1723,2213,0,0,77.86,999,704,東智里,NULL
0,1708,15,1723,2218,0,0,77.68,878,830,文南村,NULL
0,1719,3,1722,3074,0,0,56.02,1604,115,東門里,NULL
0,1708,14,1722,2400,0,0,71.75,816,892,竹崎村,NULL
0,1711,11,1722,2222,0,0,77.5,767,944,東燕村,NULL
0,1707,14,1721,2190,0,0,78.58,1037,670,圳前村,NULL
0,1699,22,1721,2203,0,0,78.12,965,734,長春里,NULL
0,1697,24,1721,2330,0,0,73.86,806,891,洋厝里,NULL
0,1700,20,1720,2235,0,0,76.96,1005,695,三條里,NULL
0,1696,24,1720,2203,0,0,78.08,788,908,永煇里,NULL
0,1698,22,1720,2117,0,0,81.25,755,943,新武里,NULL
0,1707,13,1720,2240,0,0,76.79,707,1000,新厝村,NULL
820,1706,13,1719,2194,0,0,78.35,1155,551,福仁村,NULL
0,1710,9,1719,2122,0,0,81.01,761,949,南港里,NULL
0,1710,8,1718,2324,0,0,73.92,1073,637,卑南里,NULL
0,1713,5,1718,2224,0,0,77.25,975,738,仁義里,NULL
0,1705,13,1718,2214,0,0,77.6,892,813,香楊村,NULL
682,1708,10,1718,2225,0,0,77.21,813,895,港后里,NULL
0,1708,10,1718,2225,0,0,77.21,813,895,港后里,NULL
0,1698,20,1718,2284,0,0,75.22,744,954,秀林村,NULL
0,1699,17,1716,2153,0,0,79.7,934,765,衛武里,NULL
0,1700,15,1715,2194,0,0,78.17,1099,601,福安里,NULL
0,1702,12,1714,2278,0,0,75.24,1007,695,埔頂村,NULL
0,1693,21,1714,2221,0,0,77.17,850,843,開元里,NULL
213,1696,17,1713,2121,0,0,80.76,954,742,延和里,NULL
1073,1697,15,1712,2301,0,0,74.4,1074,623,雙鳳里,NULL
0,1695,17,1712,2270,0,0,75.42,943,752,古夷里,NULL
0,1701,11,1712,2246,0,0,76.22,692,1009,南勝里,NULL
0,1703,8,1711,2274,0,0,75.24,913,790,興安里,NULL
0,1698,13,1711,2227,0,0,76.83,869,829,嵐翠里,NULL
273,1687,21,1708,2110,0,0,80.95,1116,571,后庄里,NULL
0,1691,17,1708,2172,0,0,78.64,912,779,保和里,NULL
1023,1691,16,1707,2159,0,0,79.06,1077,614,立廷里,NULL
0,1693,14,1707,2198,0,0,77.66,1069,624,延平里,NULL
0,1693,14,1707,2212,0,0,77.17,785,908,茄苳村,NULL
0,1687,20,1707,2142,0,0,79.69,510,1177,竹後村,NULL
0,1694,12,1706,2243,0,0,76.06,1284,410,碇內里,NULL
0,1687,19,1706,2355,0,0,72.44,1094,593,定興村,NULL
0,1694,12,1706,2210,0,0,77.19,907,787,水頭村,NULL
0,1693,13,1706,2117,0,0,80.59,639,1054,仕隆村,NULL
163,1696,9,1705,2080,0,0,81.97,1268,428,長樂里,NULL
0,1691,14,1705,2300,0,0,74.13,948,743,西勢里,NULL
0,1691,14,1705,2385,0,0,71.49,815,876,東中村,NULL
0,1690,14,1704,2263,0,0,75.3,1099,591,正光里,NULL
54,1696,7,1703,2327,0,0,73.18,796,900,溪心里,NULL
0,1682,21,1703,2218,0,0,76.78,781,901,干城里,NULL
0,1683,19,1702,2143,0,0,79.42,999,684,洛泉里,NULL
0,1675,26,1701,2187,0,0,77.78,1041,634,南園里,NULL
0,1680,21,1701,2206,0,0,77.11,983,697,太順里,NULL
76,1683,17,1700,2129,0,0,79.85,997,686,豐林里,NULL
0,1683,17,1700,2264,0,0,75.09,891,792,永隆里,NULL
0,1677,23,1700,2335,0,0,72.81,762,915,海西里,NULL
0,1683,17,1700,2180,0,0,77.98,720,963,新勝里,NULL
212,1691,6,1697,2170,0,0,78.2,967,724,龍水里,NULL
0,1691,5,1696,3070,0,0,55.24,1630,61,汶沙里,NULL
0,1683,13,1696,2280,0,0,74.39,840,843,新生里,NULL
0,1678,17,1695,2214,0,0,76.56,853,825,曹公里,NULL
0,1684,11,1695,2258,0,0,75.07,791,893,新東村,NULL
352,1674,20,1694,2183,0,0,77.6,970,704,南興村,NULL
0,1679,15,1694,2163,0,0,78.32,751,928,三角村,NULL
0,1683,11,1694,2198,0,0,77.07,522,1161,興龍村,NULL
0,1677,15,1692,2123,0,0,79.7,1319,358,水源里,NULL
0,1673,19,1692,2281,0,0,74.18,1062,611,干城里,NULL
192,1683,9,1692,2096,0,0,80.73,772,911,社園里,NULL
0,1678,13,1691,2341,0,0,72.23,846,832,三民村,NULL
0,1676,15,1691,2442,0,0,69.25,840,836,復興里,NULL
0,1677,13,1690,2044,0,0,82.68,973,704,和昌里,NULL
0,1668,21,1689,2200,0,0,76.77,994,674,瑚璉村,NULL
0,1668,20,1688,2221,0,0,76,926,742,屈尺里,NULL
414,1669,19,1688,2424,0,0,69.64,815,854,和興村,NULL
0,1676,12,1688,2207,0,0,76.48,627,1049,禮蚵村,NULL
0,1668,19,1687,2115,0,0,79.76,1087,581,仁武里,NULL
0,1670,16,1686,2389,0,0,70.57,1153,517,福興村,NULL
0,1671,14,1685,2226,0,0,75.7,919,752,永寧里,NULL
0,1658,26,1684,2382,0,0,70.7,1251,407,康樂村,NULL
0,1665,19,1684,2161,0,0,77.93,945,720,東聖里,NULL
0,1674,8,1682,2107,0,0,79.83,1195,479,新廍里,NULL
0,1660,21,1681,2132,0,0,78.85,1238,422,內壢里,NULL
0,1667,14,1681,2272,0,0,73.99,1033,634,七嘉村,NULL
0,1667,14,1681,2141,0,0,78.51,916,751,老庄里,NULL
0,1665,16,1681,2090,0,0,80.43,880,785,中山里,NULL
0,1667,13,1680,2326,0,0,72.23,1017,650,鹽中村,NULL
0,1668,11,1679,2154,0,0,77.95,884,784,大園里,NULL
0,1664,15,1679,2179,0,0,77.05,879,785,日中里,NULL
0,1664,15,1679,2322,0,0,72.31,737,927,廣興村,NULL
0,1671,7,1678,2214,0,0,75.79,809,862,吳沙村,NULL
0,1662,16,1678,2200,0,0,76.27,699,963,南勢里,NULL
708,1663,14,1677,2073,0,0,80.9,1211,452,青島里,NULL
0,1663,14,1677,2073,0,0,80.9,1211,452,青島里,NULL
0,1664,13,1677,2448,0,0,68.5,1161,503,志學村,NULL
0,1658,19,1677,2124,0,0,78.95,859,799,慈生里,NULL
0,1667,9,1676,2721,3632,74.92,61.6,1491,176,延平鄉,Yanping Township
117,1661,15,1676,2048,0,0,81.84,1481,180,海勝里,NULL
0,1659,17,1676,2125,0,0,78.87,901,758,福基里,NULL
0,1656,18,1674,2343,0,0,71.45,690,966,黎明村,NULL
0,1660,13,1673,2324,2737,84.91,71.99,1422,238,霧臺鄉,Wutai Township
0,1649,23,1672,2203,0,0,75.9,888,761,湖日村,NULL
0,1655,17,1672,2161,0,0,77.37,837,818,保新里,NULL
0,1660,11,1671,2288,0,0,73.03,984,676,合和里,NULL
0,1655,16,1671,2140,0,0,78.08,889,766,竹東里,NULL
0,1652,18,1670,2207,0,0,75.67,1148,504,武漢村,NULL
811,1659,11,1670,2113,0,0,79.03,1010,649,潭北村,NULL
0,1659,11,1670,2113,0,0,79.03,1010,649,潭北村,NULL
0,1656,13,1669,2095,0,0,79.67,1279,377,秀士里,NULL
0,1661,8,1669,2130,0,0,78.36,1026,635,光田里,NULL
1137,1646,23,1669,2174,0,0,76.77,938,708,西盛里,NULL
0,1654,15,1669,2153,0,0,77.52,925,729,溝皂里,NULL
0,1654,15,1669,2073,0,0,80.51,848,806,文化里,NULL
0,1662,7,1669,2105,0,0,79.29,811,851,前庄村,NULL
0,1658,10,1668,2047,0,0,81.49,1115,543,誠德里,NULL
0,1653,15,1668,2096,0,0,79.58,1060,593,鼓峰里,NULL
0,1655,13,1668,2134,0,0,78.16,1003,652,成功里,NULL
0,1660,8,1668,2117,0,0,78.79,902,758,圍下里,NULL
0,1662,6,1668,2214,0,0,75.34,792,870,南興村,NULL
0,1659,9,1668,2144,0,0,77.8,777,882,港西村,NULL
351,1653,14,1667,2026,0,0,82.28,961,692,南聖里,NULL
0,1653,14,1667,2026,0,0,82.28,961,692,南聖里,NULL
0,1654,13,1667,2206,0,0,75.57,690,964,八甲村,NULL
0,1656,10,1666,2453,3311,74.09,67.92,1575,81,金峰鄉,Jinfeng Township
0,1656,10,1666,2300,0,0,72.43,1090,566,東勢村,NULL
0,1653,13,1666,2102,0,0,79.26,928,725,壽峰里,NULL
0,1643,23,1666,2216,0,0,75.18,883,760,和龍里,NULL
562,1644,21,1665,2138,0,0,77.88,904,740,內定里,NULL
0,1650,15,1665,2241,0,0,74.3,786,864,人和村,NULL
633,1650,14,1664,2044,0,0,81.41,1094,556,明德里,NULL
0,1646,18,1664,2217,0,0,75.06,937,709,西路里,NULL
0,1647,16,1663,2264,0,0,73.45,847,800,羅莊里,NULL
831,1644,15,1659,2073,0,0,80.03,1032,612,甘蔗村,NULL
0,1643,16,1659,2106,0,0,78.77,991,652,三多里,NULL
0,1652,7,1659,2303,0,0,72.04,874,778,南陽村,NULL
0,1641,17,1658,2402,0,0,69.03,1256,385,南王里,NULL
1022,1648,10,1658,2128,0,0,77.91,1084,564,立廷里,NULL
210,1648,10,1658,2115,0,0,78.39,995,653,龍水里,NULL
0,1638,20,1658,2105,0,0,78.76,829,809,新豐村,NULL
810,1639,18,1657,2209,0,0,75.01,1130,509,梅溪里,NULL
220,1645,12,1657,2636,0,0,62.86,1082,563,山頂村,NULL
0,1642,15,1657,2099,0,0,78.94,1066,576,民生里,NULL
334,1644,13,1657,2333,0,0,71.02,901,743,仁和里,NULL
0,1637,20,1657,2241,0,0,73.94,748,889,文昌里,NULL
0,1650,6,1656,3009,0,0,55.03,1544,106,新市里,NULL
384,1645,11,1656,2118,0,0,78.19,855,790,富強里,NULL
0,1635,21,1656,2155,0,0,76.84,736,899,歸南村,NULL
152,1643,12,1655,2051,0,0,80.69,1029,614,新光里,NULL
0,1635,19,1654,2450,0,0,67.51,1423,212,大漢村,NULL
0,1644,10,1654,2069,0,0,79.94,1246,398,雄峰里,NULL
0,1642,12,1654,2031,0,0,81.44,1028,614,協榮里,NULL
0,1642,12,1654,2240,0,0,73.84,931,711,擺塘村,NULL
0,1633,21,1654,2273,0,0,72.77,614,1019,繁華村,NULL
0,1636,17,1653,2087,0,0,79.2,1304,332,黎安里,NULL
0,1631,22,1653,2106,0,0,78.49,1115,516,頂埔里,NULL
0,1641,12,1653,2024,0,0,81.67,1069,572,大昌里,NULL
773,1645,8,1653,2154,0,0,76.74,1030,615,上雅村,NULL
0,1631,22,1653,2285,0,0,72.34,939,692,福南村,NULL
0,1636,17,1653,2142,0,0,77.17,919,717,全興里,NULL
0,1642,11,1653,2088,0,0,79.17,833,809,竹北里,NULL
345,1643,10,1653,2256,0,0,73.27,797,846,北斗村,NULL
0,1633,19,1652,2244,0,0,73.62,941,692,富源村,NULL
0,1635,16,1651,2251,0,0,73.35,1110,525,溪洲里,NULL
0,1645,6,1651,2123,0,0,77.77,876,769,保寧村,NULL
0,1635,16,1651,2251,0,0,73.35,602,1033,秀昌里,NULL
1351,1643,6,1649,1764,0,0,93.48,1214,429,萬芳里,NULL
0,1640,9,1649,2174,0,0,75.85,944,696,建福里,NULL
0,1635,14,1649,2172,0,0,75.92,519,1116,喜北里,NULL
588,1635,13,1648,2127,0,0,77.48,1114,521,文化里,NULL
0,1636,12,1648,2209,0,0,74.6,890,746,秀厝村,NULL
386,1633,15,1648,2140,0,0,77.01,820,813,富裕里,NULL
0,1633,15,1648,2140,0,0,77.01,820,813,富裕里,NULL
0,1636,11,1647,2155,0,0,76.43,1259,377,建國里,NULL
0,1637,10,1647,2181,0,0,75.52,852,785,四結村,NULL
0,1633,14,1647,2105,0,0,78.24,808,825,育英里,NULL
0,1638,9,1647,2234,0,0,73.72,732,906,港南村,NULL
0,1626,21,1647,2150,0,0,76.6,725,901,美和村,NULL
0,1635,11,1646,2200,0,0,74.82,999,636,永城里,NULL
0,1632,14,1646,2245,0,0,73.32,940,692,中山里,NULL
0,1631,15,1646,2101,0,0,78.34,879,752,平安里,NULL
0,1630,16,1646,2237,0,0,73.58,876,754,大湖里,NULL
651,1625,21,1646,2029,0,0,81.12,752,873,建軍里,NULL
0,1625,21,1646,2029,0,0,81.12,752,873,建軍里,NULL
0,1625,20,1645,2086,0,0,78.86,1332,293,仁愛村,NULL
0,1629,16,1645,2239,0,0,73.47,690,939,鹿埔村,NULL
0,1627,17,1644,2258,0,0,72.81,1052,575,同聲里,NULL
0,1627,17,1644,2226,0,0,73.85,976,651,義山里,NULL
0,1631,12,1643,2233,0,0,73.58,1121,510,頂犁村,NULL
631,1627,16,1643,2104,0,0,78.09,1080,547,永光里,NULL
0,1628,15,1643,2087,0,0,78.73,829,799,福人里,NULL
593,1626,16,1642,2160,0,0,76.02,1177,449,復興里,NULL
0,1630,12,1642,2223,0,0,73.86,1069,561,大忠村,NULL
0,1629,12,1641,2089,0,0,78.55,1056,573,汴頭村,NULL
1637,1629,11,1640,2006,0,0,81.75,1192,437,東勢里,NULL
0,1626,14,1640,2170,0,0,75.58,857,769,大崎村,NULL
0,1629,11,1640,2134,0,0,76.85,749,880,丁臺村,NULL
0,1629,11,1640,2147,0,0,76.39,738,891,營前村,NULL
0,1625,14,1639,2056,0,0,79.72,610,1015,義和村,NULL
0,1629,9,1638,2081,0,0,78.71,1078,551,營南里,NULL
138,1626,11,1637,2062,0,0,79.39,1098,528,同德里,NULL
783,1623,14,1637,2203,0,0,74.31,978,645,二和村,NULL
0,1618,19,1637,2060,0,0,79.47,665,953,民享里,NULL
242,1622,14,1636,2070,0,0,79.03,949,673,楓樹村,NULL
0,1613,23,1636,2198,0,0,74.43,707,906,慈愛里,NULL
0,1623,13,1636,2283,0,0,71.66,469,1154,中汕村,NULL
0,1613,22,1635,2139,0,0,76.44,932,681,東北里,NULL
233,1624,11,1635,2101,0,0,77.82,910,714,文平里,NULL
0,1621,14,1635,2055,0,0,79.56,786,835,中埔里,NULL
0,1619,16,1635,2087,0,0,78.34,619,1000,葉厝村,NULL
358,1624,10,1634,2013,0,0,81.17,1124,500,東光里,NULL
0,1622,12,1634,2330,0,0,70.13,1113,509,國聯里,NULL
818,1617,17,1634,2144,0,0,76.21,1034,583,福仁村,NULL
0,1614,20,1634,2326,0,0,70.25,839,775,和豊村,NULL
0,1628,6,1634,2170,0,0,75.3,795,833,崁頂村,NULL
421,1616,17,1633,2045,0,0,79.85,980,636,日新里,NULL
0,1615,18,1633,2330,0,0,70.09,870,745,惠來里,NULL
0,1621,12,1633,2273,0,0,71.84,753,868,隘丁里,NULL
0,1607,25,1632,2097,0,0,77.83,859,748,慈化里,NULL
0,1620,12,1632,2187,0,0,74.62,846,774,房裡里,NULL
0,1619,13,1632,1991,0,0,81.97,788,831,本文里,NULL
372,1616,15,1631,2094,0,0,77.89,981,635,羊稠村,NULL
0,1617,13,1630,2139,0,0,76.2,922,695,圳民里,NULL
0,1603,27,1630,2069,0,0,78.78,867,736,福營里,NULL
0,1613,17,1630,2231,0,0,73.06,746,867,新興村,NULL
67,1613,17,1630,2176,0,0,74.91,649,964,安富里,NULL
293,1612,16,1628,1976,0,0,82.39,989,623,烏日村,NULL
0,1610,17,1627,2160,0,0,75.32,1137,473,柳新村,NULL
0,1611,16,1627,2117,0,0,76.85,762,849,文賢村,NULL
0,1607,19,1626,2063,0,0,78.82,985,622,泰豐里,NULL
0,1615,11,1626,2097,0,0,77.54,913,702,大興里,NULL
0,1606,20,1626,2192,0,0,74.18,653,953,新群里,NULL
0,1610,15,1625,2054,0,0,79.11,1339,271,員崠里,NULL
564,1613,12,1625,2065,0,0,78.69,1150,463,健行里,NULL
282,1611,14,1625,2050,0,0,79.27,1081,530,阿夷里,NULL
321,1616,9,1625,2050,0,0,79.27,905,711,崇善里,NULL
0,1612,11,1623,2402,3492,68.79,67.57,1345,267,三民鄉,Sanmin Township
0,1612,11,1623,2120,0,0,76.56,941,671,新庄里,NULL
0,1608,15,1623,2050,0,0,79.17,753,855,英明里,NULL
0,1614,9,1623,2220,0,0,73.11,694,920,中門村,NULL
784,1610,12,1622,2117,0,0,76.62,1074,536,二和村,NULL
0,1601,21,1622,2191,0,0,74.03,958,643,饒平村,NULL
0,1608,13,1621,2234,0,0,72.56,548,1060,共和村,NULL
148,1610,10,1620,2028,0,0,79.88,1155,455,中聖里,NULL
589,1605,14,1619,2056,0,0,78.75,1042,563,文化里,NULL
0,1603,16,1619,2295,0,0,70.54,810,793,太平里,NULL
0,1602,17,1619,2168,0,0,74.68,570,1032,渡頭村,NULL
419,1599,19,1618,2082,0,0,77.71,988,611,公平里,NULL
0,1600,18,1618,2073,0,0,78.05,627,973,同安里,NULL
0,1588,29,1617,2301,0,0,70.27,1449,139,民意里,NULL
0,1605,12,1617,2056,0,0,78.65,1047,558,炎峰里,NULL
814,1605,12,1617,2277,0,0,71.01,1004,601,潭陽村,NULL
0,1615,2,1617,2037,0,0,79.38,937,678,斯文里,NULL
0,1610,7,1617,2215,0,0,73,879,731,瀰濃里,NULL
0,1598,19,1617,2068,0,0,78.19,875,723,德望里,NULL
0,1603,14,1617,2100,0,0,77,818,785,馬興村,NULL
0,1596,21,1617,2097,0,0,77.11,813,783,富國里,NULL
0,1594,23,1617,2106,0,0,76.78,703,891,廣安村,NULL
0,1594,22,1616,2045,0,0,79.02,1092,502,紅梅里,NULL
1136,1597,19,1616,2123,0,0,76.12,888,709,西盛里,NULL
0,1603,13,1616,2084,0,0,77.54,783,820,東門里,NULL
0,1597,18,1615,2051,0,0,78.74,1020,577,豐原里,NULL
1752,1600,15,1615,2262,0,0,71.4,953,647,二橋里,NULL
384,1603,12,1615,2010,0,0,80.35,932,671,藍興里,NULL
843,1597,18,1615,2026,0,0,79.71,883,714,大豐村,NULL
0,1605,8,1613,2077,0,0,77.66,812,793,振興里,NULL
0,1602,9,1611,2081,0,0,77.41,1309,293,流東里,NULL
813,1598,13,1611,2052,0,0,78.51,957,641,潭陽村,NULL
0,1603,7,1610,2034,0,0,79.15,975,628,秀昌里,NULL
0,1593,17,1610,2230,0,0,72.2,861,732,菁埔里,NULL
0,1598,12,1610,2101,0,0,76.63,845,753,鎮東里,NULL
1033,1598,11,1609,1989,0,0,80.89,947,651,中信里,NULL
0,1592,17,1609,2180,0,0,73.81,842,750,同安村,NULL
0,1598,11,1609,2090,0,0,76.99,734,864,一甲村,NULL
191,1590,18,1608,2102,0,0,76.5,1061,529,中興村,NULL
1237,1593,15,1608,2064,0,0,77.91,978,615,下城里,NULL
0,1593,15,1608,2064,0,0,77.91,978,615,下城里,NULL
0,1594,14,1608,2062,0,0,77.98,827,767,華興里,NULL
0,1598,10,1608,2151,0,0,74.76,657,941,新達里,NULL
0,1595,13,1608,2129,0,0,75.53,523,1072,社內村,NULL
0,1585,22,1607,2108,0,0,76.23,727,858,北榮里,NULL
0,1589,17,1606,1997,0,0,80.42,631,958,灣勝里,NULL
0,1578,27,1605,2215,0,0,72.46,931,647,龍崗村,NULL
193,1595,10,1605,1955,0,0,82.1,735,860,社園里,NULL
0,1586,18,1604,2118,0,0,75.73,885,701,平和村,NULL
578,1585,19,1604,2046,0,0,78.4,874,711,三村里,NULL
363,1585,18,1603,2148,0,0,74.63,805,780,文隆村,NULL
0,1585,18,1603,2148,0,0,74.63,805,780,文隆村,NULL
0,1596,7,1603,2073,0,0,77.33,790,806,寶厝村,NULL
0,1587,15,1602,2045,0,0,78.34,928,659,萬順村,NULL
842,1582,20,1602,2045,0,0,78.34,845,737,大豐村,NULL
0,1595,7,1602,2051,0,0,78.11,797,798,南寮村,NULL
0,1587,15,1602,2072,0,0,77.32,500,1087,佛壇里,NULL
0,1589,12,1601,2120,0,0,75.52,1248,341,下興里,NULL
585,1589,12,1601,2039,0,0,78.52,1131,458,復華里,NULL
188,1587,14,1601,2110,0,0,75.88,885,702,西湖里,NULL
0,1590,10,1600,2084,0,0,76.78,599,991,和蓮村,NULL
241,1586,13,1599,1920,0,0,83.28,1277,309,營北里,NULL
0,1577,22,1599,2081,0,0,76.84,1221,356,光明里,NULL
0,1582,17,1599,2100,0,0,76.14,968,614,社口里,NULL
0,1588,11,1599,2013,0,0,79.43,802,786,瑞德里,NULL
0,1583,16,1599,2129,0,0,75.11,785,798,知義里,NULL
0,1583,16,1599,2042,0,0,78.31,586,997,芝芭里,NULL
0,1575,23,1598,2168,0,0,73.71,851,724,內灣里,NULL
0,1583,14,1597,2070,0,0,77.15,1067,516,大同里,NULL
0,1573,24,1597,2005,0,0,79.65,1054,519,景本里,NULL
0,1585,12,1597,2178,0,0,73.32,707,878,香和村,NULL
0,1582,14,1596,2032,0,0,78.54,907,675,平安里,NULL
452,1581,15,1596,1963,0,0,81.3,804,777,太平里,NULL
53,1579,17,1596,2529,0,0,63.11,682,897,溪心里,NULL
95,1580,14,1594,2062,0,0,77.3,1136,444,寶慶里,NULL
0,1579,15,1594,2007,0,0,79.42,643,936,瑞和里,NULL
0,1579,14,1593,2128,0,0,74.86,801,778,圳頭村,NULL
0,1580,13,1593,2115,0,0,75.32,753,827,社西村,NULL
0,1573,20,1593,2009,0,0,79.29,742,831,順昌里,NULL
0,1581,12,1593,2329,0,0,68.4,632,949,水北村,NULL
309,1582,10,1592,2010,0,0,79.2,1011,571,仁德村,NULL
0,1581,11,1592,2112,0,0,75.38,872,709,大明里,NULL
0,1575,17,1592,2106,0,0,75.59,850,725,金湖村,NULL
0,1581,11,1592,2034,0,0,78.27,671,910,海南里,NULL
0,1579,12,1591,2107,0,0,75.51,1107,472,勤益里,NULL
213,1582,9,1591,2007,0,0,79.27,1023,559,龍水里,NULL
0,1579,12,1591,2025,0,0,78.57,847,732,中華里,NULL
11,1579,12,1591,2094,0,0,75.98,790,789,新順里,NULL
0,1579,11,1590,2211,0,0,71.91,979,600,通灣里,NULL
242,1575,15,1590,2059,0,0,77.22,955,620,平和里,NULL
0,1574,16,1590,2113,0,0,75.25,807,767,光和里,NULL
0,1571,19,1590,2102,0,0,75.64,799,772,小康里,NULL
0,1582,8,1590,2092,0,0,76,669,913,小港里,NULL
0,1581,8,1589,1932,0,0,82.25,1459,122,自助里,NULL
411,1576,13,1589,2130,0,0,74.6,876,700,和美村,NULL
225,1577,12,1589,2103,0,0,75.56,843,734,華平里,NULL
853,1570,18,1588,2113,0,0,75.15,1125,445,高山里,NULL
0,1573,15,1588,2073,0,0,76.6,923,650,東和里,NULL
0,1568,20,1588,2044,0,0,77.69,708,860,日新里,NULL
0,1571,17,1588,2144,0,0,74.07,587,984,福安里,NULL
0,1576,12,1588,2009,0,0,79.04,587,989,梓信村,NULL
0,1568,19,1587,2018,0,0,78.64,1232,336,北興村,NULL
0,1574,13,1587,2014,0,0,78.8,1115,459,永平里,NULL
619,1576,11,1587,1985,0,0,79.95,1105,471,正義里,NULL
629,1567,18,1585,1964,0,0,80.7,914,653,五權里,NULL
0,1577,8,1585,2098,0,0,75.55,863,714,加老里,NULL
271,1572,13,1585,2031,0,0,78.04,853,719,大武里,NULL
0,1561,24,1585,1994,0,0,79.49,829,732,光明村,NULL
0,1568,17,1585,2038,0,0,77.77,600,968,鎮昌里,NULL
0,1573,11,1584,2085,0,0,75.97,919,654,竹山里,NULL
815,1567,17,1584,2033,0,0,77.91,820,747,潭陽村,NULL
173,1572,11,1583,2119,0,0,74.71,1045,527,新崙里,NULL
0,1560,22,1582,2026,0,0,78.08,1107,453,正興里,NULL
379,1575,7,1582,2136,0,0,74.06,1063,512,瓦窯村,NULL
0,1575,7,1582,2136,0,0,74.06,1063,512,瓦窯村,NULL
0,1572,10,1582,2042,0,0,77.47,928,644,通西里,NULL
301,1562,19,1581,2082,0,0,75.94,1314,248,大和里,NULL
0,1562,19,1581,2022,0,0,78.19,677,885,大甲村,NULL
0,1569,12,1581,2371,0,0,66.68,626,943,老埤村,NULL
0,1570,10,1580,2156,0,0,73.28,681,889,鎮安村,NULL
362,1565,14,1579,1977,0,0,79.87,979,586,莊敬里,NULL
0,1567,12,1579,2099,0,0,75.23,821,746,錦江里,NULL
52,1563,16,1579,1906,0,0,82.84,730,833,福昌里,NULL
0,1563,16,1579,1906,0,0,82.84,730,833,福昌里,NULL
373,1569,9,1578,1947,0,0,81.05,1093,476,羊稠村,NULL
575,1562,16,1578,1990,0,0,79.3,912,650,社皮里,NULL
0,1565,13,1578,2078,0,0,75.94,851,714,中崙里,NULL
0,1573,5,1578,2056,0,0,76.75,806,767,港南里,NULL
0,1568,10,1578,2082,0,0,75.79,533,1035,上寮村,NULL
0,1565,12,1577,2048,0,0,77,1163,402,福瑞里,NULL
0,1568,9,1577,2147,0,0,73.45,1139,429,國華里,NULL
494,1559,18,1577,1954,0,0,80.71,997,562,豐年里,NULL
310,1565,12,1577,1999,0,0,78.89,987,578,仁德村,NULL
0,1562,15,1577,2007,0,0,78.57,968,594,忠孝里,NULL
0,1562,15,1577,2162,0,0,72.94,927,635,南勢里,NULL
565,1558,18,1576,1890,0,0,83.39,1091,467,力行里,NULL
161,1566,10,1576,1961,0,0,80.37,989,577,菜公里,NULL
0,1559,17,1576,2266,0,0,69.55,933,626,竹圍里,NULL
0,1568,8,1576,1997,0,0,78.92,842,726,營盤里,NULL
0,1566,10,1576,2212,0,0,71.25,800,766,田寮里,NULL
0,1561,15,1576,2155,0,0,73.13,584,977,玉光村,NULL
581,1561,14,1575,2018,0,0,78.05,909,652,田心里,NULL
0,1561,14,1575,2065,0,0,76.27,622,939,新吉村,NULL
234,1559,15,1574,2095,0,0,75.13,956,603,文化村,NULL
821,1560,14,1574,1986,0,0,79.25,754,806,建功里,NULL
686,1560,14,1574,2106,0,0,74.74,744,816,鳳宮里,NULL
0,1560,14,1574,2106,0,0,74.74,744,816,鳳宮里,NULL
62,1556,18,1574,2057,0,0,76.52,666,890,海佃里,NULL
0,1554,20,1574,2118,0,0,74.32,657,897,北花村,NULL
0,1563,10,1573,2011,0,0,78.22,844,719,清水里,NULL
183,1556,16,1572,2105,0,0,74.68,1024,532,龜山村,NULL
39,1565,7,1572,1881,0,0,83.57,998,567,東華里,NULL
0,1559,13,1572,1972,0,0,79.72,687,872,廣澤里,NULL
594,1556,15,1571,2013,0,0,78.04,1119,437,復興里,NULL
595,1559,12,1571,2154,0,0,72.93,1054,505,復興里,NULL
0,1555,16,1571,1984,0,0,79.18,991,564,溪州里,NULL
0,1562,9,1571,2088,0,0,75.24,829,733,東榮村,NULL
0,1547,24,1571,1975,0,0,79.54,760,787,慈惠里,NULL
0,1557,13,1570,2211,0,0,71.01,844,713,湖西村,NULL
0,1545,25,1570,2067,0,0,75.96,782,763,歸仁村,NULL
0,1557,13,1570,2088,0,0,75.19,749,808,灣成里,NULL
0,1549,20,1569,1992,0,0,78.77,872,677,新埔里,NULL
0,1561,8,1569,2016,0,0,77.83,711,850,德北里,NULL
588,1548,20,1568,1969,0,0,79.63,828,720,豐田里,NULL
0,1551,17,1568,2031,0,0,77.2,754,797,頂寮里,NULL
0,1554,14,1568,2129,0,0,73.65,575,979,枕山村,NULL
0,1551,16,1567,2038,0,0,76.89,796,755,芳安里,NULL
0,1554,12,1566,1993,0,0,78.58,1011,543,碧洲里,NULL
0,1547,19,1566,2050,0,0,76.39,888,659,海山里,NULL
0,1554,12,1566,2076,0,0,75.43,749,805,南和村,NULL
0,1548,17,1565,2118,0,0,73.89,927,621,頂粘村,NULL
0,1547,18,1565,2062,0,0,75.9,850,697,協和村,NULL
0,1543,21,1564,2363,0,0,66.19,1061,482,北基村,NULL
0,1548,16,1564,1998,0,0,78.28,878,670,舊正村,NULL
775,1547,16,1563,1977,0,0,79.06,1021,526,大雅村,NULL
0,1551,12,1563,2244,0,0,69.65,843,708,塭豐村,NULL
413,1555,8,1563,2150,0,0,72.7,825,730,和美村,NULL
392,1548,15,1563,2063,0,0,75.76,814,734,大福里,NULL
0,1548,15,1563,2063,0,0,75.76,814,734,大福里,NULL
0,1546,17,1563,2015,0,0,77.57,746,800,街尾里,NULL
127,1552,10,1562,1970,0,0,79.29,938,614,新下里,NULL
0,1543,19,1562,2049,0,0,76.23,691,852,舊路村,NULL
0,1546,16,1562,2140,0,0,72.99,654,892,寮頂村,NULL
122,1549,12,1561,1913,0,0,81.6,1128,421,二重里,NULL
0,1547,14,1561,2011,0,0,77.62,1030,517,玉峰里,NULL
536,1549,12,1561,2064,0,0,75.63,898,651,德隆里,NULL
0,1549,12,1561,2095,0,0,74.51,861,688,大誠里,NULL
0,1539,22,1561,2152,0,0,72.54,790,749,林北村,NULL
0,1538,23,1561,2176,0,0,71.74,740,798,內厝村,NULL
0,1549,12,1561,2148,0,0,72.67,542,1007,高樹村,NULL
774,1544,16,1560,2143,0,0,72.8,924,620,上雅村,NULL
114,1541,18,1559,1936,0,0,80.53,1441,100,大道里,NULL
0,1541,18,1559,1936,0,0,80.53,1441,100,大道里,NULL
1879,1549,10,1559,2035,0,0,76.61,1071,478,水碓里,NULL
763,1546,13,1559,1981,0,0,78.7,791,755,德昌里,NULL
0,1546,13,1559,1981,0,0,78.7,791,755,德昌里,NULL
0,1545,14,1559,2040,0,0,76.42,790,755,自信里,NULL
0,1541,18,1559,2132,0,0,73.12,754,787,舊社里,NULL
98,1545,14,1559,2030,0,0,76.8,686,859,東石里,NULL
31,1539,19,1558,2058,0,0,75.7,710,829,理想里,NULL
0,1543,14,1557,2009,0,0,77.5,1233,310,濫坑里,NULL
64,1543,14,1557,2179,0,0,71.45,1056,487,孝德里,NULL
0,1543,14,1557,2179,0,0,71.45,1056,487,孝德里,NULL
563,1540,17,1557,1982,0,0,78.56,1003,537,健行里,NULL
255,1549,8,1557,1999,0,0,77.89,944,605,天山里,NULL
0,1548,9,1557,1986,0,0,78.4,886,662,厚里村,NULL
0,1544,13,1557,2095,0,0,74.32,743,801,田頭里,NULL
0,1540,16,1556,2018,0,0,77.11,956,584,烏樹林村,NULL
0,1536,20,1556,2124,0,0,73.26,802,734,社苓里,NULL
0,1538,17,1555,1995,0,0,77.94,983,555,學田村,NULL
0,1543,12,1555,1962,0,0,79.26,834,709,五權里,NULL
0,1544,10,1554,2024,0,0,76.78,1060,484,永安里,NULL
0,1543,11,1554,1899,0,0,81.83,1043,500,瑞穗里,NULL
40,1548,6,1554,1892,0,0,82.14,1025,523,東華里,NULL
0,1540,14,1554,2158,0,0,72.01,975,565,仁愛里,NULL
144,1542,11,1553,2063,0,0,75.28,1097,445,寶安里,NULL
383,1533,20,1553,2011,0,0,77.23,991,542,內新里,NULL
136,1541,12,1553,1961,0,0,79.19,926,615,長德里,NULL
8,1544,9,1553,2035,0,0,76.31,708,836,安順里,NULL
0,1538,15,1553,2151,0,0,72.2,608,930,五福村,NULL
731,1538,14,1552,1931,0,0,80.37,981,557,民生里,NULL
37,1543,9,1552,1866,0,0,83.17,935,608,永明里,NULL
32,1535,17,1552,2020,0,0,76.83,652,883,理想里,NULL
0,1543,9,1552,2066,0,0,75.12,473,1070,南海村,NULL
0,1534,17,1551,2042,0,0,75.95,1186,348,民生里,NULL
0,1540,11,1551,1977,0,0,78.45,1067,473,下寮里,NULL
17,1540,11,1551,1898,0,0,81.72,1060,480,福林里,NULL
214,1537,14,1551,1946,0,0,79.7,952,585,南興里,NULL
208,1535,16,1551,1990,0,0,77.94,871,664,龍子里,NULL
0,1532,19,1551,2194,0,0,70.69,708,824,麥厝村,NULL
0,1542,9,1551,2062,0,0,75.22,579,963,田洋村,NULL
0,1539,11,1550,2099,0,0,73.84,965,574,平和里,NULL
388,1537,13,1550,2005,0,0,77.31,963,574,忠孝里,NULL
0,1536,14,1550,1979,0,0,78.32,897,639,重興里,NULL
0,1544,6,1550,2046,0,0,75.76,896,648,久安里,NULL
0,1530,20,1550,1965,0,0,78.88,671,859,新田村,NULL
0,1537,12,1549,2303,0,0,67.26,955,582,東文里,NULL
0,1535,14,1549,2439,0,0,63.51,749,786,南都里,NULL
217,1539,9,1548,1908,0,0,81.13,876,663,南瑶里,NULL
0,1529,18,1547,2052,0,0,75.39,818,711,南昌里,NULL
0,1531,16,1547,1948,0,0,79.41,719,812,鹽埕村,NULL
123,1537,8,1545,1851,0,0,83.47,1419,118,果貿里,NULL
0,1537,8,1545,1851,0,0,83.47,1419,118,果貿里,NULL
216,1532,13,1545,1938,0,0,79.72,982,550,明誠里,NULL
0,1529,16,1545,2104,0,0,73.43,771,758,重光里,NULL
841,1532,13,1545,1971,0,0,78.39,763,769,大富村,NULL
0,1532,13,1545,1971,0,0,78.39,763,769,大富村,NULL
27,1536,9,1545,2114,0,0,73.08,736,800,鳳凰里,NULL
0,1531,13,1544,1908,0,0,80.92,1425,106,永清里,NULL
0,1528,16,1544,2032,0,0,75.98,992,536,和睦里,NULL
0,1527,17,1544,1910,0,0,80.84,924,603,龍潭村,NULL
0,1532,12,1544,1956,0,0,78.94,902,630,富貴里,NULL
0,1527,17,1544,2122,0,0,72.76,828,699,上新里,NULL
0,1532,11,1543,2139,0,0,72.14,797,735,拔里,NULL
369,1528,14,1542,1997,0,0,77.22,1036,492,五福村,NULL
263,1533,9,1542,1929,0,0,79.94,1011,522,仁和里,NULL
222,1531,11,1542,1905,0,0,80.94,962,569,華豐里,NULL
0,1528,14,1542,2045,0,0,75.4,922,606,浮圳里,NULL
0,1528,13,1541,2090,0,0,73.73,1142,386,砂灣里,NULL
275,1525,16,1541,1921,0,0,80.22,1088,437,后庄里,NULL
0,1525,16,1541,2003,0,0,76.93,888,637,龍安里,NULL
192,1529,12,1541,1944,0,0,79.27,837,692,中興村,NULL
320,1527,14,1541,1953,0,0,78.9,790,737,崇善里,NULL
0,1534,7,1541,2089,0,0,73.77,685,849,新園村,NULL
0,1531,10,1541,2009,0,0,76.7,605,926,媽廟村,NULL
1208,1529,11,1540,1853,0,0,83.11,1116,413,大同里,NULL
0,1527,12,1539,1979,0,0,77.77,991,536,正明里,NULL
595,1524,15,1539,2007,0,0,76.68,889,635,南陽里,NULL
0,1524,15,1539,2013,0,0,76.45,889,635,庄美里,NULL
963,1528,11,1539,1960,0,0,78.52,847,681,福興里,NULL
0,1519,20,1539,2033,0,0,75.7,726,793,二行村,NULL
0,1530,9,1539,1980,0,0,77.73,631,899,安寧里,NULL
640,1519,19,1538,1931,0,0,79.65,1001,518,永福里,NULL
344,1529,9,1538,1998,0,0,76.98,973,556,中正里,NULL
1892,1525,13,1538,1993,0,0,77.17,941,584,北投里,NULL
0,1525,13,1538,1993,0,0,77.17,941,584,北投里,NULL
0,1523,15,1538,2080,0,0,73.94,755,768,八爺里,NULL
912,1522,15,1537,1847,0,0,83.22,1213,309,保順里,NULL
1365,1528,9,1537,1872,0,0,82.1,1154,374,萬興里,NULL
0,1526,11,1537,1981,0,0,77.59,879,647,長春里,NULL
0,1525,12,1537,1933,0,0,79.51,870,655,浩然里,NULL
175,1528,9,1537,1965,0,0,78.22,867,661,福山里,NULL
69,1523,14,1537,2052,0,0,74.9,563,960,幸福里,NULL
0,1523,13,1536,2102,0,0,73.07,967,556,寓埔村,NULL
0,1525,11,1536,2038,0,0,75.37,781,744,富榮里,NULL
0,1525,11,1536,1955,0,0,78.57,678,847,新庄村,NULL
0,1518,18,1536,2114,0,0,72.66,676,842,協和里,NULL
361,1522,13,1535,1944,0,0,78.96,1078,444,南榮村,NULL
0,1519,16,1535,1979,0,0,77.56,791,728,四德村,NULL
246,1520,14,1534,1945,0,0,78.87,1031,489,向陽里,NULL
551,1522,12,1534,1916,0,0,80.06,888,634,中正里,NULL
837,1524,10,1534,1910,0,0,80.31,855,669,東寶村,NULL
212,1525,9,1534,2286,0,0,67.1,621,904,石門里,NULL
0,1525,9,1534,2286,0,0,67.1,621,904,石門里,NULL
137,1523,10,1533,1945,0,0,78.82,1098,425,同德里,NULL
521,1518,14,1532,1912,0,0,80.13,1100,418,民福里,NULL
221,1520,12,1532,1867,0,0,82.06,982,538,華豐里,NULL
0,1526,6,1532,2017,0,0,75.95,774,752,城東里,NULL
0,1513,19,1532,2326,0,0,65.86,704,809,後埔里,NULL
186,1517,14,1531,1862,0,0,82.22,997,520,海山里,NULL
226,1507,23,1530,1966,0,0,77.82,1169,338,勝利村,NULL
0,1515,15,1530,2072,0,0,73.84,1111,404,山光里,NULL
173,1524,6,1530,1959,0,0,78.1,946,578,福山里,NULL
233,1517,13,1530,1979,0,0,77.31,895,622,文化村,NULL
0,1522,8,1530,2144,0,0,71.36,834,688,番婆村,NULL
1451,1512,18,1530,1989,0,0,76.92,797,715,永安里,NULL
0,1521,7,1528,1937,0,0,78.88,938,583,圳堵村,NULL
318,1511,17,1528,1963,0,0,77.84,812,699,溪埧村,NULL
2,1516,12,1528,2031,0,0,75.23,631,885,塭南里,NULL
454,1514,13,1527,1796,0,0,85.02,1135,379,萬福里,NULL
871,1517,10,1527,1905,0,0,80.16,1130,387,潭安里,NULL
0,1512,15,1527,2031,0,0,75.18,782,730,西社里,NULL
0,1503,24,1527,2042,0,0,74.78,605,898,蘇林村,NULL
1291,1519,7,1526,1849,0,0,82.53,1185,334,興安里,NULL
0,1512,14,1526,1950,0,0,78.26,1148,364,仁愛里,NULL
12,1517,9,1526,2063,0,0,73.97,1136,381,新豐里,NULL
548,1515,11,1526,1862,0,0,81.95,1059,456,復盛里,NULL
1040,1516,10,1526,1905,0,0,80.1,954,562,中原里,NULL
402,1515,11,1526,1885,0,0,80.95,925,590,德光里,NULL
0,1513,13,1526,1937,0,0,78.78,871,642,光復里,NULL
817,1510,16,1526,1928,0,0,79.15,864,646,福仁村,NULL
0,1516,10,1526,1927,0,0,79.19,836,680,西鶯里,NULL
0,1515,11,1526,2047,0,0,74.55,786,729,長泰里,NULL
60,1515,11,1526,1966,0,0,77.62,772,743,平和里,NULL
0,1515,11,1526,1966,0,0,77.62,772,743,平和里,NULL
391,1520,5,1525,1892,0,0,80.6,994,526,崇明里,NULL
0,1508,17,1525,2293,0,0,66.51,944,564,雙冬里,NULL
0,1514,11,1525,2057,0,0,74.14,900,614,湖東村,NULL
0,1504,20,1524,2076,0,0,73.41,1092,412,中義村,NULL
0,1512,12,1524,1900,0,0,80.21,878,634,東興里,NULL
0,1501,22,1523,2025,0,0,75.21,1009,492,西勢里,NULL
0,1513,10,1523,2068,0,0,73.65,754,759,茭白里,NULL
741,1510,12,1522,1916,0,0,79.44,987,523,成功里,NULL
0,1498,24,1522,2203,0,0,69.09,935,563,豐田里,NULL
317,1504,18,1522,1901,0,0,80.06,882,622,溪埧村,NULL
0,1498,24,1522,1994,0,0,76.33,882,616,員本里,NULL
0,1504,17,1521,1913,0,0,79.51,1100,404,玉泉村,NULL
178,1511,10,1521,2016,0,0,75.45,1056,455,內寮里,NULL
0,1504,17,1521,1943,0,0,78.28,979,525,華陽里,NULL
303,1515,6,1521,1954,0,0,77.84,978,537,一心里、義勇里,NULL
0,1515,6,1521,1954,0,0,77.84,978,537,一心里、義勇里,NULL
31,1503,18,1521,1905,0,0,79.84,939,564,永和里,NULL
0,1500,20,1520,2165,0,0,70.21,795,705,龍山里,NULL
568,1506,14,1520,1925,0,0,78.96,760,746,內厝里,NULL
0,1512,8,1520,2015,0,0,75.43,696,816,蓬萊里,NULL
0,1500,20,1520,2072,0,0,73.36,595,905,棋盤村,NULL
586,1509,10,1519,1874,0,0,81.06,1051,458,復華里,NULL
178,1511,8,1519,1867,0,0,81.36,1030,481,福山里,NULL
214,1506,13,1519,1864,0,0,81.49,1004,502,明誠里,NULL
570,1506,13,1519,1899,0,0,79.99,845,661,林富里,NULL
0,1506,13,1519,1899,0,0,79.99,845,661,林富里,NULL
758,1510,9,1519,1930,0,0,78.7,629,881,明正里,NULL
0,1502,17,1519,2018,0,0,75.27,585,917,中賢村,NULL
855,1496,22,1518,2144,0,0,70.8,1082,414,青山里,NULL
0,1496,22,1518,2144,0,0,70.8,1082,414,青山里,NULL
623,1509,9,1518,1915,0,0,79.27,1024,485,忠福里,NULL
0,1505,13,1518,1891,0,0,80.27,970,535,竹南里,NULL
1308,1512,5,1517,1824,0,0,83.17,1133,379,試院里,NULL
526,1503,14,1517,1940,0,0,78.2,1077,426,成功里,NULL
370,1508,9,1517,1978,0,0,76.69,1000,508,五福村,NULL
129,1507,10,1517,1899,0,0,79.88,932,575,新下里,NULL
405,1499,18,1517,1916,0,0,79.18,819,680,大忠里,NULL
253,1510,7,1517,1964,0,0,77.24,814,696,平林里,NULL
0,1502,15,1517,1910,0,0,79.42,574,928,瓊林村,NULL
0,1498,18,1516,1898,0,0,79.87,1058,440,大愛里,NULL
666,1500,16,1516,1922,0,0,78.88,1009,491,福隆里,NULL
0,1504,12,1516,2207,0,0,68.69,993,511,豊崙村,NULL
369,1507,9,1516,1884,0,0,80.47,904,603,五分里,NULL
0,1503,13,1516,1963,0,0,77.23,857,646,虎林里,NULL
689,1510,6,1516,1973,0,0,76.84,768,742,店鎮里,NULL
191,1508,8,1516,1902,0,0,79.71,666,842,社園里,NULL
71,1501,14,1515,1929,0,0,78.54,1028,473,水錦里,NULL
0,1501,14,1515,1929,0,0,78.54,1028,473,水錦里,NULL
246,1506,9,1515,1938,0,0,78.17,965,541,大連里,NULL
0,1505,10,1515,2047,0,0,74.01,961,544,湖西里,NULL
940,1500,15,1515,2038,0,0,74.34,778,722,九斗村,NULL
0,1500,15,1515,2038,0,0,74.34,778,722,九斗村,NULL
0,1496,18,1514,1969,0,0,76.89,942,554,公誠里,NULL
0,1498,16,1514,1995,0,0,75.89,767,731,吉祥村,NULL
0,1498,15,1513,1951,0,0,77.55,1225,273,造橋村,NULL
661,1495,18,1513,1841,0,0,82.18,1189,306,福南里,NULL
581,1511,2,1513,1877,0,0,80.61,940,571,林泉里,NULL
0,1511,2,1513,1877,0,0,80.61,940,571,林泉里,NULL
0,1494,19,1513,1960,0,0,77.19,886,608,康樂里,NULL
247,1501,12,1513,1950,0,0,77.59,869,632,福興里,NULL
0,1494,19,1513,2368,0,0,63.89,729,765,施厝村,NULL
0,1506,7,1513,1963,0,0,77.08,696,810,關廟村,NULL
0,1502,11,1513,1881,0,0,80.44,644,858,福康里,NULL
0,1500,13,1513,1951,0,0,77.55,609,891,梓義村,NULL
100,1497,15,1512,1960,0,0,77.14,754,743,永安里,NULL
0,1496,15,1511,1902,0,0,79.44,944,552,三信里,NULL
828,1496,15,1511,1893,0,0,79.82,912,584,家福村,NULL
0,1488,23,1511,1949,0,0,77.53,778,710,下崙村,NULL
0,1496,15,1511,2334,0,0,64.74,772,724,三盛村,NULL
0,1502,9,1511,1977,0,0,76.43,748,754,慈福里,NULL
529,1497,12,1509,1960,0,0,76.99,960,537,新街里,NULL
0,1497,12,1509,1960,0,0,76.99,960,537,新街里,NULL
0,1488,21,1509,1944,0,0,77.62,826,662,長安里,NULL
0,1502,7,1509,1995,0,0,75.64,764,738,泉源里,NULL
0,1495,14,1509,2018,0,0,74.78,721,774,庄後村,NULL
0,1502,7,1509,2039,0,0,74.01,650,852,天時村,NULL
0,1493,16,1509,1895,0,0,79.63,618,875,甲北村,NULL
126,1502,6,1508,1803,0,0,83.64,990,512,新下里,NULL
589,1493,15,1508,1859,0,0,81.12,967,526,凱旋里,NULL
0,1493,15,1508,1859,0,0,81.12,967,526,凱旋里,NULL
471,1495,13,1508,1913,0,0,78.83,935,560,仁愛里,NULL
215,1503,5,1508,1847,0,0,81.65,872,631,明誠里,NULL
0,1493,15,1508,2035,0,0,74.1,670,823,重興里,NULL
1857,1497,10,1507,1910,0,0,78.9,996,501,福德里,NULL
1448,1491,16,1507,1969,0,0,76.54,829,662,光明里,NULL
0,1496,11,1507,2056,0,0,73.3,723,773,忠孝村,NULL
61,1495,12,1507,1986,0,0,75.88,590,905,海佃里,NULL
0,1497,9,1506,2341,0,0,64.33,1115,382,豐年里,NULL
313,1489,17,1506,1996,0,0,75.45,949,540,崑崙里,NULL
0,1493,13,1506,2012,0,0,74.85,745,748,新西里,NULL
0,1497,9,1506,2049,0,0,73.5,733,764,藍埔村,NULL
0,1495,10,1505,1896,0,0,79.38,1149,346,自強里,NULL
0,1495,10,1505,2006,0,0,75.02,1071,424,線西村,NULL
930,1495,10,1505,1847,0,0,81.48,1013,482,南福里,NULL
520,1487,18,1505,1814,0,0,82.97,1007,480,民福里,NULL
179,1488,17,1505,2045,0,0,73.59,997,491,內寮里,NULL
232,1489,16,1505,1900,0,0,79.21,960,529,西興里,NULL
797,1490,15,1505,1906,0,0,78.96,897,593,員林村,NULL
187,1495,10,1505,1929,0,0,78.02,834,661,西湖里,NULL
434,1492,12,1504,1845,0,0,81.52,1020,472,東新里,NULL
218,1490,14,1504,1909,0,0,78.78,856,634,明誠里,NULL
726,1490,14,1504,2005,0,0,75.01,640,850,坪頂里,NULL
157,1491,12,1503,1963,0,0,76.57,1092,399,會稽里,NULL
1227,1491,12,1503,1865,0,0,80.59,1012,479,信義里,NULL
75,1489,14,1503,2009,0,0,74.81,1011,478,大東村,NULL
378,1490,13,1503,1951,0,0,77.04,966,524,營盤村,NULL
20,1483,20,1503,2044,0,0,73.53,656,827,安和里,NULL
0,1483,20,1503,2044,0,0,73.53,656,827,安和里,NULL
0,1493,9,1502,1714,0,0,87.63,1453,40,仁義里,NULL
371,1488,14,1502,1851,0,0,81.15,918,570,新里里,NULL
0,1488,14,1502,1965,0,0,76.44,890,598,中路里,NULL
0,1480,22,1502,2189,0,0,68.62,837,643,樹林村,NULL
677,1481,20,1501,1912,0,0,78.5,1052,429,景平里,NULL
0,1480,21,1501,2078,0,0,72.23,979,501,鐵山村,NULL
219,1493,8,1501,1842,0,0,81.49,935,558,明誠里,NULL
0,1480,21,1501,2025,0,0,74.12,890,590,太平村,NULL
0,1485,15,1500,1910,0,0,78.53,1085,400,五埔里,NULL
0,1487,13,1500,2058,0,0,72.89,970,517,麗水村,NULL
0,1483,17,1500,1955,0,0,76.73,755,728,橋頭村,NULL
313,1495,4,1499,1856,0,0,80.77,1102,393,崇蘭里,NULL
358,1484,15,1499,1931,0,0,77.63,1052,432,南興村,NULL
70,1487,12,1499,1949,0,0,76.91,1014,473,中平里,NULL
38,1487,12,1499,1850,0,0,81.03,982,505,永明里,NULL
207,1483,15,1498,1896,0,0,79.01,754,729,龍子里,NULL
1281,1490,7,1497,1800,0,0,83.17,1132,358,興家里,NULL
120,1485,12,1497,1895,0,0,79,1030,455,新埔里,NULL
0,1488,9,1497,2030,0,0,73.74,1009,479,泰安里,NULL
1249,1487,10,1497,1814,0,0,82.52,991,496,景慶里,NULL
76,1490,7,1497,1807,0,0,82.84,967,523,加昌里,NULL
990,1487,10,1497,1845,0,0,81.14,883,604,仁德里,NULL
0,1484,13,1497,1887,0,0,79.33,838,646,林德里,NULL
1482,1476,21,1497,2007,0,0,74.59,808,668,永康里,NULL
0,1480,16,1496,2031,0,0,73.66,927,553,康樂里,NULL
0,1486,10,1496,1953,0,0,76.6,716,770,開山里,NULL
1194,1485,10,1495,1849,0,0,80.85,1226,259,中山里,NULL
1193,1487,8,1495,1913,0,0,78.15,1196,291,中山里,NULL
257,1478,16,1494,1982,0,0,75.38,982,496,新東村,NULL
247,1480,14,1494,1905,0,0,78.43,967,513,大連里,NULL
827,1476,18,1494,1938,0,0,77.09,927,549,家興村,NULL
0,1482,12,1494,1969,0,0,75.88,761,721,中原里,NULL
10,1486,8,1494,1967,0,0,75.95,703,783,州北里,NULL
80,1472,22,1494,2092,0,0,71.41,679,793,大葛里,NULL
0,1472,22,1494,2092,0,0,71.41,679,793,大葛里,NULL
257,1486,7,1493,1877,0,0,79.54,1235,251,瑞德里,NULL
0,1473,20,1493,1937,0,0,77.08,1046,427,五穀村,NULL
160,1489,4,1493,1860,0,0,80.27,1039,450,六合里,NULL
256,1477,16,1493,1921,0,0,77.72,973,504,重慶里,NULL
0,1481,12,1493,2050,0,0,72.83,881,600,中壇里,NULL
0,1481,12,1493,1922,0,0,77.68,849,632,萬福村,NULL
0,1480,13,1493,1873,0,0,79.71,718,762,正文里,NULL
0,1480,13,1493,1934,0,0,77.2,602,878,廣福村,NULL
335,1477,15,1492,1938,0,0,76.99,780,697,和平里,NULL
0,1469,22,1491,2289,0,0,65.14,1120,349,南榮里,NULL
1,1482,9,1491,1801,0,0,82.79,1099,383,鹿場里,NULL
1364,1476,15,1491,1798,0,0,82.93,1075,401,萬興里,NULL
274,1475,16,1491,1823,0,0,81.79,998,477,后庄里,NULL
262,1478,13,1491,2532,0,0,58.89,978,500,仁和里,NULL
0,1478,13,1491,1829,0,0,81.52,925,553,民安里,NULL
222,1480,11,1491,2039,0,0,73.12,883,597,育平里,NULL
424,1483,8,1491,1914,0,0,77.9,839,644,後厝村,NULL
0,1483,8,1491,1914,0,0,77.9,839,644,後厝村,NULL
0,1482,9,1491,1882,0,0,79.22,656,826,西甲里,NULL
0,1474,17,1491,1899,0,0,78.52,653,821,福西里,NULL
1326,1480,10,1490,1812,0,0,82.23,1055,425,木新里,NULL
212,1482,8,1490,1894,0,0,78.67,995,487,富民里,NULL
77,1476,14,1490,1851,0,0,80.5,921,555,豐林里,NULL
721,1475,15,1490,1873,0,0,79.55,848,627,明穗里,NULL
891,1469,20,1489,1931,0,0,77.11,991,478,上林村,NULL
220,1475,14,1489,1890,0,0,78.78,963,512,明誠里,NULL
0,1482,7,1489,2032,0,0,73.28,904,578,元寶里,NULL
159,1480,9,1489,1870,0,0,79.63,827,653,菜公里,NULL
0,1471,18,1489,1922,0,0,77.47,800,671,順德里,NULL
0,1479,10,1489,2000,0,0,74.45,779,700,朝陽村,NULL
0,1475,14,1489,1983,0,0,75.09,668,807,烏竹里,NULL
1258,1477,11,1488,1852,0,0,80.35,1089,388,安昌里,NULL
102,1478,10,1488,1829,0,0,81.36,1023,455,雲林里,NULL
89,1469,19,1488,1879,0,0,79.19,787,682,中庸里,NULL
0,1474,14,1488,1866,0,0,79.74,525,949,鎮東里,NULL
528,1473,14,1487,1975,0,0,75.29,1098,375,後寮里,NULL
0,1475,12,1487,1997,0,0,74.46,904,571,西湖村,NULL
370,1472,15,1487,1886,0,0,78.84,832,640,新里里,NULL
196,1471,16,1487,1842,0,0,80.73,790,681,軍功里,NULL
111,1478,8,1486,2035,0,0,73.02,731,747,內埔村,NULL
0,1481,5,1486,2042,0,0,72.77,567,914,佳化里,NULL
289,1475,10,1485,1845,0,0,80.49,972,503,西安里,NULL
94,1474,11,1485,1907,0,0,77.87,854,620,朝陽里,NULL
0,1474,11,1485,1907,0,0,77.87,854,620,朝陽里,NULL
0,1471,14,1485,1917,0,0,77.46,756,715,港後村,NULL
612,1464,21,1485,1871,0,0,79.37,680,784,永吉里,NULL
0,1475,10,1485,1935,0,0,76.74,572,903,安鎮里,NULL
0,1476,9,1485,1941,0,0,76.51,458,1018,中路村,NULL
904,1470,14,1484,1839,0,0,80.7,1209,261,東興村,NULL
0,1466,18,1484,1949,0,0,76.14,627,839,樹下里,NULL
7,1475,8,1483,1816,0,0,81.66,833,642,福安里,NULL
0,1470,13,1483,1967,0,0,75.39,547,923,王行里,NULL
747,1473,10,1483,1974,0,0,75.13,511,962,鳳興里,NULL
0,1473,10,1483,1974,0,0,75.13,511,962,鳳興里,NULL
1072,1472,10,1482,1873,0,0,79.12,866,606,祥鳳里,NULL
0,1472,10,1482,1873,0,0,79.12,866,606,祥鳳里,NULL
0,1472,10,1482,1941,0,0,76.35,833,639,新鐘村,NULL
1528,1462,20,1482,1866,0,0,79.42,808,654,水河里,NULL
824,1465,16,1481,1891,0,0,78.32,1002,463,頭家東村,NULL
427,1468,13,1481,1907,0,0,77.66,962,506,長榮里,NULL
154,1473,8,1481,1868,0,0,79.28,906,567,菜公里,NULL
369,1461,20,1481,2010,0,0,73.68,656,805,和平村,NULL
0,1461,20,1481,2010,0,0,73.68,656,805,和平村,NULL
337,1467,13,1480,1934,0,0,76.53,949,518,本堂村,NULL
0,1462,18,1480,1912,0,0,77.41,773,689,翁社里,NULL
251,1470,10,1480,1917,0,0,77.2,733,737,西林里,NULL
0,1470,10,1480,1917,0,0,77.2,733,737,西林里,NULL
56,1468,11,1479,1869,0,0,79.13,1148,320,東明里,NULL
0,1462,17,1479,1937,0,0,76.36,930,532,岷山里,NULL
251,1459,20,1479,1888,0,0,78.34,881,578,南安里,NULL
0,1459,20,1479,1888,0,0,78.34,881,578,南安里,NULL
189,1467,12,1479,1869,0,0,79.13,825,642,水景里,NULL
151,1463,16,1479,1838,0,0,80.47,730,733,汴洲里,NULL
0,1470,9,1479,1909,0,0,77.48,529,941,興農里,NULL
0,1469,10,1479,1908,0,0,77.52,513,956,開化村,NULL
1299,1465,13,1478,1885,0,0,78.41,952,513,粗坑里,NULL
24,1460,18,1478,1885,0,0,78.41,917,543,惠豐里,NULL
360,1464,14,1478,1934,0,0,76.42,853,611,南榮村,NULL
545,1459,19,1478,1825,0,0,80.99,832,627,中陽里,NULL
99,1459,19,1478,1931,0,0,76.54,770,689,永安里,NULL
744,1469,9,1478,1910,0,0,77.38,539,930,鳳森里,NULL
0,1469,9,1478,1910,0,0,77.38,539,930,鳳森里,NULL
110,1462,15,1477,2048,0,0,72.12,1100,362,慶豐村,NULL
0,1464,13,1477,1951,0,0,75.7,952,512,西寮里,NULL
0,1452,25,1477,1991,0,0,74.18,927,525,松隆里,NULL
212,1457,20,1477,1894,0,0,77.98,869,588,延和里,NULL
730,1461,16,1477,1783,0,0,82.84,855,606,民生里,NULL
0,1469,8,1477,2041,0,0,72.37,846,623,西勢里,NULL
156,1465,12,1477,1831,0,0,80.67,777,688,前港里,NULL
486,1464,13,1477,2002,0,0,73.78,761,703,經口村,NULL
0,1464,13,1477,2002,0,0,73.78,761,703,經口村,NULL
0,1460,17,1477,1905,0,0,77.53,613,847,山西村,NULL
1169,1465,11,1476,1862,0,0,79.27,966,499,臨江里,NULL
198,1459,17,1476,1756,0,0,84.05,890,569,莊敬里,NULL
672,1465,11,1476,1865,0,0,79.14,886,579,竹南里,NULL
1485,1471,5,1476,1850,0,0,79.78,836,635,樓厝里,NULL
0,1451,25,1476,2102,0,0,70.22,642,809,西畔村,NULL
332,1452,23,1475,1900,0,0,77.63,834,618,本鄉村,NULL
0,1452,23,1475,1900,0,0,77.63,834,618,本鄉村,NULL
0,1464,11,1475,1927,0,0,76.54,785,679,綠川里,NULL
0,1464,11,1475,1937,0,0,76.15,647,817,美城村,NULL
422,1461,13,1474,1939,0,0,76.02,936,525,公德里,NULL
0,1463,11,1474,2083,0,0,70.76,837,626,中山村,NULL
946,1463,11,1474,1816,0,0,81.17,776,687,文衡里,NULL
0,1463,11,1474,1816,0,0,81.17,776,687,文衡里,NULL
0,1462,12,1474,1946,0,0,75.75,736,726,信蚵村,NULL
493,1458,15,1473,1867,0,0,78.9,956,502,豐年里,NULL
35,1462,11,1473,1833,0,0,80.36,821,641,大林里,NULL
221,1460,12,1472,1831,0,0,80.39,966,494,松勇里,NULL
1325,1457,15,1472,1839,0,0,80.04,963,494,木新里,NULL
0,1462,10,1472,2292,0,0,64.22,860,602,陽明里,NULL
143,1456,16,1472,1885,0,0,78.09,809,647,舊佳里,NULL
7,1459,12,1471,2089,0,0,70.42,1026,433,新富里,NULL
475,1458,13,1471,1959,0,0,75.09,827,631,東和里,NULL
0,1458,13,1471,1959,0,0,75.09,827,631,東和里,NULL
57,1455,16,1471,1799,0,0,81.77,694,761,興昌里,NULL
0,1457,14,1471,1909,0,0,77.06,612,845,萬昌里,NULL
0,1461,10,1471,1841,0,0,79.9,604,857,橋頭村,NULL
0,1459,12,1471,1915,0,0,76.81,556,903,中興里,NULL
157,1463,7,1470,1883,0,0,78.07,1025,438,五福里,NULL
469,1458,12,1470,1911,0,0,76.92,1021,437,仁和里,NULL
0,1453,17,1470,1889,0,0,77.82,1017,436,南平里,NULL
79,1459,11,1470,1927,0,0,76.28,924,535,仁昌里,NULL
140,1466,4,1470,1777,0,0,82.72,815,651,福志里,NULL
395,1457,13,1470,1889,0,0,77.82,752,705,寶獅里,NULL
0,1459,11,1470,1878,0,0,78.27,634,825,松腳村,NULL
911,1461,8,1469,1789,0,0,82.11,1128,333,保順里,NULL
80,1456,13,1469,1897,0,0,77.44,959,497,仁昌里,NULL
167,1455,14,1469,1928,0,0,76.19,805,650,新南里,NULL
1047,1459,10,1469,1832,0,0,80.19,790,669,華中里,NULL
0,1458,10,1468,1789,0,0,82.06,1125,333,中山里,NULL
514,1461,7,1468,1824,0,0,80.48,1043,418,信義里,NULL
267,1452,16,1468,1817,0,0,80.79,887,565,仁美里,NULL
42,1458,10,1468,1813,0,0,80.97,884,574,吉利里,NULL
224,1456,12,1468,1912,0,0,76.78,820,636,華平里,NULL
822,1458,10,1468,1999,0,0,73.44,789,669,建功里,NULL
0,1459,9,1468,1916,0,0,76.62,789,670,興田村,NULL
186,1455,13,1468,1816,0,0,80.84,773,682,西賢里,NULL
0,1460,8,1468,1887,0,0,77.8,712,748,中正里,NULL
53,1455,12,1467,1795,0,0,81.73,867,588,立農里,NULL
364,1450,17,1467,1814,0,0,80.87,851,599,錦興村,NULL
0,1455,12,1467,1945,0,0,75.42,815,640,土庫村,NULL
270,1456,11,1467,1834,0,0,79.99,759,697,同榮里,NULL
120,1451,16,1467,1922,0,0,76.33,749,702,山崙里,NULL
198,1448,19,1467,1845,0,0,79.51,598,850,正德里,NULL
0,1448,19,1467,1845,0,0,79.51,598,850,正德里,NULL
179,1453,13,1466,1865,0,0,78.61,1058,395,三民里,NULL
1005,1462,4,1466,1800,0,0,81.44,1020,442,立人里,NULL
0,1462,4,1466,1800,0,0,81.44,1020,442,立人里,NULL
1228,1454,12,1466,1925,0,0,76.16,942,512,車層里,NULL
931,1458,8,1466,1785,0,0,82.13,915,543,南福里,NULL
1914,1451,15,1466,1944,0,0,75.41,897,554,沙崙里,NULL
217,1458,8,1466,1901,0,0,77.12,887,571,明誠里,NULL
0,1443,23,1466,2072,0,0,70.75,753,690,古坑村,NULL
0,1455,11,1466,2064,0,0,71.03,593,862,羅厝村,NULL
159,1457,8,1465,1829,0,0,80.1,1059,398,六合里,NULL
261,1455,10,1465,1890,0,0,77.51,928,527,天母里,NULL
0,1456,9,1465,1955,0,0,74.94,606,850,慈福里,NULL
102,1452,12,1464,1769,0,0,82.76,1173,279,文化里,NULL
1177,1455,9,1464,1827,0,0,80.13,1084,371,群賢里,NULL
784,1448,16,1464,1843,0,0,79.44,1077,371,秀景里,NULL
55,1447,17,1464,1788,0,0,81.88,780,667,立農里,NULL
0,1449,15,1464,1934,0,0,75.7,657,792,過溪村,NULL
0,1447,16,1463,2003,0,0,73.04,868,579,新北里,NULL
393,1456,7,1463,1807,0,0,80.96,796,660,本揚里,NULL
385,1449,14,1463,1896,0,0,77.16,742,707,富強里,NULL
0,1455,8,1463,1886,0,0,77.57,736,719,忠孝里,NULL
412,1456,7,1463,1793,0,0,81.6,721,735,寶國里,NULL
210,1445,18,1463,2004,0,0,73,652,793,大崙村,NULL
0,1445,18,1463,2004,0,0,73,652,793,大崙村,NULL
799,1443,19,1462,1927,0,0,75.87,917,526,員林村,NULL
141,1455,7,1462,1813,0,0,80.64,814,641,舊佳里,NULL
0,1450,11,1461,2727,0,0,53.58,1230,220,三民里,NULL
130,1448,13,1461,2042,0,0,71.55,989,459,和慶里,NULL
258,1448,13,1461,1871,0,0,78.09,982,466,平陽里,NULL
310,1451,10,1461,1923,0,0,75.98,874,577,崇蘭里,NULL
720,1447,14,1461,1756,0,0,83.2,834,613,明穗里,NULL
439,1449,12,1461,1862,0,0,78.46,834,615,立德里,NULL
496,1448,13,1461,1793,0,0,81.48,808,640,國光里,NULL
1025,1444,17,1461,1809,0,0,80.76,801,643,全德里,NULL
759,1449,12,1461,1806,0,0,80.9,777,672,松江里,NULL
145,1444,17,1461,1776,0,0,82.26,749,695,福佳里,NULL
127,1452,9,1461,1831,0,0,79.79,728,724,仁勇里,NULL
662,1444,16,1460,1809,0,0,80.71,1104,340,福南里,NULL
129,1454,6,1460,2006,0,0,72.78,1099,355,中和里,NULL
1248,1447,13,1460,1772,0,0,82.39,1022,425,景慶里,NULL
1207,1450,10,1460,1793,0,0,81.43,993,457,大同里,NULL
230,1447,13,1460,1886,0,0,77.41,945,502,百福里,NULL
30,1444,16,1460,1857,0,0,78.62,855,589,永和里,NULL
153,1447,13,1460,1807,0,0,80.8,751,696,菜公里,NULL
0,1449,11,1460,1845,0,0,79.13,734,715,河濱里,NULL
0,1452,7,1459,2723,0,0,53.58,1379,73,北門里,NULL
218,1447,12,1459,1859,0,0,78.48,866,581,南瑶里,NULL
348,1445,14,1459,1970,0,0,74.06,837,608,雙福村,NULL
0,1445,14,1459,1970,0,0,74.06,837,608,雙福村,NULL
160,1450,9,1459,1878,0,0,77.69,829,621,菜公里,NULL
0,1446,13,1459,1895,0,0,76.99,651,795,湖邊里,NULL
693,1439,20,1459,1895,0,0,76.99,609,830,二苓里,NULL
1145,1450,8,1458,1843,0,0,79.11,1231,219,新龍里,NULL
139,1449,9,1458,1828,0,0,79.76,848,601,新上里,NULL
569,1448,10,1458,1788,0,0,81.54,743,705,復勢里,NULL
1150,1443,14,1457,1774,0,0,82.13,1219,224,新生里,NULL
933,1446,11,1457,1756,0,0,82.97,1024,422,南福里,NULL
277,1448,9,1457,1799,0,0,80.99,1003,445,華東里,NULL
43,1450,7,1457,1857,0,0,78.46,932,518,龍安里,NULL
445,1444,13,1457,1803,0,0,80.81,879,565,合成里,NULL
0,1452,5,1457,2038,0,0,71.49,856,596,平安里,NULL
0,1444,13,1457,1933,0,0,75.38,645,799,甲北村,NULL
513,1451,5,1456,1812,0,0,80.35,987,464,中華里,NULL
319,1448,8,1456,1838,0,0,79.22,840,608,溪洲里,NULL
261,1444,12,1456,1787,0,0,81.48,761,683,仁和里,NULL
1306,1444,11,1455,1802,0,0,80.74,1172,272,試院里,NULL
245,1445,10,1455,1858,0,0,78.31,894,551,崙平里,NULL
776,1446,9,1455,1867,0,0,77.93,814,632,大雅村,NULL
158,1436,18,1454,2069,0,0,70.28,1056,380,會稽里,NULL
601,1450,3,1453,1738,0,0,83.6,988,462,新南里,NULL
0,1438,15,1453,1856,0,0,78.29,976,462,千甲里,NULL
1197,1445,8,1453,1793,0,0,81.04,975,470,芳和里,NULL
312,1438,15,1453,1775,0,0,81.86,944,494,湖濱里,NULL
0,1441,12,1453,1985,0,0,73.2,586,855,水林村,NULL
519,1447,6,1453,2014,0,0,72.14,502,945,石光村,NULL
0,1447,6,1453,2014,0,0,72.14,502,945,石光村,NULL
824,1437,15,1452,1819,0,0,79.82,958,479,楊梅里,NULL
365,1442,10,1452,1863,0,0,77.94,933,509,錦興村,NULL
215,1442,10,1452,1854,0,0,78.32,924,518,南興里,NULL
148,1438,14,1452,1922,0,0,75.55,804,634,嘉仁里,NULL
2034,1440,12,1452,1867,0,0,77.77,798,642,義仁村,NULL
581,1429,23,1452,1784,0,0,81.39,797,632,福真里,NULL
0,1441,11,1452,2269,0,0,63.99,697,744,東原村,NULL
0,1432,20,1452,1911,0,0,75.98,521,911,官田村,NULL
239,1442,9,1451,1893,0,0,76.65,898,544,五權里,NULL
260,1441,10,1451,1824,0,0,79.55,897,544,天母里,NULL
221,1443,8,1451,1921,0,0,75.53,853,590,育平里,NULL
102,1435,16,1451,1809,0,0,80.21,850,585,南社里,NULL
626,1433,18,1451,1880,0,0,77.18,845,588,興國里,NULL
0,1433,18,1451,1880,0,0,77.18,845,588,興國里,NULL
143,1438,13,1451,1811,0,0,80.12,793,645,新上里,NULL
639,1442,9,1451,1867,0,0,77.72,766,676,正心里,NULL
0,1437,14,1451,2092,0,0,69.36,710,727,社口村,NULL
377,1440,11,1451,1762,0,0,82.35,681,759,田中里,NULL
0,1444,7,1451,1852,0,0,78.35,631,813,社皮村,NULL
1307,1442,8,1450,1800,0,0,80.56,1102,340,試院里,NULL
0,1438,12,1450,1960,0,0,73.98,1028,410,國魂里,NULL
420,1435,15,1450,1893,0,0,76.6,930,505,公平里,NULL
0,1435,15,1450,1805,0,0,80.33,902,533,福丘里,NULL
361,1438,12,1450,1940,0,0,74.74,889,549,東湖里,NULL
0,1436,14,1450,1899,0,0,76.36,868,568,鎮興里,NULL
0,1437,13,1450,1813,0,0,79.98,692,745,彌靖村,NULL
0,1433,17,1450,2105,0,0,68.88,577,856,王功村,NULL
603,1436,13,1449,1787,0,0,81.09,1117,319,新南里,NULL
285,1434,15,1449,1831,0,0,79.14,855,579,復興里,NULL
272,1443,6,1449,1877,0,0,77.2,806,637,大武里,NULL
313,1435,14,1449,1930,0,0,75.08,797,638,崇信里,NULL
787,1427,22,1449,1925,0,0,75.27,783,644,西寶村,NULL
136,1438,11,1449,1840,0,0,78.75,704,734,成德里,NULL
22,1433,15,1448,1794,0,0,80.71,944,489,上安里,NULL
26,1437,11,1448,1833,0,0,79,895,542,振華里,NULL
183,1440,8,1448,1828,0,0,79.21,832,608,海山里,NULL
0,1426,22,1448,1869,0,0,77.47,723,703,安慶里,NULL
0,1434,13,1447,1878,0,0,77.05,1104,330,象山村,NULL
240,1434,13,1447,1786,0,0,81.02,855,579,天福里,NULL
308,1433,14,1447,1827,0,0,79.2,808,625,仁德村,NULL
0,1434,13,1447,1900,0,0,76.16,766,668,廣興里,NULL
0,1419,27,1446,1951,0,0,74.12,1093,326,民運里,NULL
0,1427,19,1446,1882,0,0,76.83,1054,373,清泉里,NULL
1571,1440,6,1446,1863,0,0,77.62,910,530,橋東里,NULL
0,1420,26,1446,1842,0,0,78.5,788,632,白地里,NULL
331,1439,7,1446,1863,0,0,77.62,687,752,德仁里,NULL
0,1439,7,1446,1863,0,0,77.62,687,752,德仁里,NULL
0,1427,18,1445,1903,0,0,75.93,1132,295,復興里,NULL
147,1433,12,1445,1879,0,0,76.9,1099,334,中聖里,NULL
156,1429,16,1445,1779,0,0,81.23,883,546,大興里,NULL
1027,1434,11,1445,1904,0,0,75.89,742,692,中誠里,NULL
0,1434,11,1445,1904,0,0,75.89,742,692,中誠里,NULL
0,1423,22,1445,1919,0,0,75.3,676,747,樂成里,NULL
184,1427,17,1444,1846,0,0,78.22,931,496,三和里,NULL
1592,1427,17,1444,1841,0,0,78.44,852,575,北峰里,NULL
413,1437,7,1444,1731,0,0,83.42,835,602,寶國里,NULL
0,1428,16,1444,1792,0,0,80.58,821,607,菜寮里,NULL
525,1433,11,1444,1839,0,0,78.52,801,632,慈祐里,NULL
0,1428,16,1444,1944,0,0,74.28,672,756,豊收村,NULL
734,1428,15,1443,1784,0,0,80.89,1237,191,劍潭里,NULL
3,1433,10,1443,1755,0,0,82.22,1056,377,東平里,NULL
0,1433,10,1443,1755,0,0,82.22,1056,377,東平里,NULL
0,1429,14,1443,1896,0,0,76.11,713,716,隆田村,NULL
816,1427,15,1442,1820,0,0,79.23,970,457,復華里,NULL
350,1429,13,1442,1710,0,0,84.33,902,527,關聖里,NULL
0,1425,16,1441,1824,0,0,79,1173,252,西安里,NULL
209,1426,15,1441,1824,0,0,79,925,501,延平里,NULL
253,1428,13,1441,1851,0,0,77.85,892,536,天山里,NULL
239,1426,15,1441,1863,0,0,77.35,821,605,大忠里,NULL
165,1427,14,1441,1901,0,0,75.8,797,630,新北里,NULL
0,1437,4,1441,1940,0,0,74.28,693,744,瑞吉里,NULL
677,1431,9,1440,1863,0,0,77.29,1166,265,中堅里,NULL
663,1430,10,1440,1803,0,0,79.87,1094,336,中正里,NULL
0,1423,17,1440,2107,0,0,68.34,1093,330,新興村,NULL
406,1429,11,1440,1904,0,0,75.63,897,532,塗城里,NULL
268,1422,18,1440,1937,0,0,74.34,869,553,霄裡里,NULL
0,1422,18,1440,1937,0,0,74.34,869,553,霄裡里,NULL
162,1433,7,1440,1791,0,0,80.4,834,599,菜公里,NULL
272,1427,13,1440,1830,0,0,78.69,603,824,白雪里,NULL
0,1427,13,1440,1830,0,0,78.69,603,824,白雪里,NULL
254,1431,8,1439,1839,0,0,78.25,972,459,天山里,NULL
343,1433,6,1439,1849,0,0,77.83,883,550,中正里,NULL
245,1427,12,1439,1801,0,0,79.9,869,558,大連里,NULL
0,1420,18,1438,1861,0,0,77.27,953,467,崙峯里,NULL
371,1433,5,1438,1795,0,0,80.11,918,515,五分里,NULL
359,1419,19,1438,1750,0,0,82.17,875,544,過田里,NULL
540,1428,10,1438,1834,0,0,78.41,829,599,吉祥里,NULL
0,1421,17,1438,1849,0,0,77.77,673,748,頂崁里,NULL
333,1428,9,1437,1775,0,0,80.96,985,443,碧山里,NULL
152,1418,19,1437,1839,0,0,78.14,837,581,汴洲里,NULL
205,1427,10,1437,1835,0,0,78.31,725,702,龍子里,NULL
1334,1425,11,1436,1762,0,0,81.5,1079,346,樟林里,NULL
170,1427,9,1436,1878,0,0,76.46,990,437,忠義里,NULL
530,1423,13,1436,1778,0,0,80.76,930,493,樹義里,NULL
137,1429,7,1436,1875,0,0,76.59,894,535,新上里,NULL
417,1424,12,1436,1785,0,0,80.45,889,535,公正里,NULL
0,1420,16,1436,1930,0,0,74.4,806,614,柳川里,NULL
412,1420,16,1436,1859,0,0,77.25,672,748,埔心村,NULL
370,1428,7,1435,1769,0,0,81.12,960,468,五分里,NULL
742,1427,8,1435,1819,0,0,78.89,931,496,永安里,NULL
288,1423,12,1435,1776,0,0,80.8,912,511,西安里,NULL
745,1424,11,1435,1779,0,0,80.66,896,528,永安里,NULL
329,1417,18,1435,1802,0,0,79.63,848,569,大智里,NULL
0,1417,18,1435,1899,0,0,75.57,775,642,海濱里,NULL
140,1419,16,1435,1821,0,0,78.8,749,670,成德里,NULL
316,1425,9,1434,1775,0,0,80.79,934,491,紫星里,NULL
34,1419,15,1434,1910,0,0,75.08,898,521,大林里,NULL
0,1419,15,1434,1951,0,0,73.5,850,569,永北村,NULL
328,1417,17,1434,1870,0,0,76.68,783,634,大智里,NULL
148,1428,6,1434,1790,0,0,80.11,759,669,後港里,NULL
0,1419,15,1434,1894,0,0,75.71,643,776,嘉樂村,NULL
102,1419,15,1434,1869,0,0,76.73,639,780,埔崙里,NULL
1616,1424,9,1433,1785,0,0,80.28,1071,353,湖光里,NULL
1144,1427,6,1433,1806,0,0,79.35,1041,386,新龍里,NULL
1226,1419,14,1433,1860,0,0,77.04,982,437,華聲里,NULL
914,1421,12,1433,1793,0,0,79.92,952,469,下溪里,NULL
632,1418,15,1433,1827,0,0,78.43,937,481,明德里,NULL
0,1422,11,1433,1819,0,0,78.78,882,540,華福里,NULL
403,1415,18,1433,1801,0,0,79.57,844,571,德光里,NULL
40,1423,10,1433,1892,0,0,75.74,835,588,翠屏里,NULL
0,1413,20,1433,1823,0,0,78.61,820,593,南寧里,NULL
51,1420,13,1433,1844,0,0,77.71,799,621,南佃里,NULL
0,1420,13,1433,1844,0,0,77.71,799,621,南佃里,NULL
0,1416,17,1433,2101,0,0,68.21,799,617,建平村,NULL
218,1423,10,1433,1845,0,0,77.67,779,644,億載里,NULL
0,1423,10,1433,1845,0,0,77.67,779,644,億載里,NULL
785,1422,11,1433,1803,0,0,79.48,765,657,江山里,NULL
0,1422,11,1433,1984,0,0,72.23,715,707,吉洋里,NULL
0,1420,13,1433,1844,0,0,77.71,647,773,彰南里,NULL
918,1425,7,1432,1735,0,0,82.54,1165,260,建林村,NULL
625,1422,10,1432,1724,0,0,83.06,1022,400,富臺里,NULL
562,1418,14,1432,1756,0,0,81.55,1015,403,連城里,NULL
600,1420,12,1432,1739,0,0,82.35,998,422,新南里,NULL
225,1417,15,1432,1980,0,0,72.32,982,435,長安里,NULL
0,1417,15,1432,1980,0,0,72.32,982,435,長安里,NULL
330,1423,9,1432,1780,0,0,80.45,885,538,金瑞里,NULL
211,1422,10,1432,1787,0,0,80.13,757,665,德行里,NULL
0,1420,12,1432,1993,0,0,71.85,725,695,新埤村,NULL
752,1419,13,1432,1868,0,0,76.66,660,759,草衙里,NULL
423,1422,9,1431,1758,0,0,81.4,1017,405,九如里,NULL
1296,1412,19,1431,1910,0,0,74.92,921,491,員潭里,NULL
550,1419,12,1431,1777,0,0,80.53,902,517,復盛里,NULL
241,1422,9,1431,1737,0,0,82.38,876,546,天福里,NULL
848,1419,12,1431,1796,0,0,79.68,835,584,民權里,NULL
91,1409,22,1431,1998,0,0,71.62,809,600,太保里,NULL
0,1409,22,1431,1998,0,0,71.62,809,600,太保里,NULL
119,1410,21,1431,1834,0,0,78.03,806,604,永定里,NULL
0,1406,25,1431,1921,0,0,74.49,754,652,光大里,NULL
0,1418,13,1431,1830,0,0,78.2,737,681,振興里,NULL
112,1421,10,1431,1832,0,0,78.11,664,757,一德里,NULL
847,1417,13,1430,1744,0,0,82,998,419,秀朗里,NULL
234,1419,11,1430,1898,0,0,75.34,959,460,軍功里,NULL
67,1420,10,1430,2484,0,0,57.57,952,468,龍鳳里,NULL
851,1417,13,1430,1748,0,0,81.81,930,487,秀林里,NULL
0,1411,19,1430,1795,0,0,79.67,927,484,大肚村,NULL
248,1425,5,1430,1844,0,0,77.55,908,517,大連里,NULL
1239,1421,9,1430,1728,0,0,82.75,906,515,景行里,NULL
224,1424,6,1430,1932,0,0,74.02,723,701,嘉興里,NULL
0,1424,6,1430,1932,0,0,74.02,723,701,嘉興里,NULL
412,1419,11,1430,1893,0,0,75.54,694,725,和美村,NULL
919,1409,20,1429,1769,0,0,80.78,1133,276,富林村,NULL
424,1426,3,1429,1735,0,0,82.36,1098,328,九如里,NULL
513,1415,14,1429,1751,0,0,81.61,974,441,信義里,NULL
236,1422,7,1429,1818,0,0,78.6,923,499,平田里,NULL
364,1421,8,1429,1763,0,0,81.06,906,515,鼎泰里,NULL
155,1420,9,1429,1754,0,0,81.47,785,635,菜公里,NULL
718,1414,15,1429,1815,0,0,78.73,671,743,集英里,NULL
0,1408,21,1429,2016,0,0,70.88,648,760,國姓里,NULL
97,1418,10,1428,1801,0,0,79.29,979,439,福恩里,NULL
123,1420,8,1428,1758,0,0,81.23,950,470,新埔里,NULL
0,1410,18,1428,2140,0,0,66.73,855,555,賓朗村,NULL
794,1419,9,1428,1852,0,0,77.11,823,596,興亞里,NULL
142,1417,11,1428,1794,0,0,79.6,750,667,新上里,NULL
0,1413,14,1427,1861,0,0,76.68,1022,391,廣福村,NULL
380,1414,13,1427,1765,0,0,80.85,776,638,田安里,NULL
0,1415,12,1427,1828,0,0,78.06,744,671,墩西村,NULL
0,1406,21,1427,1872,0,0,76.23,722,684,富福里,NULL
0,1413,14,1427,1864,0,0,76.56,643,770,宮前村,NULL
891,1416,10,1426,1765,0,0,80.79,1085,331,雙和里,NULL
369,1421,5,1426,1718,0,0,83,936,485,鼎泰里,NULL
366,1413,13,1426,1869,0,0,76.3,890,523,長青里,NULL
520,1413,13,1426,1766,0,0,80.75,843,570,新福里,NULL
0,1412,14,1426,1986,0,0,71.8,803,609,興農里,NULL
372,1415,11,1426,1822,0,0,78.27,797,618,五分里,NULL
206,1408,18,1426,1823,0,0,78.22,752,656,大坑里,NULL
0,1408,18,1426,1823,0,0,78.22,752,656,大坑里,NULL
32,1414,12,1426,1777,0,0,80.25,608,806,瑞屏里,NULL
804,1410,15,1425,1762,0,0,80.87,1023,387,竹林里,NULL
749,1415,10,1425,1753,0,0,81.29,941,474,金泰里,NULL
522,1402,23,1425,1745,0,0,81.66,859,543,永興里,NULL
432,1420,5,1425,1845,0,0,77.24,839,581,金城里,NULL
565,1417,8,1425,1840,0,0,77.45,793,624,西安里,NULL
793,1410,15,1425,1878,0,0,75.88,791,619,大楓村,NULL
360,1408,17,1425,1775,0,0,80.28,673,735,鼎泰里,NULL
2150,1416,8,1424,1832,0,0,77.73,865,551,龍源村,NULL
192,1414,10,1424,1780,0,0,80,856,558,水景里,NULL
1043,1414,10,1424,1788,0,0,79.64,843,571,中隆里,NULL
128,1414,10,1424,1789,0,0,79.6,769,645,新下里,NULL
268,1401,23,1424,1989,0,0,71.59,722,679,三和里,NULL
0,1401,23,1424,1989,0,0,71.59,722,679,三和里,NULL
0,1410,13,1423,1906,0,0,74.66,926,484,通明里,NULL
249,1417,6,1423,1767,0,0,80.53,864,553,大連里,NULL
141,1413,10,1423,1767,0,0,80.53,830,583,新上里,NULL
0,1411,12,1423,1903,0,0,74.78,715,696,垂楊里,NULL
0,1414,9,1423,1903,0,0,74.78,667,747,胡厝里,NULL
0,1411,12,1423,1811,0,0,78.58,567,844,赤崁村,NULL
178,1411,11,1422,1726,0,0,82.39,967,444,三民里,NULL
258,1416,6,1422,1826,0,0,77.88,894,522,天玉里,NULL
564,1409,13,1422,1782,0,0,79.8,883,526,連城里,NULL
113,1409,13,1422,1836,0,0,77.45,814,595,一德里,NULL
328,1413,9,1422,1984,0,0,71.67,812,601,雲林里,NULL
792,1413,9,1422,1924,0,0,73.91,807,606,大楓村,NULL
0,1411,11,1422,1900,0,0,74.84,759,652,苑東里,NULL
0,1414,7,1421,1865,0,0,76.19,1008,406,東光里,NULL
373,1411,10,1421,2133,0,0,66.62,961,450,三民里,NULL
0,1411,10,1421,2133,0,0,66.62,961,450,三民里,NULL
366,1416,5,1421,1757,0,0,80.88,893,523,鼎泰里,NULL
2160,1409,12,1421,1936,0,0,73.4,847,562,舊城村,NULL
0,1409,12,1421,1826,0,0,77.82,839,570,泰友村,NULL
645,1410,11,1421,1877,0,0,75.71,816,594,大埔里,NULL
0,1410,11,1421,1877,0,0,75.71,816,594,大埔里,NULL
395,1413,8,1421,1913,0,0,74.28,725,688,大同里,NULL
1060,1412,8,1420,1692,0,0,83.92,1312,100,新忠里,NULL
790,1411,9,1420,1800,0,0,78.89,999,412,忠純里,NULL
1225,1410,10,1420,1788,0,0,79.42,953,457,華聲里,NULL
1206,1410,10,1420,1751,0,0,81.1,950,460,黎孝里,NULL
0,1409,11,1420,1883,0,0,75.41,934,475,廣興村,NULL
584,1401,19,1420,1796,0,0,79.06,807,594,豐田里,NULL
517,1408,12,1420,1756,0,0,80.87,763,645,新興里,NULL
0,1408,12,1420,1756,0,0,80.87,763,645,新興里,NULL
0,1407,13,1420,1814,0,0,78.28,739,668,松柏里,NULL
1285,1409,10,1419,1780,0,0,79.72,1025,384,興得里,NULL
790,1412,7,1419,1822,0,0,77.88,885,527,新民里,NULL
0,1404,15,1419,1793,0,0,79.14,769,635,西勢村,NULL
0,1404,15,1419,1813,0,0,78.27,760,644,埔崙村,NULL
1526,1402,17,1419,1924,0,0,73.75,723,679,水河里,NULL
0,1402,17,1419,1935,0,0,73.33,534,868,萬金村,NULL
316,1410,8,1418,1849,0,0,76.69,932,478,潭墘里,NULL
304,1410,8,1418,1809,0,0,78.39,810,600,九德村,NULL
0,1406,12,1418,1931,0,0,73.43,810,596,北勢里,NULL
910,1405,13,1418,1780,0,0,79.66,809,596,永功里,NULL
0,1401,17,1418,1785,0,0,79.44,803,598,萬壽里,NULL
1524,1411,7,1418,1866,0,0,75.99,791,620,水湳里,NULL
0,1409,9,1418,1818,0,0,78,618,791,十美里,NULL
1350,1407,10,1417,1738,0,0,81.53,1029,378,萬芳里,NULL
0,1406,11,1417,2156,0,0,65.72,987,419,後安村,NULL
0,1408,9,1417,1909,0,0,74.23,839,569,永康里,NULL
54,1409,8,1417,1745,0,0,81.2,795,614,立農里,NULL
72,1404,13,1417,1742,0,0,81.34,771,633,裕昌里,NULL
991,1407,10,1417,1737,0,0,81.58,738,669,仁德里,NULL
0,1408,9,1417,1896,0,0,74.74,684,724,三和里,NULL
0,1399,18,1417,1820,0,0,77.86,671,728,新安里,NULL
353,1407,10,1417,1779,0,0,79.65,670,737,鼎力里,NULL
185,1406,11,1417,1761,0,0,80.47,664,742,社子里,NULL
172,1410,6,1416,1872,0,0,75.64,916,494,福山里,NULL
747,1404,12,1416,1730,0,0,81.85,899,505,金泰里,NULL
688,1408,8,1416,1857,0,0,76.25,678,730,店鎮里,NULL
221,1402,14,1416,1881,0,0,75.28,581,821,柳鄉村,NULL
0,1402,14,1416,1881,0,0,75.28,581,821,柳鄉村,NULL
1191,1398,17,1415,1790,0,0,79.05,1107,291,福民里,NULL
1288,1404,11,1415,1794,0,0,78.87,1033,371,華城里,NULL
0,1404,11,1415,1794,0,0,78.87,1033,371,華城里,NULL
528,1398,17,1415,1735,0,0,81.56,851,547,安平里,NULL
400,1403,12,1415,1789,0,0,79.09,719,684,寶泰里,NULL
754,1404,11,1415,1893,0,0,74.75,585,819,草衙里,NULL
2251,1403,11,1414,1850,0,0,76.43,977,426,烏來村,NULL
0,1403,11,1414,1850,0,0,76.43,977,426,烏來村,NULL
59,1402,12,1414,1797,0,0,78.69,830,572,詔安里,NULL
0,1402,12,1414,1797,0,0,78.69,830,572,詔安里,NULL
418,1405,9,1414,1934,0,0,73.11,809,596,菓林村,NULL
536,1399,14,1413,1703,0,0,82.97,1327,72,自立里,NULL
1557,1402,11,1413,1782,0,0,79.29,933,469,復興里,NULL
365,1404,9,1413,1718,0,0,82.25,917,487,鼎泰里,NULL
76,1405,8,1413,1935,0,0,73.02,913,492,大東村,NULL
0,1403,10,1413,1813,0,0,77.94,774,629,平元里,NULL
100,1401,11,1412,1736,0,0,81.34,1008,393,莒光里,NULL
0,1401,11,1412,1736,0,0,81.34,1008,393,莒光里,NULL
281,1392,20,1412,1811,0,0,77.97,907,485,陳平里,NULL
909,1396,16,1412,1772,0,0,79.68,872,524,保順里,NULL
438,1395,17,1412,1814,0,0,77.84,773,622,立德里,NULL
495,1400,12,1412,1852,0,0,76.24,733,667,國光里,NULL
1154,1399,12,1411,1751,0,0,80.58,1024,375,龍生里,NULL
964,1399,12,1411,1780,0,0,79.27,930,469,三愛里,NULL
98,1400,11,1411,1737,0,0,81.23,890,510,智仁里,NULL
130,1403,8,1411,1750,0,0,80.63,882,521,新下里,NULL
151,1399,12,1411,1750,0,0,80.63,838,561,新光里,NULL
962,1397,14,1411,1841,0,0,76.64,780,617,福興里,NULL
0,1401,10,1411,1939,0,0,72.77,548,853,長安里,NULL
328,1400,10,1410,1745,0,0,80.8,879,521,金瑞里,NULL
12,1396,14,1410,1721,0,0,81.93,862,534,成功里,NULL
257,1396,14,1410,1779,0,0,79.26,861,535,天玉里,NULL
236,1395,15,1410,1837,0,0,76.76,821,574,大林里,NULL
0,1395,15,1410,1837,0,0,76.76,821,574,大林里,NULL
61,1393,17,1410,1801,0,0,78.29,707,686,大河里,NULL
0,1397,13,1410,2022,0,0,69.73,682,715,振興里,NULL
0,1398,12,1410,1870,0,0,75.4,509,889,永寧里,NULL
0,1398,12,1410,1889,0,0,74.64,498,900,富田村,NULL
0,1394,15,1409,2107,0,0,66.87,932,462,介壽里,NULL
0,1395,14,1409,1853,0,0,76.04,864,531,粵寧里,NULL
29,1389,20,1409,1770,0,0,79.6,763,626,永和里,NULL
0,1390,19,1409,1865,0,0,75.55,716,674,仁德里,NULL
51,1400,9,1409,1921,0,0,73.35,582,818,海東里,NULL
212,1397,12,1409,1882,0,0,74.87,562,835,龍德村,NULL
0,1397,12,1409,1882,0,0,74.87,562,835,龍德村,NULL
664,1393,15,1408,1817,0,0,77.49,1116,277,中山里,NULL
776,1395,13,1408,1704,0,0,82.63,921,474,生明里,NULL
0,1395,13,1408,1704,0,0,82.63,921,474,生明里,NULL
224,1401,7,1408,1943,0,0,72.47,865,536,堵南里,NULL
0,1401,7,1408,1943,0,0,72.47,865,536,堵南里,NULL
675,1400,8,1408,1757,0,0,80.14,856,544,港口里,NULL
844,1390,18,1408,1777,0,0,79.23,823,567,栗林村,NULL
1505,1390,18,1408,1826,0,0,77.11,773,617,仁復里,NULL
0,1390,18,1408,1826,0,0,77.11,773,617,仁復里,NULL
611,1396,12,1408,1854,0,0,75.94,749,647,永吉里,NULL
0,1386,22,1408,1878,0,0,74.97,738,648,慶東里,NULL
22,1394,14,1408,1738,0,0,81.01,705,689,惠民里,NULL
461,1399,9,1408,1759,0,0,80.05,680,719,正順里,NULL
286,1394,14,1408,1800,0,0,78.22,614,780,川東里,NULL
0,1394,14,1408,1800,0,0,78.22,614,780,川東里,NULL
536,1396,11,1407,1729,0,0,81.38,1304,92,自強里,NULL
607,1395,12,1407,1868,0,0,75.32,905,490,大橋村,NULL
0,1395,12,1407,1868,0,0,75.32,905,490,大橋村,NULL
176,1402,5,1407,1827,0,0,77.01,887,515,福山里,NULL
709,1399,8,1407,1844,0,0,76.3,799,600,濟南里,NULL
81,1393,14,1407,1777,0,0,79.18,736,657,溫泉里,NULL
0,1393,14,1407,1825,0,0,77.1,690,703,溪北里,NULL
1247,1392,14,1406,1775,0,0,79.21,1011,381,景慶里,NULL
41,1398,8,1406,1761,0,0,79.84,945,453,吉利里,NULL
1895,1403,3,1406,1765,0,0,79.66,921,482,鄧公里,NULL
0,1387,19,1406,1849,0,0,76.04,839,548,下寮里,NULL
640,1396,10,1406,1783,0,0,78.86,784,612,正心里,NULL
0,1395,11,1406,1796,0,0,78.29,728,667,錦田里,NULL
365,1396,10,1406,1884,0,0,74.63,671,725,山中村,NULL
171,1398,7,1405,1837,0,0,76.48,970,428,外寮里,NULL
72,1386,19,1405,1763,0,0,79.69,902,484,糖友里,NULL
1075,1396,9,1405,1833,0,0,76.65,854,542,雙鳳里,NULL
368,1388,17,1405,1987,0,0,70.71,789,599,長興村,NULL
0,1388,17,1405,1987,0,0,70.71,789,599,長興村,NULL
0,1396,9,1405,1860,0,0,75.54,418,978,下廍里,NULL
1190,1390,14,1404,1714,0,0,81.91,1156,234,福民里,NULL
1110,1397,7,1404,1746,0,0,80.41,1055,342,龍坡里,NULL
1153,1399,5,1404,1786,0,0,78.61,1026,373,龍生里,NULL
18,1399,5,1404,2029,0,0,69.2,973,426,中正里,NULL
0,1399,5,1404,2029,0,0,69.2,973,426,中正里,NULL
835,1395,9,1404,1687,0,0,83.22,931,464,秀和里,NULL
315,1384,20,1404,1840,0,0,76.3,926,458,潭墘里,NULL
744,1395,9,1404,1796,0,0,78.17,894,501,永安里,NULL
1567,1396,8,1404,1796,0,0,78.17,852,544,崇德里,NULL
1607,1391,13,1404,1843,0,0,76.18,749,642,中興里,NULL
23,1395,9,1404,1854,0,0,75.73,735,660,惠豐里,NULL
996,1387,17,1404,1768,0,0,79.41,716,671,思賢里,NULL
0,1397,7,1404,1878,0,0,74.76,463,934,明宜里,NULL
154,1396,7,1403,1708,0,0,82.14,970,426,四維里,NULL
1362,1398,5,1403,1728,0,0,81.19,968,430,萬興里,NULL
0,1387,16,1403,1801,0,0,77.9,954,433,東新里,NULL
1260,1387,16,1403,1782,0,0,78.73,911,476,德安里,NULL
111,1395,8,1403,1878,0,0,74.71,823,572,廖厝里,NULL
553,1389,14,1403,1809,0,0,77.56,802,587,中正里,NULL
1591,1385,18,1403,1821,0,0,77.05,773,612,北峰里,NULL
531,1391,12,1403,1771,0,0,79.22,756,635,安平里,NULL
495,1398,5,1403,1875,0,0,74.83,648,750,船頭里,NULL
195,1398,4,1402,1620,0,0,86.54,1357,41,陸光村,NULL
0,1381,21,1402,1801,0,0,77.85,981,400,旱坑里,NULL
446,1395,7,1402,1720,0,0,81.51,921,474,合成里,NULL
0,1388,14,1402,2147,0,0,65.3,882,506,西文里,NULL
693,1385,17,1402,1854,0,0,75.62,831,554,永南村,NULL
0,1385,17,1402,1854,0,0,75.62,831,554,永南村,NULL
140,1391,11,1402,1745,0,0,80.34,795,596,新上里,NULL
861,1389,13,1402,1795,0,0,78.11,738,651,國慶里,NULL
362,1391,11,1402,1798,0,0,77.98,642,749,福興村,NULL
0,1391,11,1402,1798,0,0,77.98,642,749,福興村,NULL
0,1390,12,1402,1965,0,0,71.35,626,764,田尾村,NULL
0,1388,14,1402,1848,0,0,75.87,517,871,蘇厝村,NULL
808,1386,15,1401,1737,0,0,80.66,1211,175,忠義村,NULL
537,1393,8,1401,1734,0,0,80.8,1208,185,自強里,NULL
0,1383,18,1401,1818,0,0,77.06,1006,377,石光里,NULL
122,1392,9,1401,1804,0,0,77.66,933,459,德安里,NULL
229,1388,13,1401,1889,0,0,74.17,852,536,國平里,NULL
1500,1386,15,1401,1857,0,0,75.44,812,574,恆德里,NULL
1048,1389,12,1401,1746,0,0,80.24,697,692,華中里,NULL
981,1395,6,1401,1800,0,0,77.83,684,711,菜園里,NULL
907,1377,23,1400,1811,0,0,77.31,1058,319,中興村,NULL
43,1387,13,1400,1731,0,0,80.88,970,417,吉利里,NULL
568,1395,5,1400,1796,0,0,77.95,942,453,復建里,NULL
150,1392,8,1400,1688,0,0,82.94,857,535,新光里,NULL
546,1390,10,1400,1729,0,0,80.97,855,535,新聚里,NULL
374,1390,10,1400,1858,0,0,75.35,851,539,平和里,NULL
0,1390,10,1400,1858,0,0,75.35,851,539,平和里,NULL
361,1395,5,1400,1744,0,0,80.28,580,815,鼎泰里,NULL
0,1384,16,1400,1978,0,0,70.78,504,880,水南村,NULL
125,1389,10,1399,1709,0,0,81.86,1235,154,果峰里,NULL
0,1389,10,1399,1709,0,0,81.86,1235,154,果峰里,NULL
662,1386,13,1399,1811,0,0,77.25,1108,278,中正里,NULL
344,1392,7,1399,1715,0,0,81.57,1012,380,葫洲里,NULL
103,1394,5,1399,1732,0,0,80.77,1000,394,雲林里,NULL
11,1390,9,1399,1728,0,0,80.96,925,465,成功里,NULL
104,1390,9,1399,1739,0,0,80.45,878,512,豐年里,NULL
250,1381,18,1399,1846,0,0,75.79,845,536,新庄村,NULL
1019,1382,17,1399,1716,0,0,81.53,745,637,立志里,NULL
0,1388,11,1399,1885,0,0,74.22,495,893,玉田村,NULL
92,1394,4,1398,1758,0,0,79.52,868,526,開明里,NULL
101,1388,10,1398,1821,0,0,76.77,641,747,埔崙里,NULL
0,1384,14,1398,2068,0,0,67.6,521,863,真理村,NULL
0,1391,6,1397,2574,0,0,54.27,1308,83,湖埔村,NULL
171,1375,22,1397,1852,0,0,75.43,921,454,忠義里,NULL
199,1382,15,1397,1824,0,0,76.59,860,522,福源村,NULL
0,1382,15,1397,1824,0,0,76.59,860,522,福源村,NULL
77,1386,11,1397,1869,0,0,74.75,805,581,長安里,NULL
806,1383,14,1397,1847,0,0,75.64,787,596,橫山村,NULL
197,1377,20,1397,1835,0,0,76.13,722,655,水上村,NULL
223,1387,10,1397,1888,0,0,73.99,645,742,寬士村,NULL
1602,1391,5,1396,1813,0,0,77,961,430,厚德里,NULL
68,1390,6,1396,1873,0,0,74.53,884,506,林泉里,NULL
0,1390,6,1396,1873,0,0,74.53,884,506,林泉里,NULL
91,1381,15,1396,1763,0,0,79.18,807,574,開明里,NULL
82,1386,10,1396,1817,0,0,76.83,797,589,東山里,NULL
0,1386,10,1396,1817,0,0,76.83,797,589,東山里,NULL
14,1384,12,1396,1869,0,0,74.69,787,597,社寮里,NULL
0,1384,12,1396,1869,0,0,74.69,787,597,社寮里,NULL
164,1384,12,1396,1861,0,0,75.01,784,600,新北里,NULL
447,1375,21,1396,1782,0,0,78.34,682,693,保庄里,NULL
719,1380,16,1396,1801,0,0,77.51,582,798,高松里,NULL
541,1391,4,1395,1803,0,0,77.37,984,407,吉祥里,NULL
472,1385,10,1395,1769,0,0,78.86,927,458,東榮里,NULL
0,1387,8,1395,1858,0,0,75.08,880,507,面前里,NULL
848,1384,11,1395,1820,0,0,76.65,859,525,嘉仁村,NULL
1026,1383,12,1395,1740,0,0,80.17,802,581,全德里,NULL
734,1382,13,1395,1863,0,0,74.88,735,647,公館村,NULL
0,1382,13,1395,1863,0,0,74.88,735,647,公館村,NULL
454,1378,17,1395,1761,0,0,79.22,719,659,太平里,NULL
341,1381,14,1395,1771,0,0,78.77,713,668,新莊村,NULL
2,1391,4,1395,1728,0,0,80.73,706,685,建民里,NULL
0,1376,19,1395,1777,0,0,78.5,683,693,二重里,NULL
816,1384,10,1394,1771,0,0,78.71,1053,331,楊明里,NULL
216,1380,14,1394,1792,0,0,77.79,855,525,南興里,NULL
1523,1386,8,1394,1758,0,0,79.29,748,638,水湳里,NULL
19,1388,6,1394,1690,0,0,82.49,673,715,中德里,NULL
0,1384,10,1394,1917,0,0,72.72,663,721,保障村,NULL
295,1386,7,1393,1723,0,0,80.85,1224,162,文莊里,NULL
1558,1378,15,1393,1721,0,0,80.94,953,425,復興里,NULL
65,1383,10,1393,1659,0,0,83.97,949,434,慶昌里,NULL
506,1379,14,1393,1877,0,0,74.21,945,434,新榮里,NULL
148,1374,19,1393,1725,0,0,80.75,793,581,田心里,NULL
316,1376,17,1393,1772,0,0,78.61,727,649,東園村,NULL
0,1376,17,1393,1772,0,0,78.61,727,649,東園村,NULL
1450,1383,10,1393,1735,0,0,80.29,716,667,中路里,NULL
0,1384,9,1393,1850,0,0,75.3,686,698,人和里,NULL
1332,1383,9,1392,1671,0,0,83.3,1199,184,長風里,NULL
0,1383,9,1392,1671,0,0,83.3,1199,184,長風里,NULL
0,1377,15,1392,1896,0,0,73.42,1008,369,波羅村,NULL
833,1381,11,1392,1789,0,0,77.81,834,547,甘蔗村,NULL
324,1378,14,1392,1817,0,0,76.61,832,546,吉峰村,NULL
133,1380,12,1392,1884,0,0,73.89,784,596,橋頭里,NULL
157,1377,15,1392,1748,0,0,79.63,755,622,懷翠里,NULL
167,1382,10,1392,1726,0,0,80.65,719,663,福華里,NULL
505,1384,7,1391,1727,0,0,80.54,1072,312,龍田里,NULL
645,1382,9,1391,1732,0,0,80.31,1056,326,仁美里,NULL
1292,1384,7,1391,1687,0,0,82.45,1051,333,興安里,NULL
362,1387,4,1391,1679,0,0,82.85,1039,348,瑞陽里,NULL
402,1377,14,1391,1687,0,0,82.45,830,547,湖興里,NULL
0,1383,8,1391,1889,0,0,73.64,814,569,興南里,NULL
409,1379,12,1391,1919,0,0,72.49,790,589,塗城里,NULL
193,1374,17,1391,1782,0,0,78.06,746,628,水景里,NULL
230,1381,10,1391,1774,0,0,78.41,733,648,建平里,NULL
0,1382,9,1391,1736,0,0,80.13,722,660,興昌里,NULL
63,1379,12,1391,1811,0,0,76.81,587,792,國安里,NULL
0,1379,12,1391,1811,0,0,76.81,587,792,國安里,NULL
1115,1377,13,1390,1779,0,0,78.13,921,456,古風里,NULL
64,1382,8,1390,1774,0,0,78.35,857,525,奇岩里,NULL
138,1379,11,1390,1680,0,0,82.74,855,524,新上里,NULL
317,1373,17,1390,1698,0,0,81.86,851,522,紫星里,NULL
401,1380,10,1390,1819,0,0,76.42,766,614,仁德里,NULL
412,1380,10,1390,1770,0,0,78.53,742,638,中興里,NULL
736,1379,11,1390,1820,0,0,76.37,677,702,桂林里,NULL
132,1379,11,1390,1699,0,0,81.81,632,747,新上里,NULL
753,1375,15,1390,1878,0,0,74.01,600,775,草衙里,NULL
675,1374,15,1389,1724,0,0,80.57,919,455,和興里,NULL
56,1383,6,1389,1730,0,0,80.29,808,575,立農里,NULL
850,1371,18,1389,1782,0,0,77.95,666,705,聚興村,NULL
0,1380,9,1389,1887,0,0,73.61,623,757,尚義村,NULL
0,1371,17,1388,1757,0,0,79,1046,325,民權里,NULL
618,1375,13,1388,1807,0,0,76.81,884,491,正義里,NULL
140,1372,16,1388,1687,0,0,82.28,884,488,三厝里,NULL
535,1379,8,1387,1613,0,0,85.99,1343,36,自立里,NULL
242,1376,11,1387,1675,0,0,82.81,1099,277,營北里,NULL
0,1375,12,1387,1703,0,0,81.44,1021,354,上苗里,NULL
606,1379,8,1387,1676,0,0,82.76,1001,378,南山里,NULL
815,1380,7,1387,1787,0,0,77.62,964,416,復華里,NULL
1863,1377,10,1387,1724,0,0,80.45,917,460,竹圍里,NULL
3,1373,14,1387,1800,0,0,77.06,873,500,明正里,NULL
305,1373,14,1387,1774,0,0,78.18,789,584,九德村,NULL
412,1369,18,1387,1820,0,0,76.21,731,638,中南里,NULL
0,1377,10,1387,1802,0,0,76.97,453,924,中芸村,NULL
1146,1379,7,1386,1734,0,0,79.93,1071,308,新龍里,NULL
130,1376,10,1386,1746,0,0,79.38,1008,368,中泰里,NULL
567,1374,12,1386,1739,0,0,79.7,956,418,復建里,NULL
116,1378,8,1386,1741,0,0,79.61,949,429,中原里,NULL
1327,1377,9,1386,1699,0,0,81.58,945,432,木新里,NULL
473,1374,12,1386,1787,0,0,77.56,909,465,東榮里,NULL
1229,1369,17,1386,1790,0,0,77.43,876,493,車層里,NULL
786,1374,12,1386,1770,0,0,78.31,810,564,四德村,NULL
427,1367,19,1386,1853,0,0,74.8,773,594,忠誠里,NULL
0,1368,18,1386,2063,0,0,67.18,747,621,城北里,NULL
120,1372,14,1386,1829,0,0,75.78,703,669,永定里,NULL
586,1365,21,1386,1746,0,0,79.38,674,691,豐田里,NULL
0,1371,15,1386,1828,0,0,75.82,638,733,NA,NULL
450,1380,6,1386,1724,0,0,80.39,606,774,灣利里,NULL
1858,1375,10,1385,1788,0,0,77.46,1007,368,福德里,NULL
847,1371,14,1385,1916,0,0,72.29,967,404,三湖里,NULL
794,1378,7,1385,1701,0,0,81.42,820,558,西山里,NULL
461,1378,7,1385,1844,0,0,75.11,805,573,仁善里,NULL
58,1374,11,1385,1714,0,0,80.81,792,582,興昌里,NULL
209,1379,6,1385,1757,0,0,78.83,791,588,龍子里,NULL
0,1369,16,1385,1895,0,0,73.09,670,699,永光村,NULL
0,1375,9,1384,1925,0,0,71.9,927,448,福聯里,NULL
121,1367,17,1384,1871,0,0,73.97,851,516,頭南里,NULL
0,1367,17,1384,1871,0,0,73.97,851,516,頭南里,NULL
743,1372,12,1384,1725,0,0,80.23,846,526,永安里,NULL
638,1370,14,1384,1872,0,0,73.93,835,535,大南村,NULL
0,1370,14,1384,1872,0,0,73.93,835,535,大南村,NULL
412,1375,9,1384,1709,0,0,80.98,800,575,東興里,NULL
148,1373,11,1384,1700,0,0,81.41,723,650,新光里,NULL
717,1380,4,1384,1861,0,0,74.37,661,719,山明里,NULL
0,1373,10,1383,2407,3087,77.97,57.46,1241,132,綠島鄉,Green Island Township
766,1372,11,1383,1690,0,0,81.83,1022,350,安平里,NULL
111,1366,17,1383,1858,0,0,74.43,963,403,慶豐村,NULL
11,1369,14,1383,1831,0,0,75.53,908,461,泉州村,NULL
0,1369,14,1383,1831,0,0,75.53,908,461,泉州村,NULL
387,1369,14,1383,1821,0,0,75.95,882,487,忠孝里,NULL
428,1367,16,1383,1720,0,0,80.41,854,513,長榮里,NULL
39,1369,14,1383,1730,0,0,79.94,853,516,中興里,NULL
431,1371,12,1383,1740,0,0,79.48,828,543,東新里,NULL
768,1366,17,1383,1730,0,0,79.94,743,623,行政里,NULL
362,1374,9,1383,1721,0,0,80.36,658,716,鼎泰里,NULL
26,1368,14,1382,1733,0,0,79.75,1058,310,竹北里,NULL
8,1375,7,1382,1855,0,0,74.5,950,425,福安里,NULL
25,1375,7,1382,1705,0,0,81.06,910,465,振華里,NULL
541,1376,6,1382,1764,0,0,78.34,857,519,西川里,NULL
191,1367,15,1382,1779,0,0,77.68,836,531,玉光里,NULL
614,1375,7,1382,1726,0,0,80.07,809,566,翁明里,NULL
0,1375,7,1382,1726,0,0,80.07,809,566,翁明里,NULL
156,1362,20,1382,1809,0,0,76.4,700,662,懷翠里,NULL
569,1375,7,1382,1773,0,0,77.95,631,744,內厝里,NULL
37,1371,11,1382,1864,0,0,74.14,530,841,長安里,NULL
1337,1373,8,1381,1674,0,0,82.5,1027,346,樟林里,NULL
462,1368,13,1381,1825,0,0,75.67,991,377,仁善里,NULL
112,1370,11,1381,1758,0,0,78.56,938,432,實踐里,NULL
0,1370,11,1381,1758,0,0,78.56,938,432,實踐里,NULL
24,1367,14,1381,1670,0,0,82.69,930,437,新崙里,NULL
0,1361,20,1381,1877,0,0,73.57,926,435,中嵙里,NULL
543,1374,7,1381,1705,0,0,81,916,458,吉祥里,NULL
368,1374,7,1381,1677,0,0,82.35,886,488,鼎泰里,NULL
383,1371,10,1381,1710,0,0,80.76,834,537,樂康里,NULL
37,1371,10,1381,1720,0,0,80.29,727,644,中興里,NULL
351,1363,18,1381,1719,0,0,80.34,595,768,蘆竹村,NULL
0,1374,6,1380,1760,0,0,78.41,1098,276,珊湖里,NULL
405,1375,5,1380,1742,0,0,79.22,1014,361,湖興里,NULL
375,1371,9,1380,1773,0,0,77.83,966,405,利民里,NULL
0,1371,9,1380,1773,0,0,77.83,966,405,利民里,NULL
336,1370,10,1380,1771,0,0,77.92,893,477,本堂村,NULL
583,1364,16,1380,1708,0,0,80.8,834,530,福善里,NULL
363,1369,11,1380,1742,0,0,79.22,798,571,鼎泰里,NULL
0,1364,16,1380,1900,0,0,72.63,623,741,東平里,NULL
598,1364,16,1380,1745,0,0,79.08,434,930,月眉里,NULL
736,1356,23,1379,1647,0,0,83.73,1171,185,壽德里,NULL
600,1367,12,1379,1775,0,0,77.69,1055,312,忠孝里,NULL
365,1367,12,1379,1614,0,0,85.44,1014,353,瑞陽里,NULL
406,1373,6,1379,1728,0,0,79.8,798,575,橫峰村,NULL
416,1367,12,1379,1749,0,0,78.85,793,574,公正里,NULL
1470,1368,11,1379,1721,0,0,80.13,783,585,正義里,NULL
90,1369,10,1379,1736,0,0,79.44,769,600,中庸里,NULL
114,1368,11,1379,1685,0,0,81.84,755,613,德翠里,NULL
1452,1367,12,1379,1764,0,0,78.17,690,677,永安里,NULL
350,1365,14,1379,1733,0,0,79.57,569,796,鼎強里,NULL
1307,1365,13,1378,1691,0,0,81.49,1064,301,頂新里,NULL
0,1365,13,1378,1691,0,0,81.49,1064,301,頂新里,NULL
167,1367,11,1378,1690,0,0,81.54,890,477,溝墘里,NULL
0,1367,11,1378,1833,0,0,75.18,655,712,文化里,NULL
776,1359,18,1377,1782,0,0,77.27,1030,329,新安里,NULL
0,1363,14,1377,1755,0,0,78.46,790,573,黎明里,NULL
228,1364,13,1377,1847,0,0,74.55,734,630,中庄村,NULL
0,1364,13,1377,1847,0,0,74.55,734,630,中庄村,NULL
370,1362,15,1377,1675,0,0,82.21,700,662,光陽里,NULL
626,1373,3,1376,1778,0,0,77.39,1098,275,富臺里,NULL
1282,1369,7,1376,1678,0,0,82,1055,314,興家里,NULL
785,1367,9,1376,1765,0,0,77.96,883,484,四德村,NULL
287,1367,9,1376,1677,0,0,82.05,877,490,西安里,NULL
0,1365,11,1376,1979,0,0,69.53,864,501,竹安里,NULL
309,1371,5,1376,1761,0,0,78.14,819,552,崇蘭里,NULL
83,1361,15,1376,1739,0,0,79.13,787,574,溫泉里,NULL
107,1363,13,1376,1855,0,0,74.18,759,604,東崎里,NULL
207,1369,7,1376,1795,0,0,76.66,753,616,三星里,NULL
820,1368,8,1376,1638,0,0,84,742,626,瑞祥里,NULL
0,1367,8,1375,1733,0,0,79.34,1101,266,神洲里,NULL
1321,1369,6,1375,1664,0,0,82.63,990,379,木柵里,NULL
0,1366,9,1375,1703,0,0,80.74,939,427,信義里,NULL
93,1366,9,1375,1777,0,0,77.38,885,481,開明里,NULL
149,1356,19,1375,1759,0,0,78.17,868,488,龍壽里,NULL
329,1368,7,1375,1703,0,0,80.74,855,513,華山里,NULL
1074,1360,15,1375,1860,0,0,73.92,821,539,雙鳳里,NULL
0,1371,4,1375,1860,0,0,73.92,803,568,廈粘村,NULL
758,1353,22,1375,1721,0,0,79.9,742,611,松江里,NULL
229,1353,22,1375,1886,0,0,72.91,742,611,忠和村,NULL
0,1353,22,1375,1886,0,0,72.91,742,611,忠和村,NULL
692,1356,19,1375,1780,0,0,77.25,623,733,二苓里,NULL
755,1362,13,1375,1802,0,0,76.3,607,755,草衙里,NULL
34,1367,7,1374,1920,0,0,71.56,1050,317,光明里,NULL
0,1367,7,1374,1920,0,0,71.56,1050,317,光明里,NULL
425,1363,11,1374,1705,0,0,80.59,767,596,正安里,NULL
0,1363,11,1374,1705,0,0,80.59,767,596,正安里,NULL
0,1361,13,1374,2052,0,0,66.96,696,665,阿勸村,NULL
147,1367,7,1374,1659,0,0,82.82,621,746,新光里,NULL
0,1360,14,1374,1756,0,0,78.25,607,753,東寧里,NULL
3,1357,17,1374,1885,0,0,72.89,582,775,塭南里,NULL
733,1360,13,1373,1688,0,0,81.34,845,515,國光里,NULL
964,1371,2,1373,1739,0,0,78.95,844,527,昌平里,NULL
0,1369,4,1373,1813,0,0,75.73,820,549,內湖里,NULL
273,1358,15,1373,1771,0,0,77.53,757,601,茄苳里,NULL
585,1357,16,1373,1813,0,0,75.73,695,662,豐田里,NULL
0,1358,15,1373,1920,0,0,71.51,629,729,尚德村,NULL
0,1359,14,1373,1876,0,0,73.19,558,801,大溪里,NULL
76,1366,6,1372,1778,0,0,77.17,1133,233,上舘里,NULL
231,1361,11,1372,1796,0,0,76.39,733,628,建平里,NULL
0,1361,11,1372,1760,0,0,77.95,721,640,崇義里,NULL
0,1356,16,1372,1965,0,0,69.82,639,717,三協里,NULL
0,1360,12,1372,1937,0,0,70.83,593,767,復金村,NULL
511,1364,8,1372,1923,0,0,71.35,582,782,水利村,NULL
0,1364,8,1372,1923,0,0,71.35,582,782,水利村,NULL
1332,1359,12,1371,1649,0,0,83.14,1094,265,忠順里,NULL
0,1353,18,1371,1827,0,0,75.04,1038,315,南勢里,NULL
1218,1363,8,1371,1798,0,0,76.25,933,430,敦安里,NULL
677,1363,8,1371,1704,0,0,80.46,894,469,泰和里,NULL
244,1360,11,1371,1731,0,0,79.2,867,493,鄉雲里,NULL
367,1359,12,1371,1733,0,0,79.11,861,498,長青里,NULL
267,1357,14,1371,1735,0,0,79.02,849,508,華興里,NULL
314,1354,17,1371,1785,0,0,76.81,759,595,崑崙里,NULL
779,1354,17,1371,1698,0,0,80.74,702,652,下埤里,NULL
553,1351,20,1371,1748,0,0,78.43,665,686,仁華里,NULL
1573,1360,10,1370,1694,0,0,80.87,958,402,橋東里,NULL
0,1359,11,1370,1933,0,0,70.87,900,459,瑞濱里,NULL
0,1356,14,1370,1816,0,0,75.44,753,603,中寮里,NULL
235,1357,13,1370,1740,0,0,78.74,692,665,平興里,NULL
0,1358,12,1370,1917,0,0,71.47,579,779,利澤村,NULL
0,1356,14,1370,1803,0,0,75.98,472,884,港東村,NULL
541,1355,14,1369,1732,0,0,79.04,894,461,新興里,NULL
248,1356,13,1369,1725,0,0,79.36,881,475,天壽里,NULL
285,1360,9,1369,1733,0,0,79,823,537,大仁里,NULL
82,1358,11,1369,1768,0,0,77.43,813,545,溫泉里,NULL
523,1348,21,1369,1833,0,0,74.69,732,616,頭汴里,NULL
0,1348,21,1369,1833,0,0,74.69,732,616,頭汴里,NULL
0,1354,15,1369,1894,0,0,72.28,552,802,興漁里,NULL
0,1360,9,1369,1907,0,0,71.79,425,935,港後村,NULL
812,1360,8,1368,1764,0,0,77.55,1055,305,金溪里,NULL
1205,1353,15,1368,1643,0,0,83.26,1029,324,黎孝里,NULL
512,1358,10,1368,1679,0,0,81.48,952,406,中華里,NULL
280,1353,15,1368,1743,0,0,78.49,907,446,陳平里,NULL
651,1346,22,1368,1832,0,0,74.67,895,451,三和里,NULL
1198,1353,15,1368,1761,0,0,77.68,867,486,芳和里,NULL
19,1360,8,1368,1705,0,0,80.23,793,567,榮華里,NULL
372,1348,20,1368,1761,0,0,77.68,770,578,新里里,NULL
397,1360,8,1368,1787,0,0,76.55,770,590,仁化里,NULL
2155,1353,15,1368,1784,0,0,76.68,756,597,大崁村,NULL
0,1353,15,1368,1784,0,0,76.68,756,597,大崁村,NULL
1046,1354,14,1368,1711,0,0,79.95,721,633,榮德里,NULL
1028,1357,11,1368,1652,0,0,82.81,719,638,日善里,NULL
391,1357,11,1368,1686,0,0,81.14,699,658,本揚里,NULL
979,1358,10,1368,1822,0,0,75.08,658,700,上大村,NULL
0,1358,10,1368,1822,0,0,75.08,658,700,上大村,NULL
917,1354,13,1367,1661,0,0,82.3,1119,235,建林村,NULL
1357,1359,8,1367,1620,0,0,84.38,997,362,博嘉里,NULL
19,1359,8,1367,1668,0,0,81.95,950,409,斗崙里,NULL
417,1355,12,1367,1692,0,0,80.79,899,456,永隆里,NULL
0,1355,12,1367,1757,0,0,77.8,897,458,上寮里,NULL
1227,1356,11,1367,1826,0,0,74.86,895,461,車層里,NULL
303,1352,15,1367,1715,0,0,79.71,848,504,九德村,NULL
0,1354,13,1367,1836,0,0,74.46,844,510,新建里,NULL
0,1354,13,1367,1736,0,0,78.74,777,577,陽明里,NULL
529,1354,13,1367,1706,0,0,80.13,757,597,安平里,NULL
0,1351,16,1367,1916,0,0,71.35,733,618,中民村,NULL
369,1356,11,1367,1711,0,0,79.89,723,633,光陽里,NULL
0,1353,14,1367,1701,0,0,80.36,715,638,民生里,NULL
6,1348,19,1367,1729,0,0,79.06,706,642,清豐里,NULL
340,1357,10,1367,1737,0,0,78.7,689,668,新莊村,NULL
0,1352,15,1367,1922,0,0,71.12,640,712,舊埤里,NULL
143,1349,17,1366,1994,0,0,68.51,1022,327,仁安村,NULL
0,1349,17,1366,1994,0,0,68.51,1022,327,仁安村,NULL
878,1355,11,1366,1786,0,0,76.48,1020,335,店街里,NULL
806,1355,11,1366,1702,0,0,80.26,1009,346,桂林里,NULL
895,1354,12,1366,1737,0,0,78.64,1003,351,前溪里,NULL
0,1354,12,1366,1737,0,0,78.64,1003,351,前溪里,NULL
1348,1357,9,1366,1666,0,0,81.99,970,387,樟腳里,NULL
78,1359,7,1366,1740,0,0,78.51,936,423,加昌里,NULL
1222,1355,11,1366,1715,0,0,79.65,892,463,敦煌里,NULL
63,1356,10,1366,1742,0,0,78.42,872,484,中山里,NULL
94,1357,9,1366,1678,0,0,81.41,833,524,中和里,NULL
1606,1355,11,1366,1837,0,0,74.36,820,535,中興里,NULL
442,1354,12,1366,1791,0,0,76.27,784,570,新仁里,NULL
773,1351,15,1366,1732,0,0,78.87,766,585,行仁里,NULL
293,1352,14,1366,1791,0,0,76.27,671,681,牛埔里,NULL
203,1358,8,1366,1712,0,0,79.79,497,861,富洲里,NULL
0,1353,12,1365,1753,0,0,77.87,1056,297,錦華里,NULL
272,1358,7,1365,1720,0,0,79.36,965,393,同榮里,NULL
1231,1355,10,1365,1728,0,0,78.99,878,477,光信里,NULL
1168,1354,11,1365,1660,0,0,82.23,869,485,臨江里,NULL
348,1355,10,1365,1753,0,0,77.87,843,512,北勢村,NULL
0,1355,10,1365,1753,0,0,77.87,843,512,北勢村,NULL
104,1356,9,1365,1767,0,0,77.25,767,589,頂厝里,NULL
772,1350,15,1365,1674,0,0,81.54,755,595,行仁里,NULL
410,1358,7,1365,1715,0,0,79.59,736,622,寶國里,NULL
307,1354,11,1365,1879,0,0,72.65,733,621,永安里,NULL
0,1347,18,1365,2084,0,0,65.5,598,749,富甲里,NULL
1288,1357,7,1364,1696,0,0,80.42,1066,291,興業里,NULL
0,1356,8,1364,1709,0,0,79.81,1050,306,双湖村,NULL
1336,1355,9,1364,1680,0,0,81.19,948,407,樟林里,NULL
1070,1350,14,1364,1743,0,0,78.26,942,408,凌霄里,NULL
2027,1351,13,1364,1766,0,0,77.24,881,470,全興村,NULL
392,1357,7,1364,1708,0,0,79.86,748,609,本揚里,NULL
1447,1345,19,1364,1844,0,0,73.97,667,678,光明里,NULL
995,1352,12,1364,1787,0,0,76.33,620,732,柳鄉里,NULL
382,1347,17,1364,1759,0,0,77.54,606,741,崙頂村,NULL
0,1347,17,1364,1759,0,0,77.54,606,741,崙頂村,NULL
0,1353,11,1364,1832,0,0,74.45,587,766,光福村,NULL
0,1353,10,1363,1820,0,0,74.89,1218,135,三和村,NULL
1182,1350,13,1363,1664,0,0,81.91,1096,254,群英里,NULL
202,1355,8,1363,1789,0,0,76.19,1011,344,碇安里,NULL
44,1353,10,1363,1719,0,0,79.29,900,453,龍安里,NULL
114,1350,13,1363,1783,0,0,76.44,888,462,慈文里,NULL
420,1357,6,1363,1605,0,0,84.92,879,478,永隆里,NULL
170,1355,8,1363,1709,0,0,79.75,865,490,福山里,NULL
261,1351,12,1363,1709,0,0,79.75,766,585,興北里,NULL
0,1351,12,1363,1709,0,0,79.75,766,585,興北里,NULL
0,1355,8,1363,1734,0,0,78.6,762,593,朝山里,NULL
793,1352,11,1363,1696,0,0,80.37,691,661,西山里,NULL
0,1353,10,1363,1771,0,0,76.96,628,725,唪口里,NULL
759,1354,9,1363,1801,0,0,75.68,566,788,明正里,NULL
507,1355,8,1363,1752,0,0,77.8,543,812,永樂村,NULL
0,1352,10,1362,1746,0,0,78.01,1014,338,福星村,NULL
934,1351,11,1362,2690,0,0,50.63,935,416,龍福里,NULL
408,1351,11,1362,1726,0,0,78.91,894,457,三平里,NULL
449,1351,11,1362,1659,0,0,82.1,881,470,新光里,NULL
2067,1355,7,1362,1744,0,0,78.1,857,498,南勢村,NULL
333,1354,8,1362,1684,0,0,80.88,851,503,中正村,NULL
0,1354,8,1362,1684,0,0,80.88,851,503,中正村,NULL
107,1355,7,1362,1702,0,0,80.02,833,522,新翠里,NULL
639,1348,14,1362,1712,0,0,79.56,827,521,永福里,NULL
194,1350,12,1362,1809,0,0,75.29,656,694,三合里,NULL
0,1350,12,1362,1809,0,0,75.29,656,694,三合里,NULL
0,1356,6,1362,1849,0,0,73.66,626,730,加祿村,NULL
205,1355,7,1362,1708,0,0,79.74,617,738,東山里,NULL
0,1355,7,1362,1708,0,0,79.74,617,738,東山里,NULL
18,1353,8,1361,1633,0,0,83.34,1044,309,斗崙里,NULL
1603,1351,10,1361,1828,0,0,74.45,992,359,厚德里,NULL
241,1352,9,1361,1747,0,0,77.9,831,521,平和里,NULL
442,1347,14,1361,1744,0,0,78.04,690,657,長江里,NULL
0,1347,14,1361,1744,0,0,78.04,690,657,長江里,NULL
111,1352,9,1361,1807,0,0,75.32,562,790,過溝里,NULL
764,1344,17,1361,2342,0,0,58.11,522,822,平等里,NULL
0,1344,17,1361,2342,0,0,58.11,522,822,平等里,NULL
1185,1348,12,1360,1742,0,0,78.07,1012,336,臥龍里,NULL
0,1348,12,1360,1742,0,0,78.07,1012,336,臥龍里,NULL
939,1349,11,1360,1678,0,0,81.05,989,360,新營里,NULL
323,1352,8,1360,1681,0,0,80.9,946,406,秀湖里,NULL
21,1355,5,1360,1763,0,0,77.14,923,432,上安里,NULL
339,1347,13,1360,1782,0,0,76.32,918,429,賴興里,NULL
320,1348,12,1360,1742,0,0,78.07,890,458,金華里,NULL
0,1348,12,1360,1742,0,0,78.07,890,458,金華里,NULL
404,1351,9,1360,1649,0,0,82.47,860,491,湖興里,NULL
16,1355,4,1359,1635,0,0,83.12,1053,302,十興里,NULL
839,1339,20,1359,1760,0,0,77.22,961,378,豐野里,NULL
1253,1349,10,1359,1691,0,0,80.37,960,389,景華里,NULL
1192,1347,12,1359,1724,0,0,78.83,906,441,龍門里,NULL
227,1346,13,1359,1761,0,0,77.17,862,484,堵北里,NULL
0,1343,16,1359,2081,0,0,65.31,800,543,豐里里,NULL
487,1327,32,1359,1835,0,0,74.06,711,616,太平村,NULL
0,1327,32,1359,1835,0,0,74.06,711,616,太平村,NULL
255,1354,5,1359,1802,0,0,75.42,701,653,平林里,NULL
28,1348,11,1359,1873,0,0,72.56,655,693,鳳凰里,NULL
0,1348,11,1359,1824,0,0,74.51,577,771,過江村,NULL
160,1345,13,1358,1725,0,0,78.72,1265,80,致遠里,NULL
0,1345,13,1358,1725,0,0,78.72,1265,80,致遠里,NULL
1268,1351,7,1358,1665,0,0,81.56,1076,275,小城里,NULL
671,1338,20,1358,1681,0,0,80.79,1042,296,復興里,NULL
220,1348,10,1358,1705,0,0,79.65,872,476,忠誠里,NULL
378,1341,17,1358,1734,0,0,78.32,764,577,公民里,NULL
0,1351,7,1358,2039,0,0,66.6,523,828,崙前村,NULL
0,1343,14,1357,1757,0,0,77.23,972,371,上溪里,NULL
1106,1350,7,1357,1779,0,0,76.28,846,504,光武里,NULL
290,1354,3,1357,1761,0,0,77.06,843,511,新生里,NULL
2143,1343,14,1357,1884,0,0,72.03,818,525,老梅村,NULL
0,1343,14,1357,1884,0,0,72.03,818,525,老梅村,NULL
508,1349,8,1357,1683,0,0,80.63,738,611,永福里,NULL
880,1344,13,1357,1646,0,0,82.44,706,638,重慶里,NULL
507,1340,17,1357,1720,0,0,78.9,705,635,福興里,NULL
1058,1343,14,1357,1739,0,0,78.03,654,689,瓊林里,NULL
351,1348,9,1357,1732,0,0,78.35,640,708,鼎強里,NULL
0,1342,15,1357,1933,0,0,70.2,580,762,興貴村,NULL
72,1348,9,1357,1697,0,0,79.96,392,956,後庄村,NULL
0,1348,9,1357,1697,0,0,79.96,392,956,後庄村,NULL
1269,1345,11,1356,1688,0,0,80.33,996,349,萬和里,NULL
0,1345,11,1356,1688,0,0,80.33,996,349,萬和里,NULL
714,1348,8,1356,1676,0,0,80.91,977,371,平興里,NULL
14,1348,8,1356,1735,0,0,78.16,904,444,敦和里,NULL
318,1348,8,1356,1644,0,0,82.48,878,470,紫星里,NULL
206,1345,11,1356,1731,0,0,78.34,850,495,龍子里,NULL
125,1339,17,1356,1837,0,0,73.82,847,492,頂番里,NULL
600,1346,10,1356,1745,0,0,77.71,839,507,北陽里,NULL
455,1349,7,1356,1676,0,0,80.91,819,530,萬福里,NULL
791,1344,12,1356,1837,0,0,73.82,816,528,新民里,NULL
306,1346,10,1356,1664,0,0,81.49,815,531,港華里,NULL
819,1340,16,1356,1783,0,0,76.05,808,532,福仁村,NULL
394,1349,7,1356,1646,0,0,82.38,758,591,本揚里,NULL
0,1343,13,1356,1708,0,0,79.39,672,671,五谷里,NULL
0,1339,17,1356,1691,0,0,80.19,488,851,高楠村,NULL
943,1344,11,1355,1754,0,0,77.25,861,483,光復里,NULL
508,1347,8,1355,1736,0,0,78.05,821,526,福興里,NULL
1024,1343,12,1355,1670,0,0,81.14,781,562,立基里,NULL
381,1340,15,1355,1691,0,0,80.13,740,600,田安里,NULL
150,1345,10,1355,1701,0,0,79.66,702,643,後港里,NULL
0,1348,7,1355,1898,0,0,71.39,497,851,四春里,NULL
1129,1342,12,1354,1676,0,0,80.79,900,442,福住里,NULL
314,1341,13,1354,1781,0,0,76.02,829,512,建德里,NULL
1608,1342,12,1354,1797,0,0,75.35,813,529,中興里,NULL
540,1335,19,1354,1734,0,0,78.09,810,525,西川里,NULL
269,1347,7,1354,1756,0,0,77.11,794,553,大武里,NULL
408,1332,22,1354,1777,0,0,76.2,784,548,昇平里,NULL
155,1345,9,1354,1709,0,0,79.23,708,637,前港里,NULL
0,1342,12,1354,1848,0,0,73.27,701,641,安福里,NULL
0,1348,6,1354,1829,0,0,74.03,672,676,湄洲里,NULL
959,1337,17,1354,1725,0,0,78.49,624,713,頭前里,NULL
713,1344,10,1354,1829,0,0,74.03,609,735,山明里,NULL
735,1342,12,1354,1705,0,0,79.41,608,734,桂林里,NULL
0,1350,4,1354,1804,0,0,75.06,451,899,松安里,NULL
245,1345,8,1353,1665,0,0,81.26,1051,294,內興里,NULL
133,1346,7,1353,1691,0,0,80.01,986,360,三義里,NULL
746,1345,8,1353,1667,0,0,81.16,975,370,北華里,NULL
534,1338,15,1353,1667,0,0,81.16,967,371,鵬程里,NULL
141,1338,15,1353,1675,0,0,80.78,872,466,三厝里,NULL
363,1341,12,1353,1690,0,0,80.06,866,475,明德里,NULL
225,1342,11,1353,1806,0,0,74.92,862,480,嘉和里,NULL
382,1345,8,1353,1664,0,0,81.31,852,493,樂康里,NULL
177,1348,5,1353,1714,0,0,78.94,835,513,福山里,NULL
259,1340,13,1353,1737,0,0,77.89,826,514,天玉里,NULL
196,1340,13,1353,1687,0,0,80.2,804,536,埤墘里,NULL
484,1338,15,1353,1773,0,0,76.31,725,613,瓦中村,NULL
0,1338,15,1353,1773,0,0,76.31,725,613,瓦中村,NULL
0,1339,14,1353,1769,0,0,76.48,721,618,新勝里,NULL
401,1330,23,1353,1835,0,0,73.73,695,635,溪海村,NULL
378,1341,12,1353,1818,0,0,74.42,593,748,四維村,NULL
0,1341,12,1353,1818,0,0,74.42,593,748,四維村,NULL
211,1342,10,1352,1724,0,0,78.42,1005,337,富民里,NULL
332,1343,9,1352,1670,0,0,80.96,947,396,碧山里,NULL
1191,1345,7,1352,1701,0,0,79.48,916,429,龍門里,NULL
611,1337,15,1352,1872,0,0,72.22,851,486,黃厝村,NULL
0,1337,15,1352,1872,0,0,72.22,851,486,黃厝村,NULL
743,1347,5,1352,1718,0,0,78.7,836,511,高雙里,NULL
436,1337,15,1352,1748,0,0,77.35,740,597,光華里,NULL
0,1337,15,1352,1748,0,0,77.35,740,597,光華里,NULL
0,1342,10,1352,1927,0,0,70.16,432,910,鯤鯓村,NULL
297,1322,29,1351,1773,0,0,76.2,1029,293,三和村,NULL
103,1343,8,1351,1639,0,0,82.43,965,378,文化里,NULL
172,1344,7,1351,1768,0,0,76.41,937,407,外寮里,NULL
624,1339,12,1351,1762,0,0,76.67,869,470,和平里,NULL
360,1339,12,1351,1702,0,0,79.38,851,488,過田里,NULL
965,1337,14,1351,1745,0,0,77.42,829,508,三愛里,NULL
349,1336,15,1351,1764,0,0,76.59,767,569,福樂村,NULL
0,1341,10,1351,1833,0,0,73.7,757,584,錦平里,NULL
840,1334,17,1351,1737,0,0,77.78,756,578,延平里,NULL
368,1338,13,1351,1683,0,0,80.27,746,592,光陽里,NULL
0,1340,11,1351,1746,0,0,77.38,730,610,錦安里,NULL
427,1339,12,1351,1805,0,0,74.85,714,625,內海村,NULL
0,1339,12,1351,1805,0,0,74.85,714,625,內海村,NULL
1479,1339,12,1351,1738,0,0,77.73,652,687,成功里,NULL
26,1345,6,1351,1678,0,0,80.51,539,806,錦屏里,NULL
0,1334,16,1350,1772,0,0,76.19,904,430,中美里,NULL
1289,1338,12,1350,1725,0,0,78.26,860,478,青潭里,NULL
400,1337,13,1350,1826,0,0,73.93,777,560,溪海村,NULL
535,1339,11,1350,1821,0,0,74.14,732,607,德隆里,NULL
0,1341,9,1350,1744,0,0,77.41,609,732,文安村,NULL
1199,1330,19,1349,1723,0,0,78.29,985,345,芳和里,NULL
937,1338,11,1349,1688,0,0,79.92,971,367,新營里,NULL
353,1330,19,1349,1756,0,0,76.82,924,406,南興村,NULL
4,1330,19,1349,1750,0,0,77.09,904,426,明正里,NULL
330,1336,13,1349,1743,0,0,77.4,766,570,堂春里,NULL
0,1337,12,1349,1925,0,0,70.08,645,692,東港里,NULL
0,1335,14,1349,1813,0,0,74.41,624,711,重興村,NULL
0,1333,16,1349,1798,0,0,75.03,622,711,東州村,NULL
1353,1334,14,1348,1659,0,0,81.25,962,372,萬美里,NULL
832,1334,14,1348,1766,0,0,76.33,904,430,甘蔗村,NULL
99,1344,4,1348,1649,0,0,81.75,838,506,智仁里,NULL
413,1336,12,1348,1740,0,0,77.47,814,522,忠明里,NULL
223,1337,11,1348,1778,0,0,75.82,744,593,育平里,NULL
774,1336,12,1348,1726,0,0,78.1,732,604,行孝里,NULL
849,1334,14,1348,1681,0,0,80.19,665,669,民權里,NULL
635,1342,6,1348,1890,0,0,71.32,665,677,永康里,NULL
685,1327,21,1348,1769,0,0,76.2,645,682,西東里,NULL
0,1327,21,1348,1769,0,0,76.2,645,682,西東里,NULL
264,1331,17,1348,1691,0,0,79.72,613,718,金華里,NULL
130,1337,10,1347,1650,0,0,81.64,1033,304,員山里,NULL
0,1337,10,1347,1650,0,0,81.64,1033,304,員山里,NULL
0,1335,12,1347,1711,0,0,78.73,1024,311,誠信里,NULL
1286,1330,17,1347,1676,0,0,80.37,964,366,興得里,NULL
2151,1330,17,1347,1747,0,0,77.1,874,456,龍源村,NULL
74,1339,8,1347,1821,0,0,73.97,856,483,鹽北村,NULL
0,1339,8,1347,1821,0,0,73.97,856,483,鹽北村,NULL
71,1334,13,1347,1771,0,0,76.06,847,487,中平里,NULL
549,1334,13,1347,1691,0,0,79.66,842,492,復盛里,NULL
1030,1335,12,1347,1632,0,0,82.54,842,493,中港里,NULL
324,1337,10,1347,1846,0,0,72.97,808,529,邱厝里,NULL
0,1337,10,1347,1846,0,0,72.97,808,529,邱厝里,NULL
770,1335,12,1347,1683,0,0,80.04,714,621,行仁里,NULL
308,1336,11,1347,1841,0,0,73.17,689,647,永安里,NULL
737,1334,13,1347,1672,0,0,80.56,664,670,桂林里,NULL
174,1333,14,1347,1708,0,0,78.86,651,682,富光里,NULL
33,1332,14,1346,1692,0,0,79.55,868,464,大林里,NULL
0,1332,14,1346,1929,0,0,69.78,858,474,龜吼村,NULL
262,1329,17,1346,1706,0,0,78.9,841,488,天母里,NULL
801,1334,12,1346,1692,0,0,79.55,837,497,朱馥里,NULL
699,1334,12,1346,1631,0,0,82.53,828,506,積穗里,NULL
232,1333,13,1346,1728,0,0,77.89,709,624,文平里,NULL
0,1331,15,1346,1974,0,0,68.19,565,766,同仁村,NULL
348,1335,11,1346,1835,0,0,73.35,527,808,建南里,NULL
0,1331,15,1346,1785,0,0,75.41,515,816,義仁村,NULL
1213,1336,9,1345,1710,0,0,78.65,965,371,復興里,NULL
311,1339,6,1345,1760,0,0,76.42,963,376,崇蘭里,NULL
41,1335,10,1345,1655,0,0,81.27,929,406,宏南里,NULL
0,1335,10,1345,1655,0,0,81.27,929,406,宏南里,NULL
312,1323,22,1345,1657,0,0,81.17,899,424,大成里,NULL
307,1336,9,1345,1650,0,0,81.52,879,457,港華里,NULL
70,1335,10,1345,1704,0,0,78.93,870,465,虹橋里,NULL
0,1335,10,1345,1704,0,0,78.93,870,465,虹橋里,NULL
1601,1332,13,1345,1768,0,0,76.07,845,487,厚德里,NULL
388,1329,16,1345,1824,0,0,73.74,823,506,公館里,NULL
563,1329,16,1345,1817,0,0,74.02,705,624,東光里,NULL
0,1329,16,1345,1817,0,0,74.02,705,624,東光里,NULL
0,1339,6,1345,1798,0,0,74.81,597,742,竹園村,NULL
1292,1332,12,1344,1661,0,0,80.92,974,358,美潭里,NULL
426,1337,7,1344,1711,0,0,78.55,844,493,忠誠里,NULL
71,1327,17,1344,1700,0,0,79.06,841,486,港尾里,NULL
912,1335,9,1344,1702,0,0,78.97,840,495,永功里,NULL
284,1330,14,1344,1785,0,0,75.29,783,547,大發里,NULL
0,1330,14,1344,1785,0,0,75.29,783,547,大發里,NULL
184,1335,9,1344,1722,0,0,78.05,703,632,社子里,NULL
683,1332,12,1344,1942,0,0,69.21,628,704,港南里,NULL
0,1332,12,1344,1942,0,0,69.21,628,704,港南里,NULL
208,1327,17,1344,1757,0,0,76.49,580,747,民生里,NULL
0,1327,17,1344,1757,0,0,76.49,580,747,民生里,NULL
196,1331,12,1343,1568,0,0,85.65,1291,40,陸光村,NULL
648,1328,15,1343,1663,0,0,80.76,1029,299,崇南里,NULL
22,1337,6,1343,1593,0,0,84.31,999,338,北崙里,NULL
1915,1333,10,1343,1834,0,0,73.23,885,448,沙崙里,NULL
560,1318,25,1343,1685,0,0,79.7,868,450,吉仁里,NULL
2080,1330,13,1343,1681,0,0,79.89,854,476,麗園村,NULL
75,1334,9,1343,1650,0,0,81.39,792,542,豐林里,NULL
174,1333,10,1343,1775,0,0,75.66,788,545,福山里,NULL
527,1328,15,1343,1723,0,0,77.95,737,591,慈祐里,NULL
0,1329,14,1343,2003,0,0,67.05,626,703,永昌村,NULL
0,1323,20,1343,1881,0,0,71.4,603,720,橫山村,NULL
893,1333,9,1342,1689,0,0,79.46,957,376,安和里,NULL
15,1327,15,1342,1707,0,0,78.62,855,472,惠來里,NULL
0,1335,7,1342,1706,0,0,78.66,855,480,龍興里,NULL
137,1337,5,1342,1708,0,0,78.57,804,533,成德里,NULL
775,1337,5,1342,1754,0,0,76.51,742,595,行孝里,NULL
263,1328,14,1342,1837,0,0,73.05,647,681,府北里,NULL
0,1328,14,1342,1837,0,0,73.05,647,681,府北里,NULL
0,1330,12,1342,1635,0,0,82.08,546,784,石潭里,NULL
1205,1330,11,1341,1659,0,0,80.83,955,375,大豐里,NULL
474,1334,7,1341,1650,0,0,81.27,828,506,東榮里,NULL
377,1330,11,1341,1818,0,0,73.76,681,649,灣橋村,NULL
176,1334,7,1341,1724,0,0,77.78,663,671,青溪里,NULL
758,1332,8,1340,1612,0,0,83.13,1049,283,安樂里,NULL
156,1322,18,1340,1764,0,0,75.96,913,409,會稽里,NULL
177,1329,11,1340,1785,0,0,75.07,894,435,德陽村,NULL
224,1325,15,1340,1851,0,0,72.39,663,662,寬士村,NULL
182,1329,11,1340,1677,0,0,79.9,643,686,葫東里,NULL
345,1332,7,1339,1675,0,0,79.94,936,396,葫洲里,NULL
0,1331,8,1339,1742,0,0,76.87,901,430,後湖村,NULL
347,1328,11,1339,1666,0,0,80.37,864,464,大竹村,NULL
326,1323,16,1339,1728,0,0,77.49,859,464,溪福里,NULL
304,1333,6,1339,1628,0,0,82.25,798,535,港華里,NULL
62,1322,17,1339,1656,0,0,80.86,762,560,大河里,NULL
0,1326,13,1339,1785,0,0,75.01,488,838,海埔村,NULL
539,1329,9,1338,1645,0,0,81.34,1107,222,自強里,NULL
506,1330,8,1338,1691,0,0,79.12,1040,290,龍昌里,NULL
783,1326,12,1338,1659,0,0,80.65,1006,320,秀景里,NULL
1335,1330,8,1338,1639,0,0,81.64,984,346,樟林里,NULL
1242,1325,13,1338,1704,0,0,78.52,946,379,安和里,NULL
1214,1325,13,1338,1759,0,0,76.07,938,387,建倫里,NULL
330,1329,9,1338,1721,0,0,77.75,864,465,大榮里,NULL
0,1329,9,1338,1721,0,0,77.75,864,465,大榮里,NULL
330,1330,8,1338,1699,0,0,78.75,830,500,大智里,NULL
662,1326,12,1338,1685,0,0,79.41,761,565,興東里,NULL
0,1326,12,1338,1714,0,0,78.06,738,588,武安里,NULL
146,1332,6,1338,1747,0,0,76.59,639,693,文元里,NULL
691,1327,10,1337,1665,0,0,80.3,973,354,黎順里,NULL
0,1324,13,1337,1817,0,0,73.58,874,450,新興里,NULL
608,1326,11,1337,1647,0,0,81.18,821,505,平河里,NULL
309,1325,12,1337,1680,0,0,79.58,814,511,錦村里,NULL
424,1325,12,1337,1738,0,0,76.93,779,546,林頭里,NULL
231,1321,16,1337,1697,0,0,78.79,777,544,大崗村,NULL
156,1331,6,1337,1737,0,0,76.97,741,590,光路里,NULL
114,1325,12,1337,1638,0,0,81.62,733,592,一德里,NULL
340,1320,17,1337,1680,0,0,79.58,688,632,北柳村,NULL
216,1322,15,1337,1806,0,0,74.03,619,703,九曲村,NULL
802,1326,11,1337,1725,0,0,77.51,596,730,南保村,NULL
199,1333,4,1337,1662,0,0,80.45,509,824,平和里,NULL
0,1327,9,1336,1729,0,0,77.27,1061,266,朝陽村,NULL
2,1325,11,1336,1720,0,0,77.67,885,440,中路里,NULL
1213,1316,20,1336,1780,0,0,75.06,875,441,建倫里,NULL
892,1324,12,1336,1664,0,0,80.29,869,455,雙和里,NULL
290,1317,19,1336,1639,0,0,81.51,845,472,水湳里,NULL
136,1326,10,1336,1688,0,0,79.15,811,515,新上里,NULL
80,1321,15,1336,1687,0,0,79.19,803,518,大同里,NULL
683,1316,20,1336,1801,0,0,74.18,772,544,茂興里,NULL
0,1316,20,1336,1801,0,0,74.18,772,544,茂興里,NULL
587,1318,18,1336,1758,0,0,76,743,575,豐田里,NULL
493,1324,12,1336,1655,0,0,80.73,738,586,城隍里,NULL
401,1326,10,1336,1701,0,0,78.54,724,602,龍山里,NULL
291,1322,14,1336,1754,0,0,76.17,688,634,開南里,NULL
47,1327,9,1336,1693,0,0,78.91,653,674,西埔里,NULL
940,1330,5,1335,1619,0,0,82.46,1049,281,新營里,NULL
861,1329,6,1335,1670,0,0,79.94,994,335,民本里,NULL
61,1332,3,1335,1623,0,0,82.26,976,356,孝忠里,NULL
283,1327,8,1335,1690,0,0,78.99,946,381,忠平里,NULL
0,1315,20,1335,1723,0,0,77.48,920,395,大忠里,NULL
329,1324,11,1335,1704,0,0,78.35,912,412,金瑞里,NULL
795,1318,17,1335,1921,0,0,69.5,872,446,雅楓村,NULL
174,1326,9,1335,1696,0,0,78.71,849,477,北屯里,NULL
105,1325,10,1335,1672,0,0,79.84,800,525,豐年里,NULL
33,1322,13,1335,1709,0,0,78.12,712,610,瑞屏里,NULL
597,1324,11,1335,1750,0,0,76.29,616,708,月眉里,NULL
371,1322,13,1335,1785,0,0,74.79,616,706,萬全村,NULL
0,1326,9,1335,1690,0,0,78.99,577,749,龔厝村,NULL
352,1321,14,1335,1785,0,0,74.79,572,749,安西里,NULL
347,1323,12,1335,1798,0,0,74.25,546,777,建南里,NULL
1281,1329,5,1334,1657,0,0,80.51,1033,296,玫瑰里,NULL
20,1322,12,1334,1733,0,0,76.98,919,403,上石里,NULL
228,1321,13,1334,1730,0,0,77.11,870,451,福祿里,NULL
0,1319,15,1334,1671,0,0,79.83,869,450,港墘里,NULL
1560,1330,4,1334,1775,0,0,75.15,854,476,自強里,NULL
157,1326,8,1334,1674,0,0,79.69,797,529,大興里,NULL
743,1325,9,1334,1675,0,0,79.64,793,532,錦盛里,NULL
607,1316,18,1334,1732,0,0,77.02,760,556,平河里,NULL
195,1314,20,1334,1704,0,0,78.29,713,601,軍功里,NULL
261,1319,15,1334,1691,0,0,78.89,695,624,廣福里,NULL
0,1322,12,1334,1693,0,0,78.8,627,695,鴨寮村,NULL
184,1325,8,1333,1772,0,0,75.23,940,385,過港里,NULL
171,1317,16,1333,1662,0,0,80.2,921,396,惠中里,NULL
2092,1321,12,1333,1765,0,0,75.52,918,403,賴仲村,NULL
0,1321,12,1333,1765,0,0,75.52,918,403,賴仲村,NULL
877,1315,18,1333,1742,0,0,76.52,886,429,烏林村,NULL
740,1323,10,1333,1649,0,0,80.84,792,531,成功里,NULL
425,1318,15,1333,1760,0,0,75.74,792,526,忠誠里,NULL
54,1319,14,1333,1670,0,0,79.82,783,536,大豐里,NULL
440,1321,12,1333,1736,0,0,76.79,769,552,立德里,NULL
77,1319,14,1333,1767,0,0,75.44,764,555,嘉寶里,NULL
0,1319,14,1333,1767,0,0,75.44,764,555,嘉寶里,NULL
813,1323,10,1333,1746,0,0,76.35,737,586,力行里,NULL
117,1325,8,1333,1683,0,0,79.2,658,667,永興里,NULL
0,1325,8,1333,1683,0,0,79.2,658,667,永興里,NULL
149,1321,12,1333,1664,0,0,80.11,652,669,後港里,NULL
805,1318,15,1333,1789,0,0,74.51,599,719,南興村,NULL
749,1317,16,1333,1816,0,0,73.4,483,834,鳳源里,NULL
0,1323,10,1333,1787,0,0,74.59,461,862,新榮里,NULL
1343,1322,10,1332,1626,0,0,81.92,1003,319,樟新里,NULL
107,1322,10,1332,1878,0,0,70.93,990,332,永安村,NULL
138,1315,17,1332,1608,0,0,82.84,958,357,福志里,NULL
6,1322,10,1332,1697,0,0,78.49,947,375,西平里,NULL
807,1317,15,1332,1727,0,0,77.13,932,385,瑞塘里,NULL
58,1318,14,1332,1699,0,0,78.4,883,435,嘉犁里,NULL
0,1318,14,1332,1699,0,0,78.4,883,435,嘉犁里,NULL
542,1313,19,1332,1718,0,0,77.53,829,484,吉祥里,NULL
276,1313,19,1332,1717,0,0,77.58,805,508,高明里,NULL
0,1319,13,1332,1659,0,0,80.29,794,525,舊明里,NULL
210,1325,7,1332,1651,0,0,80.68,784,541,德行里,NULL
1756,1320,12,1332,1724,0,0,77.26,768,552,尖山里,NULL
0,1310,22,1332,1864,0,0,71.46,734,576,岑海里,NULL
738,1318,14,1332,1696,0,0,78.54,730,588,庄前村,NULL
0,1318,14,1332,1696,0,0,78.54,730,588,庄前村,NULL
752,1318,14,1332,1725,0,0,77.22,725,593,社口村,NULL
705,1314,18,1332,1761,0,0,75.64,695,619,宏亮里,NULL
1522,1319,13,1332,1786,0,0,74.58,652,667,水湳里,NULL
282,1321,11,1332,1772,0,0,75.17,602,719,郡南里,NULL
0,1326,6,1332,1748,0,0,76.2,489,837,埔子村,NULL
670,1315,16,1331,1634,0,0,81.46,1032,283,六合里,NULL
514,1320,11,1331,1708,0,0,77.93,821,499,中華里,NULL
229,1322,9,1331,1656,0,0,80.37,807,515,三玉里,NULL
588,1321,10,1331,1661,0,0,80.13,792,529,興雅里,NULL
346,1321,10,1331,1664,0,0,79.99,771,550,大竹村,NULL
0,1321,10,1331,1702,0,0,78.2,724,597,社東里,NULL
0,1324,7,1331,1902,0,0,69.98,664,660,水源里,NULL
433,1321,10,1331,1688,0,0,78.85,621,700,寶珠里,NULL
133,1325,6,1331,1613,0,0,82.52,572,753,新上里,NULL
68,1325,6,1331,1772,0,0,75.11,483,842,東寧村,NULL
599,1321,9,1330,1672,0,0,79.55,911,410,忠孝里,NULL
1165,1321,9,1330,1699,0,0,78.28,878,443,通安里,NULL
95,1314,16,1330,1689,0,0,78.74,855,459,聯翠里,NULL
241,1319,11,1330,1703,0,0,78.1,811,508,南美村,NULL
0,1319,11,1330,1703,0,0,78.1,811,508,南美村,NULL
1132,1315,15,1330,1792,0,0,74.22,803,512,光華里,NULL
362,1314,16,1330,1924,0,0,69.13,786,528,三合村,NULL
0,1314,16,1330,1924,0,0,69.13,786,528,三合村,NULL
1559,1317,13,1330,1753,0,0,75.87,770,547,自強里,NULL
501,1320,10,1330,1671,0,0,79.59,761,559,永安里,NULL
363,1314,16,1330,1630,0,0,81.6,719,595,莊敬里,NULL
14,1316,14,1330,1746,0,0,76.17,584,732,頂安里,NULL
1178,1323,6,1329,1790,0,0,74.25,989,334,群賢里,NULL
467,1321,8,1329,1623,0,0,81.89,957,364,仁福里,NULL
1574,1322,7,1329,1670,0,0,79.58,957,365,橋東里,NULL
1194,1318,11,1329,1690,0,0,78.64,917,401,大學里,NULL
226,1319,10,1329,1816,0,0,73.18,757,562,嘉和里,NULL
578,1307,22,1329,1704,0,0,77.99,698,609,林西里,NULL
0,1307,22,1329,1704,0,0,77.99,698,609,林西里,NULL
141,1316,12,1328,1802,0,0,73.7,1072,244,東昌村,NULL
155,1321,7,1328,1660,0,0,80,929,392,四維里,NULL
1036,1319,9,1328,1652,0,0,80.39,869,450,中平里,NULL
552,1321,7,1328,1740,0,0,76.32,824,497,中正里,NULL
157,1320,8,1328,1697,0,0,78.26,777,543,菜公里,NULL
141,1318,10,1328,1633,0,0,81.32,722,596,忠翠里,NULL
1989,1319,9,1328,1639,0,0,81.03,700,619,五股村,NULL
114,1308,20,1328,1739,0,0,76.37,547,761,南新里,NULL
0,1308,20,1328,1739,0,0,76.37,547,761,南新里,NULL
1323,1317,10,1327,1561,0,0,85.01,1086,231,木柵里,NULL
180,1320,7,1327,1595,0,0,83.2,908,412,葫蘆里,NULL
235,1316,11,1327,1845,0,0,71.92,856,460,軍功里,NULL
1549,1322,5,1327,1674,0,0,79.27,843,479,福安里,NULL
171,1318,9,1327,1683,0,0,78.85,794,524,福山里,NULL
923,1318,9,1327,1688,0,0,78.61,737,581,高原村,NULL
74,1312,15,1327,1699,0,0,78.1,735,577,國昌里,NULL
357,1309,18,1327,1798,0,0,73.8,665,644,興中村,NULL
0,1309,18,1327,1798,0,0,73.8,665,644,興中村,NULL
0,1316,11,1327,1811,0,0,73.27,543,773,明和村,NULL
1061,1314,12,1326,1570,0,0,84.46,1184,130,新和里,NULL
331,1312,14,1326,1665,0,0,79.64,983,329,大千里,NULL
0,1312,14,1326,1665,0,0,79.64,983,329,大千里,NULL
5,1314,12,1326,1704,0,0,77.82,872,442,至善里,NULL
1,1314,12,1326,1687,0,0,78.6,839,475,中路里,NULL
278,1315,11,1326,1688,0,0,78.55,836,479,華東里,NULL
83,1322,4,1326,1769,0,0,74.96,748,574,後湖里,NULL
0,1313,13,1326,1860,0,0,71.29,714,599,中圳里,NULL
935,1316,10,1326,1785,0,0,74.29,661,655,石磊村,NULL
0,1316,10,1326,1785,0,0,74.29,661,655,石磊村,NULL
345,1316,10,1326,1659,0,0,79.93,555,761,鼎金里,NULL
233,1310,15,1325,1719,0,0,77.08,939,371,平興里,NULL
710,1315,10,1325,1662,0,0,79.72,887,428,濟南里,NULL
11,1318,7,1325,1669,0,0,79.39,827,491,太平里,NULL
1581,1318,7,1325,1736,0,0,76.32,814,504,鄉長里,NULL
0,1318,7,1325,1736,0,0,76.32,814,504,鄉長里,NULL
814,1311,14,1325,1675,0,0,79.1,785,526,力行里,NULL
779,1313,12,1325,1732,0,0,76.5,776,537,文雅村,NULL
104,1307,18,1325,1697,0,0,78.08,766,541,雲林里,NULL
235,1310,15,1325,1676,0,0,79.06,717,593,大恩里,NULL
142,1314,11,1325,1637,0,0,80.94,676,638,舊佳里,NULL
679,1312,13,1325,1688,0,0,78.5,651,661,港墘里,NULL
0,1312,13,1325,1688,0,0,78.5,651,661,港墘里,NULL
354,1305,19,1324,1673,0,0,79.14,944,361,康寧里,NULL
1294,1316,8,1324,1599,0,0,82.8,895,421,興福里,NULL
0,1309,15,1324,1967,0,0,67.31,862,447,北港村,NULL
208,1310,14,1324,1667,0,0,79.42,837,473,延平里,NULL
224,1321,3,1324,1714,0,0,77.25,811,510,龍西村,NULL
0,1321,3,1324,1714,0,0,77.25,811,510,龍西村,NULL
712,1309,15,1324,1710,0,0,77.43,790,519,宋屋里,NULL
1025,1311,13,1324,1706,0,0,77.61,764,547,立基里,NULL
1757,1310,14,1324,1838,0,0,72.03,729,581,尖山里,NULL
78,1317,7,1324,1677,0,0,78.95,662,655,大同里,NULL
547,1312,12,1324,1661,0,0,79.71,614,698,五華里,NULL
1,1312,12,1324,1683,0,0,78.67,601,711,建民里,NULL
539,1319,4,1323,1709,0,0,77.41,1220,99,自立里,NULL
505,1314,9,1323,1620,0,0,81.67,1022,292,龍昌里,NULL
833,1314,9,1323,1626,0,0,81.37,978,336,河濱里,NULL
205,1314,9,1323,1618,0,0,81.77,873,441,岩山里,NULL
253,1309,14,1323,1744,0,0,75.86,836,473,平德里,NULL
302,1308,15,1323,1713,0,0,77.23,812,496,九德村,NULL
256,1313,10,1323,1756,0,0,75.34,765,548,新東村,NULL
878,1309,14,1323,1618,0,0,81.77,739,570,重慶里,NULL
203,1307,16,1323,1708,0,0,77.46,665,642,廍子里,NULL
0,1307,16,1323,1708,0,0,77.46,665,642,廍子里,NULL
152,1314,9,1323,1673,0,0,79.08,551,763,大和里,NULL
479,1311,11,1322,1589,0,0,83.2,1230,81,富仁里,NULL
61,1308,14,1322,1750,0,0,75.54,929,379,龍祥里,NULL
517,1311,11,1322,1783,0,0,74.14,780,531,竹塘村,NULL
0,1311,11,1322,1783,0,0,74.14,780,531,竹塘村,NULL
411,1317,5,1322,1700,0,0,77.76,682,635,寶國里,NULL
0,1312,9,1321,1645,0,0,80.3,982,330,中正里,NULL
30,1314,7,1321,1629,0,0,81.09,963,351,逢福里,NULL
689,1305,16,1321,1753,0,0,75.36,954,351,金星里,NULL
586,1309,12,1321,1656,0,0,79.77,946,363,興雅里,NULL
1264,1307,14,1321,1624,0,0,81.34,926,381,萬隆里,NULL
304,1303,18,1321,1852,0,0,71.33,891,412,大信里,NULL
47,1301,20,1321,1607,0,0,82.2,862,439,廣昌里,NULL
182,1296,25,1321,1694,0,0,77.98,802,494,龜山村,NULL
628,1309,12,1321,1752,0,0,75.4,794,515,梅子村,NULL
0,1309,12,1321,1752,0,0,75.4,794,515,梅子村,NULL
11,1312,9,1321,1654,0,0,79.87,790,522,東寧里,NULL
0,1304,17,1321,2651,0,0,49.83,770,534,石頭里,NULL
352,1315,6,1321,1626,0,0,81.24,766,549,文聖里,NULL
408,1311,10,1321,1651,0,0,80.01,764,547,清和里,NULL
0,1304,17,1321,1708,0,0,77.34,745,559,金興村,NULL
1053,1310,11,1321,1717,0,0,76.94,739,571,豐年里,NULL
576,1310,11,1321,1683,0,0,78.49,726,584,三村里,NULL
430,1306,15,1321,1713,0,0,77.12,721,585,繼光里,NULL
0,1306,15,1321,1713,0,0,77.12,721,585,繼光里,NULL
355,1312,9,1321,1679,0,0,78.68,711,601,福德里,NULL
783,1304,16,1320,1678,0,0,78.67,905,399,北貴里,NULL
0,1313,7,1320,1851,0,0,71.31,797,516,傑魚里,NULL
1477,1312,8,1320,1707,0,0,77.33,696,616,成功里,NULL
0,1311,9,1320,1752,0,0,75.34,690,621,清水里,NULL
0,1307,13,1320,1854,0,0,71.2,663,644,成功村,NULL
756,1311,8,1319,1620,0,0,81.42,968,343,宜安里,NULL
0,1311,8,1319,1620,0,0,81.42,968,343,宜安里,NULL
158,1308,11,1319,1636,0,0,80.62,965,343,五福里,NULL
1366,1312,7,1319,1688,0,0,78.14,911,401,指南里,NULL
145,1309,10,1319,1692,0,0,77.96,906,403,寶安里,NULL
524,1310,9,1319,1756,0,0,75.11,884,426,永興里,NULL
339,1313,6,1319,1577,0,0,83.64,871,442,清白里,NULL
1564,1310,9,1319,1683,0,0,78.37,856,454,白雲里,NULL
263,1311,8,1319,1734,0,0,76.07,837,474,瑞光里,NULL
68,1313,6,1319,1622,0,0,81.32,834,479,清江里,NULL
67,1310,9,1319,1630,0,0,80.92,798,512,隆昌里,NULL
410,1306,13,1319,1695,0,0,77.82,761,545,昇平里,NULL
911,1313,6,1319,1634,0,0,80.72,759,554,永功里,NULL
349,1304,15,1319,1659,0,0,79.51,652,652,鼎盛里,NULL
13,1309,10,1319,1705,0,0,77.36,644,665,五常里,NULL
790,1305,13,1318,1689,0,0,78.03,1038,267,東社里,NULL
1165,1308,10,1318,1663,0,0,79.25,980,328,新安里,NULL
894,1302,16,1318,1625,0,0,81.11,946,356,龍星村,NULL
134,1308,10,1318,1722,0,0,76.54,927,381,勝安村,NULL
1196,1309,9,1318,1652,0,0,79.78,900,409,大學里,NULL
210,1307,11,1318,1668,0,0,79.02,768,539,延平里,NULL
415,1311,7,1318,1704,0,0,77.35,717,594,忠明里,NULL
200,1308,10,1318,1641,0,0,80.32,614,694,平和里,NULL
552,1304,14,1318,1698,0,0,77.62,588,716,大道里,NULL
0,1304,14,1318,1698,0,0,77.62,588,716,大道里,NULL
756,1312,6,1318,1644,0,0,80.17,496,816,明孝里,NULL
276,1304,13,1317,1729,0,0,76.17,957,347,后庄里,NULL
311,1306,11,1317,1660,0,0,79.34,924,382,湖濱里,NULL
285,1306,11,1317,1678,0,0,78.49,922,384,大德里,NULL
936,1306,11,1317,1646,0,0,80.01,848,458,龍福里,NULL
289,1297,20,1317,1689,0,0,77.98,798,499,水湳里,NULL
86,1301,16,1317,1734,0,0,75.95,790,511,中心里,NULL
417,1304,13,1317,1646,0,0,80.01,771,533,新富里,NULL
0,1299,18,1317,1675,0,0,78.63,756,543,土城里,NULL
0,1306,11,1317,2182,0,0,60.36,743,563,同安村,NULL
479,1307,10,1317,1697,0,0,77.61,741,566,東門村,NULL
154,1308,9,1317,1642,0,0,80.21,649,659,福中里,NULL
538,1307,9,1316,1664,0,0,79.09,1061,246,自強里,NULL
0,1302,14,1316,1701,0,0,77.37,1023,279,富台里,NULL
0,1303,13,1316,1930,0,0,68.19,924,379,豐山村,NULL
134,1313,3,1316,1628,0,0,80.84,918,395,三義里,NULL
272,1309,7,1316,1741,0,0,75.59,854,455,茄明里,NULL
219,1301,15,1316,1716,0,0,76.69,803,498,山頂村,NULL
0,1303,13,1316,1726,0,0,76.25,765,538,三和村,NULL
494,1311,5,1316,1669,0,0,78.85,730,581,城隍里,NULL
0,1308,8,1316,1737,0,0,75.76,715,593,舊社里,NULL
0,1297,19,1316,1757,0,0,74.9,632,665,北園里,NULL
0,1302,13,1315,1662,0,0,79.12,1045,257,民族里,NULL
738,1306,9,1315,1671,0,0,78.7,876,430,大直里,NULL
331,1304,11,1315,1608,0,0,81.78,874,430,華山里,NULL
848,1308,7,1315,1699,0,0,77.4,840,468,秀朗里,NULL
280,1304,11,1315,1572,0,0,83.65,794,510,西湖里,NULL
296,1299,16,1315,1676,0,0,78.46,789,510,文莊里,NULL
577,1304,11,1315,1647,0,0,79.84,750,554,三村里,NULL
311,1308,7,1315,1611,0,0,81.63,740,568,大成里,NULL
65,1309,6,1315,1618,0,0,81.27,734,575,奇岩里,NULL
1521,1308,7,1315,1722,0,0,76.36,705,603,水湳里,NULL
65,1305,10,1315,1700,0,0,77.35,642,663,溪東里,NULL
413,1299,16,1315,1716,0,0,76.63,636,663,坐駕里,NULL
358,1311,4,1315,1578,0,0,83.33,578,733,鼎中里,NULL
0,1304,11,1315,1876,0,0,70.1,487,817,聖賢村,NULL
279,1308,7,1315,1788,0,0,73.55,464,844,南汕里,NULL
0,1308,7,1315,1788,0,0,73.55,464,844,南汕里,NULL
718,1305,9,1314,1572,0,0,83.59,1225,80,文華里,NULL
0,1305,9,1314,1719,0,0,76.44,1052,253,靜湖村,NULL
1248,1298,16,1314,1682,0,0,78.12,1020,278,新和里,NULL
1152,1299,15,1314,1625,0,0,80.86,887,412,龍生里,NULL
1360,1310,4,1314,1610,0,0,81.61,868,442,萬興里,NULL
680,1302,12,1314,1611,0,0,81.56,866,436,景新里,NULL
897,1298,16,1314,1641,0,0,80.07,795,503,頂東里,NULL
1036,1300,14,1314,1664,0,0,78.97,747,553,錦德里,NULL
135,1296,18,1314,1712,0,0,76.75,721,575,長德里,NULL
344,1305,9,1314,1660,0,0,79.16,684,621,中興里,NULL
512,1297,16,1313,1641,0,0,80.01,936,361,光明里,NULL
1295,1304,9,1313,1559,0,0,84.22,935,369,興福里,NULL
244,1295,18,1313,1691,0,0,77.65,803,492,平安里,NULL
523,1301,12,1313,1664,0,0,78.91,752,549,松基里,NULL
0,1307,6,1313,1791,0,0,73.31,748,559,公園里,NULL
2033,1301,12,1313,1677,0,0,78.29,741,560,義仁村,NULL
319,1299,14,1313,1675,0,0,78.39,733,566,螺潭村,NULL
0,1299,14,1313,1675,0,0,78.39,733,566,螺潭村,NULL
724,1297,16,1313,1676,0,0,78.34,701,596,墩北村,NULL
302,1300,13,1313,1678,0,0,78.25,692,608,福山里,NULL
213,1296,17,1313,1653,0,0,79.43,687,609,德華里,NULL
0,1303,10,1313,1827,0,0,71.87,563,740,鯤鯓里,NULL
689,1306,6,1312,1573,0,0,83.41,944,362,景文里,NULL
160,1302,10,1312,1685,0,0,77.86,925,377,大有里,NULL
489,1300,12,1312,1703,0,0,77.04,900,400,光明里,NULL
1568,1302,10,1312,1751,0,0,74.93,869,433,崇德里,NULL
305,1304,8,1312,1560,0,0,84.1,867,437,港華里,NULL
374,1302,10,1312,1604,0,0,81.8,832,470,東湖里,NULL
925,1296,16,1312,1673,0,0,78.42,830,466,後溪里,NULL
0,1296,16,1312,1673,0,0,78.42,830,466,後溪里,NULL
812,1301,11,1312,1677,0,0,78.23,794,507,潭陽村,NULL
543,1292,20,1312,1671,0,0,78.52,757,535,崇倫里,NULL
0,1300,12,1312,1729,0,0,75.88,700,600,仁愛里,NULL
79,1304,8,1312,1647,0,0,79.66,657,647,大同里,NULL
0,1300,12,1312,1765,0,0,74.33,614,686,園寮村,NULL
0,1304,8,1312,1737,0,0,75.53,436,868,鳳芸村,NULL
1196,1305,6,1311,1612,0,0,81.33,992,313,中央里,NULL
80,1302,9,1311,1688,0,0,77.67,939,363,永安里,NULL
351,1307,4,1311,1621,0,0,80.88,927,380,康寧里,NULL
522,1299,12,1311,1680,0,0,78.04,914,385,民福里,NULL
619,1301,10,1311,1646,0,0,79.65,893,408,四維里,NULL
554,1300,11,1311,1654,0,0,79.26,786,514,中正里,NULL
592,1298,13,1311,1617,0,0,81.08,740,558,奏捷里,NULL
0,1298,13,1311,1617,0,0,81.08,740,558,奏捷里,NULL
308,1302,9,1311,1694,0,0,77.39,724,578,竹東村,NULL
220,1292,19,1311,1814,0,0,72.27,635,657,柳林村,NULL
0,1292,19,1311,1814,0,0,72.27,635,657,柳林村,NULL
0,1298,13,1311,3675,4443,82.71,35.67,605,693,望安鄉,Wangan Township
0,1288,23,1311,1737,0,0,75.47,542,746,崙頂里,NULL
25,1298,13,1311,1631,0,0,80.38,410,888,錦屏里,NULL
703,1289,21,1310,1669,0,0,78.49,966,323,湧光里,NULL
226,1301,9,1310,1762,0,0,74.35,918,383,大湖村,NULL
211,1301,9,1310,1678,0,0,78.07,813,488,延平里,NULL
231,1292,18,1310,1665,0,0,78.68,799,493,松竹里,NULL
53,1302,8,1310,1577,0,0,83.07,753,549,盛昌里,NULL
88,1295,15,1310,1807,0,0,72.5,752,543,中心里,NULL
2065,1296,14,1310,1670,0,0,78.44,747,549,湖南村,NULL
557,1293,17,1310,1656,0,0,79.11,677,616,西湳里,NULL
382,1304,6,1310,1622,0,0,80.76,673,631,本元里,NULL
1018,1300,10,1310,1607,0,0,81.52,654,646,和平里,NULL
325,1298,12,1310,1618,0,0,80.96,538,760,達明里,NULL
0,1298,12,1310,1618,0,0,80.96,538,760,達明里,NULL
665,1301,8,1309,1681,0,0,77.87,1001,300,中山里,NULL
83,1300,9,1309,1664,0,0,78.67,939,361,莊敬里,NULL
829,1291,18,1309,1628,0,0,80.41,922,369,永貞里,NULL
172,1299,10,1309,1673,0,0,78.24,863,436,惠中里,NULL
523,1301,8,1309,1722,0,0,76.02,836,465,永興里,NULL
1278,1288,21,1309,1723,0,0,75.97,772,516,日興里,NULL
0,1294,15,1309,1721,0,0,76.06,696,598,廣福里,NULL
2032,1299,10,1309,1726,0,0,75.84,690,609,義仁村,NULL
0,1302,7,1309,1748,0,0,74.89,657,645,永華村,NULL
823,1298,11,1309,1677,0,0,78.06,624,674,建泰里,NULL
638,1298,11,1309,1682,0,0,77.82,591,707,埔園里,NULL
0,1298,10,1308,1573,0,0,83.15,1168,130,光明里,NULL
938,1297,11,1308,1632,0,0,80.15,895,402,新營里,NULL
1230,1298,10,1308,1637,0,0,79.9,862,436,光信里,NULL
1114,1291,17,1308,1685,0,0,77.63,847,444,古風里,NULL
737,1296,12,1308,1639,0,0,79.8,834,462,義興里,NULL
0,1301,7,1308,1673,0,0,78.18,791,510,新華里,NULL
486,1290,18,1308,1663,0,0,78.65,763,527,東信里,NULL
0,1299,9,1308,1660,0,0,78.8,745,554,北口村,NULL
0,1295,13,1308,1594,0,0,82.06,721,574,彌陀村,NULL
298,1301,7,1308,1704,0,0,76.76,611,690,興德里,NULL
0,1301,7,1308,1704,0,0,76.76,611,690,興德里,NULL
1021,1300,8,1308,1645,0,0,79.51,589,711,和德里,NULL
0,1294,14,1308,1822,0,0,71.79,568,726,嘉興村,NULL
324,1298,9,1307,1590,0,0,82.2,941,357,秀湖里,NULL
1293,1298,9,1307,1578,0,0,82.83,913,385,興福里,NULL
777,1299,8,1307,1590,0,0,82.2,884,415,秀成里,NULL
1324,1299,8,1307,1774,0,0,73.68,850,449,木新里,NULL
898,1295,12,1307,1609,0,0,81.23,826,469,頂東里,NULL
1893,1301,6,1307,1680,0,0,77.8,809,492,鄧公里,NULL
608,1293,14,1307,1693,0,0,77.2,800,493,水尾里,NULL
226,1297,10,1307,1634,0,0,79.99,763,534,彰安里,NULL
407,1299,8,1307,1697,0,0,77.02,754,545,福利里,NULL
0,1299,8,1307,1697,0,0,77.02,754,545,福利里,NULL
149,1295,12,1307,1636,0,0,79.89,721,574,新光里,NULL
376,1292,15,1307,1828,0,0,71.5,710,582,灣橋村,NULL
481,1298,9,1307,1694,0,0,77.15,683,615,新生里,NULL
1484,1289,18,1307,1685,0,0,77.57,640,649,永德里,NULL
843,1297,10,1307,1621,0,0,80.63,624,673,雙連里,NULL
183,1300,7,1307,1653,0,0,79.07,583,717,社子里,NULL
170,1299,7,1306,1613,0,0,80.97,832,467,惠中里,NULL
475,1295,11,1306,1666,0,0,78.39,803,492,東榮里,NULL
529,1286,20,1306,1607,0,0,81.27,787,499,樹義里,NULL
722,1292,14,1306,1585,0,0,82.4,767,525,文華里,NULL
933,1293,13,1306,1745,0,0,74.84,757,536,清華村,NULL
988,1294,12,1306,1606,0,0,81.32,707,587,福音里,NULL
342,1294,12,1306,1671,0,0,78.16,686,608,復興里,NULL
156,1292,14,1306,1642,0,0,79.54,610,682,菜公里,NULL
865,1294,12,1306,1641,0,0,79.59,582,712,斯文里,NULL
0,1292,14,1306,1652,0,0,79.06,512,780,嘉峰里,NULL
1259,1297,8,1305,1641,0,0,79.52,995,302,安昌里,NULL
98,1294,11,1305,1597,0,0,81.72,967,327,仁愛里,NULL
1295,1292,13,1305,1667,0,0,78.28,911,381,員潭里,NULL
1580,1290,15,1305,1782,0,0,73.23,864,426,保長里,NULL
580,1293,12,1305,1656,0,0,78.8,828,465,福真里,NULL
457,1297,8,1305,1651,0,0,79.04,814,483,正興里,NULL
421,1300,5,1305,1703,0,0,76.63,788,512,公德里,NULL
1005,1295,10,1305,1596,0,0,81.77,766,529,糖廍里,NULL
483,1292,13,1305,1665,0,0,78.38,701,591,瓦北村,NULL
0,1292,13,1305,1665,0,0,78.38,701,591,瓦北村,NULL
819,1296,9,1305,1626,0,0,80.26,607,689,瑞祥里,NULL
0,1294,11,1305,1758,0,0,74.23,580,714,竹崙里,NULL
27,1294,10,1304,1757,0,0,74.22,791,503,下犁村,NULL
0,1294,10,1304,1757,0,0,74.22,791,503,下犁村,NULL
662,1291,13,1304,1731,0,0,75.33,764,527,中央里,NULL
0,1291,13,1304,1731,0,0,75.33,764,527,中央里,NULL
459,1293,11,1304,1645,0,0,79.27,749,544,正興里,NULL
720,1291,13,1304,1694,0,0,76.98,743,548,集英里,NULL
425,1297,7,1304,1689,0,0,77.21,669,628,寶安里,NULL
828,1295,9,1304,1726,0,0,75.55,666,629,朝陽里,NULL
1000,1293,11,1304,1690,0,0,77.16,653,640,中美里,NULL
313,1293,11,1304,1845,0,0,70.68,578,715,大隱村,NULL
0,1296,7,1303,2469,0,0,52.77,1249,47,榜林村,NULL
40,1294,9,1303,1834,0,0,71.05,1013,281,豐榮里,NULL
64,1291,12,1303,1736,0,0,75.06,944,347,國富里,NULL
708,1295,8,1303,1611,0,0,80.88,900,395,湧豐里,NULL
0,1295,8,1303,1611,0,0,80.88,900,395,湧豐里,NULL
0,1297,6,1303,1867,0,0,69.79,828,469,楠西村,NULL
410,1292,11,1303,1636,0,0,79.65,800,492,南港里,NULL
562,1285,18,1303,1549,0,0,84.12,796,489,敦化里,NULL
599,1291,12,1303,1657,0,0,78.64,721,570,北陽里,NULL
156,1291,12,1303,1650,0,0,78.97,689,602,大港里,NULL
1478,1292,11,1303,1688,0,0,77.19,678,614,成功里,NULL
0,1291,12,1303,1817,0,0,71.71,507,784,油車村,NULL
0,1292,10,1302,1659,0,0,78.48,1125,167,光榮里,NULL
17,1297,5,1302,1642,0,0,79.29,954,343,斗崙里,NULL
1151,1295,7,1302,1649,0,0,78.96,867,428,新生里,NULL
1614,1290,12,1302,1688,0,0,77.13,844,446,康福里,NULL
846,1291,11,1302,1832,0,0,71.07,809,482,三湖里,NULL
916,1292,10,1302,1645,0,0,79.15,807,485,龍興里,NULL
239,1290,12,1302,1696,0,0,76.77,768,522,福德里,NULL
0,1286,16,1302,1627,0,0,80.02,746,540,三龍里,NULL
558,1287,15,1302,1662,0,0,78.34,744,543,豐西里,NULL
0,1287,15,1302,1662,0,0,78.34,744,543,豐西里,NULL
0,1295,7,1302,1760,0,0,73.98,633,662,下寮村,NULL
437,1295,7,1302,1738,0,0,74.91,603,692,下坑村,NULL
0,1295,7,1302,1738,0,0,74.91,603,692,下坑村,NULL
570,1287,14,1301,1593,0,0,81.67,941,346,德行里,NULL
555,1293,8,1301,1639,0,0,79.38,846,447,中崙里,NULL
384,1295,6,1301,1631,0,0,79.77,801,494,樂康里,NULL
0,1290,11,1301,1628,0,0,79.91,789,501,博愛里,NULL
106,1290,11,1301,1598,0,0,81.41,751,539,豐樂里,NULL
128,1288,13,1301,1616,0,0,80.51,722,566,仁勇里,NULL
81,1283,18,1301,1854,0,0,70.17,675,608,振興村,NULL
0,1283,18,1301,1854,0,0,70.17,675,608,振興村,NULL
771,1289,12,1301,1626,0,0,80.01,653,636,行仁里,NULL
0,1288,13,1301,1618,0,0,80.41,606,682,興和里,NULL
40,1294,7,1301,1691,0,0,76.94,546,748,總頭里,NULL
0,1294,7,1301,1691,0,0,76.94,546,748,總頭里,NULL
0,1286,14,1300,1639,0,0,79.32,1001,285,獅潭村,NULL
563,1293,7,1300,1578,0,0,82.38,935,358,連城里,NULL
282,1285,15,1300,1647,0,0,78.93,901,384,忠平里,NULL
312,1291,9,1300,1682,0,0,77.29,870,421,崇蘭里,NULL
470,1290,10,1300,1605,0,0,81,832,458,莊敬里,NULL
224,1289,11,1300,1597,0,0,81.4,821,468,芝山里,NULL
73,1290,10,1300,1625,0,0,80,768,522,泰山里,NULL
254,1289,11,1300,1710,0,0,76.02,767,522,重慶里,NULL
73,1291,9,1300,1595,0,0,81.5,730,561,國昌里,NULL
202,1285,15,1300,1695,0,0,76.7,712,573,迴龍村,NULL
788,1287,13,1300,1703,0,0,76.34,668,619,西寶村,NULL
148,1283,17,1300,1627,0,0,79.9,651,632,文聖里,NULL
167,1294,6,1300,1604,0,0,81.05,636,658,福山里,NULL
874,1291,9,1300,1654,0,0,78.6,619,672,至聖里,NULL
0,1295,5,1300,1646,0,0,78.98,597,698,振豐村,NULL
359,1291,9,1300,1565,0,0,83.07,574,717,鼎中里,NULL
0,1289,11,1300,1725,0,0,75.36,531,758,延平里,NULL
910,1289,10,1299,1602,0,0,81.09,976,313,保順里,NULL
1074,1284,15,1299,1674,0,0,77.6,955,329,德安里,NULL
0,1291,8,1299,1781,0,0,72.94,946,345,主學里,NULL
70,1289,10,1299,1716,0,0,75.7,904,385,六分村,NULL
0,1289,10,1299,1716,0,0,75.7,904,385,六分村,NULL
1193,1298,1,1299,1670,0,0,77.78,886,412,大學里,NULL
786,1290,9,1299,1653,0,0,78.58,736,554,江山里,NULL
493,1288,11,1299,1753,0,0,74.1,618,670,芎蕉村,NULL
0,1288,11,1299,1753,0,0,74.1,618,670,芎蕉村,NULL
153,1282,17,1299,1638,0,0,79.3,583,699,大和里,NULL
0,1286,12,1298,1936,0,0,67.05,941,345,瑞穗村,NULL
35,1289,9,1298,1622,0,0,80.02,893,396,翠屏里,NULL
681,1280,18,1298,1632,0,0,79.53,890,390,景新里,NULL
349,1291,7,1298,1589,0,0,81.69,877,414,金湖里,NULL
84,1288,10,1298,1600,0,0,81.13,754,534,華江里,NULL
0,1278,20,1298,1714,0,0,75.73,723,555,湖山里,NULL
176,1285,13,1298,1790,0,0,72.51,722,563,南紙里,NULL
253,1282,16,1298,1694,0,0,76.62,721,561,東芳里,NULL
160,1295,3,1298,1579,0,0,82.2,688,607,百齡里,NULL
521,1292,6,1298,1586,0,0,81.84,680,612,開平里,NULL
0,1278,20,1298,1722,0,0,75.38,676,602,梅林里,NULL
0,1284,14,1298,1765,0,0,73.54,624,660,光復里,NULL
847,1281,17,1298,1635,0,0,79.39,579,702,南芳里,NULL
336,1288,9,1297,1536,0,0,84.44,1059,229,紫雲里,NULL
0,1290,7,1297,1708,0,0,75.94,1019,271,大湖村,NULL
506,1285,12,1297,1583,0,0,81.93,1001,284,龍田里,NULL
570,1278,19,1297,1675,0,0,77.43,950,328,至善里,NULL
1894,1290,7,1297,1656,0,0,78.32,896,394,鄧公里,NULL
0,1284,13,1297,2094,0,0,61.94,888,396,蚊港村,NULL
1084,1285,12,1297,1689,0,0,76.79,799,486,民炤里,NULL
1719,1281,16,1297,1680,0,0,77.2,757,524,東陽里,NULL
1041,1287,10,1297,1654,0,0,78.42,742,545,中原里,NULL
519,1287,10,1297,1695,0,0,76.52,695,592,福隆里,NULL
829,1290,7,1297,1660,0,0,78.13,652,638,朝陽里,NULL
320,1283,14,1297,1581,0,0,82.04,514,769,安生里,NULL
0,1283,14,1297,1581,0,0,82.04,514,769,安生里,NULL
300,1287,10,1297,1753,0,0,73.99,410,877,喜東里,NULL
0,1287,10,1297,1753,0,0,73.99,410,877,喜東里,NULL
337,1280,16,1296,1569,0,0,82.6,942,338,紫雲里,NULL
335,1285,11,1296,1586,0,0,81.72,873,412,紫雲里,NULL
597,1278,18,1296,1607,0,0,80.65,864,414,佳和里,NULL
381,1283,13,1296,1626,0,0,79.7,823,460,樂康里,NULL
1865,1286,10,1296,1657,0,0,78.21,813,473,民生里,NULL
322,1284,12,1296,1650,0,0,78.55,804,480,秀湖里,NULL
2011,1286,10,1296,1661,0,0,78.03,788,498,山腳村,NULL
633,1286,10,1296,1618,0,0,80.1,776,510,正大里,NULL
752,1284,12,1296,1647,0,0,78.69,753,531,冠穗里,NULL
609,1283,13,1296,1645,0,0,78.78,753,530,南村里,NULL
75,1286,10,1296,1648,0,0,78.64,719,567,長安里,NULL
1488,1282,14,1296,1682,0,0,77.05,672,610,信義里,NULL
111,1284,12,1296,1650,0,0,78.55,637,647,桃源里,NULL
504,1285,10,1295,1663,0,0,77.87,1191,94,龍田里,NULL
135,1278,17,1295,1625,0,0,79.69,898,380,三義里,NULL
22,1285,10,1295,1754,0,0,73.83,893,392,東海里,NULL
1200,1281,14,1295,1586,0,0,81.65,892,389,黎元里,NULL
674,1282,13,1295,1695,0,0,76.4,872,410,泰和里,NULL
533,1272,23,1295,1603,0,0,80.79,826,446,鵬程里,NULL
255,1285,10,1295,1603,0,0,80.79,815,470,重慶里,NULL
501,1277,18,1295,1696,0,0,76.36,787,490,宜佳里,NULL
745,1283,12,1295,1633,0,0,79.3,780,503,中興里,NULL
0,1288,7,1295,1740,0,0,74.43,702,586,西勢里,NULL
334,1278,17,1295,1799,0,0,71.98,674,604,東湖村,NULL
0,1278,17,1295,1799,0,0,71.98,674,604,東湖村,NULL
719,1283,12,1295,1678,0,0,77.18,658,625,集英里,NULL
510,1290,5,1295,1656,0,0,78.2,655,635,永清里,NULL
0,1278,17,1295,1782,0,0,72.67,565,713,溪洲村,NULL
107,1284,10,1294,1583,0,0,81.74,1065,219,榮華里,NULL
1071,1285,9,1294,1635,0,0,79.14,1003,282,凌霄里,NULL
906,1282,12,1294,1715,0,0,75.45,954,328,中興村,NULL
375,1288,6,1294,1615,0,0,80.12,918,370,羊稠村,NULL
131,1283,11,1294,1726,0,0,74.97,866,417,寶山里,NULL
6,1280,14,1294,1703,0,0,75.98,790,490,海尾村,NULL
0,1280,14,1294,1703,0,0,75.98,790,490,海尾村,NULL
430,1281,13,1294,1744,0,0,74.2,778,503,金城里,NULL
158,1284,10,1294,1650,0,0,78.42,762,522,菜公里,NULL
798,1284,10,1294,1671,0,0,77.44,750,534,員林村,NULL
324,1285,9,1294,1621,0,0,79.83,746,539,大福里,NULL
556,1284,10,1294,1568,0,0,82.53,741,543,中崙里,NULL
612,1286,8,1294,1765,0,0,73.31,713,573,福興村,NULL
0,1286,8,1294,1765,0,0,73.31,713,573,福興村,NULL
352,1287,7,1294,1636,0,0,79.1,596,691,鼎力里,NULL
21,1282,12,1294,1660,0,0,77.95,594,688,惠民里,NULL
789,1284,9,1293,1551,0,0,83.37,1105,179,忠純里,NULL
153,1284,9,1293,1671,0,0,77.38,973,311,壯觀里,NULL
18,1290,3,1293,1655,0,0,78.13,905,385,山腳里,NULL
260,1283,10,1293,1674,0,0,77.24,756,527,瑞光里,NULL
253,1281,12,1293,1702,0,0,75.97,744,537,重慶里,NULL
268,1288,5,1293,1666,0,0,77.61,739,549,清溪里,NULL
288,1281,12,1293,1685,0,0,76.74,738,543,自強村,NULL
1078,1276,17,1293,1695,0,0,76.28,712,564,龍鳳里,NULL
955,1278,15,1293,1585,0,0,81.58,707,571,文明里,NULL
0,1278,15,1293,1585,0,0,81.58,707,571,文明里,NULL
401,1286,7,1293,1711,0,0,75.57,698,588,寶泰里,NULL
542,1283,10,1293,1671,0,0,77.38,588,695,苓中里,NULL
0,1283,10,1293,1671,0,0,77.38,588,695,苓中里,NULL
534,1277,16,1293,1660,0,0,77.89,586,691,慈愛里,NULL
1166,1285,7,1292,1613,0,0,80.1,996,289,新安里,NULL
1256,1283,9,1292,1608,0,0,80.35,977,306,公崙里,NULL
675,1278,14,1292,1608,0,0,80.35,887,391,泰和里,NULL
1344,1278,14,1292,1574,0,0,82.08,886,392,樟腳里,NULL
664,1278,14,1292,1607,0,0,80.4,877,401,三張里,NULL
318,1284,8,1292,1740,0,0,74.25,870,414,錦祥里,NULL
254,1286,6,1292,1633,0,0,79.12,837,449,平德里,NULL
150,1276,16,1292,1702,0,0,75.91,823,453,龍壽里,NULL
2045,1273,19,1292,1591,0,0,81.21,820,453,貴賢村,NULL
652,1283,9,1292,1790,0,0,72.18,815,468,三和里,NULL
218,1280,12,1292,1679,0,0,76.95,767,513,山德村,NULL
279,1283,9,1292,1569,0,0,82.35,766,517,西湖里,NULL
398,1284,8,1292,1770,0,0,72.99,738,546,仁化里,NULL
580,1282,10,1292,1645,0,0,78.54,704,578,林中里,NULL
0,1283,9,1292,1749,0,0,73.87,644,639,觀亭村,NULL
462,1282,10,1292,1638,0,0,78.88,595,687,灣興里,NULL
0,1282,10,1292,1638,0,0,78.88,595,687,灣興里,NULL
897,1281,10,1291,1632,0,0,79.11,923,358,中正村,NULL
694,1285,6,1291,1587,0,0,81.35,922,363,錦昌里,NULL
0,1285,6,1291,1587,0,0,81.35,922,363,錦昌里,NULL
465,1288,3,1291,1597,0,0,80.84,910,378,成福里,NULL
0,1281,10,1291,1598,0,0,80.79,888,393,館中村,NULL
585,1276,15,1291,1534,0,0,84.16,885,391,福美里,NULL
1859,1284,7,1291,1597,0,0,80.84,881,403,福德里,NULL
257,1276,15,1291,1670,0,0,77.31,855,421,漳和里,NULL
587,1284,7,1291,1606,0,0,80.39,840,444,興雅里,NULL
64,1281,10,1291,1625,0,0,79.45,813,468,中山里,NULL
291,1282,9,1291,1573,0,0,82.07,799,483,港墘里,NULL
670,1273,18,1291,1687,0,0,76.53,773,500,新盛里,NULL
360,1280,11,1291,1644,0,0,78.53,771,509,東明里,NULL
216,1279,12,1291,1674,0,0,77.12,737,542,金城里,NULL
0,1279,12,1291,1674,0,0,77.12,737,542,金城里,NULL
306,1283,8,1291,1595,0,0,80.94,721,562,九德村,NULL
1525,1278,13,1291,1681,0,0,76.8,712,566,水河里,NULL
150,1284,7,1291,1600,0,0,80.69,651,633,文成里,NULL
170,1278,13,1291,1777,0,0,72.65,622,656,民榮里,NULL
0,1281,10,1291,1756,0,0,73.52,547,734,朝安里,NULL
0,1286,5,1291,1591,0,0,81.14,539,747,江山村,NULL
125,1275,15,1290,1845,0,0,69.92,1002,273,南昌村,NULL
1621,1279,11,1290,1694,0,0,76.15,961,318,湖興里,NULL
1158,1284,6,1290,1624,0,0,79.43,903,381,義安里,NULL
1104,1281,9,1290,1746,0,0,73.88,891,390,光武里,NULL
1342,1279,11,1290,1608,0,0,80.22,890,389,樟新里,NULL
1096,1276,14,1290,1692,0,0,76.24,867,409,民輝里,NULL
598,1276,14,1290,1638,0,0,78.75,817,459,南陽里,NULL
631,1282,8,1290,1678,0,0,76.88,793,489,惠來里,NULL
709,1277,13,1290,1605,0,0,80.37,782,495,文元里,NULL
373,1279,11,1290,1579,0,0,81.7,769,510,東湖里,NULL
409,1280,10,1290,1642,0,0,78.56,739,541,清和里,NULL
530,1277,13,1290,1627,0,0,79.29,731,546,安平里,NULL
129,1273,17,1290,1624,0,0,79.43,703,570,松翠里,NULL
382,1281,9,1290,1626,0,0,79.34,697,584,裕農里,NULL
1003,1277,13,1290,1629,0,0,79.19,653,624,糖廍里,NULL
257,1278,12,1290,1583,0,0,81.49,561,717,文華里,NULL
299,1277,13,1290,1618,0,0,79.73,489,788,鳳北里,NULL
0,1277,13,1290,1618,0,0,79.73,489,788,鳳北里,NULL
744,1273,16,1289,1656,0,0,77.84,850,423,錦盛里,NULL
607,1280,9,1289,1595,0,0,80.82,833,447,五常里,NULL
690,1282,7,1289,1715,0,0,75.16,812,470,黎順里,NULL
240,1274,15,1289,1707,0,0,75.51,797,477,五權里,NULL
391,1274,15,1289,1675,0,0,76.96,785,489,民龍里,NULL
1080,1284,5,1289,1622,0,0,79.47,781,503,龍鳳里,NULL
112,1281,8,1289,1712,0,0,75.29,745,536,慈文里,NULL
361,1276,13,1289,1645,0,0,78.36,730,546,東明里,NULL
379,1281,8,1289,1569,0,0,82.15,693,588,田安里,NULL
962,1268,21,1289,1740,0,0,74.08,633,635,保生村,NULL
0,1268,21,1289,1740,0,0,74.08,633,635,保生村,NULL
0,1273,16,1289,1751,0,0,73.62,575,698,四合村,NULL
875,1280,9,1289,1643,0,0,78.45,566,714,老師里,NULL
804,1279,9,1288,1564,0,0,82.35,1087,192,龍洲里,NULL
77,1272,16,1288,1740,0,0,74.02,845,427,三崁村,NULL
0,1272,16,1288,1740,0,0,74.02,845,427,三崁村,NULL
302,1280,8,1288,1576,0,0,81.73,780,500,港富里,NULL
504,1275,13,1288,1738,0,0,74.11,767,508,新坪里,NULL
24,1280,8,1288,1579,0,0,81.57,758,522,裕民里,NULL
696,1275,13,1288,1676,0,0,76.85,736,539,港西村,NULL
0,1275,13,1288,1676,0,0,76.85,736,539,港西村,NULL
105,1279,9,1288,1592,0,0,80.9,718,561,新翠里,NULL
415,1271,17,1288,1745,0,0,73.81,664,607,和興村,NULL
113,1280,8,1288,1762,0,0,73.1,634,646,內田村,NULL
0,1275,13,1288,1674,0,0,76.94,456,819,大潭村,NULL
24,1277,10,1287,1607,0,0,80.09,1022,255,勝利里,NULL
20,1281,6,1287,1522,0,0,84.56,956,325,斗崙里,NULL
342,1279,8,1287,1560,0,0,82.5,950,329,葫洲里,NULL
906,1284,3,1287,1557,0,0,82.66,926,358,保安里,NULL
325,1280,7,1287,1596,0,0,80.64,908,372,金龍里,NULL
904,1280,7,1287,1597,0,0,80.59,894,386,螢圃里,NULL
695,1275,12,1287,1603,0,0,80.29,882,393,黎平里,NULL
227,1279,8,1287,1643,0,0,78.33,831,448,大湖村,NULL
379,1270,17,1287,1667,0,0,77.2,789,481,廣民里,NULL
0,1270,17,1287,1667,0,0,77.2,789,481,廣民里,NULL
0,1273,14,1287,1707,0,0,75.4,759,514,林內村,NULL
1087,1281,6,1287,1637,0,0,78.62,731,550,民炤里,NULL
399,1275,12,1287,1724,0,0,74.65,731,544,仁化里,NULL
1964,1272,15,1287,1680,0,0,76.61,681,591,興珍村,NULL
1508,1272,15,1287,1631,0,0,78.91,670,602,仁德里,NULL
309,1277,10,1287,1543,0,0,83.41,558,719,安宜里,NULL
894,1278,8,1286,1571,0,0,81.86,1006,272,安和里,NULL
819,1277,9,1286,1624,0,0,79.19,910,367,豫溪里,NULL
1241,1274,12,1286,1608,0,0,79.98,907,367,柴埕里,NULL
682,1273,13,1286,1576,0,0,81.6,897,376,景福里,NULL
39,1265,21,1286,1610,0,0,79.88,809,456,和西里,NULL
278,1275,11,1286,1609,0,0,79.93,792,483,西湖里,NULL
317,1275,11,1286,1675,0,0,76.78,777,498,成和里,NULL
411,1277,9,1286,1605,0,0,80.12,739,538,中興里,NULL
1596,1269,17,1286,1691,0,0,76.05,733,536,樟樹里,NULL
0,1269,17,1286,1691,0,0,76.05,733,536,樟樹里,NULL
728,1278,8,1286,1708,0,0,75.29,730,548,圓山里,NULL
602,1269,17,1286,1646,0,0,78.13,727,542,北陽里,NULL
556,1270,16,1286,1669,0,0,77.05,676,594,五順里,NULL
87,1270,15,1285,1594,0,0,80.61,1051,219,大鄉里,NULL
363,1277,8,1285,1583,0,0,81.17,1012,265,瑞陽里,NULL
240,1273,12,1285,1634,0,0,78.64,911,362,營北里,NULL
468,1272,13,1285,1574,0,0,81.64,902,370,仁福里,NULL
1780,1274,11,1285,1638,0,0,78.45,873,401,大湖里,NULL
252,1277,8,1285,1647,0,0,78.02,866,411,瑞泰里,NULL
690,1268,17,1285,1651,0,0,77.83,861,407,金星里,NULL
1216,1277,8,1285,1710,0,0,75.15,838,439,敦安里,NULL
375,1269,16,1285,1619,0,0,79.37,820,449,東湖里,NULL
517,1277,8,1285,1628,0,0,78.93,724,553,平和里,NULL
400,1274,11,1285,1669,0,0,76.99,713,561,仁德里,NULL
0,1279,6,1285,1643,0,0,78.21,686,593,秀水村,NULL
466,1272,13,1285,1610,0,0,79.81,682,590,六合里,NULL
93,1268,17,1285,1716,0,0,74.88,647,621,福和里,NULL
42,1276,9,1285,1841,0,0,69.8,583,693,學東里,NULL
0,1276,9,1285,1841,0,0,69.8,583,693,學東里,NULL
97,1275,10,1285,1634,0,0,78.64,536,739,東石里,NULL
532,1278,6,1284,1556,0,0,82.52,1076,202,鵬程里,NULL
1161,1274,10,1284,1552,0,0,82.73,1011,263,五峰里,NULL
878,1273,11,1284,1673,0,0,76.75,1007,266,烏林村,NULL
869,1271,13,1284,1569,0,0,81.84,948,323,智光里,NULL
343,1269,15,1284,1581,0,0,81.21,934,335,葫洲里,NULL
676,1277,7,1284,1618,0,0,79.36,873,404,泰和里,NULL
0,1271,13,1284,1850,0,0,69.41,867,404,福龜村,NULL
11,1275,9,1284,1606,0,0,79.95,807,468,思源里,NULL
243,1270,14,1284,1608,0,0,79.85,798,472,崙平里,NULL
27,1274,10,1284,1698,0,0,75.62,739,535,圳頭里,NULL
378,1273,11,1284,1569,0,0,81.84,623,650,田中里,NULL
877,1276,8,1284,1608,0,0,79.85,619,657,老師里,NULL
298,1278,6,1284,1846,0,0,69.56,535,743,季新村,NULL
0,1277,7,1284,1707,0,0,75.22,344,933,中洲村,NULL
905,1267,16,1283,1668,0,0,76.92,1063,204,東興村,NULL
821,1278,5,1283,1581,0,0,81.15,907,371,大同里,NULL
197,1270,13,1283,1688,0,0,76.01,872,398,碇和里,NULL
1203,1272,11,1283,1567,0,0,81.88,846,426,黎孝里,NULL
593,1269,14,1283,1565,0,0,81.98,843,426,瓦磘里,NULL
39,1272,11,1283,1663,0,0,77.15,809,463,翠屏里,NULL
309,1280,3,1283,1620,0,0,79.2,804,476,內湖里,NULL
545,1271,12,1283,1596,0,0,80.39,795,476,新聚里,NULL
242,1272,11,1283,1603,0,0,80.04,757,515,竹溪里,NULL
0,1272,11,1283,1603,0,0,80.04,757,515,竹溪里,NULL
431,1263,20,1283,1730,0,0,74.16,731,532,公園里,NULL
0,1263,20,1283,1730,0,0,74.16,731,532,公園里,NULL
355,1268,15,1283,1576,0,0,81.41,660,608,後甲里,NULL
842,1276,7,1283,1624,0,0,79,593,683,雙連里,NULL
518,1272,11,1283,1775,0,0,72.28,537,735,萬建村,NULL
0,1275,8,1283,1719,0,0,74.64,537,738,三廍村,NULL
0,1272,11,1283,1775,0,0,72.28,537,735,萬建村,NULL
46,1273,9,1282,1644,0,0,77.98,932,341,國風里,NULL
207,1264,18,1282,1583,0,0,80.99,928,336,信勢村,NULL
1878,1270,12,1282,1637,0,0,78.31,900,370,水碓里,NULL
611,1268,14,1282,1649,0,0,77.74,829,439,忠義里,NULL
0,1268,14,1282,1649,0,0,77.74,829,439,忠義里,NULL
75,1271,11,1282,1580,0,0,81.14,827,444,加昌里,NULL
547,1270,12,1282,1592,0,0,80.53,789,481,新聚里,NULL
1869,1266,16,1282,1665,0,0,77,784,482,八勢里,NULL
301,1257,25,1282,1658,0,0,77.32,753,504,福山里,NULL
375,1275,7,1282,1610,0,0,79.63,739,536,中西里,NULL
78,1266,16,1282,1686,0,0,76.04,710,556,月眉里,NULL
460,1275,7,1282,1625,0,0,78.89,695,580,信安里,NULL
0,1275,7,1282,1625,0,0,78.89,695,580,信安里,NULL
1456,1271,11,1282,1647,0,0,77.84,651,620,延平里,NULL
0,1278,4,1282,1605,0,0,79.88,569,709,社東村,NULL
314,1271,10,1281,1743,0,0,73.49,909,362,潭墘里,NULL
1152,1272,9,1281,1609,0,0,79.61,908,364,新生里,NULL
848,1265,16,1281,1814,0,0,70.62,825,440,上湖里,NULL
0,1272,9,1281,1747,0,0,73.33,806,466,永平村,NULL
307,1261,20,1281,1640,0,0,78.11,749,512,大竹里,NULL
1028,1266,15,1281,1635,0,0,78.35,705,561,中港里,NULL
0,1273,8,1281,1841,0,0,69.58,692,581,山崇里,NULL
471,1274,7,1281,1609,0,0,79.61,645,629,安吉里,NULL
0,1278,3,1281,1648,0,0,77.73,516,762,溪埔村,NULL
1284,1273,7,1280,1561,0,0,82,923,350,興得里,NULL
462,1262,18,1280,1711,0,0,74.81,764,498,中平里,NULL
0,1269,11,1280,1871,0,0,68.41,754,515,豐田里,NULL
68,1275,5,1280,1587,0,0,80.66,747,528,隆昌里,NULL
343,1269,11,1280,1808,0,0,70.8,672,597,延祥里,NULL
979,1265,15,1280,1600,0,0,80,637,628,昌明里,NULL
515,1268,12,1280,1579,0,0,81.06,635,633,溪美里,NULL
680,1272,8,1280,1648,0,0,77.67,577,695,港明里,NULL
0,1269,11,1280,1760,0,0,72.73,552,717,白河里,NULL
56,1266,14,1280,1737,0,0,73.69,515,751,淵東里,NULL
0,1264,16,1280,1723,0,0,74.29,445,819,月眉村,NULL
637,1267,12,1279,1536,0,0,83.27,1042,225,龍平里,NULL
1220,1260,19,1279,1539,0,0,83.11,987,273,寶福里,NULL
1160,1266,13,1279,1617,0,0,79.1,930,336,五峰里,NULL
592,1266,13,1279,1617,0,0,79.1,848,418,廣居里,NULL
739,1268,11,1279,1627,0,0,78.61,827,441,大直里,NULL
1262,1264,15,1279,1688,0,0,75.77,794,470,德安里,NULL
634,1266,13,1279,1750,0,0,73.09,791,475,復盛村,NULL
0,1266,13,1279,1750,0,0,73.09,791,475,復盛村,NULL
386,1271,8,1279,1619,0,0,79,762,509,公館里,NULL
109,1267,12,1279,1589,0,0,80.49,712,555,桃源里,NULL
983,1274,5,1279,1645,0,0,77.75,660,614,青山里,NULL
1753,1263,16,1279,1667,0,0,76.72,647,616,二橋里,NULL
0,1267,12,1279,1775,0,0,72.06,502,765,六合村,NULL
244,1268,10,1278,1633,0,0,78.26,924,344,內興里,NULL
543,1268,10,1278,1623,0,0,78.74,878,390,新興里,NULL
106,1268,10,1278,1541,0,0,82.93,818,450,新翠里,NULL
251,1273,5,1278,1658,0,0,77.08,817,456,天和里,NULL
1782,1267,11,1278,1734,0,0,73.7,805,462,中湖里,NULL
256,1270,8,1278,1632,0,0,78.31,795,475,天玉里,NULL
616,1266,12,1278,1592,0,0,80.28,692,574,四育里,NULL
616,1265,13,1278,1621,0,0,78.84,674,591,五福里,NULL
398,1268,10,1278,1596,0,0,80.08,671,597,泉南里,NULL
872,1266,12,1278,1587,0,0,80.53,607,659,至聖里,NULL
313,1263,14,1277,1645,0,0,77.63,950,313,大義里,NULL
1265,1269,8,1277,1516,0,0,84.23,910,359,萬隆里,NULL
669,1268,9,1277,1693,0,0,75.43,859,409,新盛里,NULL
74,1269,8,1277,1658,0,0,77.02,859,410,塗厝里,NULL
0,1269,8,1277,1658,0,0,77.02,859,410,塗厝里,NULL
284,1266,11,1277,1568,0,0,81.44,857,409,西康里,NULL
1195,1268,9,1277,1691,0,0,75.52,837,431,大學里,NULL
334,1267,10,1277,1630,0,0,78.34,827,440,碧山里,NULL
166,1272,5,1277,1631,0,0,78.3,750,522,福山里,NULL
629,1265,12,1277,1642,0,0,77.77,718,547,惠來里,NULL
35,1265,12,1277,1699,0,0,75.16,524,741,原佃里,NULL
0,1265,12,1277,1699,0,0,75.16,524,741,原佃里,NULL
4,1266,11,1277,1706,0,0,74.85,499,767,州南里,NULL
896,1268,8,1276,1603,0,0,79.6,942,326,中正村,NULL
684,1267,9,1276,1564,0,0,81.59,903,364,雙和里,NULL
901,1264,12,1276,1690,0,0,75.5,890,374,九龍村,NULL
1339,1267,9,1276,1579,0,0,80.81,885,382,樟新里,NULL
860,1268,8,1276,1569,0,0,81.33,866,402,民本里,NULL
849,1265,11,1276,1737,0,0,73.46,866,399,上湖里,NULL
1239,1265,11,1276,1598,0,0,79.85,840,425,柴埕里,NULL
360,1264,12,1276,1710,0,0,74.62,767,497,東湖里,NULL
799,1259,17,1276,1610,0,0,79.25,750,509,朱馥里,NULL
461,1255,21,1276,1728,0,0,73.84,743,512,河東里,NULL
0,1255,21,1276,1728,0,0,73.84,743,512,河東里,NULL
938,1262,14,1276,1608,0,0,79.35,729,533,全安里,NULL
1434,1267,9,1276,1575,0,0,81.02,717,550,平和里,NULL
0,1270,6,1276,1602,0,0,79.65,704,566,和德里,NULL
262,1257,19,1276,1736,0,0,73.5,656,601,大美里,NULL
0,1257,19,1276,1736,0,0,73.5,656,601,大美里,NULL
176,1268,8,1276,1641,0,0,77.76,633,635,富光里,NULL
344,1266,10,1276,1673,0,0,76.27,589,677,鼎金里,NULL
308,1262,14,1276,1567,0,0,81.43,539,723,安宜里,NULL
364,1260,15,1275,1471,0,0,86.68,970,290,瑞陽里,NULL
935,1270,5,1275,1627,0,0,78.37,883,387,龍福里,NULL
1872,1267,8,1275,1674,0,0,76.16,878,389,竿蓁里,NULL
1128,1264,11,1275,1617,0,0,78.85,876,388,福住里,NULL
353,1270,5,1275,1579,0,0,80.75,851,419,康寧里,NULL
1243,1258,17,1275,1621,0,0,78.66,828,430,安和里,NULL
672,1261,14,1275,1573,0,0,81.06,825,436,復興里,NULL
36,1263,12,1275,1608,0,0,79.29,819,444,永欣里,NULL
403,1259,16,1275,1602,0,0,79.59,810,449,土庫里,NULL
169,1260,15,1275,1739,0,0,73.32,753,507,大興里,NULL
498,1261,14,1275,1626,0,0,78.41,741,520,南門里,NULL
618,1267,8,1275,1570,0,0,81.21,739,528,四育里,NULL
1491,1260,15,1275,1635,0,0,77.98,729,531,玉清里,NULL
989,1265,10,1275,1728,0,0,73.78,725,540,草漯村,NULL
163,1266,9,1275,1622,0,0,78.61,721,545,菜公里,NULL
375,1263,12,1275,1552,0,0,82.15,668,595,福田里,NULL
9,1263,12,1275,1668,0,0,76.44,542,721,州北里,NULL
84,1264,10,1274,1632,0,0,78.06,929,335,莊敬里,NULL
115,1269,5,1274,1602,0,0,79.53,882,387,中原里,NULL
131,1264,10,1274,1754,0,0,72.63,856,408,和慶里,NULL
341,1269,5,1274,1538,0,0,82.83,813,456,裕聖里,NULL
161,1257,17,1274,1689,0,0,75.43,811,446,寶山里,NULL
941,1266,8,1274,1531,0,0,83.21,766,500,全泰里,NULL
158,1265,9,1274,1694,0,0,75.21,712,553,福德里,NULL
0,1259,15,1274,1847,0,0,68.98,700,559,圓富里,NULL
0,1265,9,1274,1815,0,0,70.19,676,589,江厝里,NULL
804,1265,9,1274,1655,0,0,76.98,662,603,秀山村,NULL
0,1265,9,1274,1777,0,0,71.69,576,689,大新村,NULL
270,1263,11,1274,1683,0,0,75.7,518,745,振興里,NULL
0,1263,11,1274,1683,0,0,75.7,518,745,振興里,NULL
673,1259,14,1273,1541,0,0,82.61,1057,202,華勛里,NULL
181,1257,16,1273,1579,0,0,80.62,849,408,湳雅里、金雅里,NULL
0,1257,16,1273,1579,0,0,80.62,849,408,湳雅里、金雅里,NULL
19,1260,13,1273,1639,0,0,77.67,847,413,上石里,NULL
1338,1261,12,1273,1550,0,0,82.13,834,427,樟新里,NULL
59,1265,8,1273,1669,0,0,76.27,823,442,建國里,NULL
290,1267,6,1273,1541,0,0,82.61,810,457,港墘里,NULL
77,1269,4,1273,1668,0,0,76.32,796,473,加昌里,NULL
472,1256,17,1273,1674,0,0,76.05,747,509,東平里,NULL
469,1266,7,1273,1616,0,0,78.77,737,529,永平里,NULL
120,1256,17,1273,1613,0,0,78.92,735,521,劉厝里,NULL
266,1261,12,1273,1617,0,0,78.73,728,533,華興里,NULL
973,1261,12,1273,1642,0,0,77.53,727,534,昌隆里,NULL
212,1264,9,1273,1621,0,0,78.53,699,565,德華里,NULL
571,1252,21,1273,1680,0,0,75.77,675,577,社皮里,NULL
1049,1265,8,1273,1573,0,0,80.93,650,615,華中里,NULL
839,1261,12,1273,1674,0,0,76.05,626,635,延平里,NULL
0,1257,16,1273,1642,0,0,77.53,588,669,泉源里,NULL
1275,1268,4,1272,1539,0,0,82.65,944,324,興豐里,NULL
138,1264,8,1272,1539,0,0,82.65,932,332,三和里,NULL
1310,1264,8,1272,1591,0,0,79.95,922,342,華興里,NULL
1340,1266,6,1272,1564,0,0,81.33,892,374,樟新里,NULL
335,1259,13,1272,2393,0,0,53.16,861,398,賴厝里,NULL
281,1267,5,1272,1542,0,0,82.49,828,439,西湖里,NULL
2098,1260,12,1272,1665,0,0,76.4,806,454,昇高村,NULL
0,1260,12,1272,1665,0,0,76.4,806,454,昇高村,NULL
260,1263,9,1272,1700,0,0,74.82,798,465,漳和里,NULL
234,1269,3,1272,1587,0,0,80.15,787,482,國泰里,NULL
253,1259,13,1272,1646,0,0,77.28,786,473,瑞泰里,NULL
131,1250,22,1272,1771,0,0,71.82,413,837,東勢村,NULL
282,1259,13,1272,1720,0,0,73.95,402,857,中洲里,NULL
0,1259,13,1272,1720,0,0,73.95,402,857,中洲里,NULL
805,1260,11,1271,1632,0,0,77.88,952,308,竹林里,NULL
808,1263,8,1271,1614,0,0,78.75,950,313,上林里,NULL
359,1256,15,1271,1657,0,0,76.7,875,381,南興村,NULL
164,1260,11,1271,1596,0,0,79.64,854,406,中華里,NULL
221,1258,13,1271,1649,0,0,77.08,848,410,泰安里,NULL
913,1259,12,1271,1574,0,0,80.75,846,413,下溪里,NULL
411,1259,12,1271,1874,0,0,67.82,779,480,南港里,NULL
22,1262,9,1271,1563,0,0,81.32,769,493,裕民里,NULL
617,1256,15,1271,1642,0,0,77.41,764,492,五福里,NULL
133,1265,6,1271,1543,0,0,82.37,735,530,光興里,NULL
162,1266,5,1271,1567,0,0,81.11,732,534,承德里,NULL
0,1252,19,1271,1695,0,0,74.99,725,527,南東里,NULL
202,1250,21,1271,1613,0,0,78.8,658,592,雙玉里,NULL
323,1258,13,1271,1544,0,0,82.32,573,685,安東里,NULL
0,1262,9,1271,1743,0,0,72.92,480,782,重溪村,NULL
201,1266,4,1270,1638,0,0,77.53,911,355,碇安里,NULL
1311,1263,7,1270,1578,0,0,80.48,910,353,華興里,NULL
715,1259,11,1270,1641,0,0,77.39,893,366,平興里,NULL
172,1262,8,1270,1671,0,0,76,888,374,忠義里,NULL
146,1260,10,1270,1755,0,0,72.36,876,384,寶安里,NULL
2136,1262,8,1270,1748,0,0,72.65,849,413,後厝村,NULL
0,1262,8,1270,1748,0,0,72.65,849,413,後厝村,NULL
1255,1257,13,1270,1648,0,0,77.06,846,411,公崙里,NULL
731,1260,10,1270,1516,0,0,83.77,828,432,復興里,NULL
0,1260,10,1270,2002,0,0,63.44,814,446,海口村,NULL
12,1264,6,1270,1639,0,0,77.49,809,455,思源里,NULL
1897,1257,13,1270,1638,0,0,77.53,758,499,鄧公里,NULL
42,1258,12,1270,1612,0,0,78.78,747,511,南埔里,NULL
139,1261,9,1270,1575,0,0,80.63,734,527,福志里,NULL
409,1259,11,1270,1615,0,0,78.64,731,528,南港里,NULL
296,1260,10,1270,1598,0,0,79.47,721,539,三和村,NULL
144,1262,8,1270,1677,0,0,75.73,714,548,和順里,NULL
1042,1253,17,1270,1569,0,0,80.94,695,558,中原里,NULL
174,1261,9,1270,1625,0,0,78.15,667,594,埔墘里,NULL
0,1263,7,1270,1722,0,0,73.75,662,601,頂湳里,NULL
0,1257,13,1270,1800,0,0,70.56,488,769,南平里,NULL
21,1262,7,1269,1542,0,0,82.3,970,292,北崙里,NULL
811,1254,15,1269,1675,0,0,75.76,926,328,梅溪里,NULL
336,1254,15,1269,1700,0,0,74.65,883,371,賴厝里,NULL
254,1256,13,1269,1608,0,0,78.92,851,405,瑞發里,NULL
165,1261,8,1269,1762,0,0,72.02,794,467,大村里,NULL
1037,1263,6,1269,1607,0,0,78.97,792,471,中平里,NULL
705,1253,16,1269,1756,0,0,72.27,724,529,東寧村,NULL
0,1253,16,1269,1756,0,0,72.27,724,529,東寧村,NULL
497,1261,8,1269,1620,0,0,78.33,706,555,南門里,NULL
503,1264,5,1269,1584,0,0,80.11,626,638,正氣里,NULL
0,1264,5,1269,1584,0,0,80.11,626,638,正氣里,NULL
196,1260,9,1269,1533,0,0,82.78,605,655,永倫里,NULL
280,1260,9,1269,1675,0,0,75.76,517,743,明興里,NULL
0,1259,10,1269,1656,0,0,76.63,492,767,溪美里,NULL
1290,1262,6,1268,1578,0,0,80.35,923,339,興安里,NULL
1170,1265,3,1268,1564,0,0,81.07,922,343,中正里,NULL
810,1257,11,1268,1572,0,0,80.66,885,372,福林里,NULL
317,1265,3,1268,1692,0,0,74.94,864,401,潭墘里,NULL
559,1257,11,1268,1657,0,0,76.52,841,416,中原里,NULL
776,1257,11,1268,1736,0,0,73.04,816,441,北路里,NULL
168,1260,8,1268,1634,0,0,77.6,773,487,福山里,NULL
402,1252,16,1268,1629,0,0,77.84,720,532,仁德里,NULL
130,1256,12,1268,1605,0,0,79,704,552,柏翠里,NULL
400,1256,12,1268,1659,0,0,76.43,686,570,後龍里,NULL
426,1254,14,1268,1603,0,0,79.1,670,584,自強里,NULL
0,1254,14,1268,1603,0,0,79.1,670,584,自強里,NULL
518,1256,12,1268,1627,0,0,77.93,664,592,平和里,NULL
0,1261,7,1268,1838,0,0,68.99,654,607,石廟里,NULL
1489,1256,12,1268,1643,0,0,77.18,647,609,信義里,NULL
163,1254,14,1268,1583,0,0,80.1,643,611,安溪村,NULL
0,1254,14,1268,1583,0,0,80.1,643,611,安溪村,NULL
716,1253,15,1268,1643,0,0,77.18,587,666,山明里,NULL
0,1247,21,1268,1812,0,0,69.98,535,712,溪厝村,NULL
31,1259,9,1268,1824,0,0,69.52,513,746,東石村,NULL
0,1259,9,1268,1824,0,0,69.52,513,746,東石村,NULL
825,1260,8,1268,1603,0,0,79.1,477,783,看西村,NULL
0,1260,8,1268,1603,0,0,79.1,477,783,看西村,NULL
0,1263,5,1268,1652,0,0,76.76,477,786,瓦磘村,NULL
30,1261,7,1268,1596,0,0,79.45,430,831,金田里,NULL
0,1244,23,1267,1764,0,0,71.83,966,278,復興里,NULL
144,1262,5,1267,1525,0,0,83.08,856,406,忠翠里,NULL
628,1255,12,1267,1529,0,0,82.86,846,409,國業里,NULL
90,1260,7,1267,1673,0,0,75.73,836,424,北埔里,NULL
501,1256,11,1267,1573,0,0,80.55,817,439,東光里,NULL
235,1259,8,1267,1574,0,0,80.5,793,466,西勢里,NULL
490,1246,21,1267,1708,0,0,74.18,764,482,三民村,NULL
0,1246,21,1267,1708,0,0,74.18,764,482,三民村,NULL
234,1253,14,1267,1604,0,0,78.99,758,495,大恩里,NULL
224,1262,5,1267,1523,0,0,83.19,752,510,裕興里,NULL
825,1262,5,1267,1622,0,0,78.11,626,636,永樂里,NULL
396,1257,10,1267,1578,0,0,80.29,625,632,寶獅里,NULL
0,1262,5,1267,2010,0,0,63.03,587,675,豐榮村,NULL
94,1264,3,1267,1654,0,0,76.6,569,695,潭頭村,NULL
0,1264,3,1267,1654,0,0,76.6,569,695,潭頭村,NULL
0,1255,12,1267,1879,0,0,67.43,469,786,東平里,NULL
766,1261,6,1267,1682,0,0,75.33,417,844,明禮里,NULL
0,1261,6,1267,1682,0,0,75.33,417,844,明禮里,NULL
0,1249,18,1267,1796,0,0,70.55,341,908,安定里,NULL
788,1256,10,1266,1519,0,0,83.34,1152,104,忠純里,NULL
77,1255,11,1266,1599,0,0,79.17,1059,196,上舘里,NULL
610,1256,10,1266,1548,0,0,81.78,927,329,平河里,NULL
809,1248,18,1266,1687,0,0,75.04,900,348,瑞坪里,NULL
424,1258,8,1266,1604,0,0,78.93,810,448,西榮里,NULL
341,1258,8,1266,1566,0,0,80.84,783,475,清白里,NULL
1864,1255,11,1266,1611,0,0,78.58,770,485,竹圍里,NULL
398,1254,12,1266,1630,0,0,77.67,755,499,田心村,NULL
178,1249,17,1266,1619,0,0,78.2,754,495,北興里,NULL
172,1249,17,1266,1568,0,0,80.74,741,508,埔墘里,NULL
340,1257,9,1266,1744,0,0,72.59,727,530,舊社村,NULL
0,1257,9,1266,1744,0,0,72.59,727,530,舊社村,NULL
486,1255,11,1266,1598,0,0,79.22,658,597,培德里,NULL
0,1255,11,1266,1631,0,0,77.62,562,693,復安村,NULL
16,1261,5,1266,1680,0,0,75.36,511,750,安慶里,NULL
1276,1255,10,1265,1565,0,0,80.83,943,312,興豐里,NULL
66,1260,5,1265,1502,0,0,84.22,935,325,科園里,NULL
1223,1258,7,1265,1591,0,0,79.51,932,326,寶安里,NULL
481,1253,12,1265,1585,0,0,79.81,920,333,坪林里,NULL
626,1256,9,1265,1571,0,0,80.52,848,408,碧河里,NULL
1068,1254,11,1265,1763,0,0,71.75,842,412,丹鳳里,NULL
596,1256,9,1265,1597,0,0,79.21,815,441,南陽里,NULL
41,1254,11,1265,1607,0,0,78.72,799,455,南埔里,NULL
327,1257,8,1265,1676,0,0,75.48,798,459,吉峰村,NULL
711,1252,13,1265,1647,0,0,76.81,783,469,嘉新里,NULL
303,1252,13,1265,1650,0,0,76.67,713,539,福山里,NULL
424,1253,12,1265,1545,0,0,81.88,669,584,正義里,NULL
0,1253,12,1265,1545,0,0,81.88,669,584,正義里,NULL
0,1255,10,1265,1559,0,0,81.14,653,602,白米里,NULL
148,1257,8,1265,1559,0,0,81.14,627,630,文元里,NULL
782,1252,13,1265,1613,0,0,78.43,616,636,鎮海里,NULL
0,1258,7,1265,1754,0,0,72.12,579,679,南平里,NULL
124,1257,7,1264,1568,0,0,80.61,1045,212,果惠里,NULL
0,1257,7,1264,1568,0,0,80.61,1045,212,果惠里,NULL
4,1255,9,1264,1578,0,0,80.1,863,392,至善里,NULL
630,1252,12,1264,1593,0,0,79.35,845,407,國業里,NULL
1613,1255,9,1264,1691,0,0,74.75,843,412,康福里,NULL
900,1253,11,1264,1539,0,0,82.13,806,447,保平里,NULL
407,1252,12,1264,1717,0,0,73.62,801,451,三平里,NULL
376,1260,4,1264,1551,0,0,81.5,800,460,東湖里,NULL
326,1253,11,1264,1587,0,0,79.65,779,474,金龍里,NULL
425,1256,8,1264,1677,0,0,75.37,739,517,九如里,NULL
0,1254,10,1264,1674,0,0,75.51,732,522,永安村,NULL
1745,1253,11,1264,1574,0,0,80.3,693,560,南鶯里,NULL
100,1245,19,1264,1664,0,0,75.96,678,567,南社里,NULL
483,1250,14,1264,1606,0,0,78.7,677,573,尚德里,NULL
1035,1259,5,1264,1557,0,0,81.18,638,621,錦德里,NULL
354,1257,7,1264,1626,0,0,77.74,631,626,福德里,NULL
633,1250,13,1263,1540,0,0,82.01,965,285,華新里,NULL
318,1251,12,1263,1717,0,0,73.56,940,311,潭墘里,NULL
352,1260,3,1263,1567,0,0,80.6,824,436,康寧里,NULL
619,1251,12,1263,1664,0,0,75.9,806,445,中正里,NULL
98,1255,8,1263,1631,0,0,77.44,798,457,福恩里,NULL
1358,1253,10,1263,1574,0,0,80.24,785,468,博嘉里,NULL
384,1258,5,1263,1513,0,0,83.48,694,564,本元里,NULL
788,1250,13,1263,1643,0,0,76.87,689,561,中吉里,NULL
552,1247,16,1263,1575,0,0,80.19,674,573,福樂里,NULL
0,1252,11,1263,1686,0,0,74.91,665,587,苑南里,NULL
453,1249,14,1263,1649,0,0,76.59,648,601,龍門里,NULL
0,1249,14,1263,1649,0,0,76.59,648,601,龍門里,NULL
315,1255,8,1263,1567,0,0,80.6,593,662,精華里,NULL
0,1255,8,1263,1567,0,0,80.6,593,662,精華里,NULL
0,1246,17,1263,1914,0,0,65.99,545,701,大庄村,NULL
0,1255,8,1263,1932,0,0,65.37,487,768,泰山村,NULL
308,1245,17,1262,1540,0,0,81.95,1210,35,陸光里,NULL
1318,1252,10,1262,1553,0,0,81.26,965,287,明興里,NULL
1065,1256,6,1262,1515,0,0,83.3,961,295,新和里,NULL
13,1250,12,1262,1535,0,0,82.21,956,294,十興里,NULL
625,1252,10,1262,1591,0,0,79.32,936,316,普強里,NULL
1361,1252,10,1262,1582,0,0,79.77,902,350,萬興里,NULL
1887,1250,12,1262,1674,0,0,75.39,849,401,新興里,NULL
253,1254,8,1262,1641,0,0,76.9,847,407,東海村,NULL
737,1253,9,1262,1546,0,0,81.63,806,447,大直里,NULL
570,1253,9,1262,1572,0,0,80.28,774,479,復勢里,NULL
0,1253,9,1262,1668,0,0,75.66,759,494,武曲里,NULL
529,1249,13,1262,1649,0,0,76.53,746,503,福隆里,NULL
165,1245,17,1262,1570,0,0,80.38,739,506,五妃里,NULL
0,1245,17,1262,1570,0,0,80.38,739,506,五妃里,NULL
182,1256,6,1262,1680,0,0,75.12,672,584,保安里,NULL
1754,1241,21,1262,1667,0,0,75.7,623,618,二橋里,NULL
82,1248,13,1261,1507,0,0,83.68,948,300,仙水里,NULL
273,1243,18,1261,1507,0,0,83.68,915,328,芎林村,NULL
0,1243,18,1261,1507,0,0,83.68,915,328,芎林村,NULL
226,1257,4,1261,1570,0,0,80.32,820,437,東山里,NULL
402,1245,16,1261,1607,0,0,78.47,748,497,土庫里,NULL
1982,1249,12,1261,1632,0,0,77.27,625,624,成泰村,NULL
249,1247,13,1260,1637,0,0,76.97,932,315,上坑村,NULL
0,1247,13,1260,1637,0,0,76.97,932,315,上坑村,NULL
2,1251,9,1260,1533,0,0,82.19,925,326,鹿場里,NULL
0,1242,18,1260,1754,0,0,71.84,865,377,南勢村,NULL
28,1252,8,1260,1588,0,0,79.35,817,435,南門里,NULL
0,1254,6,1260,1755,0,0,71.79,803,451,東和里,NULL
1224,1249,11,1260,1607,0,0,78.41,799,450,敦煌里,NULL
421,1252,8,1260,1516,0,0,83.11,798,454,中研里,NULL
31,1250,10,1260,1668,0,0,75.54,771,479,御史里,NULL
315,1250,10,1260,1530,0,0,82.35,769,481,紫星里,NULL
274,1246,14,1260,1822,0,0,69.15,740,506,福山里,NULL
0,1246,14,1260,1822,0,0,69.15,740,506,福山里,NULL
417,1247,13,1260,1607,0,0,78.41,686,561,重陽里,NULL
432,1252,8,1260,1588,0,0,79.35,671,581,寶珠里,NULL
520,1247,13,1260,1634,0,0,77.11,650,597,福隆里,NULL
1277,1253,6,1259,1504,0,0,83.71,1031,222,興豐里,NULL
0,1252,7,1259,1552,0,0,81.12,987,265,新興村,NULL
21,1244,15,1259,1582,0,0,79.58,832,412,上林里,NULL
559,1251,8,1259,1574,0,0,79.99,798,453,吉仁里,NULL
1201,1247,12,1259,1564,0,0,80.5,793,454,黎元里,NULL
263,1242,17,1259,1598,0,0,78.79,793,449,廣興里,NULL
0,1252,7,1259,1660,0,0,75.84,790,462,協和里,NULL
354,1243,16,1259,1620,0,0,77.72,776,467,淡溝里,NULL
1563,1244,15,1259,1640,0,0,76.77,767,477,白雲里,NULL
936,1247,12,1259,1575,0,0,79.94,738,509,海山里,NULL
807,1247,12,1259,1605,0,0,78.44,705,542,橫山村,NULL
292,1247,12,1259,1692,0,0,74.41,665,582,烏日村,NULL
101,1246,12,1258,1557,0,0,80.8,995,251,忠孝里,NULL
0,1246,12,1258,1557,0,0,80.8,995,251,忠孝里,NULL
11,1249,9,1258,1581,0,0,79.57,959,290,十興里,NULL
1206,1251,7,1258,1569,0,0,80.18,902,349,大豐里,NULL
38,1250,8,1258,1597,0,0,78.77,886,364,翠屏里,NULL
208,1248,10,1258,1551,0,0,81.11,824,424,深丘里,NULL
653,1249,9,1258,1628,0,0,77.27,822,427,三和里,NULL
37,1250,8,1258,1677,0,0,75.01,800,450,翠屏里,NULL
177,1250,8,1258,1553,0,0,81,617,633,葫蘆里,NULL
0,1246,12,1258,1681,0,0,74.84,578,668,浸水里,NULL
572,1243,14,1257,1567,0,0,80.22,1021,222,至善里,NULL
814,1252,5,1257,1537,0,0,81.78,957,295,金溪里,NULL
340,1252,5,1257,1579,0,0,79.61,929,323,清白里,NULL
361,1249,8,1257,1513,0,0,83.08,822,427,紫陽里,NULL
251,1246,11,1257,1558,0,0,80.68,804,442,平福里,NULL
258,1248,9,1257,1695,0,0,74.16,790,458,漳和里,NULL
1345,1251,6,1257,1604,0,0,78.37,731,520,日和里,NULL
149,1240,17,1257,1543,0,0,81.46,679,561,文聖里,NULL
453,1243,14,1257,1618,0,0,77.69,641,602,太平里,NULL
422,1245,12,1257,1573,0,0,79.91,626,619,寶盛里,NULL
557,1230,27,1257,1597,0,0,78.71,622,608,中原里,NULL
733,1249,8,1257,1642,0,0,76.55,622,627,月眉村,NULL
0,1249,8,1257,1642,0,0,76.55,622,627,月眉村,NULL
417,1241,16,1257,1729,0,0,72.7,611,630,隆興村,NULL
0,1241,16,1257,1729,0,0,72.7,611,630,隆興村,NULL
0,1247,10,1257,1744,0,0,72.08,604,643,吉東里,NULL
0,1243,14,1257,1718,0,0,73.17,309,934,龍山村,NULL
571,1246,10,1256,1600,0,0,78.5,1030,216,至善里,NULL
47,1242,14,1256,1582,0,0,79.39,921,321,禮東里,NULL
0,1242,14,1256,1582,0,0,79.39,921,321,禮東里,NULL
1223,1243,13,1256,1661,0,0,75.62,840,403,敦煌里,NULL
716,1245,11,1256,1610,0,0,78.01,805,440,墩東村,NULL
229,1241,15,1256,1668,0,0,75.3,790,451,百福里,NULL
1363,1245,11,1256,1574,0,0,79.8,787,458,萬興里,NULL
639,1245,11,1256,1543,0,0,81.4,771,474,松光里,NULL
353,1248,8,1256,1558,0,0,80.62,750,498,福祉里,NULL
52,1239,17,1256,1592,0,0,78.89,744,495,何德里,NULL
50,1244,12,1256,1667,0,0,75.34,742,502,源埤里,NULL
0,1244,12,1256,1667,0,0,75.34,742,502,源埤里,NULL
142,1243,13,1256,1535,0,0,81.82,730,513,忠翠里,NULL
393,1243,13,1256,1571,0,0,79.95,724,519,永春里,NULL
0,1243,13,1256,1571,0,0,79.95,724,519,永春里,NULL
0,1240,16,1256,2070,0,0,60.68,537,703,鎖港里,NULL
374,1247,9,1256,1551,0,0,80.98,531,716,本館里,NULL
0,1241,15,1256,1724,0,0,72.85,485,756,大新里,NULL
60,1245,11,1256,1616,0,0,77.72,464,781,洲美里,NULL
0,1245,11,1256,1616,0,0,77.72,464,781,洲美里,NULL
68,1241,14,1255,1520,0,0,82.57,1007,234,科園里,NULL
1333,1243,12,1255,1524,0,0,82.35,964,279,忠順里,NULL
1254,1248,7,1255,1546,0,0,81.18,919,329,景華里,NULL
341,1246,9,1255,1705,0,0,73.61,748,498,延和里,NULL
1468,1247,8,1255,1496,0,0,83.89,736,511,正義里,NULL
286,1244,11,1255,1581,0,0,79.38,729,515,大仁里,NULL
277,1242,13,1255,1709,0,0,73.43,719,523,中正村,NULL
287,1236,19,1255,1667,0,0,75.28,709,527,大明里,NULL
291,1246,9,1255,1601,0,0,78.39,683,563,烏日村,NULL
261,1238,17,1255,1736,0,0,72.29,653,585,瑞光里,NULL
0,1247,8,1255,1767,0,0,71.02,644,603,穎川里,NULL
343,1244,11,1255,1576,0,0,79.63,632,612,復興里,NULL
5,1247,8,1255,1576,0,0,79.63,622,625,清豐里,NULL
0,1244,11,1255,1747,0,0,71.84,600,644,安樂村,NULL
0,1243,12,1255,1554,0,0,80.76,324,919,龍目村,NULL
0,1244,11,1255,1797,0,0,69.84,277,967,台子村,NULL
9,1251,3,1254,1638,0,0,76.56,841,410,中寧里,NULL
91,1248,6,1254,1642,0,0,76.37,836,412,北埔里,NULL
314,1245,9,1254,1614,0,0,77.7,831,414,大義里,NULL
693,1241,13,1254,1507,0,0,83.21,810,431,黎平里,NULL
968,1240,14,1254,1584,0,0,79.17,738,502,福星里,NULL
147,1247,7,1254,1502,0,0,83.49,736,511,福佳里,NULL
287,1231,23,1254,1614,0,0,77.7,723,508,水湳里,NULL
367,1242,12,1254,1624,0,0,77.22,716,526,大里里,NULL
460,1243,11,1254,1590,0,0,78.87,705,538,永成里,NULL
676,1239,15,1254,1629,0,0,76.98,699,540,港口里,NULL
328,1251,3,1254,1622,0,0,77.31,683,568,中樂村,NULL
0,1251,3,1254,1622,0,0,77.31,683,568,中樂村,NULL
197,1237,17,1254,1586,0,0,79.07,565,672,永倫里,NULL
134,1246,8,1254,1559,0,0,80.44,544,702,新上里,NULL
0,1248,6,1254,1566,0,0,80.08,544,704,南洲村,NULL
1257,1243,10,1253,1575,0,0,79.56,943,300,公崙里,NULL
106,1242,11,1253,1699,0,0,73.75,941,301,永安村,NULL
87,1245,8,1253,1591,0,0,78.76,891,354,福林里,NULL
1889,1241,12,1253,1621,0,0,77.3,844,397,新興里,NULL
15,1245,8,1253,1670,0,0,75.03,837,408,山腳里,NULL
377,1244,9,1253,1539,0,0,81.42,808,436,安湖里,NULL
368,1240,13,1253,1610,0,0,77.83,804,436,長青里,NULL
388,1236,17,1253,1628,0,0,76.97,786,450,光正里,NULL
0,1236,17,1253,1628,0,0,76.97,786,450,光正里,NULL
1034,1244,9,1253,1625,0,0,77.11,709,535,中信里,NULL
987,1243,10,1253,1583,0,0,79.15,668,575,自立里,NULL
767,1242,11,1253,1631,0,0,76.82,654,588,豐洲村,NULL
104,1240,13,1253,1579,0,0,79.35,585,655,新翠里,NULL
665,1237,15,1252,1559,0,0,80.31,980,257,三張里,NULL
389,1242,10,1252,1680,0,0,74.52,859,383,南光里,NULL
83,1237,15,1252,1600,0,0,78.25,797,440,福雅里,NULL
337,1238,14,1252,1673,0,0,74.84,791,447,三春村,NULL
0,1238,14,1252,1673,0,0,74.84,791,447,三春村,NULL
280,1237,15,1252,1669,0,0,75.01,775,462,頂街村,NULL
567,1232,20,1252,1794,0,0,69.79,768,464,新生里,NULL
0,1232,20,1252,1794,0,0,69.79,768,464,新生里,NULL
590,1236,16,1252,1586,0,0,78.94,749,487,福祥里,NULL
200,1240,12,1252,1734,0,0,72.2,737,503,兔坑村,NULL
255,1235,17,1252,1625,0,0,77.05,733,502,磚磘里,NULL
1029,1243,9,1252,1596,0,0,78.45,718,525,中港里,NULL
156,1239,13,1252,1634,0,0,76.62,701,538,南簡里,NULL
280,1241,11,1252,1605,0,0,78.01,695,546,白鷺里,NULL
1046,1241,11,1252,1607,0,0,77.91,666,575,立功里,NULL
0,1241,11,1252,1689,0,0,74.13,408,833,田寮里,NULL
620,1245,6,1251,1558,0,0,80.3,840,405,四維里,NULL
574,1240,11,1251,1569,0,0,79.73,837,403,枋寮里,NULL
326,1243,8,1251,1634,0,0,76.56,837,406,勝利里,NULL
271,1239,12,1251,1617,0,0,77.37,832,407,同榮里,NULL
526,1243,8,1251,1648,0,0,75.91,762,481,永和里,NULL
947,1236,15,1251,1579,0,0,79.23,759,477,文聖里,NULL
372,1241,10,1251,1557,0,0,80.35,651,590,本館里,NULL
66,1242,9,1251,2226,0,0,56.2,621,621,清江里,NULL
376,1237,14,1251,1539,0,0,81.29,598,639,本和里,NULL
724,1239,12,1251,1686,0,0,74.2,491,748,大坪里,NULL
0,1239,12,1251,1686,0,0,74.2,491,748,大坪里,NULL
1240,1242,8,1250,1534,0,0,81.49,945,297,景東里,NULL
42,1240,10,1250,1561,0,0,80.08,883,357,泰和里,NULL
471,1243,7,1250,1604,0,0,77.93,881,362,莊敬里,NULL
658,1235,15,1250,1544,0,0,80.96,881,354,內南里,NULL
1249,1230,20,1250,1561,0,0,80.08,874,356,新和里,NULL
629,1244,6,1250,1577,0,0,79.26,836,408,國業里,NULL
469,1240,10,1250,1552,0,0,80.54,814,426,莊敬里,NULL
922,1245,5,1250,1553,0,0,80.49,803,442,廈安里,NULL
365,1244,6,1250,1573,0,0,79.47,779,465,小東里,NULL
617,1230,20,1250,1535,0,0,81.43,767,463,四育里,NULL
233,1239,11,1250,1531,0,0,81.65,753,486,蘭雅里,NULL
250,1235,15,1250,1590,0,0,78.62,751,484,南美里,NULL
0,1235,15,1250,1590,0,0,78.62,751,484,南美里,NULL
263,1239,11,1250,1617,0,0,77.3,625,614,金華里,NULL
66,1242,8,1250,1505,0,0,83.06,613,629,慶昌里,NULL
526,1238,12,1250,2490,0,0,50.2,612,626,慈祐里,NULL
800,1237,12,1249,1522,0,0,82.06,913,324,光華里,NULL
121,1239,10,1249,1616,0,0,77.29,804,435,新埔里,NULL
237,1239,10,1249,1579,0,0,79.1,797,442,友一里,NULL
0,1239,10,1249,1579,0,0,79.1,797,442,友一里,NULL
1086,1237,12,1249,1650,0,0,75.7,792,445,民炤里,NULL
181,1235,14,1249,1586,0,0,78.75,788,447,三光里,NULL
37,1243,6,1249,1621,0,0,77.05,768,475,何明里,NULL
270,1235,14,1249,1567,0,0,79.71,750,485,下廍里,NULL
500,1243,6,1249,1635,0,0,76.39,727,516,明昌里,NULL
760,1240,9,1249,1580,0,0,79.05,721,519,松江里,NULL
1492,1240,9,1249,1559,0,0,80.12,679,561,玉清里,NULL
661,1244,5,1249,1609,0,0,77.63,656,588,興東里,NULL
219,1241,8,1249,1714,0,0,72.87,630,611,員山村,NULL
544,1236,13,1249,1600,0,0,78.06,567,669,苓東里,NULL
0,1236,13,1249,1600,0,0,78.06,567,669,苓東里,NULL
387,1237,12,1249,1587,0,0,78.7,410,827,坑子村,NULL
0,1237,12,1249,1587,0,0,78.7,410,827,坑子村,NULL
930,1242,6,1248,1610,0,0,77.52,810,432,新生村,NULL
609,1239,9,1248,1549,0,0,80.57,801,438,林靖里,NULL
0,1239,9,1248,1549,0,0,80.57,801,438,林靖里,NULL
250,1243,5,1248,1539,0,0,81.09,797,446,天和里,NULL
286,1236,12,1248,1592,0,0,78.39,782,454,復興里,NULL
228,1238,10,1248,1647,0,0,75.77,766,472,松和里,NULL
1128,1236,12,1248,1641,0,0,76.05,742,494,光榮里,NULL
850,1244,4,1248,1595,0,0,78.24,740,504,民權里,NULL
252,1242,6,1248,1545,0,0,80.78,739,503,天和里,NULL
189,1240,8,1248,1936,0,0,64.46,736,504,魚池村,NULL
0,1240,8,1248,1936,0,0,64.46,736,504,魚池村,NULL
416,1236,12,1248,1615,0,0,77.28,704,532,菓林村,NULL
473,1238,10,1248,1598,0,0,78.1,668,570,承德里,NULL
0,1238,10,1248,1598,0,0,78.1,668,570,承德里,NULL
375,1237,11,1248,1566,0,0,79.69,665,572,本和里,NULL
467,1233,15,1248,1563,0,0,79.85,636,597,六合里,NULL
955,1231,17,1248,1644,0,0,75.91,590,641,下田村,NULL
0,1231,17,1248,1644,0,0,75.91,590,641,下田村,NULL
0,1243,4,1247,2268,0,0,54.98,1177,66,安美村,NULL
278,1238,9,1247,1628,0,0,76.6,845,393,新平里,NULL
662,1234,13,1247,1544,0,0,80.76,796,438,三張里,NULL
58,1242,5,1247,1532,0,0,81.4,790,452,八仙里,NULL
4,1233,14,1247,1575,0,0,79.17,754,479,同安里,NULL
397,1238,9,1247,1557,0,0,80.09,688,550,寶德里,NULL
765,1236,11,1247,1653,0,0,75.44,650,586,豐洲村,NULL
0,1236,11,1247,1754,0,0,71.09,489,747,大庄村,NULL
820,1237,9,1246,2408,0,0,51.74,947,290,豫溪里,NULL
225,1238,8,1246,1481,0,0,84.13,916,322,東山里,NULL
1088,1235,11,1246,1681,0,0,74.12,840,395,仁愛里,NULL
429,1236,10,1246,1547,0,0,80.54,795,441,長榮里,NULL
724,1226,20,1246,1674,0,0,74.43,778,448,恆安里,NULL
710,1238,8,1246,1583,0,0,78.71,775,463,嘉新里,NULL
149,1237,9,1246,1553,0,0,80.23,775,462,田心里,NULL
331,1237,9,1246,1798,0,0,69.3,754,483,桂林里,NULL
296,1238,8,1246,1513,0,0,82.35,740,498,麗山里,NULL
566,1242,4,1246,1562,0,0,79.77,717,525,西安里,NULL
208,1235,11,1246,1649,0,0,75.56,655,580,三共里,NULL
346,1235,11,1246,1576,0,0,79.06,639,596,鼎盛里,NULL
383,1235,11,1246,1579,0,0,78.91,614,621,本元里,NULL
381,1238,8,1246,1551,0,0,80.34,564,674,本武里,NULL
0,1238,8,1246,1551,0,0,80.34,564,674,本武里,NULL
1017,1232,14,1246,1588,0,0,78.46,545,687,和平里,NULL
146,1239,7,1246,1540,0,0,80.91,537,702,新中里,NULL
123,1230,16,1246,1582,0,0,78.76,523,707,玉皇里,NULL
0,1230,16,1246,1582,0,0,78.76,523,707,玉皇里,NULL
1296,1233,12,1245,1515,0,0,82.18,988,245,興旺里,NULL
220,1235,10,1245,1578,0,0,78.9,888,347,三興里,NULL
219,1239,6,1245,1507,0,0,82.61,869,370,忠誠里,NULL
2075,1238,7,1245,1539,0,0,80.9,845,393,麗林村,NULL
174,1232,13,1245,1639,0,0,75.96,823,409,三元里,NULL
188,1236,9,1245,1593,0,0,78.15,796,440,大同村,NULL
1556,1238,7,1245,1547,0,0,80.48,791,447,復興里,NULL
1554,1229,16,1245,1584,0,0,78.6,754,475,秀山里,NULL
1548,1238,7,1245,1609,0,0,77.38,745,493,新昌里,NULL
1916,1233,12,1245,1656,0,0,75.18,745,488,沙崙里,NULL
36,1234,11,1245,1583,0,0,78.65,740,494,何明里,NULL
561,1231,14,1245,1588,0,0,78.4,732,499,豐圳里,NULL
44,1240,5,1245,1687,0,0,73.8,708,532,富寮里,NULL
307,1231,14,1245,1668,0,0,74.64,698,533,九德村,NULL
333,1236,9,1245,1644,0,0,75.73,687,549,仁和里,NULL
233,1236,9,1245,1555,0,0,80.06,584,652,河邊里,NULL
0,1236,9,1245,1555,0,0,80.06,584,652,河邊里,NULL
351,1232,13,1245,1688,0,0,73.76,583,649,福樂村,NULL
281,1232,13,1245,1734,0,0,71.8,443,789,上竹里,NULL
145,1233,12,1245,1530,0,0,81.37,424,809,新中里,NULL
1320,1236,8,1244,1551,0,0,80.21,904,332,木柵里,NULL
1187,1232,12,1244,1558,0,0,79.85,855,377,龍淵里,NULL
940,1235,9,1244,1535,0,0,81.04,811,424,全泰里,NULL
1077,1236,8,1244,1627,0,0,76.46,784,452,龍福里,NULL
0,1236,8,1244,1627,0,0,76.46,784,452,龍福里,NULL
361,1229,15,1244,1556,0,0,79.95,782,447,明德里,NULL
1566,1234,10,1244,1648,0,0,75.49,761,473,茄苳里,NULL
2046,1232,12,1244,1596,0,0,77.94,714,518,貴賢村,NULL
85,1230,14,1244,1953,0,0,63.7,663,567,進學里,NULL
0,1230,14,1244,1953,0,0,63.7,663,567,進學里,NULL
1534,1237,7,1244,1613,0,0,77.12,652,585,保佑里,NULL
291,1236,8,1244,1620,0,0,76.79,585,651,新生里,NULL
1981,1231,13,1244,1596,0,0,77.94,581,650,成泰村,NULL
0,1236,8,1244,1765,0,0,70.48,576,660,昇平村,NULL
1222,1234,9,1243,1549,0,0,80.25,948,286,寶安里,NULL
505,1229,14,1243,1696,0,0,73.29,798,431,新坪里,NULL
1547,1237,6,1243,1545,0,0,80.45,790,447,新昌里,NULL
55,1233,10,1243,1518,0,0,81.88,788,445,盛昌里,NULL
755,1229,14,1243,1609,0,0,77.25,731,498,國華里,NULL
18,1238,5,1243,1532,0,0,81.14,731,507,福林里,NULL
979,1229,14,1243,1629,0,0,76.3,721,508,菜園里,NULL
1107,1233,10,1243,1638,0,0,75.89,716,517,建安里,NULL
1988,1230,13,1243,1743,0,0,71.31,701,529,五股村,NULL
76,1230,13,1243,1548,0,0,80.3,597,633,永安里,NULL
175,1228,15,1243,1560,0,0,79.68,587,641,富光里,NULL
841,1237,6,1243,1506,0,0,82.54,573,664,雙連里,NULL
522,1230,13,1243,1590,0,0,78.18,455,775,山東里,NULL
1179,1234,8,1242,1592,0,0,78.02,1119,115,群英里,NULL
809,1228,14,1242,1583,0,0,78.46,1055,173,忠義村,NULL
62,1229,13,1242,1537,0,0,80.81,982,247,光明里,NULL
1183,1233,9,1242,1628,0,0,76.29,917,316,虎嘯里,NULL
0,1233,9,1242,2207,0,0,56.28,909,324,都蘭村,NULL
185,1235,7,1242,1649,0,0,75.32,886,349,過港里,NULL
59,1235,7,1242,1601,0,0,77.58,884,351,孝賢里,NULL
1124,1239,3,1242,1567,0,0,79.26,852,387,錦安里,NULL
207,1228,14,1242,1527,0,0,81.34,810,418,名山里,NULL
1271,1230,12,1242,1630,0,0,76.2,805,425,雙城里,NULL
0,1232,10,1242,1549,0,0,80.18,773,459,東川里,NULL
134,1236,6,1242,1538,0,0,80.75,755,481,光興里,NULL
363,1231,11,1242,1573,0,0,78.96,753,478,南崁村,NULL
716,1232,10,1242,1714,0,0,72.46,751,481,聚盛里,NULL
732,1222,20,1242,1530,0,0,81.18,731,491,國光里,NULL
370,1232,10,1242,1707,0,0,72.76,716,516,鹿谷村,NULL
0,1232,10,1242,1707,0,0,72.76,716,516,鹿谷村,NULL
183,1238,4,1242,1596,0,0,77.82,680,558,保安里,NULL
0,1230,12,1242,1722,0,0,72.13,626,604,安溪里,NULL
547,1232,10,1242,1523,0,0,81.55,617,615,大華村,NULL
354,1229,13,1242,1546,0,0,80.34,576,653,鼎西里,NULL
130,1236,5,1241,1600,0,0,77.56,910,326,北昌村,NULL
1238,1234,7,1241,1540,0,0,80.58,903,331,柴埕里,NULL
811,1231,10,1241,1514,0,0,81.97,881,350,福林里,NULL
1183,1231,10,1241,1547,0,0,80.22,881,350,百和里,NULL
1255,1236,5,1241,1520,0,0,81.64,880,356,景華里,NULL
147,1228,13,1241,1558,0,0,79.65,858,370,聖福里,NULL
110,1236,5,1241,1531,0,0,81.06,838,398,豐樂里,NULL
633,1216,25,1241,1554,0,0,79.86,806,410,新社村,NULL
74,1225,16,1241,1587,0,0,78.2,778,447,泰山里,NULL
483,1232,9,1241,1624,0,0,76.42,763,469,西岐里,NULL
58,1235,6,1241,1612,0,0,76.99,722,513,建國里,NULL
262,1233,8,1241,1659,0,0,74.8,715,518,瑞光里,NULL
315,1231,10,1241,1633,0,0,76,706,525,金墩村,NULL
0,1231,10,1241,1633,0,0,76,706,525,金墩村,NULL
568,1233,8,1241,1546,0,0,80.27,703,530,普天里,NULL
71,1227,14,1241,1682,0,0,73.78,698,529,中圍里,NULL
441,1232,9,1241,1638,0,0,75.76,677,555,一德里,NULL
402,1225,16,1241,1593,0,0,77.9,651,574,忠孝里,NULL
0,1225,16,1241,1593,0,0,77.9,651,574,忠孝里,NULL
467,1225,16,1241,1599,0,0,77.61,641,584,中興里,NULL
1012,1236,5,1241,1522,0,0,81.54,631,605,頂碩里,NULL
407,1230,11,1241,1640,0,0,75.67,627,603,塗城里,NULL
393,1226,15,1241,1527,0,0,81.27,593,633,大元里,NULL
0,1233,8,1241,1705,0,0,72.79,501,732,龍山村,NULL
0,1211,29,1240,2873,3935,73.01,43.16,984,227,蘭嶼鄉,Lanyu Township
1210,1234,6,1240,1493,0,0,83.05,946,288,江陵里,NULL
1282,1225,15,1240,1549,0,0,80.05,916,309,玫瑰里,NULL
593,1228,12,1240,1534,0,0,80.83,889,339,廣居里,NULL
23,1235,5,1240,1569,0,0,79.03,823,412,自強里,NULL
630,1229,11,1240,1589,0,0,78.04,775,454,惠來里,NULL
458,1234,6,1240,1583,0,0,78.33,762,472,正興里,NULL
188,1230,10,1240,1581,0,0,78.43,760,470,東興里,NULL
0,1230,10,1240,1581,0,0,78.43,760,470,東興里,NULL
470,1231,9,1240,1650,0,0,75.15,729,502,永平里,NULL
135,1232,8,1240,1510,0,0,82.12,710,522,新上里,NULL
809,1230,10,1240,1570,0,0,78.98,702,528,埤頭里,NULL
440,1230,10,1240,1721,0,0,72.05,689,541,中華里,NULL
0,1230,10,1240,1721,0,0,72.05,689,541,中華里,NULL
203,1228,12,1240,1525,0,0,81.31,688,540,雙玉里,NULL
199,1239,1,1240,1620,0,0,76.54,660,579,藥王里,NULL
1045,1227,13,1240,1510,0,0,82.12,627,600,榮德里,NULL
606,1216,24,1240,1579,0,0,78.53,559,657,東陽里,NULL
0,1216,24,1240,1579,0,0,78.53,559,657,東陽里,NULL
9,1237,2,1239,1550,0,0,79.94,882,355,十興里,NULL
16,1236,3,1239,1622,0,0,76.39,831,405,山腳里,NULL
325,1225,14,1239,1565,0,0,79.17,823,402,長沙村,NULL
932,1225,14,1239,1613,0,0,76.81,815,410,南福里,NULL
78,1230,9,1239,1504,0,0,82.38,802,428,中正里,NULL
960,1233,6,1239,1574,0,0,78.72,801,432,文祥里,NULL
1418,1227,12,1239,1561,0,0,79.37,793,434,金城里,NULL
155,1224,15,1239,1739,0,0,71.25,786,438,春日里,NULL
22,1230,9,1239,1566,0,0,79.12,742,488,新店里,NULL
995,1221,18,1239,1537,0,0,80.61,730,491,思賢里,NULL
1108,1234,5,1239,1619,0,0,76.53,711,523,建安里,NULL
982,1228,11,1239,1633,0,0,75.87,654,574,青山里,NULL
527,1227,12,1239,1533,0,0,80.82,603,624,仁慈村,NULL
0,1227,12,1239,1533,0,0,80.82,603,624,仁慈村,NULL
1211,1225,13,1238,1497,0,0,82.7,902,323,江陵里,NULL
666,1224,14,1238,1512,0,0,81.88,894,330,中興里,NULL
594,1229,9,1238,1516,0,0,81.66,859,370,廣居里,NULL
1293,1227,11,1238,1580,0,0,78.35,828,399,美潭里,NULL
691,1224,14,1238,1472,0,0,84.1,772,452,錦和里,NULL
238,1234,4,1238,1545,0,0,80.13,771,463,長庚村,NULL
448,1223,15,1238,1675,0,0,73.91,719,504,保庄里,NULL
409,1230,8,1238,1600,0,0,77.38,715,515,昇平里,NULL
408,1229,9,1238,1709,0,0,72.44,665,564,塗城里,NULL
284,1228,10,1238,1734,0,0,71.4,607,621,大南村,NULL
0,1228,10,1238,1734,0,0,71.4,607,621,大南村,NULL
816,1232,6,1238,1531,0,0,80.86,579,653,瑞南里,NULL
0,1222,16,1238,1818,0,0,68.1,513,709,梧南村,NULL
302,1228,10,1238,1656,0,0,74.76,476,752,厚生里,NULL
0,1227,11,1238,1544,0,0,80.18,447,780,翠屏村,NULL
527,1218,19,1237,1660,0,0,74.52,835,383,後寮里,NULL
0,1227,10,1237,1931,0,0,64.06,819,408,福原村,NULL
973,1220,17,1237,1720,0,0,71.92,811,409,西門里,NULL
175,1225,12,1237,1608,0,0,76.93,760,465,北京里,NULL
519,1226,11,1237,1600,0,0,77.31,748,478,新高里,NULL
292,1226,11,1237,1519,0,0,81.44,725,501,港墘里,NULL
410,1217,20,1237,1538,0,0,80.43,721,496,東興里,NULL
279,1222,15,1237,1743,0,0,70.97,718,504,頂街村,NULL
390,1225,12,1237,1589,0,0,77.85,718,507,崇明里,NULL
267,1221,16,1237,1622,0,0,76.26,664,557,清溪里,NULL
355,1229,8,1237,1537,0,0,80.48,548,681,鼎西里,NULL
908,1233,3,1236,1492,0,0,82.84,933,300,保安里,NULL
120,1223,13,1236,1727,0,0,71.57,924,299,永興村,NULL
255,1225,11,1236,1554,0,0,79.54,917,308,瑞發里,NULL
866,1221,15,1236,1740,0,0,71.03,829,392,瑞原里,NULL
1880,1221,15,1236,1634,0,0,75.64,819,402,水碓里,NULL
308,1225,11,1236,1530,0,0,80.78,818,407,內湖里,NULL
17,1230,6,1236,1551,0,0,79.69,803,427,榮華里,NULL
145,1224,12,1236,1560,0,0,79.23,755,469,忠翠里,NULL
782,1213,23,1236,1612,0,0,76.67,723,490,北貴里,NULL
258,1221,15,1236,1632,0,0,75.74,679,542,王田村,NULL
269,1226,10,1236,1528,0,0,80.89,659,567,四民里,NULL
0,1226,10,1236,1528,0,0,80.89,659,567,四民里,NULL
0,1226,10,1236,1548,0,0,79.84,633,593,士林里,NULL
33,1217,19,1236,1638,0,0,75.46,608,609,塭港村,NULL
0,1217,19,1236,1638,0,0,75.46,608,609,塭港村,NULL
348,1226,10,1236,1606,0,0,76.96,606,620,鼎盛里,NULL
431,1219,17,1236,2174,0,0,56.85,591,628,寶珠里,NULL
120,1225,10,1235,1522,0,0,81.14,1081,144,崇實里,NULL
0,1225,10,1235,1522,0,0,81.14,1081,144,崇實里,NULL
53,1226,9,1235,1554,0,0,79.47,958,268,文山里,NULL
877,1225,10,1235,1575,0,0,78.41,859,366,店街里,NULL
1898,1222,13,1235,1639,0,0,75.35,812,410,鄧公里,NULL
1167,1218,17,1235,1534,0,0,80.51,792,426,通安里,NULL
1108,1221,14,1235,1575,0,0,78.41,779,442,龍坡里,NULL
535,1219,16,1235,1565,0,0,78.91,655,564,慈愛里,NULL
424,1229,6,1235,1544,0,0,79.99,595,634,寶安里,NULL
814,1221,14,1235,1533,0,0,80.56,584,637,瑞南里,NULL
871,1224,11,1235,1547,0,0,79.83,583,641,至聖里,NULL
383,1223,12,1235,1569,0,0,78.71,431,792,厦北村,NULL
0,1223,12,1235,1569,0,0,78.71,431,792,厦北村,NULL
624,1220,14,1234,1490,0,0,82.82,886,334,普強里,NULL
483,1222,12,1234,1597,0,0,77.27,863,359,富錦里,NULL
595,1225,9,1234,1543,0,0,79.97,830,395,廣居里,NULL
901,1224,10,1234,1538,0,0,80.23,818,406,網溪里,NULL
1896,1229,5,1234,1679,0,0,73.5,775,454,鄧公里,NULL
107,1223,11,1234,1538,0,0,80.23,772,451,稻香里,NULL
865,1225,9,1234,1638,0,0,75.34,772,453,瑞原里,NULL
931,1228,6,1234,1590,0,0,77.61,741,487,新生村,NULL
342,1224,10,1234,1650,0,0,74.79,722,502,竹林村,NULL
0,1224,10,1234,1650,0,0,74.79,722,502,竹林村,NULL
0,1224,10,1234,1674,0,0,73.72,692,532,新興里,NULL
610,1212,22,1234,1602,0,0,77.03,653,559,南田里,NULL
356,1217,17,1234,1533,0,0,80.5,553,664,鼎西里,NULL
71,1229,5,1234,1482,0,0,83.27,544,685,裕昌里,NULL
0,1228,6,1234,1529,0,0,80.71,536,692,中新里,NULL
647,1223,10,1233,1496,0,0,82.42,922,301,崇南里,NULL
678,1216,17,1233,1573,0,0,78.39,847,369,景平里,NULL
358,1231,2,1233,1517,0,0,81.28,834,397,紫陽里,NULL
1210,1223,10,1233,1585,0,0,77.79,829,394,建安里,NULL
340,1222,11,1233,1451,0,0,84.98,776,446,裕聖里,NULL
723,1220,13,1233,1652,0,0,74.64,694,526,恆安里,NULL
780,1222,11,1233,1559,0,0,79.09,693,529,江寧里,NULL
96,1226,7,1233,1574,0,0,78.34,670,556,香楊村,NULL
1059,1215,18,1233,1575,0,0,78.29,661,554,瓊林里,NULL
248,1223,10,1233,1647,0,0,74.86,608,615,白雲村,NULL
0,1223,10,1233,1647,0,0,74.86,608,615,白雲村,NULL
958,1220,13,1233,1589,0,0,77.6,519,701,頭前里,NULL
31,1225,8,1233,1543,0,0,79.91,337,888,稔田里,NULL
0,1225,8,1233,1543,0,0,79.91,337,888,稔田里,NULL
503,1227,5,1232,1525,0,0,80.79,993,234,華愛里,NULL
1263,1225,7,1232,1559,0,0,79.03,964,261,達觀里,NULL
1221,1218,14,1232,1553,0,0,79.33,902,316,寶安里,NULL
1176,1228,4,1232,1552,0,0,79.38,834,394,群賢里,NULL
789,1218,14,1232,1510,0,0,81.59,808,410,東社里,NULL
1266,1223,9,1232,1531,0,0,80.47,779,444,萬年里,NULL
334,1225,7,1232,1555,0,0,79.23,759,466,崇德里,NULL
182,1223,9,1232,1499,0,0,82.19,751,472,金雅里,NULL
0,1223,9,1232,1499,0,0,82.19,751,472,金雅里,NULL
144,1229,3,1232,1557,0,0,79.13,715,514,福佳里,NULL
157,1215,17,1232,1609,0,0,76.57,679,536,福德里,NULL
429,1218,14,1232,1550,0,0,79.48,627,591,中央里,NULL
0,1218,14,1232,1550,0,0,79.48,627,591,中央里,NULL
210,1222,10,1232,1597,0,0,77.14,586,636,平安里,NULL
154,1215,17,1232,1571,0,0,78.42,554,661,大港里,NULL
0,1225,7,1232,1588,0,0,77.58,512,713,本洲里,NULL
0,1229,3,1232,1663,0,0,74.08,490,739,港埔村,NULL
8,1222,9,1231,1478,0,0,83.29,1005,217,西平里,NULL
1301,1222,9,1231,1519,0,0,81.04,909,313,興泰里,NULL
274,1215,16,1231,1481,0,0,83.12,901,314,上山村,NULL
1910,1223,8,1231,1612,0,0,76.36,819,404,文化里,NULL
0,1223,8,1231,1612,0,0,76.36,819,404,文化里,NULL
222,1223,8,1231,1512,0,0,81.42,769,454,芝山里,NULL
1999,1219,12,1231,1593,0,0,77.28,765,454,德泰村,NULL
176,1223,8,1231,1686,0,0,73.01,739,484,德陽村,NULL
539,1216,15,1231,1726,0,0,71.32,734,482,合興村,NULL
374,1219,12,1231,1548,0,0,79.52,724,495,國光里,NULL
573,1222,9,1231,1528,0,0,80.56,697,525,林安里,NULL
0,1222,9,1231,1528,0,0,80.56,697,525,林安里,NULL
549,1226,5,1231,1504,0,0,81.85,687,539,大華村,NULL
416,1223,8,1231,1545,0,0,79.68,678,545,新富里,NULL
112,1221,10,1231,1685,0,0,73.06,640,581,詔安里,NULL
0,1221,10,1231,1685,0,0,73.06,640,581,詔安里,NULL
0,1219,12,1231,1679,0,0,73.32,614,605,東湖村,NULL
660,1217,14,1231,1563,0,0,78.76,578,639,興東里,NULL
370,1222,9,1231,1529,0,0,80.51,527,695,本館里,NULL
259,1216,14,1230,1518,0,0,81.03,1000,216,瑞祥里,NULL
1197,1218,12,1230,1507,0,0,81.62,959,259,中央里,NULL
838,1220,10,1230,1483,0,0,82.94,874,346,永元里,NULL
687,1221,9,1230,1529,0,0,80.44,840,381,雙和里,NULL
2078,1222,8,1230,1569,0,0,78.39,813,409,東勢村,NULL
402,1222,8,1230,1652,0,0,74.46,796,426,鎮西里,NULL
339,1219,11,1230,1534,0,0,80.18,769,450,北柳村,NULL
906,1223,7,1230,1513,0,0,81.3,758,465,螢圃里,NULL
181,1224,6,1230,1566,0,0,78.54,674,550,龜山村,NULL
607,1224,6,1230,1544,0,0,79.66,640,584,水尾里,NULL
756,1218,12,1230,1534,0,0,80.18,625,593,新福里,NULL
879,1224,6,1230,1473,0,0,83.5,621,603,重慶里,NULL
314,1219,11,1230,2026,0,0,60.71,613,606,崇信里,NULL
551,1222,7,1229,1484,0,0,82.82,1079,143,自治里,NULL
33,1219,10,1229,1533,0,0,80.17,913,306,竹仁里,NULL
777,1213,16,1229,1553,0,0,79.14,871,342,新安里,NULL
484,1214,15,1229,1537,0,0,79.96,821,393,富錦里,NULL
242,1219,10,1229,1566,0,0,78.48,798,421,天福里,NULL
904,1220,9,1229,1528,0,0,80.43,779,441,中溪里,NULL
15,1216,13,1229,1609,0,0,76.38,722,494,信光里,NULL
800,1218,11,1229,1611,0,0,76.29,719,499,朱馥里,NULL
290,1217,12,1229,1652,0,0,74.39,704,513,竹中里,NULL
0,1217,12,1229,1652,0,0,74.39,704,513,竹中里,NULL
1471,1214,15,1229,1612,0,0,76.24,679,535,南港里,NULL
138,1217,12,1229,1506,0,0,81.61,655,562,成德里,NULL
378,1223,6,1229,1505,0,0,81.66,641,582,本和里,NULL
69,1214,14,1228,1563,0,0,78.57,844,370,龍鳳里,NULL
199,1217,11,1228,1638,0,0,74.97,796,421,福興里,NULL
77,1221,7,1228,1680,0,0,73.1,787,434,鹽南村,NULL
0,1221,7,1228,1680,0,0,73.1,787,434,鹽南村,NULL
1215,1209,19,1228,1623,0,0,75.66,781,428,建倫里,NULL
2000,1222,6,1228,1640,0,0,74.88,713,509,德泰村,NULL
708,1216,12,1228,1577,0,0,77.87,684,532,文元里,NULL
1124,1216,12,1228,1633,0,0,75.2,663,553,光明里,NULL
1476,1217,11,1228,1577,0,0,77.87,629,588,永樂里,NULL
678,1218,10,1228,1720,0,0,71.4,628,590,出水里,NULL
0,1218,10,1228,1720,0,0,71.4,628,590,出水里,NULL
173,1221,7,1228,1517,0,0,80.95,615,606,福順里,NULL
1363,1223,4,1227,1499,0,0,81.85,838,385,廣福里,NULL
354,1214,13,1227,1658,0,0,74,818,396,南興村,NULL
277,1215,12,1227,1626,0,0,75.46,818,397,新平里,NULL
282,1216,11,1227,1517,0,0,80.88,763,453,西康里,NULL
953,1216,11,1227,2231,0,0,55,747,469,榮和里,NULL
433,1217,10,1227,1645,0,0,74.59,719,498,金城里,NULL
1321,1217,10,1227,1587,0,0,77.32,676,541,大安里,NULL
461,1220,7,1227,1618,0,0,75.83,673,547,中平里,NULL
502,1214,13,1227,1606,0,0,76.4,654,560,宜昌里,NULL
292,1216,11,1227,1657,0,0,74.05,599,617,六合里,NULL
0,1216,11,1227,1657,0,0,74.05,599,617,六合里,NULL
449,1219,8,1227,1597,0,0,76.83,585,634,長平里,NULL
0,1219,8,1227,1597,0,0,76.83,585,634,長平里,NULL
194,1215,12,1227,1552,0,0,79.06,529,686,永倫里,NULL
94,1224,3,1227,1530,0,0,80.2,518,706,尾北里,NULL
593,1214,13,1227,1518,0,0,80.83,502,712,福壽里,NULL
0,1214,13,1227,1518,0,0,80.83,502,712,福壽里,NULL
302,1217,10,1227,1503,0,0,81.64,480,737,十全里,NULL
0,1217,10,1227,1503,0,0,81.64,480,737,十全里,NULL
51,1215,11,1226,1459,0,0,84.03,1107,108,武功里,NULL
89,1219,7,1226,1555,0,0,78.84,923,296,中成里,NULL
15,1215,11,1226,1468,0,0,83.51,919,296,十興里,NULL
1322,1218,8,1226,1522,0,0,80.55,914,304,木柵里,NULL
348,1215,11,1226,1520,0,0,80.66,883,332,金湖里,NULL
554,1217,9,1226,1603,0,0,76.48,874,343,振興里,NULL
406,1211,15,1226,1579,0,0,77.64,747,464,双龍里,NULL
0,1208,18,1226,1598,0,0,76.72,733,475,龜売村,NULL
540,1212,14,1226,1738,0,0,70.54,718,494,平原村,NULL
0,1212,14,1226,1738,0,0,70.54,718,494,平原村,NULL
1749,1208,18,1226,1633,0,0,75.08,686,522,建國里,NULL
54,1214,12,1226,1512,0,0,81.08,685,529,盛昌里,NULL
463,1219,7,1226,1639,0,0,74.8,678,541,中政里,NULL
57,1216,10,1226,1655,0,0,74.08,621,595,北津里,NULL
0,1216,10,1226,1655,0,0,74.08,621,595,北津里,NULL
579,1219,7,1226,1520,0,0,80.66,616,603,林中里,NULL
879,1218,7,1225,1540,0,0,79.55,1020,198,百年村,NULL
1062,1218,7,1225,1483,0,0,82.6,1006,212,新和里,NULL
153,1215,10,1225,1611,0,0,76.04,836,379,春日里,NULL
3,1213,12,1225,1549,0,0,79.08,821,392,同安里,NULL
963,1218,7,1225,1537,0,0,79.7,813,405,文祥里,NULL
79,1217,8,1225,1596,0,0,76.75,786,431,中正里,NULL
563,1218,7,1225,1507,0,0,81.29,741,477,敦化里,NULL
206,1218,7,1225,1538,0,0,79.65,725,493,名山里,NULL
209,1215,10,1225,1489,0,0,82.27,717,498,名山里,NULL
410,1215,10,1225,1617,0,0,75.76,659,556,埔心村,NULL
214,1216,9,1225,1541,0,0,79.49,654,562,德華里,NULL
980,1213,12,1225,1524,0,0,80.38,645,568,菜園里,NULL
765,1219,6,1225,1548,0,0,79.13,643,576,中庄里,NULL
189,1216,9,1225,1533,0,0,79.91,536,680,光賢里,NULL
0,1216,9,1225,1574,0,0,77.83,422,794,茄苳村,NULL
1309,1220,4,1224,1556,0,0,78.66,918,302,華興里,NULL
1215,1216,8,1224,1528,0,0,80.1,881,335,寶興里,NULL
1555,1216,8,1224,1562,0,0,78.36,869,347,秀山里,NULL
408,1219,5,1224,1478,0,0,82.81,794,425,湖元里,NULL
184,1216,8,1224,1490,0,0,82.15,782,434,新路村,NULL
249,1211,13,1224,1519,0,0,80.58,763,448,天和里,NULL
94,1211,13,1224,1593,0,0,76.84,698,513,福和里,NULL
482,1216,8,1224,1583,0,0,77.32,686,530,西岐里,NULL
0,1206,18,1224,1929,0,0,63.45,680,526,大光里,NULL
396,1210,14,1224,1588,0,0,77.08,679,531,大同里,NULL
0,1210,14,1224,1588,0,0,77.08,679,531,大同里,NULL
554,1209,15,1224,1554,0,0,78.76,659,550,仁華里,NULL
81,1205,19,1224,1594,0,0,76.79,629,576,北門里,NULL
0,1205,19,1224,1594,0,0,76.79,629,576,北門里,NULL
860,1214,10,1224,1576,0,0,77.66,580,634,國慶里,NULL
0,1215,9,1224,1820,0,0,67.25,494,721,西平里,NULL
1057,1214,9,1223,1482,0,0,82.52,996,218,忠貞里,NULL
129,1209,14,1223,1681,0,0,72.75,876,333,北昌村,NULL
310,1214,9,1223,1558,0,0,78.5,862,352,內湖里,NULL
896,1217,6,1223,1584,0,0,77.21,836,381,頂東里,NULL
257,1215,8,1223,1517,0,0,80.62,735,480,新興里,NULL
976,1211,12,1223,1599,0,0,76.49,697,514,信義里,NULL
808,1214,9,1223,1548,0,0,79.01,663,551,盛豐里,NULL
542,1205,18,1223,1540,0,0,79.42,662,543,崇倫里,NULL
511,1204,19,1223,1552,0,0,78.8,658,546,福平里,NULL
74,1215,8,1223,1616,0,0,75.68,652,563,中央里,NULL
846,1213,10,1223,1604,0,0,76.25,651,562,南芳里,NULL
108,1211,12,1223,1491,0,0,82.03,651,560,豐樂里,NULL
439,1210,13,1223,1662,0,0,73.59,575,635,小新里,NULL
204,1215,8,1223,1497,0,0,81.7,468,747,厚生里,NULL
574,1216,6,1222,1392,0,0,87.79,1174,42,莊敬里,NULL
537,1208,14,1222,1525,0,0,80.13,973,235,自立里,NULL
797,1208,14,1222,1561,0,0,78.28,814,394,仁美里,NULL
400,1213,9,1222,1541,0,0,79.3,799,414,湖興里,NULL
777,1210,12,1222,1499,0,0,81.52,728,482,下埤里,NULL
1310,1211,11,1222,1547,0,0,78.99,719,492,頂福里,NULL
573,1205,17,1222,1606,0,0,76.09,714,491,社皮里,NULL
1565,1205,17,1222,1589,0,0,76.9,687,518,茄苳里,NULL
514,1206,16,1222,1560,0,0,78.33,663,543,新光里,NULL
520,1215,7,1222,1499,0,0,81.52,641,574,開平里,NULL
505,1216,6,1222,1561,0,0,78.28,587,629,永豐里,NULL
460,1210,12,1222,1569,0,0,77.88,573,637,正順里,NULL
307,1208,13,1221,1453,0,0,84.03,1152,56,陸光里,NULL
801,1203,18,1221,1530,0,0,79.8,888,315,光華里,NULL
686,1211,10,1221,1466,0,0,83.29,855,356,雙和里,NULL
592,1214,7,1221,1576,0,0,77.47,847,367,幸福里,NULL
89,1211,10,1221,1640,0,0,74.45,839,372,德厚里,NULL
0,1211,10,1221,1640,0,0,74.45,839,372,德厚里,NULL
830,1206,15,1221,1517,0,0,80.49,817,389,永貞里,NULL
321,1210,11,1221,1594,0,0,76.6,746,464,溪福里,NULL
466,1203,18,1221,1661,0,0,73.51,733,470,西溪里,NULL
0,1203,18,1221,1661,0,0,73.51,733,470,西溪里,NULL
1746,1211,10,1221,1554,0,0,78.57,685,526,南鶯里,NULL
424,1210,11,1221,1654,0,0,73.82,672,538,南港村,NULL
0,1210,11,1221,1654,0,0,73.82,672,538,南港村,NULL
85,1213,8,1221,1581,0,0,77.23,650,563,土城村,NULL
0,1213,8,1221,1581,0,0,77.23,650,563,土城村,NULL
1020,1212,9,1221,1531,0,0,79.75,627,585,和平里,NULL
376,1209,12,1221,1536,0,0,79.49,578,631,田中里,NULL
396,1212,9,1221,1578,0,0,77.38,268,944,寮廍里,NULL
0,1212,9,1221,1578,0,0,77.38,268,944,寮廍里,NULL
1341,1208,12,1220,1512,0,0,80.69,880,328,樟新里,NULL
816,1207,13,1220,1558,0,0,78.31,876,331,永興里,NULL
1682,1208,12,1220,1569,0,0,77.76,755,453,樹西里,NULL
582,1215,5,1220,1531,0,0,79.69,751,464,林南里,NULL
315,1208,12,1220,1514,0,0,80.58,736,472,建德里,NULL
346,1211,9,1220,1576,0,0,77.41,693,518,明正里、興樂里,NULL
0,1211,9,1220,1576,0,0,77.41,693,518,明正里、興樂里,NULL
157,1211,9,1220,1575,0,0,77.46,644,567,光路里,NULL
399,1211,9,1220,1547,0,0,78.86,532,679,寶德里,NULL
687,1211,9,1220,1617,0,0,75.45,524,687,店鎮里,NULL
84,1211,9,1220,1541,0,0,79.17,434,777,中和里,NULL
0,1211,9,1220,1541,0,0,79.17,434,777,中和里,NULL
43,1207,12,1219,1724,0,0,70.71,937,270,豐榮里,NULL
807,1206,13,1219,1527,0,0,79.83,930,276,桂林里,NULL
571,1211,8,1219,1503,0,0,81.1,854,357,德行里,NULL
1109,1209,10,1219,1559,0,0,78.19,846,363,龍坡里,NULL
591,1211,8,1219,1566,0,0,77.84,837,374,幸福里,NULL
4,1207,12,1219,1451,0,0,84.01,836,371,中興里,NULL
397,1212,7,1219,1559,0,0,78.19,775,437,吉龍里,NULL
428,1212,7,1219,1543,0,0,79,766,446,舊莊里,NULL
0,1212,7,1219,1537,0,0,79.31,765,447,三和村,NULL
185,1211,8,1219,1622,0,0,75.15,633,578,保安里,NULL
88,1206,13,1219,1524,0,0,79.99,610,596,純翠里,NULL
153,1207,12,1219,1521,0,0,80.14,599,608,福中里,NULL
873,1208,11,1219,1538,0,0,79.26,595,613,至聖里,NULL
513,1206,13,1219,1527,0,0,79.83,582,624,新光里,NULL
30,1203,16,1219,1688,0,0,72.22,564,639,梅花里,NULL
350,1213,5,1218,1448,0,0,84.12,870,343,金湖里,NULL
1159,1204,14,1218,1554,0,0,78.38,865,339,義安里,NULL
832,1206,12,1218,1565,0,0,77.83,858,348,永寧里,NULL
213,1204,14,1218,1551,0,0,78.53,845,359,松茂里,NULL
544,1205,13,1218,1514,0,0,80.45,823,382,新興里,NULL
476,1210,8,1218,1505,0,0,80.93,768,442,三民里,NULL
418,1208,10,1218,1534,0,0,79.4,703,505,中研里,NULL
602,1211,7,1218,1442,0,0,84.47,689,522,六藝里,NULL
784,1210,8,1218,1549,0,0,78.63,686,524,江山里,NULL
205,1192,26,1218,1502,0,0,81.09,675,517,光南里,NULL
0,1192,26,1218,1502,0,0,81.09,675,517,光南里,NULL
403,1211,7,1218,1622,0,0,75.09,651,560,健民里,NULL
175,1209,9,1218,1640,0,0,74.27,646,563,玉石村,NULL
0,1209,9,1218,1640,0,0,74.27,646,563,玉石村,NULL
469,1208,10,1218,1528,0,0,79.71,567,641,六福里,NULL
324,1201,17,1218,1499,0,0,81.25,564,637,安東里,NULL
0,1204,14,1218,1588,0,0,76.7,540,664,龍壽村,NULL
258,1203,14,1217,1489,0,0,81.73,939,264,瑞祥里,NULL
220,1208,9,1217,1559,0,0,78.06,782,426,南瑶里,NULL
237,1202,15,1217,1539,0,0,79.08,766,436,忠權里,NULL
498,1203,14,1217,1624,0,0,74.94,763,440,東光里,NULL
905,1207,10,1217,1517,0,0,80.22,743,464,保安里,NULL
1052,1211,6,1217,1562,0,0,77.91,719,492,立言里,NULL
230,1208,9,1217,1511,0,0,80.54,686,522,三玉里,NULL
1038,1214,3,1217,1485,0,0,81.95,659,555,銘德里,NULL
393,1203,14,1217,1606,0,0,75.78,644,559,大德里,NULL
0,1203,14,1217,1606,0,0,75.78,644,559,大德里,NULL
373,1207,10,1217,1496,0,0,81.35,612,595,本館里,NULL
766,1196,21,1217,1665,0,0,73.09,579,617,豐洲村,NULL
144,1209,8,1217,1518,0,0,80.17,477,732,新中里,NULL
229,1203,13,1216,1524,0,0,79.79,823,380,松竹里,NULL
44,1203,13,1216,1594,0,0,76.29,806,397,何成里,NULL
37,1200,16,1216,1623,0,0,74.92,794,406,新庄里,NULL
147,1206,10,1216,1679,0,0,72.42,754,452,湖西村,NULL
8,1209,7,1216,1547,0,0,78.6,744,465,盧厝里,NULL
88,1203,13,1216,1540,0,0,78.96,657,546,中成里,NULL
381,1205,11,1216,1606,0,0,75.72,656,549,衛國里,NULL
0,1205,11,1216,1606,0,0,75.72,656,549,衛國里,NULL
217,1208,8,1216,1486,0,0,81.83,651,557,東丘里,NULL
1126,1202,14,1216,1585,0,0,76.72,651,551,光正里,NULL
456,1211,5,1216,1548,0,0,78.55,621,590,正興里,NULL
157,1200,16,1216,1538,0,0,79.06,603,597,百齡里,NULL
338,1205,11,1216,1554,0,0,78.25,596,609,虎尾里,NULL
290,1203,13,1216,1626,0,0,74.78,569,634,開南里,NULL
211,1212,4,1216,1567,0,0,77.6,490,722,平安里,NULL
1300,1205,10,1215,1500,0,0,81,895,310,興泰里,NULL
68,1207,8,1215,1550,0,0,78.39,869,338,龍鳳里,NULL
89,1209,6,1215,1607,0,0,75.61,740,469,頂庄里,NULL
281,1202,13,1215,1523,0,0,79.78,738,464,阿夷里,NULL
249,1206,9,1215,1632,0,0,74.45,709,497,新庄村,NULL
999,1207,8,1215,1564,0,0,77.69,702,505,中美里,NULL
157,1197,18,1215,1631,0,0,74.49,681,516,福興村,NULL
0,1201,14,1215,1599,0,0,75.98,676,525,順天里,NULL
935,1202,13,1215,1512,0,0,80.36,643,559,海山里,NULL
158,1210,5,1215,1559,0,0,77.93,608,602,大豐里,NULL
0,1211,4,1215,1608,0,0,75.56,586,625,美福村,NULL
0,1202,13,1215,1690,0,0,71.89,586,616,宣信里,NULL
0,1202,12,1214,1568,0,0,77.42,902,300,仁愛里,NULL
1105,1204,10,1214,1616,0,0,75.12,839,365,光武里,NULL
212,1206,8,1214,1666,0,0,72.87,824,382,新嶺村,NULL
34,1205,9,1214,1533,0,0,79.19,786,419,翠屏里,NULL
1217,1207,7,1214,1607,0,0,75.54,744,463,敦安里,NULL
179,1205,9,1214,1493,0,0,81.31,739,466,葫蘆里,NULL
118,1203,11,1214,1543,0,0,78.68,721,482,草中里,NULL
250,1205,9,1214,1566,0,0,77.52,717,488,大豐里,NULL
601,1201,13,1214,1526,0,0,79.55,707,494,六藝里,NULL
113,1201,13,1214,1548,0,0,78.42,692,509,慈文里,NULL
227,1205,9,1214,1576,0,0,77.03,682,523,怡平里,NULL
796,1204,10,1214,1555,0,0,78.07,635,569,員林村,NULL
198,1212,2,1214,1668,0,0,72.78,612,600,光華里,NULL
283,1202,12,1214,1507,0,0,80.56,579,623,建南里,NULL
330,1203,11,1214,1575,0,0,77.08,577,626,西安村,NULL
439,1196,18,1214,1588,0,0,76.45,509,687,灣子里,NULL
519,1200,13,1213,1462,0,0,82.97,1054,146,龍東里,NULL
809,1209,4,1213,1539,0,0,78.82,944,265,上林里,NULL
95,1206,7,1213,1488,0,0,81.52,921,285,屏山里,NULL
0,1206,7,1213,1488,0,0,81.52,921,285,屏山里,NULL
213,1193,20,1213,1530,0,0,79.28,890,303,長嶺村,NULL
1346,1203,10,1213,1463,0,0,82.91,858,345,樟腳里,NULL
659,1211,2,1213,1527,0,0,79.44,857,354,惠安里,NULL
1862,1201,12,1213,1568,0,0,77.36,784,417,竹圍里,NULL
106,1208,5,1213,1582,0,0,76.68,760,448,中信里,NULL
453,1204,9,1213,1475,0,0,82.24,738,466,聯成里,NULL
115,1207,6,1213,1542,0,0,78.66,732,475,關渡里,NULL
311,1197,16,1213,1599,0,0,75.86,724,473,崑崙里,NULL
201,1200,13,1213,1684,0,0,72.03,714,486,兔坑村,NULL
564,1204,9,1213,1491,0,0,81.35,678,526,西安里,NULL
876,1202,11,1213,1512,0,0,80.22,613,589,老師里,NULL
1512,1203,10,1213,1568,0,0,77.36,599,604,得勝里,NULL
186,1208,5,1213,1502,0,0,80.76,565,643,社新里,NULL
346,1204,9,1213,1602,0,0,75.72,536,668,建南里,NULL
21,1201,11,1212,1595,0,0,75.99,875,326,中德里,NULL
46,1205,7,1212,1540,0,0,78.7,874,331,禮儀里,NULL
0,1205,7,1212,1540,0,0,78.7,874,331,禮儀里,NULL
1633,1202,10,1212,1519,0,0,79.79,856,346,福山里,NULL
223,1208,4,1212,1479,0,0,81.95,777,431,芝山里,NULL
359,1204,8,1212,1504,0,0,80.59,748,456,紫陽里,NULL
87,1201,11,1212,1564,0,0,77.49,730,471,中心里,NULL
325,1199,13,1212,1497,0,0,80.96,724,475,崇文里,NULL
243,1202,10,1212,1602,0,0,75.66,693,509,內興里,NULL
1367,1191,21,1212,1530,0,0,79.22,667,524,埤林里,NULL
502,1200,12,1212,1539,0,0,78.75,663,537,積善里,NULL
108,1205,7,1212,1542,0,0,78.6,653,552,永祥里,NULL
113,1198,14,1212,1660,0,0,73.01,639,559,麻寮里,NULL
118,1205,7,1212,1616,0,0,75,615,590,長安里,NULL
509,1204,8,1212,1573,0,0,77.05,612,592,永清里,NULL
172,1202,10,1212,1562,0,0,77.59,601,601,鶴鳴村,NULL
387,1202,10,1212,1496,0,0,81.02,597,605,公館里,NULL
267,1201,11,1212,1530,0,0,79.22,588,613,清溝村,NULL
374,1203,9,1212,1470,0,0,82.45,579,624,福田里,NULL
0,1206,6,1212,1601,0,0,75.7,494,712,埤頭村,NULL
197,1195,17,1212,1565,0,0,77.44,462,733,民權里,NULL
0,1195,17,1212,1565,0,0,77.44,462,733,民權里,NULL
228,1196,15,1211,1603,0,0,75.55,949,247,鳳山村,NULL
507,1199,12,1211,1447,0,0,83.69,937,262,龍昌里,NULL
1076,1203,8,1211,1631,0,0,74.25,806,397,德安里,NULL
70,1199,12,1211,1512,0,0,80.09,752,447,港尾里,NULL
516,1193,18,1211,1492,0,0,81.17,746,447,民有里,NULL
1315,1196,15,1211,1585,0,0,76.4,678,518,沛陂里,NULL
543,1205,6,1211,1543,0,0,78.48,663,542,中陽里,NULL
112,1194,17,1211,1499,0,0,80.79,651,543,楓樹里,NULL
1001,1197,14,1211,1507,0,0,80.36,650,547,中美里,NULL
107,1199,12,1211,1604,0,0,75.5,644,555,中樓里,NULL
0,1199,12,1211,1604,0,0,75.5,644,555,中樓里,NULL
986,1190,21,1211,1566,0,0,77.33,587,603,富民里,NULL
33,1196,15,1211,1651,0,0,73.35,544,652,大安里,NULL
178,1202,9,1211,1477,0,0,81.99,506,696,葫蘆里,NULL
336,1208,3,1211,1651,0,0,73.35,328,880,菁埔村,NULL
0,1208,3,1211,1651,0,0,73.35,328,880,菁埔村,NULL
256,1198,12,1210,1513,0,0,79.97,907,291,瑞德里,NULL
131,1199,11,1210,1600,0,0,75.63,890,309,北昌村,NULL
660,1202,8,1210,1428,0,0,84.73,873,329,惠安里,NULL
1169,1195,15,1210,1482,0,0,81.65,830,365,中正里,NULL
62,1203,7,1210,1497,0,0,80.83,788,415,奇岩里,NULL
576,1198,12,1210,1493,0,0,81.04,773,425,漳和里,NULL
688,1201,9,1210,1475,0,0,82.03,732,469,嘉興里,NULL
459,1202,8,1210,1572,0,0,76.97,730,472,永成里,NULL
77,1195,15,1210,1557,0,0,77.71,730,465,永安里,NULL
0,1204,6,1210,1640,0,0,73.78,729,475,智誠里,NULL
459,1198,12,1210,1507,0,0,80.29,713,485,百福里,NULL
155,1205,5,1210,1488,0,0,81.32,711,494,新東里,NULL
1774,1184,26,1210,1588,0,0,76.2,691,493,鳳鳴里,NULL
69,1200,10,1210,1493,0,0,81.04,624,576,清江里,NULL
452,1203,7,1210,1651,0,0,73.29,624,579,灣復里,NULL
434,1201,9,1210,1551,0,0,78.01,620,581,寶玉里,NULL
644,1194,16,1210,1602,0,0,75.53,611,583,源潭里,NULL
0,1194,16,1210,1602,0,0,75.53,611,583,源潭里,NULL
576,1202,8,1210,1495,0,0,80.94,535,667,林華里,NULL
157,1195,15,1210,1525,0,0,79.34,514,681,大豐里,NULL
493,1204,6,1210,1506,0,0,80.35,492,712,仁武村,NULL
0,1197,13,1210,1566,0,0,77.27,387,810,檨林村,NULL
218,1199,10,1209,1473,0,0,82.08,1012,187,忠誠里,NULL
748,1193,16,1209,1493,0,0,80.98,773,420,金泰里,NULL
573,1199,10,1209,1502,0,0,80.49,749,450,枋寮里,NULL
2244,1199,10,1209,1596,0,0,75.75,745,454,大鵬村,NULL
15,1196,13,1209,1498,0,0,80.71,744,452,榮光里,NULL
417,1192,17,1209,1609,0,0,75.14,715,477,菓林村,NULL
426,1202,7,1209,1497,0,0,80.76,708,494,長榮里,NULL
389,1196,13,1209,1470,0,0,82.24,707,489,本上里,NULL
441,1193,16,1209,1555,0,0,77.75,698,495,新仁里,NULL
0,1193,16,1209,1537,0,0,78.66,690,503,北安里,NULL
461,1198,11,1209,1632,0,0,74.08,681,517,溪洲里,NULL
0,1199,10,1209,1540,0,0,78.51,576,623,舊港村,NULL
22,1194,15,1209,1557,0,0,77.65,553,641,溪頂里,NULL
75,1201,7,1208,1514,0,0,79.79,1014,187,上舘里,NULL
632,1199,9,1208,1507,0,0,80.16,884,315,頂南里,NULL
870,1197,11,1208,1502,0,0,80.43,849,348,智光里,NULL
12,1201,7,1208,1509,0,0,80.05,838,363,文華里,NULL
173,1201,7,1208,1535,0,0,78.7,827,374,北屯里,NULL
760,1203,5,1208,1675,0,0,72.12,653,550,打簾村,NULL
0,1203,5,1208,1675,0,0,72.12,653,550,打簾村,NULL
1314,1200,8,1208,1596,0,0,75.69,651,549,沛陂里,NULL
1721,1196,12,1208,1573,0,0,76.8,644,552,東山里,NULL
583,1197,11,1208,1528,0,0,79.06,621,576,田心里,NULL
833,1196,12,1208,1516,0,0,79.68,535,661,光能里,NULL
0,1199,9,1208,1599,0,0,75.55,435,764,義和里,NULL
733,1198,9,1207,1504,0,0,80.25,1071,127,劍潭里,NULL
137,1201,6,1207,1655,0,0,72.93,910,291,仁里村,NULL
137,1202,5,1207,1521,0,0,79.36,857,345,福志里,NULL
1157,1201,6,1207,1571,0,0,76.83,842,359,住安里,NULL
1132,1202,5,1207,1521,0,0,79.36,838,364,光明里,NULL
1125,1195,12,1207,1502,0,0,80.36,827,368,錦安里,NULL
919,1188,19,1207,1491,0,0,80.95,796,392,忠勤里,NULL
843,1199,8,1207,1655,0,0,72.93,770,429,富岡里,NULL
470,1193,14,1207,1501,0,0,80.41,757,436,仁和里,NULL
753,1201,6,1207,1425,0,0,84.7,747,454,冠穗里,NULL
1584,1200,7,1207,1651,0,0,73.11,735,465,江北里,NULL
972,1197,10,1207,1502,0,0,80.36,733,464,昌隆里,NULL
594,1190,17,1207,1569,0,0,76.93,703,487,南陽里,NULL
798,1195,12,1207,1552,0,0,77.77,702,493,中央里,NULL
119,1197,10,1207,1547,0,0,78.02,699,498,關渡里,NULL
1483,1193,14,1207,1579,0,0,76.44,691,502,永德里,NULL
0,1196,11,1207,1660,0,0,72.71,597,599,新光村,NULL
470,1194,13,1207,1538,0,0,78.48,577,617,六福里,NULL
504,1202,5,1207,1639,0,0,73.64,494,708,光林村,NULL
0,1202,5,1207,1639,0,0,73.64,494,708,光林村,NULL
34,1199,7,1206,1480,0,0,81.49,854,345,永欣里,NULL
0,1194,12,1206,1542,0,0,78.21,835,359,挹秀里,NULL
234,1194,12,1206,1507,0,0,80.03,780,414,西勢里,NULL
1998,1201,5,1206,1554,0,0,77.61,721,480,水碓村,NULL
297,1197,9,1206,1468,0,0,82.15,712,485,麗山里,NULL
438,1199,7,1206,1558,0,0,77.41,687,512,寶玉里,NULL
799,1201,5,1206,1481,0,0,81.43,667,534,鳳東里,NULL
707,1194,12,1206,1520,0,0,79.34,663,531,文元里,NULL
480,1192,14,1206,1470,0,0,82.04,632,560,厚德里,NULL
127,1194,12,1206,1541,0,0,78.26,630,564,玉山里,NULL
306,1197,9,1206,1606,0,0,75.09,607,590,永安里,NULL
0,1196,10,1206,1715,0,0,70.32,392,804,來惠村,NULL
726,1195,10,1205,1524,0,0,79.07,887,308,復旦里,NULL
248,1191,14,1205,1575,0,0,76.51,844,347,福興里,NULL
457,1195,10,1205,1555,0,0,77.49,755,440,長億里,NULL
432,1199,6,1205,1494,0,0,80.66,722,477,東新里,NULL
349,1198,7,1205,1512,0,0,79.7,714,484,關聖里,NULL
161,1198,7,1205,1529,0,0,78.81,698,500,承德里,NULL
387,1193,12,1205,1436,0,0,83.91,664,529,本安里,NULL
1970,1186,19,1205,1551,0,0,77.69,607,579,集賢村,NULL
418,1195,10,1205,1521,0,0,79.22,601,594,寶業里,NULL
477,1199,6,1205,1594,0,0,75.6,561,638,興東里,NULL
0,1195,10,1205,1586,0,0,75.98,502,693,深坑村,NULL
834,1191,13,1204,1496,0,0,80.48,805,386,大平里,NULL
32,1196,8,1204,1499,0,0,80.32,745,451,永和里,NULL
1763,1193,11,1204,1539,0,0,78.23,733,460,永昌里,NULL
606,1197,7,1204,1528,0,0,78.8,724,473,五常里,NULL
515,1195,9,1204,1516,0,0,79.42,688,507,民有里,NULL
974,1188,16,1204,1534,0,0,78.49,679,509,信義里,NULL
696,1197,7,1204,1534,0,0,78.49,652,545,積穗里,NULL
368,1192,12,1204,1510,0,0,79.74,645,547,大里里,NULL
102,1193,11,1204,1538,0,0,78.28,608,585,南屯里,NULL
812,1196,8,1204,1549,0,0,77.73,596,600,力行里,NULL
657,1198,6,1204,1489,0,0,80.86,579,619,竹中里,NULL
815,1194,10,1204,1541,0,0,78.13,519,675,瑞南里,NULL
338,1193,10,1203,1458,0,0,82.51,880,313,清白里,NULL
882,1190,13,1203,1592,0,0,75.57,834,356,凌雲村,NULL
830,1195,8,1203,1532,0,0,78.52,791,404,甘蔗村,NULL
899,1189,14,1203,1563,0,0,76.97,787,402,網溪里,NULL
396,1197,6,1203,1571,0,0,76.58,775,422,吉龍里,NULL
300,1192,11,1203,1496,0,0,80.41,746,446,港富里,NULL
142,1187,16,1203,1517,0,0,79.3,746,441,三厝里,NULL
183,1192,11,1203,1543,0,0,77.97,736,456,三和里,NULL
0,1197,6,1203,1810,0,0,66.46,704,493,光復里,NULL
683,1192,11,1203,1622,0,0,74.17,685,507,龍潭里,NULL
1134,1191,12,1203,1637,0,0,73.49,678,513,光華里,NULL
993,1195,8,1203,1567,0,0,76.77,618,577,思源里,NULL
997,1192,11,1203,1539,0,0,78.17,608,584,柳鄉里,NULL
612,1189,14,1203,1537,0,0,78.27,564,625,南嵩里,NULL
0,1191,12,1203,1536,0,0,78.32,363,828,井腳村,NULL
584,1193,9,1202,1481,0,0,81.16,908,285,新仁里,NULL
4,1190,12,1202,1687,0,0,71.25,887,303,砂子里,NULL
1620,1193,9,1202,1535,0,0,78.31,865,328,湖興里,NULL
78,1197,5,1202,1619,0,0,74.24,856,341,永安里,NULL
1251,1183,19,1202,1447,0,0,83.07,853,330,景仁里,NULL
736,1194,8,1202,1487,0,0,80.83,802,392,大直里,NULL
142,1191,11,1202,1568,0,0,76.66,771,420,頂寮里,NULL
390,1192,10,1202,1540,0,0,78.05,761,431,同慶里,NULL
0,1192,10,1202,1540,0,0,78.05,761,431,同慶里,NULL
223,1194,8,1202,1558,0,0,77.15,746,448,六堵里,NULL
0,1194,8,1202,1558,0,0,77.15,746,448,六堵里,NULL
293,1184,18,1202,1515,0,0,79.34,702,482,大興里,NULL
329,1191,11,1202,1558,0,0,77.15,698,493,堂春里,NULL
113,1194,8,1202,1464,0,0,82.1,691,503,楓樹里,NULL
1027,1194,8,1202,1500,0,0,80.13,690,504,日善里,NULL
586,1191,11,1202,1530,0,0,78.56,667,524,尚義里,NULL
0,1191,11,1202,1530,0,0,78.56,667,524,尚義里,NULL
73,1191,11,1202,1513,0,0,79.44,656,535,中央里,NULL
169,1192,10,1202,1566,0,0,76.76,653,539,福山里,NULL
510,1178,24,1202,1543,0,0,77.9,648,530,福平里,NULL
1001,1196,6,1202,1482,0,0,81.11,640,556,華江里,NULL
377,1190,12,1202,1515,0,0,79.34,575,615,樹王里,NULL
738,1191,11,1202,1605,0,0,74.89,534,657,中厝里,NULL
12,1184,17,1201,1548,0,0,77.58,1046,138,民孝里,NULL
1209,1193,8,1201,1517,0,0,79.17,885,308,江陵里,NULL
1245,1192,9,1201,1525,0,0,78.75,834,358,永安里,NULL
1330,1191,10,1201,1465,0,0,81.98,821,370,順興里,NULL
1155,1191,10,1201,1551,0,0,77.43,783,408,住安里,NULL
12,1190,11,1201,1452,0,0,82.71,760,430,福興里,NULL
571,1186,15,1201,1531,0,0,78.45,752,434,復勢里,NULL
1015,1194,7,1201,1525,0,0,78.75,671,523,中宏里,NULL
388,1190,11,1201,1458,0,0,82.37,663,527,本上里,NULL
1718,1189,12,1201,1532,0,0,78.39,657,532,東陽里,NULL
0,1187,14,1201,1664,0,0,72.18,571,616,仁里村,NULL
455,1190,11,1201,1517,0,0,79.17,551,639,正興里,NULL
540,1197,4,1201,1610,0,0,74.6,551,646,地利村,NULL
0,1197,4,1201,1610,0,0,74.6,551,646,地利村,NULL
296,1192,9,1201,1622,0,0,74.04,498,694,成興村,NULL
1075,1192,8,1200,1553,0,0,77.27,796,396,德安里,NULL
229,1184,16,1200,1463,0,0,82.02,764,420,福祿里,NULL
128,1188,12,1200,1582,0,0,75.85,729,459,玉山里,NULL
339,1188,12,1200,1578,0,0,76.05,725,463,虎尾里,NULL
330,1198,2,1200,1557,0,0,77.07,714,484,華山里,NULL
0,1184,16,1200,1752,0,0,68.49,696,488,護國里,NULL
278,1188,12,1200,1529,0,0,78.48,668,520,府南里,NULL
1644,1178,22,1200,1613,0,0,74.4,658,520,三多里,NULL
399,1190,10,1200,1599,0,0,75.05,637,553,田心村,NULL
291,1191,9,1200,1535,0,0,78.18,628,563,中正里,NULL
0,1191,9,1200,1535,0,0,78.18,628,563,中正里,NULL
234,1190,10,1200,1617,0,0,74.21,447,743,枕山村,NULL
47,1185,14,1199,1471,0,0,81.51,959,226,建功里,NULL
136,1188,11,1199,1488,0,0,80.58,889,299,三和里,NULL
840,1194,5,1199,1431,0,0,83.79,860,334,永元里,NULL
1912,1185,14,1199,1550,0,0,77.35,828,357,油車里,NULL
401,1189,10,1199,2317,0,0,51.75,799,390,湖興里,NULL
30,1189,10,1199,1603,0,0,74.8,770,419,奉化里,NULL
0,1189,10,1199,1603,0,0,74.8,770,419,奉化里,NULL
1240,1188,11,1199,1551,0,0,77.3,755,433,柴埕里,NULL
223,1195,4,1199,1500,0,0,79.93,749,446,三和里,NULL
324,1184,15,1199,1556,0,0,77.06,743,441,溪福里,NULL
681,1183,16,1199,1637,0,0,73.24,681,502,下新里,NULL
0,1183,16,1199,1637,0,0,73.24,681,502,下新里,NULL
138,1188,11,1199,1475,0,0,81.29,669,519,華翠里,NULL
1474,1187,12,1199,1519,0,0,78.93,660,527,永樂里,NULL
226,1186,13,1199,1583,0,0,75.74,616,570,民生村,NULL
287,1188,11,1199,1565,0,0,76.61,596,592,華中里,NULL
71,1192,7,1199,1506,0,0,79.61,589,603,中央里,NULL
0,1186,13,1199,1522,0,0,78.78,542,644,灣裡里,NULL
115,1185,13,1198,1464,0,0,81.83,1128,57,中社里,NULL
1244,1182,16,1198,1469,0,0,81.55,846,336,景美里,NULL
760,1189,9,1198,1496,0,0,80.08,753,436,協和里,NULL
0,1187,11,1198,1577,0,0,75.97,749,438,中埔里,NULL
21,1188,10,1198,1513,0,0,79.18,730,458,裕民里,NULL
28,1190,8,1198,1482,0,0,80.84,660,530,振華里,NULL
163,1183,15,1198,1611,0,0,74.36,543,640,民生里,NULL
29,1190,8,1198,1497,0,0,80.03,340,850,金田里,NULL
552,1194,3,1197,1471,0,0,81.37,1077,117,自治里,NULL
651,1189,8,1197,1467,0,0,81.6,908,281,龍岡里,NULL
819,1189,8,1197,1637,0,0,73.12,900,289,裕成里,NULL
845,1186,11,1197,1470,0,0,81.43,866,320,民族里,NULL
781,1183,14,1197,1438,0,0,83.24,820,363,秀福里,NULL
261,1189,8,1197,1681,0,0,71.21,805,384,平山里,NULL
204,1180,17,1197,1574,0,0,76.05,738,442,迴龍村,NULL
1030,1192,5,1197,1516,0,0,78.96,721,471,壽德里,NULL
445,1184,13,1197,1622,0,0,73.8,714,470,虎溪里,NULL
1029,1185,12,1197,1470,0,0,81.43,663,522,壽德里,NULL
555,1184,13,1197,1543,0,0,77.58,642,542,五順里,NULL
1499,1185,12,1197,1488,0,0,80.44,606,579,鷺江里,NULL
742,1182,15,1197,1514,0,0,79.06,589,593,高雙里,NULL
83,1183,14,1197,1603,0,0,74.67,580,603,四草里,NULL
0,1183,14,1197,1603,0,0,74.67,580,603,四草里,NULL
0,1185,11,1196,1589,0,0,75.27,936,249,博愛村,NULL
764,1182,14,1196,1426,0,0,83.87,880,302,安平里,NULL
357,1187,9,1196,1585,0,0,75.46,842,345,南興村,NULL
1233,1185,11,1196,1557,0,0,76.81,819,366,光信里,NULL
360,1191,5,1196,1516,0,0,78.89,779,412,紫陽里,NULL
413,1181,15,1196,1518,0,0,78.79,777,404,大海村,NULL
0,1181,15,1196,1518,0,0,78.79,777,404,大海村,NULL
0,1187,9,1196,1634,0,0,73.19,771,416,民權里,NULL
0,1188,8,1196,1742,0,0,68.66,771,417,石泉里,NULL
325,1190,6,1196,1530,0,0,78.17,770,420,勝利里,NULL
20,1181,15,1196,1427,0,0,83.81,739,442,榮華里,NULL
1119,1188,8,1196,1507,0,0,79.36,730,458,古莊里,NULL
29,1186,10,1196,1469,0,0,81.42,722,464,逢福里,NULL
776,1191,5,1196,1496,0,0,79.95,695,496,下埤里,NULL
517,1183,13,1196,1537,0,0,77.81,644,539,溪美里,NULL
122,1190,6,1196,1570,0,0,76.18,608,582,泉源里,NULL
221,1185,11,1196,1513,0,0,79.05,602,583,久堂村,NULL
402,1190,6,1196,1653,0,0,72.35,554,636,中埔村,NULL
0,1190,6,1196,1653,0,0,72.35,554,636,中埔村,NULL
0,1184,12,1196,1528,0,0,78.27,496,688,港尾村,NULL
0,1188,8,1196,1545,0,0,77.41,473,715,麟蹄村,NULL
0,1187,9,1196,1608,0,0,74.38,471,716,中社村,NULL
100,1181,14,1195,1404,0,0,85.11,1076,105,長榮里,NULL
198,1183,12,1195,1527,0,0,78.26,908,275,愛勢村,NULL
1232,1182,13,1195,1497,0,0,79.83,820,362,太平里,NULL
122,1186,9,1195,1686,0,0,70.88,809,377,大城里,NULL
542,1183,12,1195,1551,0,0,77.05,780,403,新興里,NULL
16,1182,13,1195,1476,0,0,80.96,723,459,惠來里,NULL
392,1182,13,1195,1692,0,0,70.63,718,464,海湖村,NULL
512,1174,21,1195,1504,0,0,79.45,703,471,福順里,NULL
292,1179,16,1195,1517,0,0,78.77,599,580,大觀里,NULL
1287,1187,7,1194,1822,0,0,65.53,933,254,興業里,NULL
58,1184,10,1194,1617,0,0,73.84,920,264,新英里,NULL
0,1184,10,1194,1617,0,0,73.84,920,264,新英里,NULL
252,1187,7,1194,1512,0,0,78.97,817,370,東海村,NULL
85,1192,2,1194,1501,0,0,79.55,813,379,莊敬里,NULL
924,1188,6,1194,1605,0,0,74.39,799,389,高原村,NULL
124,1188,6,1194,1516,0,0,78.76,788,400,德和里,NULL
97,1188,6,1194,1468,0,0,81.34,767,421,智仁里,NULL
2026,1185,9,1194,1674,0,0,71.33,749,436,全興村,NULL
707,1189,5,1194,1588,0,0,75.19,748,441,正得里,NULL
105,1186,8,1194,1549,0,0,77.08,747,439,公安里,NULL
7,1181,13,1194,1578,0,0,75.67,745,436,西平里,NULL
339,1183,11,1194,1543,0,0,77.38,703,480,北興里,NULL
474,1181,13,1194,1597,0,0,74.77,699,482,成功里,NULL
238,1188,6,1194,1440,0,0,82.92,689,499,蘭興里,NULL
443,1185,9,1194,1580,0,0,75.57,620,565,一德里,NULL
387,1181,13,1194,1452,0,0,82.23,614,567,光明里,NULL
294,1188,6,1194,1575,0,0,75.81,493,695,大湖里,NULL
0,1188,6,1194,1575,0,0,75.81,493,695,大湖里,NULL
1265,1189,4,1193,1497,0,0,79.69,938,251,明城里,NULL
1267,1180,13,1193,1478,0,0,80.72,798,382,萬年里,NULL
500,1176,17,1193,1551,0,0,76.92,783,393,宜佳里,NULL
778,1184,9,1193,1549,0,0,77.02,782,402,文雅村,NULL
499,1186,7,1193,1561,0,0,76.43,763,423,宜佳里,NULL
721,1185,8,1193,1603,0,0,74.42,681,504,聚葉里,NULL
213,1177,16,1193,1640,0,0,72.74,649,528,新嶺村,NULL
276,1184,9,1193,1544,0,0,77.27,644,540,永順村,NULL
0,1184,9,1193,1544,0,0,77.27,644,540,永順村,NULL
1535,1185,8,1193,1553,0,0,76.82,624,561,保佑里,NULL
311,1184,9,1193,1524,0,0,78.28,613,571,建成里,NULL
258,1182,11,1193,1548,0,0,77.07,604,578,文華里,NULL
451,1183,10,1193,1482,0,0,80.5,443,740,灣利里,NULL
1262,1181,11,1192,1441,0,0,82.72,893,288,萬隆里,NULL
369,1182,10,1192,1543,0,0,77.25,849,333,立人里,NULL
695,1179,13,1192,1522,0,0,78.32,831,348,平南里,NULL
51,1179,13,1192,1520,0,0,78.42,810,369,新國里,NULL
448,1176,16,1192,1598,0,0,74.59,790,386,東寮里,NULL
185,1182,10,1192,1514,0,0,78.73,782,400,三和里,NULL
617,1181,11,1192,1563,0,0,76.26,781,400,民生里,NULL
168,1186,6,1192,1635,0,0,72.91,772,414,金面里,NULL
0,1186,6,1192,1635,0,0,72.91,772,414,金面里,NULL
119,1185,7,1192,1507,0,0,79.1,762,423,長安里,NULL
1801,1181,11,1192,1612,0,0,73.95,712,469,鳶山里,NULL
34,1182,10,1192,1519,0,0,78.47,709,473,和東里,NULL
304,1183,9,1192,1542,0,0,77.3,691,492,安溪里,NULL
0,1183,9,1192,1542,0,0,77.3,691,492,安溪里,NULL
603,1178,14,1192,1506,0,0,79.15,685,493,北陽里,NULL
338,1183,9,1192,1561,0,0,76.36,680,503,賴福里,NULL
201,1185,7,1192,1471,0,0,81.03,668,517,永安里,NULL
1031,1180,12,1192,1519,0,0,78.47,662,518,中信里,NULL
16,1188,4,1192,1504,0,0,79.26,645,543,享平里,NULL
446,1181,11,1192,1630,0,0,73.13,628,553,虎溪里,NULL
0,1188,4,1192,1553,0,0,76.75,624,564,安仁里,NULL
974,1173,19,1192,1555,0,0,76.66,555,618,崙坪村,NULL
559,1183,9,1192,1511,0,0,78.89,554,629,華堂里,NULL
183,1181,11,1192,1520,0,0,78.42,532,649,金陵村,NULL
283,1185,7,1192,1610,0,0,74.04,532,653,前進里,NULL
0,1181,11,1192,1520,0,0,78.42,532,649,金陵村,NULL
155,1182,10,1192,1545,0,0,77.15,512,670,大港里,NULL
0,1182,9,1191,1453,0,0,81.97,1133,49,大鵬里,NULL
1297,1177,14,1191,1458,0,0,81.69,885,292,興旺里,NULL
83,1182,9,1191,1422,0,0,83.76,866,316,仙水里,NULL
268,1175,16,1191,1501,0,0,79.35,853,322,新鳳村,NULL
0,1175,16,1191,1501,0,0,79.35,853,322,新鳳村,NULL
1316,1183,8,1191,1480,0,0,80.47,827,356,明興里,NULL
1148,1180,11,1191,1569,0,0,75.91,822,358,龍陣里,NULL
1133,1182,9,1191,1501,0,0,79.35,809,373,光明里,NULL
1130,1183,8,1191,1478,0,0,80.58,797,386,永康里,NULL
914,1183,8,1191,1513,0,0,78.72,766,417,永昌里,NULL
390,1183,8,1191,1462,0,0,81.46,699,484,本上里,NULL
787,1183,8,1191,1467,0,0,81.19,688,495,江山里,NULL
369,1185,6,1191,1903,0,0,62.59,671,514,新里里,NULL
502,1177,14,1191,1517,0,0,78.51,620,557,永安里,NULL
280,1184,7,1191,1690,0,0,70.47,614,570,樹腳里,NULL
551,1176,15,1191,1497,0,0,79.56,568,608,福樂里,NULL
380,1184,7,1191,1642,0,0,72.53,532,652,內埔村,NULL
0,1184,7,1191,1642,0,0,72.53,532,652,內埔村,NULL
51,1178,12,1190,1517,0,0,78.44,929,249,東信里,NULL
802,1184,6,1190,1496,0,0,79.55,853,331,龍洲里,NULL
163,1175,15,1190,1618,0,0,73.55,833,342,寶山里,NULL
757,1171,19,1190,1486,0,0,80.08,832,339,安樂里,NULL
663,1188,2,1190,1497,0,0,79.49,808,380,三張里,NULL
1877,1178,12,1190,1567,0,0,75.94,783,395,水碓里,NULL
1632,1180,10,1190,1480,0,0,80.41,772,408,福山里,NULL
2066,1180,10,1190,1556,0,0,76.48,766,414,湖南村,NULL
1232,1178,12,1190,1554,0,0,76.58,751,427,光信里,NULL
225,1181,9,1190,1546,0,0,76.97,657,524,田中村,NULL
134,1181,9,1190,1469,0,0,81.01,643,538,龍翠里,NULL
0,1179,11,1190,1588,0,0,74.94,621,558,溪州村,NULL
485,1178,12,1190,1463,0,0,81.34,600,578,培德里,NULL
1481,1178,12,1190,1490,0,0,79.87,579,599,永康里,NULL
0,1184,6,1190,1585,0,0,75.08,484,700,潭頂村,NULL
42,1177,12,1189,1725,0,0,68.93,877,300,豐榮里,NULL
1254,1180,9,1189,1484,0,0,80.12,833,347,公崙里,NULL
1345,1182,7,1189,1477,0,0,80.5,810,372,樟腳里,NULL
63,1186,3,1189,1500,0,0,79.27,796,390,大眉里,NULL
0,1186,3,1189,1500,0,0,79.27,796,390,大眉里,NULL
228,1177,12,1189,1482,0,0,80.23,756,421,三玉里,NULL
902,1179,10,1189,1487,0,0,79.96,738,441,板溪里,NULL
1107,1172,17,1189,1601,0,0,74.27,737,435,光武里,NULL
151,1181,8,1189,1472,0,0,80.77,722,459,向心里,NULL
2058,1181,8,1189,1510,0,0,78.74,705,476,西林村,NULL
314,1181,8,1189,1511,0,0,78.69,700,481,花壇村,NULL
789,1177,12,1189,1657,0,0,71.76,693,484,沙崙里,NULL
0,1177,12,1189,1657,0,0,71.76,693,484,沙崙里,NULL
714,1179,10,1189,1598,0,0,74.41,673,506,中山里,NULL
493,1182,7,1189,1571,0,0,75.68,664,518,長生里,NULL
0,1182,7,1189,1571,0,0,75.68,664,518,長生里,NULL
248,1178,11,1189,1597,0,0,74.45,660,518,新庄村,NULL
151,1176,13,1189,1496,0,0,79.48,602,574,後港里,NULL
229,1177,12,1189,1573,0,0,75.59,526,651,泗林里,NULL
0,1177,12,1189,1573,0,0,75.59,526,651,泗林里,NULL
326,1181,8,1189,1421,0,0,83.67,492,689,達德里,NULL
0,1181,8,1189,1421,0,0,83.67,492,689,達德里,NULL
192,1182,7,1189,1578,0,0,75.35,452,730,佳佐村,NULL
0,1182,7,1189,1578,0,0,75.35,452,730,佳佐村,NULL
116,1183,5,1188,1400,0,0,84.86,1032,151,海勝里,NULL
1280,1179,9,1188,1478,0,0,80.38,902,277,興家里,NULL
0,1173,15,1188,1556,0,0,76.35,896,277,成功里,NULL
1299,1177,11,1188,1488,0,0,79.84,882,295,興旺里,NULL
800,1177,11,1188,1542,0,0,77.04,870,307,光復里,NULL
0,1177,11,1188,1542,0,0,77.04,870,307,光復里,NULL
1263,1175,13,1188,1442,0,0,82.39,869,306,萬隆里,NULL
105,1178,10,1188,1498,0,0,79.31,813,365,南屯里,NULL
708,1171,17,1188,1483,0,0,80.11,807,364,義里村,NULL
255,1179,9,1188,1523,0,0,78,791,388,東海村,NULL
550,1181,7,1188,1651,0,0,71.96,736,445,意誠里,NULL
1925,1176,12,1188,1564,0,0,75.96,725,451,爪峯里,NULL
471,1180,8,1188,1564,0,0,75.96,707,473,東平里,NULL
3,1181,7,1188,1555,0,0,76.4,706,475,短竹里,NULL
1985,1179,9,1188,1544,0,0,76.94,694,485,五福村,NULL
46,1181,7,1188,1522,0,0,78.06,681,500,何安里,NULL
356,1177,11,1188,1440,0,0,82.5,632,545,福民里,NULL
511,1177,11,1188,1486,0,0,79.95,585,592,永清里,NULL
260,1178,10,1188,1463,0,0,81.2,553,625,文南里,NULL
353,1179,9,1188,1520,0,0,78.16,539,640,溪頭村,NULL
0,1179,9,1188,1520,0,0,78.16,539,640,溪頭村,NULL
265,1178,10,1188,1512,0,0,78.57,533,645,國宅里,NULL
61,1183,5,1188,1513,0,0,78.52,378,805,九清村,NULL
0,1183,5,1188,1513,0,0,78.52,378,805,九清村,NULL
321,1176,11,1187,1521,0,0,78.04,902,274,空翔里,NULL
0,1176,11,1187,1521,0,0,78.04,902,274,空翔里,NULL
823,1177,10,1187,1492,0,0,79.56,888,289,福和里,NULL
298,1176,11,1187,1490,0,0,79.66,862,314,埔尾村,NULL
776,1174,13,1187,1475,0,0,80.47,820,354,秀成里,NULL
896,1171,16,1187,1453,0,0,81.69,781,390,和平里,NULL
1687,1174,13,1187,1500,0,0,79.13,779,395,樹人里,NULL
2010,1170,17,1187,1562,0,0,75.99,770,400,山腳村,NULL
1323,1172,15,1187,1563,0,0,75.94,752,420,大安里,NULL
967,1180,7,1187,1517,0,0,78.25,742,438,三愛里,NULL
520,1173,14,1187,1750,0,0,67.83,736,437,南和里,NULL
8,1178,9,1187,1648,0,0,72.03,673,505,溪底村,NULL
0,1178,9,1187,1648,0,0,72.03,673,505,溪底村,NULL
189,1178,9,1187,1503,0,0,78.98,667,511,華北里,NULL
0,1178,9,1187,1503,0,0,78.98,667,511,華北里,NULL
8,1178,9,1187,1470,0,0,80.75,643,535,石牌里,NULL
75,1177,10,1187,1643,0,0,72.25,581,596,永和里,NULL
364,1175,12,1187,1589,0,0,74.7,463,712,山中村,NULL
388,1180,7,1187,1548,0,0,76.68,349,831,油車里,NULL
1298,1178,8,1186,1426,0,0,83.17,942,236,興旺里,NULL
78,1172,14,1186,1428,0,0,83.05,922,250,上舘里,NULL
1142,1180,6,1186,1504,0,0,78.86,891,289,文中里,NULL
0,1180,6,1186,1504,0,0,78.86,891,289,文中里,NULL
346,1179,7,1186,1449,0,0,81.85,855,324,葫洲里,NULL
685,1174,12,1186,1439,0,0,82.42,823,351,雙和里,NULL
266,1174,12,1186,1547,0,0,76.66,762,412,竹園里,NULL
5,1178,8,1186,1508,0,0,78.65,761,417,同安里,NULL
294,1176,10,1186,1450,0,0,81.79,733,443,港都里,NULL
0,1175,11,1186,1739,0,0,68.2,731,444,牡丹村,NULL
401,1173,13,1186,1498,0,0,79.17,679,494,土庫里,NULL
799,1176,10,1186,1465,0,0,80.96,672,504,埔心里,NULL
0,1176,10,1186,1465,0,0,80.96,672,504,埔心里,NULL
331,1177,9,1186,1603,0,0,73.99,653,524,正興里,NULL
1031,1174,12,1186,1466,0,0,80.9,643,531,壽德里,NULL
143,1183,3,1186,1455,0,0,81.51,628,555,福民里,NULL
31,1169,17,1186,1541,0,0,76.96,624,545,竹營里,NULL
514,1179,7,1186,1476,0,0,80.35,549,630,五和村,NULL
0,1176,10,1186,2053,0,0,57.77,439,737,下崙村,NULL
393,1175,11,1186,1565,0,0,75.78,420,755,社中村,NULL
0,1175,11,1186,1565,0,0,75.78,420,755,社中村,NULL
1274,1172,13,1185,1443,0,0,82.12,885,287,興豐里,NULL
88,1181,4,1185,1508,0,0,78.58,837,344,福林里,NULL
450,1178,7,1185,1514,0,0,78.27,793,385,新光里,NULL
570,1171,14,1185,1453,0,0,81.56,785,386,中興里,NULL
1888,1176,9,1185,1542,0,0,76.85,742,434,新興里,NULL
133,1174,11,1185,1612,0,0,73.51,730,444,西康里,NULL
0,1174,11,1185,1612,0,0,73.51,730,444,西康里,NULL
2076,1174,11,1185,1503,0,0,78.84,730,444,東勢村,NULL
18,1180,5,1185,1550,0,0,76.45,725,455,榮華里,NULL
544,1173,12,1185,1531,0,0,77.4,724,449,新聚里,NULL
524,1178,7,1185,1530,0,0,77.45,715,463,松基里,NULL
702,1171,14,1185,1556,0,0,76.16,683,488,正守里,NULL
1138,1174,11,1185,1499,0,0,79.05,665,509,新店里,NULL
0,1174,11,1185,1499,0,0,79.05,665,509,新店里,NULL
1796,1178,7,1185,1558,0,0,76.06,657,521,永館里,NULL
313,1176,9,1185,1530,0,0,77.45,657,519,五光村,NULL
0,1176,9,1185,1530,0,0,77.45,657,519,五光村,NULL
755,1174,11,1185,1584,0,0,74.81,597,577,社南村,NULL
712,1177,8,1185,1513,0,0,78.32,582,595,泰山里,NULL
110,1177,8,1185,1461,0,0,81.11,575,602,永安里,NULL
408,1170,15,1185,1718,0,0,68.98,546,624,富收村,NULL
0,1170,15,1185,1604,0,0,73.88,522,648,復興村,NULL
1304,1175,9,1184,1478,0,0,80.11,961,214,興昌里,NULL
289,1172,12,1184,1418,0,0,83.5,927,245,自強村,NULL
1063,1175,9,1184,1452,0,0,81.54,897,278,新和里,NULL
1627,1176,8,1184,1454,0,0,81.43,830,346,忠山里,NULL
598,1176,8,1184,1447,0,0,81.82,736,440,佳和里,NULL
216,1166,18,1184,1573,0,0,75.27,708,458,山德村,NULL
0,1170,14,1184,1633,0,0,72.5,707,463,好修里,NULL
978,1174,10,1184,1483,0,0,79.84,690,484,新起里,NULL
317,1171,13,1184,1470,0,0,80.54,633,538,崇德里,NULL
479,1169,15,1184,1545,0,0,76.63,525,644,南興里,NULL
332,1176,8,1184,1474,0,0,80.33,522,654,同德里,NULL
105,1176,8,1184,1711,0,0,69.2,482,694,繁昌村,NULL
0,1176,8,1184,1711,0,0,69.2,482,694,繁昌村,NULL
277,1175,9,1184,1643,0,0,72.06,431,744,三興村,NULL
0,1175,9,1184,1643,0,0,72.06,431,744,三興村,NULL
326,1177,7,1184,1568,0,0,75.51,421,756,振興里,NULL
0,1177,7,1184,1568,0,0,75.51,421,756,振興里,NULL
132,1170,13,1183,1587,0,0,74.54,862,308,北昌村,NULL
0,1172,11,1183,1787,0,0,66.2,840,332,瑞美村,NULL
1312,1174,9,1183,1431,0,0,82.67,815,359,華興里,NULL
367,1177,6,1183,1442,0,0,82.04,783,394,鼎泰里,NULL
277,1171,12,1183,1593,0,0,74.26,780,391,高明里,NULL
2096,1171,12,1183,1475,0,0,80.2,776,395,埔新村,NULL
566,1171,12,1183,1421,0,0,83.25,766,405,力行里,NULL
316,1172,11,1183,1480,0,0,79.93,764,408,錦洲里,NULL
2159,1172,11,1183,1589,0,0,74.45,664,508,舊城村,NULL
1109,1176,7,1183,1534,0,0,77.12,663,513,建安里,NULL
708,1173,10,1183,1514,0,0,78.14,649,524,民安里,NULL
409,1177,6,1183,1493,0,0,79.24,642,535,寶華里,NULL
444,1175,8,1183,1542,0,0,76.72,569,606,灣中里,NULL
304,1167,16,1183,1650,0,0,71.7,514,653,崙西村,NULL
0,1167,16,1183,1650,0,0,71.7,514,653,崙西村,NULL
491,1165,17,1182,1510,0,0,78.28,868,297,中山里,NULL
254,1169,13,1182,1522,0,0,77.66,860,309,東海村,NULL
221,1173,9,1182,1580,0,0,74.81,790,383,三興里,NULL
18,1170,12,1182,1467,0,0,80.57,790,380,復興里,NULL
602,1172,10,1182,1485,0,0,79.6,778,394,新南里,NULL
108,1170,12,1182,1668,0,0,70.86,772,398,太昌村,NULL
682,1166,16,1182,1521,0,0,77.71,713,453,平鎮里,NULL
656,1171,11,1182,1481,0,0,79.81,701,470,竹中里,NULL
423,1175,7,1182,1433,0,0,82.48,700,475,寶盛里,NULL
556,1168,14,1182,1605,0,0,73.64,700,468,西安里,NULL
0,1168,14,1182,1605,0,0,73.64,700,468,西安里,NULL
13,1169,13,1182,1613,0,0,73.28,632,537,曾家村,NULL
0,1169,13,1182,1613,0,0,73.28,632,537,曾家村,NULL
0,1169,13,1182,1638,0,0,72.16,630,539,龍肚里,NULL
768,1165,17,1182,1511,0,0,78.23,605,560,豐洲村,NULL
1024,1172,10,1182,1481,0,0,79.81,586,586,和德里,NULL
548,1169,13,1182,1465,0,0,80.68,553,616,五華里,NULL
357,1175,7,1182,1550,0,0,76.26,538,637,鼎西里,NULL
0,1161,21,1182,1500,0,0,78.8,529,632,鎮平里,NULL
847,1167,15,1182,1544,0,0,76.55,524,643,嘉仁村,NULL
190,1173,9,1182,1452,0,0,81.4,520,653,光賢里,NULL
402,1176,6,1182,1407,0,0,84.01,501,675,寶興里,NULL
847,1178,4,1182,1467,0,0,80.57,430,748,瑞昌里,NULL
387,1176,6,1182,1538,0,0,76.85,355,821,油車里,NULL
599,1174,7,1181,1458,0,0,81,845,329,安康里,NULL
18,1169,12,1181,1508,0,0,78.32,780,389,惠來里,NULL
1119,1173,8,1181,1513,0,0,78.06,749,424,民安里,NULL
320,1160,21,1181,1545,0,0,76.44,723,437,南口村,NULL
0,1160,21,1181,1545,0,0,76.44,723,437,南口村,NULL
221,1172,9,1181,1520,0,0,77.7,718,454,山福村,NULL
290,1173,8,1181,1502,0,0,78.63,715,458,大安里,NULL
63,1170,11,1181,1490,0,0,79.26,679,491,奇岩里,NULL
374,1172,9,1181,1520,0,0,77.7,642,530,中西里,NULL
312,1175,6,1181,1535,0,0,76.94,564,611,安泰里,NULL
380,1173,8,1181,1516,0,0,77.9,532,641,水泉村,NULL
0,1173,8,1181,1516,0,0,77.9,532,641,水泉村,NULL
453,1172,9,1181,1532,0,0,77.09,518,654,灣復里,NULL
12,1177,4,1181,1500,0,0,78.73,497,680,五常里,NULL
0,1173,8,1181,1551,0,0,76.14,492,681,蔦松里,NULL
350,1172,9,1181,1487,0,0,79.42,416,756,蘆竹村,NULL
230,1175,5,1180,1486,0,0,79.41,810,365,松竹里,NULL
1329,1175,5,1180,1431,0,0,82.46,804,371,順興里,NULL
612,1172,8,1180,1517,0,0,77.79,798,374,普忠里,NULL
204,1173,7,1180,1599,0,0,73.8,790,383,岩山里,NULL
198,1164,16,1180,1553,0,0,75.98,788,376,軍功里,NULL
735,1170,10,1180,1446,0,0,81.6,780,390,大直里,NULL
528,1163,17,1180,1488,0,0,79.3,695,468,樹義里,NULL
0,1174,6,1180,1894,0,0,62.3,688,486,五港村,NULL
954,1169,11,1180,1483,0,0,79.57,671,498,文德里,NULL
0,1169,11,1180,1483,0,0,79.57,671,498,文德里,NULL
609,1171,9,1180,1561,0,0,75.59,669,502,美港村,NULL
332,1177,3,1180,1624,0,0,72.66,660,517,桂林里,NULL
286,1169,11,1180,1542,0,0,76.52,657,512,華中里,NULL
0,1170,10,1180,1573,0,0,75.02,654,516,新厝里,NULL
489,1162,18,1180,1470,0,0,80.27,652,510,永德里,NULL
377,1171,9,1180,1518,0,0,77.73,640,531,本和里,NULL
7,1172,8,1180,1437,0,0,82.12,619,553,石牌里,NULL
1135,1172,8,1180,1521,0,0,77.58,604,568,西盛里,NULL
290,1170,10,1180,1584,0,0,74.49,604,566,大吉村,NULL
610,1173,7,1180,1503,0,0,78.51,574,599,朝陽里,NULL
0,1173,7,1180,1503,0,0,78.51,574,599,朝陽里,NULL
545,1175,5,1180,1549,0,0,76.18,562,613,城北里,NULL
0,1175,5,1180,1549,0,0,76.18,562,613,城北里,NULL
0,1169,11,1180,1650,0,0,71.52,551,618,大福村,NULL
443,1171,9,1180,1467,0,0,80.44,509,662,灣中里,NULL
258,1168,12,1180,1657,0,0,71.21,501,667,順安村,NULL
0,1176,4,1180,1528,0,0,77.23,406,770,大堀村,NULL
575,1164,15,1179,1495,0,0,78.86,947,217,莊敬里,NULL
217,1173,6,1179,1428,0,0,82.56,935,238,聖山里,NULL
789,1165,14,1179,1492,0,0,79.02,877,288,秀明里,NULL
33,1167,12,1179,1564,0,0,75.38,757,410,竹營里,NULL
1538,1170,9,1179,1509,0,0,78.13,738,432,仁德里,NULL
0,1170,9,1179,1509,0,0,78.13,738,432,仁德里,NULL
279,1167,12,1179,1563,0,0,75.43,731,436,阿夷里,NULL
437,1174,5,1179,1435,0,0,82.16,698,476,寶玉里,NULL
706,1160,19,1179,1537,0,0,76.71,687,473,永興村,NULL
0,1160,19,1179,1537,0,0,76.71,687,473,永興村,NULL
1125,1170,9,1179,1543,0,0,76.41,659,511,光明里,NULL
472,1175,4,1179,1469,0,0,80.26,652,523,安發里,NULL
371,1174,5,1179,1480,0,0,79.66,609,565,本館里,NULL
278,1169,10,1179,1573,0,0,74.95,605,564,二結村,NULL
0,1169,10,1179,1573,0,0,74.95,605,564,二結村,NULL
655,1169,10,1179,1451,0,0,81.25,592,577,復國里,NULL
293,1159,19,1178,1448,0,0,81.35,965,194,大肚村,NULL
0,1159,19,1178,1448,0,0,81.35,965,194,大肚村,NULL
1283,1174,4,1178,1464,0,0,80.46,929,245,玫瑰里,NULL
635,1165,13,1178,1532,0,0,76.89,880,285,普義里,NULL
825,1176,2,1178,1474,0,0,79.92,868,308,福和里,NULL
902,1167,11,1178,1409,0,0,83.61,820,347,中溪里,NULL
1137,1164,14,1178,1433,0,0,82.21,802,362,錦華里,NULL
1221,1159,19,1178,1573,0,0,74.89,797,362,正聲里,NULL
917,1171,7,1178,1442,0,0,81.69,793,378,龍興里,NULL
182,1166,12,1178,1489,0,0,79.11,774,392,三光里,NULL
380,1168,10,1178,1481,0,0,79.54,768,400,安湖里,NULL
1244,1170,8,1178,1513,0,0,77.86,767,403,安和里,NULL
1204,1166,12,1178,1461,0,0,80.63,765,401,黎孝里,NULL
165,1173,5,1178,1504,0,0,78.32,742,431,福山里,NULL
531,1162,16,1178,1491,0,0,79.01,684,478,樹義里,NULL
139,1171,7,1178,1450,0,0,81.24,648,523,成德里,NULL
131,1164,14,1178,1561,0,0,75.46,616,548,橋頭里,NULL
81,1165,13,1178,1437,0,0,81.98,610,555,藍田里,NULL
554,1165,13,1178,1537,0,0,76.64,594,571,西湳里,NULL
447,1167,11,1178,1661,0,0,70.92,592,575,新埤村,NULL
809,1153,25,1178,1507,0,0,78.17,581,572,興中里,NULL
453,1172,6,1178,1511,0,0,77.96,575,597,智蚵村,NULL
112,1167,11,1178,1561,0,0,75.46,551,616,麻寮里,NULL
859,1165,13,1178,1489,0,0,79.11,502,663,國順里,NULL
73,1165,12,1177,1468,0,0,80.18,857,308,新莊里,NULL
0,1169,8,1177,1445,0,0,81.45,856,313,竹東里,NULL
113,1163,14,1177,1578,0,0,74.59,845,318,吉安村,NULL
387,1171,6,1177,1426,0,0,82.54,808,363,內溝里,NULL
604,1169,8,1177,1448,0,0,81.28,781,388,南山里,NULL
252,1168,9,1177,1534,0,0,76.73,732,436,平德里,NULL
329,1169,8,1177,1505,0,0,78.21,708,461,甲寅村,NULL
341,1167,10,1177,1574,0,0,74.78,666,501,南柳村,NULL
0,1167,10,1177,1574,0,0,74.78,666,501,南柳村,NULL
1238,1168,9,1177,1457,0,0,80.78,640,528,景行里,NULL
725,1166,11,1177,1459,0,0,80.67,633,533,自強里,NULL
113,1171,6,1177,1548,0,0,76.03,623,548,海埔里,NULL
1504,1165,12,1177,1482,0,0,79.42,621,544,溪墘里,NULL
801,1169,8,1177,1520,0,0,77.43,560,609,南保村,NULL
22,1170,6,1176,2206,0,0,53.31,1069,101,盤山村,NULL
0,1170,6,1176,2206,0,0,53.31,1069,101,盤山村,NULL
296,1162,14,1176,1533,0,0,76.71,792,370,大華里,NULL
169,1165,11,1176,1553,0,0,75.72,752,413,海口里,NULL
3,1163,13,1176,1597,0,0,73.64,727,436,新港村,NULL
189,1158,18,1176,1536,0,0,76.56,695,463,大同村,NULL
1013,1165,11,1176,1419,0,0,82.88,665,500,頂碩里,NULL
434,1171,5,1176,1565,0,0,75.14,653,518,金城里,NULL
153,1170,6,1176,1490,0,0,78.93,651,519,美源里,NULL
1346,1163,13,1176,1518,0,0,77.47,606,557,日和里,NULL
232,1169,7,1176,1661,0,0,70.8,549,620,永和村,NULL
0,1169,7,1176,1661,0,0,70.8,549,620,永和村,NULL
129,1165,11,1176,1485,0,0,79.19,547,618,國姓里,NULL
0,1165,11,1176,1485,0,0,79.19,547,618,國姓里,NULL
533,1162,14,1176,1624,0,0,72.41,540,622,埤頭村,NULL
0,1162,14,1176,1624,0,0,72.41,540,622,埤頭村,NULL
817,1165,11,1176,1497,0,0,78.56,533,632,瑞豐里,NULL
250,1167,9,1176,1606,0,0,73.23,518,649,嘉賜村,NULL
395,1165,11,1176,1561,0,0,75.34,516,649,南勢里,NULL
182,1167,9,1176,1513,0,0,77.73,464,703,萬和村,NULL
0,1167,9,1176,1513,0,0,77.73,464,703,萬和村,NULL
11,1168,7,1175,2220,0,0,52.93,1104,64,賢庵里,NULL
0,1168,7,1175,2220,0,0,52.93,1104,64,賢庵里,NULL
842,1165,10,1175,1431,0,0,82.11,899,266,民權里,NULL
267,1169,6,1175,1482,0,0,79.28,864,305,石潭村,NULL
826,1168,7,1175,1418,0,0,82.86,844,324,得和里,NULL
321,1168,7,1175,1414,0,0,83.1,837,331,大湖里,NULL
1079,1169,6,1175,1530,0,0,76.8,786,383,仁慈里,NULL
419,1163,12,1175,1463,0,0,80.31,781,382,中研里,NULL
283,1157,18,1175,1621,0,0,72.49,719,438,大湳里,NULL
197,1161,14,1175,1522,0,0,77.2,713,448,軍功里,NULL
430,1166,9,1175,1521,0,0,77.25,685,481,舊莊里,NULL
629,1166,9,1175,1465,0,0,80.2,664,502,二王里,NULL
92,1167,8,1175,1481,0,0,79.34,656,511,溪頭里,NULL
52,1158,17,1175,1529,0,0,76.85,653,505,立賢里,NULL
778,1164,11,1175,1686,0,0,69.69,635,529,中潭里,NULL
0,1164,11,1175,1686,0,0,69.69,635,529,中潭里,NULL
147,1168,7,1175,1464,0,0,80.26,615,553,文元里,NULL
934,1164,11,1175,1508,0,0,77.92,599,565,海山里,NULL
499,1167,8,1175,1577,0,0,74.51,571,596,明昌里,NULL
715,1164,11,1175,1518,0,0,77.4,507,657,山明里,NULL
0,1164,11,1175,1589,0,0,73.95,491,673,士林村,NULL
15,1164,11,1175,1531,0,0,76.75,467,697,安慶里,NULL
234,1161,14,1175,1526,0,0,77,454,707,綠川里,NULL
0,1161,14,1175,1526,0,0,77,454,707,綠川里,NULL
511,1167,8,1175,1560,0,0,75.32,389,778,小東里,NULL
0,1167,8,1175,1560,0,0,75.32,389,778,小東里,NULL
151,1168,6,1174,1525,0,0,76.98,824,344,三民里,NULL
6,1167,7,1174,1665,0,0,70.51,808,359,民生里,NULL
212,1155,19,1174,1646,0,0,71.32,791,364,三鹿里,NULL
142,1169,5,1174,1523,0,0,77.08,771,398,干城里,NULL
523,1161,13,1174,1504,0,0,78.06,738,423,仁義里,NULL
1876,1160,14,1174,1541,0,0,76.18,713,447,水碓里,NULL
431,1163,11,1174,1607,0,0,73.06,696,467,金城里,NULL
1899,1168,6,1174,1522,0,0,77.14,695,473,鄧公里,NULL
117,1164,10,1174,1454,0,0,80.74,688,476,關渡里,NULL
323,1166,8,1174,1518,0,0,77.34,688,478,溪福里,NULL
216,1168,6,1174,1444,0,0,81.3,686,482,聖山里,NULL
299,1166,8,1174,1449,0,0,81.02,666,500,港富里,NULL
0,1160,14,1174,1664,0,0,70.55,616,544,玉田里,NULL
1453,1164,10,1174,1503,0,0,78.11,541,623,九芎里,NULL
0,1166,8,1174,1596,0,0,73.56,488,678,新崙里,NULL
773,1164,10,1174,1492,0,0,78.69,436,728,前鎮里,NULL
0,1164,10,1174,1492,0,0,78.69,436,728,前鎮里,NULL
243,1166,7,1173,1476,0,0,79.47,946,220,員山村,NULL
500,1164,9,1173,1501,0,0,78.15,813,351,東光里,NULL
974,1162,11,1173,1586,0,0,73.96,793,369,西門里,NULL
769,1161,12,1173,2738,0,0,42.84,706,455,行政里,NULL
574,1167,6,1173,1621,0,0,72.36,701,466,社皮里,NULL
778,1168,5,1173,1449,0,0,80.95,685,483,下埤里,NULL
464,1159,14,1173,1604,0,0,73.13,673,486,中政里,NULL
70,1163,10,1173,1618,0,0,72.5,669,494,東安里,NULL
69,1158,15,1173,1411,0,0,83.13,667,491,文德里,NULL
608,1167,6,1173,1470,0,0,79.8,663,504,五全里,NULL
79,1165,8,1173,1566,0,0,74.9,648,517,中庄里,NULL
145,1165,8,1173,1618,0,0,72.5,630,535,福民里,NULL
729,1161,12,1173,1564,0,0,75,627,534,圓山里,NULL
942,1162,11,1173,1519,0,0,77.22,563,599,頭洲村,NULL
491,1163,10,1173,1633,0,0,71.83,498,665,嘉蓮里,NULL
0,1163,10,1173,1633,0,0,71.83,498,665,嘉蓮里,NULL
634,1154,18,1172,1482,0,0,79.08,896,258,華新里,NULL
1156,1169,3,1172,1480,0,0,79.19,846,323,張北里,NULL
25,1166,6,1172,1482,0,0,79.08,822,344,自強里,NULL
1186,1158,14,1172,1463,0,0,80.11,810,348,龍淵里,NULL
627,1161,11,1172,1443,0,0,81.22,775,386,國業里,NULL
503,1162,10,1172,1428,0,0,82.07,758,404,龍田里,NULL
480,1167,5,1172,1473,0,0,79.57,749,418,坪林里,NULL
55,1158,14,1172,1476,0,0,79.4,720,438,大豐里,NULL
503,1162,10,1172,1633,0,0,71.77,704,458,宜昌里,NULL
137,1165,7,1172,1601,0,0,73.2,696,469,忠政里,NULL
139,1162,10,1172,1516,0,0,77.31,672,490,忠政里,NULL
348,1160,12,1172,1575,0,0,74.41,660,500,嘉興村,NULL
0,1160,12,1172,1575,0,0,74.41,660,500,嘉興村,NULL
609,1159,13,1172,1421,0,0,82.48,638,521,五全里,NULL
543,1162,10,1172,1456,0,0,80.49,638,524,苓雅里,NULL
0,1162,10,1172,1456,0,0,80.49,638,524,苓雅里,NULL
627,1162,10,1172,1465,0,0,80,634,528,碧河里,NULL
0,1164,8,1172,1475,0,0,79.46,617,547,大義里,NULL
372,1165,7,1172,1526,0,0,76.8,581,584,萬全村,NULL
340,1166,6,1172,1578,0,0,74.27,508,658,忠仁里,NULL
284,1167,5,1172,1498,0,0,78.24,495,672,建南里,NULL
508,1163,9,1172,1547,0,0,75.76,449,714,仁和村,NULL
0,1163,9,1172,1547,0,0,75.76,449,714,仁和村,NULL
199,1162,9,1171,1698,0,0,68.96,833,329,碇祥里,NULL
1320,1162,9,1171,1586,0,0,73.83,737,425,永寧里,NULL
27,1160,11,1171,1442,0,0,81.21,734,426,振華里,NULL
1253,1165,6,1171,1512,0,0,77.45,730,435,公崙里,NULL
1784,1161,10,1171,1549,0,0,75.6,668,493,中湖里,NULL
14,1166,5,1171,1542,0,0,75.94,657,509,信光里,NULL
425,1163,8,1171,1537,0,0,76.19,640,523,西榮里,NULL
423,1160,11,1171,1594,0,0,73.46,638,522,西榮里,NULL
992,1157,14,1171,1480,0,0,79.12,612,545,思源里,NULL
0,1163,8,1171,1701,0,0,68.84,612,551,萬隆村,NULL
72,1162,9,1171,1507,0,0,77.7,611,551,中央里,NULL
422,1155,16,1171,1494,0,0,78.38,596,559,日新里,NULL
0,1156,15,1171,1711,0,0,68.44,589,567,福隆村,NULL
2218,1167,4,1171,1651,0,0,70.93,547,620,磺港村,NULL
0,1167,4,1171,1651,0,0,70.93,547,620,磺港村,NULL
281,1164,7,1171,1489,0,0,78.64,532,632,郡南里,NULL
171,1167,4,1171,1611,0,0,72.69,510,657,埤寮里,NULL
0,1167,4,1171,1611,0,0,72.69,510,657,埤寮里,NULL
0,1154,17,1171,1453,0,0,80.59,378,776,西林村,NULL
659,1160,10,1170,1511,0,0,77.43,905,255,興仁里,NULL
340,1163,7,1170,1483,0,0,78.89,761,402,賴興里,NULL
110,1161,9,1170,1619,0,0,72.27,734,427,西安里,NULL
714,1150,20,1170,1484,0,0,78.84,726,424,民安里,NULL
231,1157,13,1170,1494,0,0,78.31,714,443,蘭雅里,NULL
166,1163,7,1170,1533,0,0,76.32,705,458,福華里,NULL
221,1158,12,1170,1495,0,0,78.26,689,469,成功里,NULL
0,1158,12,1170,1495,0,0,78.26,689,469,成功里,NULL
1129,1162,8,1170,1551,0,0,75.44,681,481,光榮里,NULL
2219,1161,9,1170,1602,0,0,73.03,670,491,美田村,NULL
467,1159,11,1170,1428,0,0,81.93,662,497,東英里,NULL
290,1156,14,1170,1451,0,0,80.63,624,532,烏日村,NULL
498,1159,11,1170,1484,0,0,78.84,560,599,永盛里,NULL
0,1160,10,1170,1559,0,0,75.05,539,621,竹峰里,NULL
0,1159,11,1170,1554,0,0,75.29,519,640,後壁村,NULL
499,1163,7,1170,1559,0,0,75.05,494,669,大潭里,NULL
0,1163,7,1170,1559,0,0,75.05,494,669,大潭里,NULL
832,1163,7,1170,1445,0,0,80.97,439,724,瑞北里,NULL
313,1156,13,1169,1407,0,0,83.08,848,308,湖濱里,NULL
132,1158,11,1169,1536,0,0,76.11,785,373,和慶里,NULL
1884,1157,12,1169,1533,0,0,76.26,776,381,新興里,NULL
101,1159,10,1169,1565,0,0,74.7,763,396,協和里,NULL
123,1161,8,1169,1522,0,0,76.81,762,399,德安里,NULL
1417,1158,11,1169,1513,0,0,77.26,761,397,金城里,NULL
1364,1157,12,1169,1474,0,0,79.31,722,435,廣福里,NULL
29,1166,3,1169,1617,0,0,72.29,712,454,復興里,NULL
790,1157,12,1169,1549,0,0,75.47,705,452,上楓村,NULL
270,1162,7,1169,1473,0,0,79.36,702,460,大武里,NULL
1374,1152,17,1169,1499,0,0,77.99,694,458,樂利里,NULL
1081,1157,12,1169,1531,0,0,76.36,654,503,裕民里,NULL
1703,1159,10,1169,1574,0,0,74.27,643,516,彭興里,NULL
76,1157,12,1169,1501,0,0,77.88,632,525,長安里,NULL
597,1161,8,1169,1463,0,0,79.9,625,536,南陽里,NULL
504,1154,15,1169,1534,0,0,76.21,611,543,永豐里,NULL
440,1165,4,1169,1546,0,0,75.61,600,565,灣子里,NULL
379,1156,13,1169,1583,0,0,73.85,518,638,竹林村,NULL
0,1156,13,1169,1583,0,0,73.85,518,638,竹林村,NULL
0,1154,15,1169,1605,0,0,72.83,410,744,九塊里,NULL
0,1156,13,1169,1676,0,0,69.75,389,767,歡雅里,NULL
478,1158,10,1168,1491,0,0,78.34,791,367,三民里,NULL
16,1162,6,1168,1443,0,0,80.94,779,383,榮光里,NULL
1166,1158,10,1168,1519,0,0,76.89,748,410,通安里,NULL
408,1157,11,1168,1453,0,0,80.39,731,426,寶華里,NULL
344,1159,9,1168,1493,0,0,78.23,698,461,自強里,NULL
56,1159,9,1168,1451,0,0,80.5,680,479,麻園里,NULL
0,1159,9,1168,1451,0,0,80.5,680,479,麻園里,NULL
1045,1156,12,1168,1521,0,0,76.79,670,486,立功里,NULL
846,1160,8,1168,1427,0,0,81.85,638,522,瑞華里,NULL
845,1163,5,1168,1451,0,0,80.5,627,536,雙連里,NULL
167,1161,7,1168,1467,0,0,79.62,602,559,振義里,NULL
454,1158,10,1168,1551,0,0,75.31,593,565,正興里,NULL
285,1162,6,1168,1555,0,0,75.11,469,693,福興村,NULL
0,1162,6,1168,1555,0,0,75.11,469,693,福興村,NULL
0,1155,13,1168,1631,0,0,71.61,343,812,大潭村,NULL
538,1159,8,1167,1495,0,0,78.06,910,249,自立里,NULL
667,1163,4,1167,1444,0,0,80.82,821,342,三犁里,NULL
627,1153,14,1167,1439,0,0,81.1,704,449,萬興村,NULL
0,1153,14,1167,1439,0,0,81.1,704,449,萬興村,NULL
244,1156,11,1167,1437,0,0,81.21,687,469,天祿里,NULL
2028,1153,14,1167,1532,0,0,76.17,678,475,全興村,NULL
110,1161,6,1167,1567,0,0,74.47,669,492,廖厝里,NULL
635,1161,6,1167,1558,0,0,74.9,666,495,正大里,NULL
423,1157,10,1167,1465,0,0,79.66,645,512,公益里,NULL
443,1150,17,1167,1568,0,0,74.43,616,534,新仁里,NULL
189,1154,13,1167,1467,0,0,79.55,594,560,正泰里,NULL
755,1157,10,1167,1467,0,0,79.55,551,606,新福里,NULL
163,1147,19,1166,1456,0,0,80.08,762,385,承德里,NULL
698,1157,9,1166,1453,0,0,80.25,740,417,黎忠里,NULL
247,1152,14,1166,1521,0,0,76.66,729,423,向陽里,NULL
845,1162,4,1166,1434,0,0,81.31,696,466,海洋里,NULL
30,1160,6,1166,1596,0,0,73.06,695,465,御史里,NULL
111,1149,17,1166,1465,0,0,79.59,622,527,楓樹里,NULL
484,1154,12,1166,1537,0,0,75.86,621,533,青山里,NULL
0,1154,12,1166,1537,0,0,75.86,621,533,青山里,NULL
144,1150,16,1166,1514,0,0,77.01,618,532,福民里,NULL
1032,1156,10,1166,1472,0,0,79.21,610,546,中信里,NULL
160,1154,12,1166,1485,0,0,78.52,608,546,賢北里,NULL
1530,1154,12,1166,1583,0,0,73.66,592,562,仁愛里,NULL
1059,1156,9,1165,1542,0,0,75.55,881,275,新忠里,NULL
1251,1151,14,1165,1489,0,0,78.24,865,286,永平里,NULL
17,1153,12,1165,1447,0,0,80.51,797,356,惠來里,NULL
1237,1157,8,1165,1468,0,0,79.36,730,427,景行里,NULL
398,1159,6,1165,1437,0,0,81.07,723,436,行善里,NULL
184,1159,6,1165,1431,0,0,81.41,722,437,前峰里,NULL
106,1155,10,1165,1509,0,0,77.2,717,438,稻香里,NULL
1095,1159,6,1165,1550,0,0,75.16,710,449,民輝里,NULL
338,1157,8,1165,1453,0,0,80.18,698,459,本堂村,NULL
605,1156,9,1165,1465,0,0,79.52,676,480,興和里,NULL
469,1158,7,1165,1529,0,0,76.19,632,526,安吉里,NULL
107,1159,6,1165,1500,0,0,77.67,600,559,仁愛里,NULL
404,1154,11,1165,1419,0,0,82.1,597,557,寶興里,NULL
459,1156,9,1165,1617,0,0,72.05,597,559,長安里,NULL
189,1156,9,1165,1418,0,0,82.16,570,586,民族里,NULL
0,1156,9,1165,1418,0,0,82.16,570,586,民族里,NULL
1018,1156,9,1165,1482,0,0,78.61,565,591,立志里,NULL
14,1157,7,1164,1415,0,0,82.26,851,306,十興里,NULL
827,1144,20,1164,1512,0,0,76.98,848,296,梅新里,NULL
0,1144,20,1164,1512,0,0,76.98,848,296,梅新里,NULL
569,1151,13,1164,1428,0,0,81.51,837,314,正行里,NULL
777,1153,11,1164,1567,0,0,74.28,811,342,文雅村,NULL
0,1159,5,1164,1785,0,0,65.21,806,353,國威里,NULL
356,1149,15,1164,1585,0,0,73.44,775,374,南興村,NULL
0,1159,5,1164,1511,0,0,77.04,737,422,八德里,NULL
152,1149,15,1164,1569,0,0,74.19,723,426,草湳里,NULL
420,1150,14,1164,1579,0,0,73.72,721,429,埔鹽村,NULL
0,1150,14,1164,1579,0,0,73.72,721,429,埔鹽村,NULL
653,1151,13,1164,1424,0,0,81.74,681,470,大仁里,NULL
221,1158,6,1164,1562,0,0,74.52,652,506,永春里,NULL
356,1155,9,1164,1683,0,0,69.16,605,550,松山村,NULL
0,1155,9,1164,1683,0,0,69.16,605,550,松山村,NULL
539,1156,8,1164,1456,0,0,79.95,481,675,鳥松村,NULL
279,1158,6,1164,1520,0,0,76.58,470,688,明興里,NULL
506,1155,9,1164,1507,0,0,77.24,439,716,永樂村,NULL
0,1161,2,1163,2144,0,0,54.24,1079,82,山外里,NULL
815,1154,9,1163,1465,0,0,79.39,869,285,永興里,NULL
137,1158,5,1163,1446,0,0,80.43,829,329,三和里,NULL
764,1147,16,1163,1442,0,0,80.65,730,417,北興里,NULL
146,1155,8,1163,1465,0,0,79.39,715,440,福佳里,NULL
507,1157,6,1163,1448,0,0,80.32,713,444,新吉里,NULL
243,1157,6,1163,1453,0,0,80.04,691,466,天祿里,NULL
722,1151,12,1163,1529,0,0,76.06,666,485,聚葉里,NULL
692,1145,18,1163,1509,0,0,77.07,655,490,永西村,NULL
0,1145,18,1163,1509,0,0,77.07,655,490,永西村,NULL
7,1154,9,1163,1441,0,0,80.71,653,501,清豐里,NULL
215,1154,9,1163,1511,0,0,76.97,616,538,西門里,NULL
0,1154,9,1163,1511,0,0,76.97,616,538,西門里,NULL
603,1155,8,1163,1425,0,0,81.61,610,545,林貴里,NULL
0,1155,8,1163,1425,0,0,81.61,610,545,林貴里,NULL
222,1156,7,1163,1608,0,0,72.33,609,547,永春里,NULL
0,1150,13,1163,1611,0,0,72.19,582,568,德化里,NULL
713,1157,6,1163,1465,0,0,79.39,563,594,忠誠里,NULL
0,1156,7,1163,1548,0,0,75.13,394,762,新東村,NULL
1243,1155,7,1162,1415,0,0,82.12,886,269,景東里,NULL
143,1150,12,1162,1406,0,0,82.65,833,317,黎明里,NULL
7,1149,13,1162,1589,0,0,73.13,827,322,全興村,NULL
0,1149,13,1162,1589,0,0,73.13,827,322,全興村,NULL
696,1148,14,1162,1435,0,0,80.98,803,345,平南里,NULL
913,1159,3,1162,1464,0,0,79.37,719,440,永昌里,NULL
47,1144,18,1162,1519,0,0,76.5,717,427,何安里,NULL
638,1154,8,1162,1452,0,0,80.03,700,454,松光里,NULL
263,1150,12,1162,1462,0,0,79.48,668,482,民生里,NULL
0,1150,12,1162,1462,0,0,79.48,668,482,民生里,NULL
396,1152,10,1162,1511,0,0,76.9,643,509,仁化里,NULL
85,1150,12,1162,1473,0,0,78.89,642,508,江翠里,NULL
132,1157,5,1162,1470,0,0,79.05,642,515,光興里,NULL
263,1151,11,1162,1579,0,0,73.59,640,511,光復里,NULL
0,1151,11,1162,1579,0,0,73.59,640,511,光復里,NULL
624,1151,11,1162,1454,0,0,79.92,633,518,永春里,NULL
838,1158,4,1162,1463,0,0,79.43,612,546,大有里,NULL
704,1149,13,1162,1596,0,0,72.81,584,565,光雲村,NULL
0,1149,13,1162,1596,0,0,72.81,584,565,光雲村,NULL
416,1150,12,1162,1502,0,0,77.36,576,574,光文里,NULL
84,1152,10,1162,1505,0,0,77.21,549,603,後湖里,NULL
130,1151,11,1162,1454,0,0,79.92,547,604,寶山里,NULL
671,1153,8,1161,1435,0,0,80.91,881,272,六合里,NULL
490,1152,9,1161,1526,0,0,76.08,820,332,光明里,NULL
782,1149,12,1161,1410,0,0,82.34,817,332,秀福里,NULL
855,1156,5,1161,1429,0,0,81.25,808,348,秀元里,NULL
673,1156,5,1161,1424,0,0,81.53,783,373,復興里,NULL
82,1148,13,1161,1461,0,0,79.47,747,401,華江里,NULL
2,1139,22,1161,1645,0,0,70.58,734,405,新港村,NULL
1582,1148,13,1161,1444,0,0,80.4,711,437,江北里,NULL
266,1152,9,1161,1441,0,0,80.57,702,450,仁美里,NULL
12,1145,16,1161,1548,0,0,75,699,446,新興里,NULL
872,1149,12,1161,1469,0,0,79.03,697,452,中山村,NULL
1121,1153,8,1161,1541,0,0,75.34,664,489,民有里,NULL
386,1146,15,1161,1420,0,0,81.76,640,506,本安里,NULL
642,1150,11,1161,1469,0,0,79.03,629,521,正道里,NULL
435,1154,7,1161,1475,0,0,78.71,622,532,寶玉里,NULL
556,1150,11,1161,1442,0,0,80.51,614,536,過嶺里,NULL
276,1150,11,1161,1540,0,0,75.39,606,544,府南里,NULL
94,1153,8,1161,1491,0,0,77.87,582,571,西寧里,NULL
0,1153,8,1161,1491,0,0,77.87,582,571,西寧里,NULL
42,1152,9,1161,1390,0,0,83.53,536,616,宏毅里,NULL
181,1149,12,1161,1458,0,0,79.63,484,665,保安里,NULL
518,1152,8,1160,1433,0,0,80.95,962,190,龍東里,NULL
140,1144,16,1160,1590,0,0,72.96,931,213,東昌村,NULL
224,1144,16,1160,1579,0,0,73.46,891,253,鳳凰村,NULL
1352,1152,8,1160,1429,0,0,81.18,877,275,萬芳里,NULL
646,1152,8,1160,1474,0,0,78.7,855,297,仁美里,NULL
1085,1141,19,1160,1498,0,0,77.44,758,383,民炤里,NULL
65,1150,10,1160,1432,0,0,81.01,726,424,中山里,NULL
303,1149,11,1160,1442,0,0,80.44,716,433,港富里,NULL
622,1149,11,1160,1470,0,0,78.91,711,438,永春里,NULL
970,1142,18,1160,1534,0,0,75.62,679,463,福星里,NULL
671,1149,11,1160,1536,0,0,75.52,670,479,詒福里,NULL
0,1149,11,1160,1536,0,0,75.52,670,479,詒福里,NULL
596,1143,17,1160,1529,0,0,75.87,650,493,茄苳村,NULL
0,1143,17,1160,1529,0,0,75.87,650,493,茄苳村,NULL
427,1155,5,1160,1531,0,0,75.77,641,514,寶安里,NULL
604,1145,15,1160,1492,0,0,77.75,640,505,北陽里,NULL
154,1145,15,1160,1506,0,0,77.03,633,512,春日里,NULL
985,1155,5,1160,1466,0,0,79.13,605,550,富民里,NULL
376,1148,12,1160,1453,0,0,79.83,570,578,樹王里,NULL
622,1150,10,1160,1442,0,0,80.44,525,625,福居里,NULL
496,1143,17,1160,1411,0,0,82.21,474,669,永發里,NULL
60,1154,6,1160,1533,0,0,75.67,461,693,溪墘里,NULL
214,1152,7,1159,1428,0,0,81.16,953,199,山下里,NULL
185,1151,8,1159,1386,0,0,83.62,846,305,前峰里,NULL
63,1141,18,1159,1568,0,0,73.92,834,307,國富里,NULL
451,1156,3,1159,1385,0,0,83.68,817,339,聯成里,NULL
35,1153,6,1159,1456,0,0,79.6,766,387,永欣里,NULL
167,1148,11,1159,1468,0,0,78.95,732,416,大興里,NULL
1058,1151,8,1159,1464,0,0,79.17,707,444,忠貞里,NULL
0,1145,14,1159,1541,0,0,75.21,703,442,西岐里,NULL
217,1146,13,1159,1475,0,0,78.58,684,462,松強里,NULL
532,1137,22,1159,1622,0,0,71.45,681,456,興農村,NULL
0,1137,22,1159,1622,0,0,71.45,681,456,興農村,NULL
14,1152,7,1159,1455,0,0,79.66,650,502,榮光里,NULL
525,1146,13,1159,1542,0,0,75.16,631,515,永和里,NULL
118,1148,11,1159,1457,0,0,79.55,619,529,關渡里,NULL
1645,1154,5,1159,1483,0,0,78.15,618,536,三多里,NULL
1039,1151,8,1159,1511,0,0,76.7,615,536,中原里,NULL
0,1146,13,1159,1653,0,0,70.11,603,543,延正里,NULL
487,1149,10,1159,1423,0,0,81.45,601,548,立德里,NULL
1054,1149,10,1159,1480,0,0,78.31,594,555,豐年里,NULL
181,1154,5,1159,1475,0,0,78.58,515,639,葫東里,NULL
59,1152,7,1159,1482,0,0,78.21,493,659,溪墘里,NULL
520,1149,9,1158,1370,0,0,84.53,1036,113,龍東里,NULL
653,1144,14,1158,1454,0,0,79.64,906,238,龍岡里,NULL
2069,1153,5,1158,1493,0,0,77.56,807,346,仁愛村,NULL
1089,1142,16,1158,1656,0,0,69.93,765,377,仁愛里,NULL
338,1140,18,1158,1566,0,0,73.95,753,387,永春村,NULL
0,1140,18,1158,1566,0,0,73.95,753,387,永春村,NULL
0,1146,12,1158,1607,0,0,72.06,747,399,土城里,NULL
452,1148,10,1158,1417,0,0,81.72,727,421,聯成里,NULL
948,1147,11,1158,1413,0,0,81.95,719,428,文聖里,NULL
484,1149,9,1158,1551,0,0,74.66,716,433,西岐里,NULL
101,1151,7,1158,1479,0,0,78.3,714,437,秀山里,NULL
430,1148,10,1158,1469,0,0,78.83,660,488,寶龍里,NULL
500,1145,13,1158,1461,0,0,79.26,656,489,德生里,NULL
941,1144,14,1158,1488,0,0,77.82,652,492,頭洲村,NULL
346,1151,7,1158,1506,0,0,76.89,627,524,自強里,NULL
994,1150,8,1158,1415,0,0,81.84,591,559,富福里,NULL
728,1144,14,1158,1570,0,0,73.76,581,563,聯合村,NULL
0,1144,14,1158,1570,0,0,73.76,581,563,聯合村,NULL
112,1138,19,1157,1624,0,0,71.24,843,295,慶豐村,NULL
32,1149,8,1157,1566,0,0,73.88,713,436,竹營里,NULL
835,1139,18,1157,1477,0,0,78.33,705,434,秀才里,NULL
252,1146,11,1157,1556,0,0,74.36,697,449,豐田里,NULL
205,1146,11,1157,1571,0,0,73.65,678,468,六路里,NULL
732,1151,6,1157,1416,0,0,81.71,668,483,文德里,NULL
751,1147,10,1157,1513,0,0,76.47,615,532,社口村,NULL
421,1153,4,1157,1450,0,0,79.79,595,558,寶盛里,NULL
55,1152,5,1157,1598,0,0,72.4,562,590,淵東里,NULL
259,1150,7,1157,1595,0,0,72.54,472,678,順安村,NULL
36,1141,16,1157,1586,0,0,72.95,442,699,長安里,NULL
0,1149,8,1157,1528,0,0,75.72,333,816,子龍里,NULL
0,1148,8,1156,1473,0,0,78.48,934,214,親仁里,NULL
530,1146,10,1156,1418,0,0,81.52,856,290,龍德里,NULL
225,1143,13,1156,1538,0,0,75.16,851,292,鳳凰村,NULL
276,1144,12,1156,1453,0,0,79.56,809,335,華東里,NULL
597,1145,11,1156,1413,0,0,81.81,756,389,安康里,NULL
1750,1149,7,1156,1544,0,0,74.87,744,405,建國里,NULL
642,1145,11,1156,1420,0,0,81.41,721,424,中坡里,NULL
328,1148,8,1156,1479,0,0,78.16,705,443,溪北里,NULL
352,1143,13,1156,1479,0,0,78.16,698,445,育德里,NULL
0,1146,10,1156,1703,0,0,67.88,666,480,月眉村,NULL
840,1143,13,1156,1488,0,0,77.69,659,484,東寶村,NULL
119,1150,6,1156,1591,0,0,72.66,656,494,新吉里,NULL
722,1144,12,1156,1467,0,0,78.8,598,546,墩南村,NULL
516,1140,16,1156,1451,0,0,79.67,563,577,溪美里,NULL
0,1149,7,1156,1573,0,0,73.49,435,714,庄內里,NULL
118,1149,6,1155,1385,0,0,83.39,1061,88,海勝里,NULL
146,1147,8,1155,1428,0,0,80.88,760,387,文心里,NULL
295,1145,10,1155,1380,0,0,83.7,737,408,港都里,NULL
320,1141,14,1155,1565,0,0,73.8,693,448,溪洲里,NULL
176,1141,14,1155,1544,0,0,74.81,688,453,北京里,NULL
121,1142,13,1155,1490,0,0,77.52,687,455,春社里,NULL
115,1134,21,1155,1434,0,0,80.54,641,493,中和里,NULL
989,1148,7,1155,1436,0,0,80.43,620,528,福音里,NULL
473,1149,6,1155,1469,0,0,78.62,595,554,安發里,NULL
3,1147,8,1155,1483,0,0,77.88,500,647,清豐里,NULL
174,1141,14,1155,1584,0,0,72.92,423,718,太北里,NULL
0,1141,14,1155,1584,0,0,72.92,423,718,太北里,NULL
421,1145,10,1155,1528,0,0,75.59,377,768,鹽埔村,NULL
767,1144,11,1155,1461,0,0,79.06,373,771,信義里,NULL
0,1144,11,1155,1461,0,0,79.06,373,771,信義里,NULL
1143,1149,5,1154,1525,0,0,75.67,825,324,龍圖里,NULL
353,1151,3,1154,1428,0,0,80.81,773,378,文聖里,NULL
208,1145,9,1154,1409,0,0,81.9,759,386,名山里,NULL
168,1149,5,1154,1524,0,0,75.72,694,455,大興里,NULL
0,1141,13,1154,1508,0,0,76.53,694,447,五湖村,NULL
273,1146,8,1154,1497,0,0,77.09,683,463,華德里,NULL
250,1144,10,1154,1467,0,0,78.66,641,503,瑞興里,NULL
764,1138,16,1154,1456,0,0,79.26,602,536,中庄里,NULL
1494,1142,12,1154,1477,0,0,78.13,537,605,復興里,NULL
129,1147,7,1154,1615,0,0,71.46,426,721,竹圍村,NULL
0,1147,7,1154,1615,0,0,71.46,426,721,竹圍村,NULL
623,1147,6,1153,1989,0,0,57.97,705,442,本福村,NULL
0,1147,6,1153,1989,0,0,57.97,705,442,本福村,NULL
57,1145,8,1153,1448,0,0,79.63,700,445,何源里,NULL
129,1141,12,1153,1484,0,0,77.7,676,465,文山里,NULL
224,1138,15,1153,1437,0,0,80.24,656,482,西安里,NULL
837,1138,15,1153,1594,0,0,72.33,639,499,東流里,NULL
325,1144,9,1153,1486,0,0,77.59,606,538,吉峰村,NULL
833,1143,10,1153,1498,0,0,76.97,535,608,瑞北里,NULL
177,1145,8,1153,1501,0,0,76.82,533,612,天后里,NULL
0,1145,8,1153,1501,0,0,76.82,533,612,天后里,NULL
341,1144,9,1153,1524,0,0,75.66,512,632,維新村,NULL
1229,1141,11,1152,1407,0,0,81.88,887,254,忠孝里,NULL
890,1140,12,1152,1367,0,0,84.27,811,329,協和里,NULL
10,1144,8,1152,1514,0,0,76.09,779,365,中寧里,NULL
355,1143,9,1152,1563,0,0,73.7,773,370,南興村,NULL
895,1144,8,1152,1754,0,0,65.68,737,407,龍星村,NULL
404,1134,18,1152,1629,0,0,70.72,736,398,趙甲里,NULL
0,1134,18,1152,1629,0,0,70.72,736,398,趙甲里,NULL
359,1140,12,1152,1462,0,0,78.8,693,447,健行里,NULL
1748,1139,13,1152,1489,0,0,77.37,639,500,建國里,NULL
345,1143,9,1152,1524,0,0,75.59,544,599,建南里,NULL
106,1143,9,1152,1527,0,0,75.44,522,621,頂厝里,NULL
34,1140,12,1152,1589,0,0,72.5,480,660,大安里,NULL
240,1143,9,1152,1455,0,0,79.18,476,667,楠樹里、扶風里、慶春里,NULL
0,1143,9,1152,1455,0,0,79.18,476,667,楠樹里、扶風里、慶春里,NULL
1083,1148,3,1151,1410,0,0,81.63,874,274,和安里,NULL
1261,1138,13,1151,1415,0,0,81.34,811,327,德安里,NULL
679,1138,13,1151,1406,0,0,81.86,789,349,景聯里,NULL
598,1146,5,1151,1408,0,0,81.75,776,370,安康里,NULL
0,1138,13,1151,1807,0,0,63.7,774,364,南港村,NULL
122,1142,9,1151,1513,0,0,76.07,766,376,春社里,NULL
2077,1145,6,1151,1504,0,0,76.53,758,387,東勢村,NULL
745,1135,16,1151,1456,0,0,79.05,737,398,民有里,NULL
1542,1145,6,1151,1487,0,0,77.4,732,413,智慧里,NULL
1984,1145,6,1151,1466,0,0,78.51,729,416,五福村,NULL
923,1146,5,1151,1477,0,0,77.93,722,424,廈安里,NULL
197,1145,6,1151,1456,0,0,79.05,716,429,竹林里,NULL
0,1148,3,1151,1449,0,0,79.43,670,478,忠孝里,NULL
767,1139,12,1151,1450,0,0,79.38,641,498,行政里,NULL
242,1142,9,1151,1449,0,0,79.43,640,502,福星里,NULL
9,1139,12,1151,1412,0,0,81.52,639,500,福興里,NULL
115,1146,5,1151,1508,0,0,76.33,629,517,福全里,NULL
243,1145,6,1151,1586,0,0,72.57,627,518,橋南里,NULL
0,1145,6,1151,1586,0,0,72.57,627,518,橋南里,NULL
390,1136,15,1151,1494,0,0,77.04,607,529,東昇里,NULL
671,1141,10,1151,1423,0,0,80.89,603,538,竹南里,NULL
193,1144,7,1151,1495,0,0,76.99,569,575,佳和村,NULL
0,1144,7,1151,1495,0,0,76.99,569,575,佳和村,NULL
0,1143,8,1151,1751,0,0,65.73,558,585,四湖村,NULL
329,1142,9,1151,1507,0,0,76.38,538,604,西安村,NULL
0,1139,12,1151,1457,0,0,79,409,730,西埔村,NULL
636,1141,9,1150,1354,0,0,84.93,1030,111,龍平里,NULL
0,1131,19,1150,1511,0,0,76.11,913,218,建國里,NULL
17,1139,11,1150,1422,0,0,80.87,830,309,復興里,NULL
72,1139,11,1150,1438,0,0,79.97,814,325,新莊里,NULL
0,1143,7,1150,1857,0,0,61.93,767,376,崙後村,NULL
373,1140,10,1150,1453,0,0,79.15,735,405,國光里,NULL
509,1142,8,1150,1522,0,0,75.56,706,436,福平里,NULL
481,1142,8,1150,1490,0,0,77.18,694,448,義民村,NULL
0,1142,8,1150,1490,0,0,77.18,694,448,義民村,NULL
38,1139,11,1150,1386,0,0,82.97,661,478,中興里,NULL
643,1145,5,1150,1449,0,0,79.37,641,504,中行里,NULL
624,1141,9,1150,1428,0,0,80.53,634,507,福東里,NULL
1082,1140,10,1150,1509,0,0,76.21,613,527,裕民里,NULL
1006,1143,7,1150,1390,0,0,82.73,603,540,綠堤里,NULL
1041,1143,7,1150,1449,0,0,79.37,545,598,孝德里,NULL
1268,1142,7,1149,1444,0,0,79.57,822,320,萬年里,NULL
506,1135,14,1149,1539,0,0,74.66,770,365,新坪里,NULL
0,1138,11,1149,1584,0,0,72.54,755,383,吉慶里,NULL
1026,1142,7,1149,1482,0,0,77.53,696,446,立基里,NULL
92,1142,7,1149,1540,0,0,74.61,665,477,新潭村,NULL
240,1140,9,1149,1413,0,0,81.32,632,508,南上村,NULL
0,1140,9,1149,1413,0,0,81.32,632,508,南上村,NULL
137,1138,11,1149,1456,0,0,78.91,561,577,華翠里,NULL
865,1140,8,1148,1391,0,0,82.53,892,248,民樂里,NULL
0,1143,5,1148,1430,0,0,80.28,892,251,榮樂里,NULL
1331,1141,7,1148,1419,0,0,80.9,809,332,順興里,NULL
659,1141,7,1148,1450,0,0,79.17,795,346,廣興里,NULL
0,1141,7,1148,1450,0,0,79.17,795,346,廣興里,NULL
754,1138,10,1148,1440,0,0,79.72,793,345,新榮里,NULL
1541,1136,12,1148,1482,0,0,77.46,790,346,智慧里,NULL
836,1132,16,1148,1504,0,0,76.33,772,360,秀才里,NULL
335,1136,12,1148,1403,0,0,81.82,753,383,博愛里,NULL
735,1135,13,1148,1393,0,0,82.41,709,426,義興里,NULL
85,1141,7,1148,1516,0,0,75.73,708,433,林泉里,NULL
28,1137,11,1148,1471,0,0,78.04,700,437,進士里,NULL
1994,1139,9,1148,1447,0,0,79.34,660,479,德音村,NULL
791,1142,6,1148,1523,0,0,75.38,654,488,上楓村,NULL
516,1137,11,1148,1474,0,0,77.88,629,508,新光里,NULL
1016,1140,8,1148,1502,0,0,76.43,595,545,中全里,NULL
910,1139,9,1148,1458,0,0,78.74,541,598,大德里,NULL
201,1140,8,1148,1431,0,0,80.22,359,781,富洲里,NULL
650,1133,14,1147,1487,0,0,77.14,880,253,興南里,NULL
713,1139,8,1147,1446,0,0,79.32,810,329,宋屋里,NULL
389,1138,9,1147,1414,0,0,81.12,798,340,安泰里,NULL
404,1136,11,1147,1434,0,0,79.99,775,361,大忠里,NULL
2068,1140,7,1147,1513,0,0,75.81,773,367,南勢村,NULL
210,1132,15,1147,1552,0,0,73.9,729,403,埔子里,NULL
183,1134,13,1147,1389,0,0,82.58,714,420,湳中里,NULL
831,1132,15,1147,1472,0,0,77.92,698,434,永寧里,NULL
702,1131,16,1147,1403,0,0,81.75,666,465,員山里,NULL
419,1144,3,1147,1487,0,0,77.14,644,500,寶業里,NULL
50,1141,6,1147,1465,0,0,78.29,636,505,立賢里,NULL
610,1135,12,1147,1398,0,0,82.05,635,500,五全里,NULL
480,1140,7,1147,1436,0,0,79.87,620,520,新生里,NULL
517,1135,12,1147,1449,0,0,79.16,613,522,民有里,NULL
1366,1140,7,1147,1423,0,0,80.6,605,535,學成里,NULL
56,1137,10,1147,1436,0,0,79.87,592,545,泰昌里,NULL
1529,1133,14,1147,1406,0,0,81.58,592,541,仁愛里,NULL
0,1137,10,1147,1436,0,0,79.87,592,545,泰昌里,NULL
46,1139,8,1147,1408,0,0,81.46,512,627,廣昌里,NULL
73,1135,12,1147,1636,0,0,70.11,499,636,城南里,NULL
0,1138,9,1147,1578,0,0,72.69,458,680,宮後村,NULL
1148,1134,12,1146,1364,0,0,84.02,888,246,中興里,NULL
1081,1140,6,1146,1453,0,0,78.87,751,389,和安里,NULL
555,1133,13,1146,1449,0,0,79.09,729,404,振興里,NULL
2079,1131,15,1146,1483,0,0,77.28,719,412,麗園村,NULL
2221,1134,12,1146,1550,0,0,73.94,711,423,金美村,NULL
102,1136,10,1146,1410,0,0,81.28,691,445,光輝里,NULL
1105,1138,8,1146,1413,0,0,81.1,662,476,南港里,NULL
399,1136,10,1146,1522,0,0,75.3,658,478,後龍里,NULL
309,1133,13,1146,1436,0,0,79.81,628,505,大同里,NULL
0,1133,13,1146,1436,0,0,79.81,628,505,大同里,NULL
544,1136,10,1146,1459,0,0,78.55,601,535,富貴里,NULL
250,1140,6,1146,1508,0,0,75.99,578,562,新興里,NULL
403,1139,7,1146,1412,0,0,81.16,513,626,寶興里,NULL
286,1142,4,1146,1430,0,0,80.14,424,718,新興里,NULL
0,1138,8,1146,1405,0,0,81.57,284,854,華崗里,NULL
305,1126,19,1145,1371,0,0,83.52,867,259,大信里,NULL
188,1131,14,1145,1508,0,0,75.93,749,382,東光里,NULL
258,1138,7,1145,1449,0,0,79.02,740,398,新興里,NULL
46,1139,6,1145,1610,0,0,71.12,720,419,慈安里,NULL
154,1135,10,1145,1516,0,0,75.53,713,422,草湳里,NULL
328,1134,11,1145,1535,0,0,74.59,705,429,吉峰村,NULL
781,1134,11,1145,1462,0,0,78.32,690,444,江寧里,NULL
601,1131,14,1145,1508,0,0,75.93,685,446,北陽里,NULL
634,1134,11,1145,1528,0,0,74.93,640,494,正大里,NULL
29,1136,9,1145,1559,0,0,73.44,477,659,梅花里,NULL
5,1136,9,1145,1572,0,0,72.84,473,663,八斗里,NULL
0,1136,9,1145,1572,0,0,72.84,473,663,八斗里,NULL
0,1123,21,1144,1694,0,0,67.53,809,314,石門村,NULL
700,1130,14,1144,1457,0,0,78.52,789,341,福林里,NULL
649,1130,14,1144,1444,0,0,79.22,765,365,興南里,NULL
146,1130,14,1144,1482,0,0,77.19,733,397,營盤里,NULL
1150,1142,2,1144,1414,0,0,80.91,723,419,龍雲里,NULL
1814,1135,9,1144,1527,0,0,74.92,723,412,安溪里,NULL
648,1134,10,1144,1440,0,0,79.44,671,463,大道里,NULL
35,1135,9,1144,1495,0,0,76.52,657,478,何厝里,NULL
326,1133,11,1144,1455,0,0,78.63,580,553,大強里,NULL
279,1138,6,1144,1572,0,0,72.77,551,587,梅北村,NULL
511,1135,9,1144,1462,0,0,78.25,404,731,六嘉村,NULL
0,1135,9,1144,1462,0,0,78.25,404,731,六嘉村,NULL
575,1137,6,1143,1414,0,0,80.83,1000,137,西村里,NULL
1159,1133,10,1143,1418,0,0,80.61,872,261,五峰里,NULL
333,1127,16,1143,1478,0,0,77.33,719,408,橋頭村,NULL
0,1136,7,1143,1535,0,0,74.46,707,429,龍川里,NULL
0,1130,13,1143,1567,0,0,72.94,667,463,大山里,NULL
1460,1132,11,1143,1520,0,0,75.2,618,514,中原里,NULL
452,1138,5,1143,1455,0,0,78.56,604,534,龍濱里,NULL
553,1133,10,1143,1487,0,0,76.87,582,551,西湳里,NULL
327,1129,14,1143,1566,0,0,72.99,502,627,大園里,NULL
0,1129,14,1143,1566,0,0,72.99,502,627,大園里,NULL
0,1127,16,1143,1942,0,0,58.86,491,636,牛厝村,NULL
63,1139,4,1143,1465,0,0,78.02,385,754,九明村,NULL
0,1139,4,1143,1465,0,0,78.02,385,754,九明村,NULL
1319,1135,7,1142,1391,0,0,82.1,882,253,明興里,NULL
0,1132,10,1142,2097,0,0,54.46,852,280,長濱村,NULL
4,1128,14,1142,1608,0,0,71.02,809,319,什股村,NULL
0,1128,14,1142,1608,0,0,71.02,809,319,什股村,NULL
918,1131,11,1142,1481,0,0,77.11,790,341,忠勤里,NULL
389,1136,6,1142,1454,0,0,78.54,762,374,中新里,NULL
1035,1138,4,1142,1421,0,0,80.37,742,396,中平里,NULL
334,1134,8,1142,1516,0,0,75.33,726,408,橋頭村,NULL
0,1127,15,1142,1692,0,0,67.49,665,462,新庄村,NULL
0,1139,3,1142,1823,0,0,62.64,626,513,興華村,NULL
183,1125,17,1142,1445,0,0,79.03,566,559,前峰里,NULL
340,1131,11,1142,1539,0,0,74.2,550,581,豊收村,NULL
1675,1129,13,1142,1433,0,0,79.69,517,612,圳生里,NULL
0,1129,13,1142,1433,0,0,79.69,517,612,圳生里,NULL
834,1131,11,1142,1413,0,0,80.82,412,719,瑞西里,NULL
1117,1133,8,1141,1471,0,0,77.57,808,325,古莊里,NULL
804,1128,13,1141,1486,0,0,76.78,770,358,永平里,NULL
0,1128,13,1141,1486,0,0,76.78,770,358,永平里,NULL
337,1127,14,1141,1398,0,0,81.62,768,359,賴福里,NULL
438,1132,9,1141,1424,0,0,80.13,766,366,東明里,NULL
97,1127,14,1141,1556,0,0,73.33,763,364,朝棟里,NULL
20,1134,7,1141,1390,0,0,82.09,714,420,三民里,NULL
276,1133,8,1141,1435,0,0,79.51,710,423,臨溪里,NULL
431,1129,12,1141,1475,0,0,77.36,639,490,錦通里,NULL
0,1129,12,1141,1475,0,0,77.36,639,490,錦通里,NULL
600,1132,9,1141,1501,0,0,76.02,585,547,大崙村,NULL
0,1132,9,1141,1501,0,0,76.02,585,547,大崙村,NULL
406,1133,8,1141,1422,0,0,80.24,543,590,寶中里,NULL
43,1132,9,1141,1395,0,0,81.79,542,590,宏毅里,NULL
108,1136,5,1141,1505,0,0,75.81,540,596,仁愛里,NULL
136,1129,12,1141,1488,0,0,76.68,536,593,南蓮村,NULL
478,1124,17,1141,1439,0,0,79.29,516,608,崇德里,NULL
853,1132,9,1141,1444,0,0,79.02,510,622,隆和里,NULL
0,1135,6,1141,1500,0,0,76.07,437,698,太康村,NULL
0,1134,6,1140,1574,0,0,72.43,928,206,大同村,NULL
215,1129,11,1140,1400,0,0,81.43,893,236,山下里,NULL
645,1129,11,1140,1396,0,0,81.66,885,244,忠孝里,NULL
1158,1127,13,1140,1390,0,0,82.01,879,248,張北里,NULL
12,1128,12,1140,1392,0,0,81.9,812,316,十興里,NULL
615,1135,5,1140,1455,0,0,78.35,811,324,仁和里,NULL
671,1135,5,1140,1384,0,0,82.37,772,363,萬年里,NULL
0,1139,1,1140,1647,0,0,69.22,740,399,國姓村,NULL
3,1128,12,1140,1432,0,0,79.61,738,390,西安里,NULL
138,1130,10,1140,1452,0,0,78.51,690,440,忠政里,NULL
793,1127,13,1140,1535,0,0,74.27,680,447,三民里,NULL
0,1127,13,1140,1535,0,0,74.27,680,447,三民里,NULL
789,1130,10,1140,1484,0,0,76.82,663,467,上楓村,NULL
46,1129,11,1140,1367,0,0,83.39,642,487,吉慶里,NULL
1093,1128,12,1140,1468,0,0,77.66,633,495,萬安里,NULL
792,1129,11,1140,1452,0,0,78.51,616,513,中原里,NULL
630,1128,12,1140,1414,0,0,80.62,599,529,永光里,NULL
103,1133,7,1140,1398,0,0,81.55,585,548,南屯里,NULL
162,1127,13,1140,1565,0,0,72.84,580,547,民生里,NULL
466,1133,7,1140,1445,0,0,78.89,501,632,安康里,NULL
267,1127,13,1140,1534,0,0,74.32,395,732,中林里,NULL
0,1127,13,1140,1534,0,0,74.32,395,732,中林里,NULL
1146,1132,7,1139,1361,0,0,83.69,861,271,中興里,NULL
881,1128,11,1139,1460,0,0,78.01,826,302,凌雲村,NULL
386,1124,15,1139,1455,0,0,78.28,712,412,內新里,NULL
219,1132,7,1139,1470,0,0,77.48,695,437,南瑶里,NULL
1377,1129,10,1139,1428,0,0,79.76,677,452,學府里,NULL
637,1135,4,1139,1429,0,0,79.71,672,463,松光里,NULL
529,1128,11,1139,1442,0,0,78.99,654,474,中東里,NULL
238,1127,12,1139,1388,0,0,82.06,653,474,福德里,NULL
975,1129,10,1139,1430,0,0,79.65,651,478,信義里,NULL
1445,1127,12,1139,1447,0,0,78.71,632,495,光華里,NULL
1498,1129,10,1139,1456,0,0,78.23,628,501,鷺江里,NULL
0,1132,7,1139,1470,0,0,77.48,623,509,南大里,NULL
197,1133,6,1139,1435,0,0,79.37,595,538,埤墘里,NULL
339,1130,9,1139,1425,0,0,79.93,583,547,港新里,NULL
0,1130,9,1139,1425,0,0,79.93,583,547,港新里,NULL
320,1125,14,1139,1477,0,0,77.12,568,557,北里村,NULL
0,1125,14,1139,1477,0,0,77.12,568,557,北里村,NULL
327,1129,10,1139,1406,0,0,81.01,566,563,達仁里,NULL
0,1129,10,1139,1406,0,0,81.01,566,563,達仁里,NULL
385,1127,12,1139,1472,0,0,77.38,336,791,興農里,NULL
0,1127,12,1139,1472,0,0,77.38,336,791,興農里,NULL
124,1131,7,1138,1537,0,0,74.04,935,196,南昌村,NULL
16,1121,17,1138,1475,0,0,77.15,865,256,高苗里,NULL
153,1126,12,1138,1502,0,0,75.77,812,314,同心里,NULL
1160,1132,6,1138,1427,0,0,79.75,803,329,義安里,NULL
238,1130,8,1138,1496,0,0,76.07,741,389,平田里,NULL
1138,1127,11,1138,1444,0,0,78.81,727,400,錦華里,NULL
127,1127,11,1138,1525,0,0,74.62,720,407,文山里,NULL
426,1129,9,1138,1449,0,0,78.54,634,495,寶安里,NULL
397,1131,7,1138,1471,0,0,77.36,606,525,泉南里,NULL
0,1124,14,1138,1478,0,0,77,568,556,粗溪村,NULL
467,1130,8,1138,1494,0,0,76.17,556,574,南和村,NULL
4,1129,9,1138,1445,0,0,78.75,545,584,清豐里,NULL
164,1132,6,1138,1459,0,0,78,524,608,竹田村,NULL
0,1132,6,1138,1459,0,0,78,524,608,竹田村,NULL
133,1123,15,1138,1433,0,0,79.41,508,615,成功里,NULL
98,1131,7,1138,1525,0,0,74.62,507,624,崙上村,NULL
0,1131,7,1138,1525,0,0,74.62,507,624,崙上村,NULL
845,1124,14,1138,1442,0,0,78.92,472,652,瑞華里,NULL
503,1128,10,1138,1481,0,0,76.84,402,726,林邊村,NULL
0,1128,10,1138,1481,0,0,76.84,402,726,林邊村,NULL
1289,1130,7,1137,1430,0,0,79.51,914,216,興業里,NULL
1986,1131,6,1137,1414,0,0,80.41,800,331,六福村,NULL
203,1126,11,1137,1513,0,0,75.15,729,397,迴龍村,NULL
433,1126,11,1137,1430,0,0,79.51,724,402,東新里,NULL
604,1124,13,1137,1382,0,0,82.27,695,429,林榮里,NULL
400,1130,7,1137,1433,0,0,79.34,647,483,龍山里,NULL
367,1133,4,1137,1371,0,0,82.93,643,490,光田里,NULL
796,1126,11,1137,1338,0,0,84.98,635,491,民權里,NULL
0,1134,3,1137,1486,0,0,76.51,615,519,永安村,NULL
968,1135,2,1137,1416,0,0,80.3,599,536,和平里,NULL
495,1129,8,1137,1537,0,0,73.98,572,557,將軍里,NULL
0,1129,8,1137,1537,0,0,73.98,572,557,將軍里,NULL
392,1132,5,1137,1388,0,0,81.92,550,582,週美里,NULL
219,1117,19,1136,1439,0,0,78.94,892,225,湖南村,NULL
0,1117,19,1136,1439,0,0,78.94,892,225,湖南村,NULL
666,1126,10,1136,1435,0,0,79.16,772,354,三張里,NULL
1273,1128,8,1136,1425,0,0,79.72,756,372,興豐里,NULL
962,1129,7,1136,1474,0,0,77.07,739,390,文祥里,NULL
499,1130,6,1136,1407,0,0,80.74,724,406,東光里,NULL
713,1118,18,1136,1502,0,0,75.63,712,406,中山里,NULL
511,1128,8,1136,1426,0,0,79.66,708,420,光明里,NULL
262,1130,6,1136,1514,0,0,75.03,684,446,廣福里,NULL
619,1129,7,1136,1454,0,0,78.13,652,477,福地里,NULL
206,1130,6,1136,1553,0,0,73.15,639,491,三星里,NULL
282,1122,14,1136,1473,0,0,77.12,619,503,瑞井村,NULL
1004,1124,12,1136,1510,0,0,75.23,606,518,糖廍里,NULL
96,1129,7,1136,1503,0,0,75.58,605,524,聯翠里,NULL
1502,1121,15,1136,1504,0,0,75.53,602,519,恆德里,NULL
376,1123,13,1136,1598,0,0,71.09,594,529,新寶村,NULL
0,1123,13,1136,1598,0,0,71.09,594,529,新寶村,NULL
727,1124,12,1136,1501,0,0,75.68,563,561,舊社村,NULL
0,1124,12,1136,1501,0,0,75.68,563,561,舊社村,NULL
827,1122,14,1136,1462,0,0,77.7,541,581,永樂里,NULL
544,1126,10,1136,1364,0,0,83.28,538,588,大華村,NULL
0,1131,5,1136,1538,0,0,73.86,499,632,福德村,NULL
1339,1121,14,1135,1422,0,0,79.82,735,386,員林里,NULL
1860,1122,13,1135,1423,0,0,79.76,726,396,竹圍里,NULL
797,1129,6,1135,1438,0,0,78.93,705,424,中央里,NULL
147,1128,7,1135,1441,0,0,78.76,700,428,文心里,NULL
560,1126,9,1135,1462,0,0,77.63,655,471,華堂里,NULL
90,1127,8,1135,1437,0,0,78.98,654,473,純翠里,NULL
345,1121,14,1135,1403,0,0,80.9,652,469,自強里,NULL
312,1121,14,1135,1492,0,0,76.07,640,481,崑崙里,NULL
934,1126,9,1135,1535,0,0,73.94,638,488,清華村,NULL
413,1123,12,1135,1425,0,0,79.65,632,491,中南里,NULL
19,1122,13,1135,1716,0,0,66.14,615,507,橋頭村,NULL
988,1122,13,1135,1565,0,0,72.52,607,515,草漯村,NULL
733,1120,15,1135,1497,0,0,75.82,550,570,湳底村,NULL
0,1120,15,1135,1497,0,0,75.82,550,570,湳底村,NULL
177,1123,12,1135,1567,0,0,72.43,465,658,嘉芳里,NULL
0,1123,12,1135,1567,0,0,72.43,465,658,嘉芳里,NULL
1276,1130,4,1134,1477,0,0,76.78,892,238,香坡里,NULL
928,1129,5,1134,1455,0,0,77.94,785,344,龍光里,NULL
633,1123,11,1134,1472,0,0,77.04,761,362,松友里,NULL
65,1121,13,1134,1439,0,0,78.8,691,430,新民里,NULL
605,1126,8,1134,1431,0,0,79.25,666,460,雅祥里,NULL
1875,1123,11,1134,1503,0,0,75.45,649,474,水碓里,NULL
518,1119,15,1134,1432,0,0,79.19,644,475,溪美里,NULL
1089,1120,14,1134,1429,0,0,79.36,633,487,富民里,NULL
0,1115,19,1134,1664,0,0,68.15,619,496,仙草里,NULL
44,1130,4,1134,1398,0,0,81.12,595,535,吉慶里,NULL
0,1125,9,1134,1812,0,0,62.58,467,658,集來村,NULL
0,1128,6,1134,1444,0,0,78.53,403,725,筆秀村,NULL
114,1125,8,1133,1485,0,0,76.3,734,391,德興里,NULL
0,1125,8,1133,1485,0,0,76.3,734,391,德興里,NULL
240,1117,16,1133,1450,0,0,78.14,729,388,平昌里,NULL
565,1119,14,1133,1439,0,0,78.74,718,401,復源里,NULL
204,1128,5,1133,1470,0,0,77.07,710,418,長興里,NULL
429,1119,14,1133,1430,0,0,79.23,702,417,舊莊里,NULL
199,1121,12,1133,1425,0,0,79.51,639,482,中正里,NULL
0,1121,12,1133,1425,0,0,79.51,639,482,中正里,NULL
243,1115,18,1133,1469,0,0,77.13,638,477,平安里,NULL
133,1124,9,1133,1404,0,0,80.7,604,520,福林里,NULL
61,1126,7,1133,1463,0,0,77.44,602,524,奇岩里,NULL
158,1124,9,1133,1401,0,0,80.87,583,541,百齡里,NULL
577,1123,10,1133,1438,0,0,78.79,578,545,林華里,NULL
292,1126,7,1133,1557,0,0,72.77,567,559,開南里,NULL
161,1128,5,1133,1402,0,0,80.81,550,578,賢北里,NULL
515,1126,7,1133,1535,0,0,73.81,466,660,佳冬村,NULL
0,1126,7,1133,1535,0,0,73.81,466,660,佳冬村,NULL
242,1124,9,1133,1512,0,0,74.93,442,682,壽山里,NULL
0,1124,9,1133,1512,0,0,74.93,442,682,壽山里,NULL
364,1123,10,1133,1614,0,0,70.2,306,817,甘西村,NULL
0,1123,10,1133,1614,0,0,70.2,306,817,甘西村,NULL
38,1114,18,1132,1435,0,0,78.89,887,227,嘉新里,NULL
822,1126,6,1132,1442,0,0,78.5,837,289,光明里,NULL
230,1111,21,1132,1656,0,0,68.36,824,287,中城里,NULL
824,1119,13,1132,1406,0,0,80.51,795,324,福和里,NULL
686,1124,8,1132,1449,0,0,78.12,708,416,南勢里,NULL
1501,1121,11,1132,1485,0,0,76.23,629,492,恆德里,NULL
119,1126,6,1132,1509,0,0,75.02,621,505,和興村,NULL
8,1125,7,1132,1464,0,0,77.32,600,525,清豐里,NULL
230,1126,6,1132,1420,0,0,79.72,584,542,興宗里,NULL
0,1126,6,1132,1420,0,0,79.72,584,542,興宗里,NULL
89,1119,13,1132,1439,0,0,78.67,559,560,純翠里,NULL
748,1119,13,1132,1484,0,0,76.28,558,561,員富里,NULL
695,1127,5,1132,1415,0,0,80,540,587,三苓里,NULL
663,1125,7,1132,1435,0,0,78.89,482,643,塩行里,NULL
17,1120,11,1131,1422,0,0,79.54,815,305,山腳里,NULL
1188,1121,10,1131,1398,0,0,80.9,767,354,龍淵里,NULL
298,1123,8,1131,1443,0,0,78.38,731,392,榮泉村,NULL
921,1115,16,1131,1401,0,0,80.73,672,443,忠勤里,NULL
221,1124,7,1131,1495,0,0,75.65,671,453,頂埔里,NULL
1764,1122,9,1131,1479,0,0,76.47,668,454,永昌里,NULL
87,1120,11,1131,1571,0,0,71.99,651,469,荖藤里,NULL
418,1122,9,1131,1491,0,0,75.86,638,484,八德里,NULL
164,1123,8,1131,1385,0,0,81.66,623,500,振興里,NULL
830,1122,9,1131,1435,0,0,78.82,599,523,星明里,NULL
352,1118,13,1131,1392,0,0,81.25,598,520,福祉里,NULL
114,1118,13,1131,1566,0,0,72.22,569,549,海埔里,NULL
0,1118,13,1131,1579,0,0,71.63,564,554,北汕村,NULL
508,1117,14,1131,1450,0,0,78,508,609,三民里,NULL
0,1115,16,1131,1591,0,0,71.09,493,622,過嶺村,NULL
138,1121,10,1131,1520,0,0,74.41,486,635,清蓮村,NULL
402,1120,11,1131,1480,0,0,76.42,474,646,和平村,NULL
0,1120,11,1131,1480,0,0,76.42,474,646,和平村,NULL
69,1123,8,1131,1574,0,0,71.86,468,655,永和里,NULL
180,1122,9,1131,1468,0,0,77.04,438,684,保安里,NULL
1181,1123,7,1130,1377,0,0,82.06,878,245,群英里,NULL
1272,1121,9,1130,1374,0,0,82.24,846,275,萬盛里,NULL
961,1121,9,1130,1398,0,0,80.83,770,351,文祥里,NULL
519,1120,10,1130,1470,0,0,76.87,769,351,南和里,NULL
1328,1122,8,1130,1388,0,0,81.41,739,383,順興里,NULL
105,1125,5,1130,1387,0,0,81.47,703,422,中信里,NULL
234,1120,10,1130,1446,0,0,78.15,701,419,蘭雅里,NULL
65,1116,14,1130,1492,0,0,75.74,686,430,大福里,NULL
478,1117,13,1130,1506,0,0,75.03,672,445,建興里,NULL
240,1121,9,1130,1402,0,0,80.6,659,462,景星里,NULL
181,1126,4,1130,1501,0,0,75.28,657,469,崎頂里,NULL
1663,1119,11,1130,1460,0,0,77.4,648,471,保安里,NULL
505,1126,4,1130,1453,0,0,77.77,645,481,新榮里,NULL
1433,1118,12,1130,1430,0,0,79.02,615,503,平和里,NULL
523,1123,7,1130,1425,0,0,79.3,580,543,仁和村,NULL
982,1118,12,1130,1460,0,0,77.4,554,564,仁義里,NULL
0,1121,9,1130,1476,0,0,76.56,498,623,竹文里,NULL
288,1124,6,1130,1448,0,0,78.04,479,645,公館里,NULL
0,1124,6,1130,1448,0,0,78.04,479,645,公館里,NULL
201,1116,14,1130,1361,0,0,83.03,445,671,民強里,NULL
657,1123,6,1129,1406,0,0,80.3,836,287,內南里,NULL
0,1110,19,1129,1695,0,0,66.61,829,281,啟模里,NULL
366,1120,9,1129,1348,0,0,83.75,759,361,瑞光里,NULL
20,1119,10,1129,1411,0,0,80.01,745,374,中德里,NULL
1077,1121,8,1129,1451,0,0,77.81,721,400,仁慈里,NULL
33,1119,10,1129,1462,0,0,77.22,706,413,永欣里,NULL
445,1115,14,1129,1477,0,0,76.44,701,414,太平里,NULL
0,1115,14,1129,1477,0,0,76.44,701,414,太平里,NULL
41,1120,9,1129,1386,0,0,81.46,691,429,新生里,NULL
1090,1121,8,1129,1452,0,0,77.75,667,454,富民里,NULL
324,1123,6,1129,1399,0,0,80.7,667,456,崇文里,NULL
1561,1115,14,1129,1472,0,0,76.7,650,465,文化里,NULL
398,1123,6,1129,1390,0,0,81.22,645,478,吉龍里,NULL
831,1119,10,1129,1436,0,0,78.62,621,498,星明里,NULL
821,1113,16,1129,1396,0,0,80.87,602,511,瑞祥里,NULL
349,1116,13,1129,1460,0,0,77.33,602,514,賴村里,NULL
580,1124,5,1129,1432,0,0,78.84,541,583,後庄村,NULL
681,1126,3,1129,1490,0,0,75.77,535,591,港明里,NULL
151,1120,9,1129,1531,0,0,73.74,495,625,義竹村,NULL
0,1120,9,1129,1531,0,0,73.74,495,625,義竹村,NULL
1067,1119,9,1128,1438,0,0,78.44,731,388,新安里,NULL
325,1120,8,1128,1451,0,0,77.74,720,400,溪福里,NULL
852,1117,11,1128,1550,0,0,72.77,703,414,高山里,NULL
235,1120,8,1128,1415,0,0,79.72,702,418,蘭雅里,NULL
72,1117,11,1128,1392,0,0,81.03,700,417,文明里,NULL
0,1117,11,1128,1392,0,0,81.03,700,417,文明里,NULL
154,1118,10,1128,1427,0,0,79.05,683,435,同心里,NULL
264,1119,9,1128,1441,0,0,78.28,672,447,文化里,NULL
0,1119,9,1128,1441,0,0,78.28,672,447,文化里,NULL
399,1113,15,1128,1430,0,0,78.88,666,447,大安里,NULL
0,1113,15,1128,1430,0,0,78.88,666,447,大安里,NULL
13,1113,15,1128,1477,0,0,76.37,661,452,平寮里,NULL
0,1113,15,1128,1477,0,0,76.37,661,452,平寮里,NULL
405,1116,12,1128,1370,0,0,82.34,639,477,光輝里,NULL
0,1116,12,1128,1370,0,0,82.34,639,477,光輝里,NULL
128,1121,7,1128,1446,0,0,78.01,618,503,松翠里,NULL
131,1112,16,1128,1428,0,0,78.99,618,494,柏翠里,NULL
397,1121,7,1128,1460,0,0,77.26,617,504,田心村,NULL
114,1109,19,1128,1471,0,0,76.68,590,519,中和里,NULL
450,1118,10,1128,1357,0,0,83.12,584,534,東興里,NULL
844,1122,6,1128,1432,0,0,78.77,570,552,瑞華里,NULL
763,1102,26,1128,1451,0,0,77.74,549,553,新生里,NULL
490,1118,10,1128,1407,0,0,80.17,546,572,永德里,NULL
268,1121,7,1128,1517,0,0,74.36,461,660,清溝村,NULL
78,1119,9,1128,1498,0,0,75.3,437,682,大鄉里,NULL
432,1124,4,1128,1520,0,0,74.21,398,726,北勢村,NULL
0,1124,4,1128,1520,0,0,74.21,398,726,北勢村,NULL
656,1113,14,1127,1415,0,0,79.65,821,292,內南里,NULL
1135,1122,5,1127,1371,0,0,82.2,811,311,錦泰里,NULL
1412,1115,12,1127,1519,0,0,74.19,744,371,永富里,NULL
237,1116,11,1127,1435,0,0,78.54,725,391,平田里,NULL
463,1113,14,1127,1380,0,0,81.67,681,432,成福里,NULL
568,1122,5,1127,1589,0,0,70.93,680,442,大新里,NULL
0,1122,5,1127,1589,0,0,70.93,680,442,大新里,NULL
418,1118,9,1127,1426,0,0,79.03,643,475,重陽里,NULL
158,1118,9,1127,1563,0,0,72.1,587,531,福興村,NULL
1973,1115,12,1127,1442,0,0,78.16,558,557,成州村,NULL
1286,1119,7,1126,1394,0,0,80.77,908,211,吉祥里,NULL
692,1117,9,1126,1401,0,0,80.37,782,335,黎平里,NULL
1572,1114,12,1126,1429,0,0,78.8,766,348,橋東里,NULL
526,1114,12,1126,1520,0,0,74.08,752,362,興隆里,NULL
444,1119,7,1126,1437,0,0,78.36,739,380,虎溪里,NULL
1202,1122,4,1126,1419,0,0,79.35,728,394,黎元里,NULL
179,1114,12,1126,1396,0,0,80.66,710,404,福壽里,NULL
301,1124,2,1126,1395,0,0,80.72,705,419,港富里,NULL
421,1112,14,1126,1532,0,0,73.5,660,452,埔南村,NULL
0,1112,14,1126,1532,0,0,73.5,660,452,埔南村,NULL
640,1121,5,1126,1441,0,0,78.14,650,471,南平里,NULL
723,1121,5,1126,1495,0,0,75.32,640,481,仁雅村,NULL
436,1112,14,1126,1538,0,0,73.21,631,481,立仁里,NULL
1375,1115,11,1126,1464,0,0,76.91,625,490,樂利里,NULL
1469,1118,8,1126,1377,0,0,81.77,580,538,正義里,NULL
163,1115,11,1126,1551,0,0,72.6,439,676,新店村,NULL
0,1115,11,1126,1551,0,0,72.6,439,676,新店村,NULL
104,1118,7,1125,1412,0,0,79.67,1083,35,明建里,NULL
0,1118,7,1125,1412,0,0,79.67,1083,35,明建里,NULL
0,1116,9,1125,1396,0,0,80.59,908,208,西湖村,NULL
788,1104,21,1125,1426,0,0,78.89,876,228,秀明里,NULL
224,1108,17,1125,1441,0,0,78.07,750,358,松安里,NULL
516,1117,8,1125,1469,0,0,76.58,736,381,和平里,NULL
115,1114,11,1125,1474,0,0,76.32,703,411,大仁里、大山里,NULL
0,1114,11,1125,1474,0,0,76.32,703,411,大仁里、大山里,NULL
1100,1118,7,1125,1460,0,0,77.05,669,449,昌隆里,NULL
2017,1119,6,1125,1399,0,0,80.41,667,452,福興村,NULL
38,1117,8,1125,1506,0,0,74.7,665,452,東村里,NULL
1747,1117,8,1125,1439,0,0,78.18,634,483,南鶯里,NULL
434,1108,17,1125,1500,0,0,75,620,488,大墩里,NULL
85,1119,6,1125,1519,0,0,74.06,601,518,新二村,NULL
170,1118,7,1125,1424,0,0,79,570,548,明勝里,NULL
14,1108,17,1125,1564,0,0,71.93,553,555,五常里,NULL
718,1116,9,1125,1517,0,0,74.16,541,575,高松里,NULL
188,1116,9,1125,1488,0,0,75.6,501,615,社新里,NULL
0,1116,8,1124,1399,0,0,80.34,862,254,連和里,NULL
2070,1117,7,1124,1433,0,0,78.44,797,320,仁愛村,NULL
2220,1116,8,1124,1508,0,0,74.54,784,332,美田村,NULL
393,1107,17,1124,1624,0,0,69.21,762,345,中西里,NULL
0,1107,17,1124,1624,0,0,69.21,762,345,中西里,NULL
1147,1115,9,1124,1470,0,0,76.46,749,366,龍陣里,NULL
456,1116,8,1124,1468,0,0,76.57,731,385,長億里,NULL
655,1119,5,1124,1426,0,0,78.82,727,392,景新里,NULL
901,1115,9,1124,1407,0,0,79.89,716,399,保平里,NULL
753,1114,10,1124,1370,0,0,82.04,709,405,新榮里,NULL
319,1117,7,1124,1418,0,0,79.27,701,416,崇德里,NULL
275,1114,10,1124,1469,0,0,76.51,697,417,茄苳里,NULL
1094,1116,8,1124,1469,0,0,76.51,676,440,義村里,NULL
793,1114,10,1124,1426,0,0,78.82,622,492,中原里,NULL
411,1106,18,1124,1430,0,0,78.6,587,519,埔心村,NULL
364,1110,14,1124,1353,0,0,83.07,584,526,重明里,NULL
384,1109,15,1124,1638,0,0,68.62,581,528,漢寶村,NULL
107,1112,12,1124,1403,0,0,80.11,580,532,豐樂里,NULL
832,1115,9,1124,1467,0,0,76.62,538,577,星明里,NULL
849,1109,15,1124,1469,0,0,76.51,535,574,新田村,NULL
0,1109,15,1124,1469,0,0,76.51,535,574,新田村,NULL
48,1113,11,1124,1478,0,0,76.05,498,615,淵西里,NULL
120,1111,13,1124,1451,0,0,77.46,486,625,東寧村,NULL
734,1107,17,1124,1455,0,0,77.25,429,678,桂林里,NULL
301,1116,8,1124,1499,0,0,74.98,362,754,省躬里,NULL
62,1114,9,1123,1503,0,0,74.72,817,297,孝忠里,NULL
126,1115,8,1123,1443,0,0,77.82,800,315,德和里,NULL
1190,1119,4,1123,1392,0,0,80.68,751,368,龍淵里,NULL
64,1111,12,1123,1459,0,0,76.97,737,374,大福里,NULL
406,1116,7,1123,1445,0,0,77.72,716,400,鎮東里,NULL
201,1114,9,1123,1480,0,0,75.88,665,449,和平里,NULL
444,1113,10,1123,1480,0,0,75.88,651,462,新仁里,NULL
67,1104,19,1123,1508,0,0,74.47,625,479,西安村,NULL
0,1104,19,1123,1508,0,0,74.47,625,479,西安村,NULL
435,1115,8,1123,1434,0,0,78.31,553,562,田心里,NULL
810,1111,12,1123,1389,0,0,80.85,531,580,潭秀村,NULL
0,1111,12,1123,1389,0,0,80.85,531,580,潭秀村,NULL
151,1112,11,1123,1402,0,0,80.1,501,611,裕民里,NULL
0,1112,11,1123,1402,0,0,80.1,501,611,裕民里,NULL
438,1111,12,1123,1498,0,0,74.97,454,657,小新里,NULL
215,1115,7,1122,1393,0,0,80.55,841,274,湖口村,NULL
785,1117,5,1122,1373,0,0,81.72,809,308,瑞興里,NULL
525,1112,10,1122,1410,0,0,79.57,785,327,成功里,NULL
621,1111,11,1122,1417,0,0,79.18,725,386,四維里,NULL
31,1107,15,1122,1443,0,0,77.75,725,382,逢福里,NULL
1066,1111,11,1122,1474,0,0,76.12,695,416,新安里,NULL
1055,1110,12,1122,1417,0,0,79.18,672,438,國泰里,NULL
0,1110,12,1122,1417,0,0,79.18,672,438,國泰里,NULL
477,1114,8,1122,1564,0,0,71.74,659,455,番婆里,NULL
0,1114,8,1122,1564,0,0,71.74,659,455,番婆里,NULL
251,1103,19,1122,1426,0,0,78.68,651,452,北龍里,NULL
0,1103,19,1122,1426,0,0,78.68,651,452,北龍里,NULL
237,1112,10,1122,1535,0,0,73.09,643,469,忠和村,NULL
800,1112,10,1122,1425,0,0,78.74,640,472,六寶村,NULL
582,1116,6,1122,1451,0,0,77.33,626,490,田心里,NULL
261,1105,17,1122,1502,0,0,74.7,617,488,文南里,NULL
727,1113,9,1122,1509,0,0,74.35,570,543,舊社村,NULL
0,1113,9,1122,1509,0,0,74.35,570,543,舊社村,NULL
445,1111,11,1122,1434,0,0,78.24,569,542,長福里,NULL
0,1111,11,1122,1434,0,0,78.24,569,542,長福里,NULL
289,1115,7,1122,1461,0,0,76.8,560,555,新生里,NULL
468,1106,16,1122,1432,0,0,78.35,558,548,中興里,NULL
86,1112,10,1122,1622,0,0,69.17,550,562,新二村,NULL
355,1115,7,1122,1509,0,0,74.35,545,570,安西里,NULL
1,1112,10,1122,1400,0,0,80.14,539,573,西安里,NULL
981,1107,15,1122,1502,0,0,74.7,520,587,仁義里,NULL
0,1112,10,1122,1620,0,0,69.26,404,708,三和村,NULL
62,1103,18,1121,1518,0,0,73.85,833,270,國強里,NULL
0,1103,18,1121,1518,0,0,73.85,833,270,國強里,NULL
696,1110,11,1121,1389,0,0,80.71,788,322,黎忠里,NULL
250,1113,8,1121,1396,0,0,80.3,767,346,平福里,NULL
669,1109,12,1121,1431,0,0,78.34,764,345,三犁里,NULL
870,1113,8,1121,1434,0,0,78.17,757,356,永興村,NULL
164,1110,11,1121,1362,0,0,82.31,728,382,菜公里,NULL
905,1117,4,1121,1393,0,0,80.47,700,417,螢圃里,NULL
688,1106,15,1121,1531,0,0,73.22,645,461,中東里,NULL
0,1106,15,1121,1531,0,0,73.22,645,461,中東里,NULL
641,1112,9,1121,1461,0,0,76.73,637,475,南興里,NULL
225,1109,12,1121,1401,0,0,80.01,621,488,彰安里,NULL
121,1109,12,1121,1463,0,0,76.62,609,500,港坪里,NULL
543,1102,19,1121,1607,0,0,69.76,594,508,芙朝村,NULL
0,1102,19,1121,1607,0,0,69.76,594,508,芙朝村,NULL
419,1112,9,1121,1612,0,0,69.54,566,546,社口村,NULL
681,1115,6,1121,1441,0,0,77.79,397,718,港嘴村,NULL
0,1115,6,1121,1441,0,0,77.79,397,718,港嘴村,NULL
286,1112,8,1120,1349,0,0,83.02,866,246,西康里,NULL
514,1114,6,1120,1488,0,0,75.27,809,305,福順里,NULL
667,1110,10,1120,1421,0,0,78.82,788,322,中興里,NULL
802,1113,7,1120,1406,0,0,79.66,758,355,良和里,NULL
256,1109,11,1120,1450,0,0,77.24,734,375,平和里,NULL
1731,1111,9,1120,1429,0,0,78.38,728,383,柑園里,NULL
517,1106,14,1120,1417,0,0,79.04,707,399,新明里,NULL
15,1115,5,1120,1392,0,0,80.46,701,414,復中里,NULL
36,1110,10,1120,1469,0,0,76.24,691,419,翠屏里,NULL
713,1107,13,1120,1359,0,0,82.41,681,426,民安里,NULL
442,1115,5,1120,1411,0,0,79.38,640,475,玉成里,NULL
1329,1107,13,1120,2195,0,0,51.03,623,484,埤塘里,NULL
0,1114,6,1120,1563,0,0,71.66,619,495,上舘里,NULL
1427,1104,16,1120,1461,0,0,76.66,618,486,延壽里,NULL
316,1109,11,1120,1442,0,0,77.67,595,514,崇學里,NULL
94,1115,5,1120,1547,0,0,72.4,512,603,後潭里,NULL
0,1115,5,1120,1547,0,0,72.4,512,603,後潭里,NULL
575,1111,9,1120,1414,0,0,79.21,470,641,林興里,NULL
0,1111,9,1120,1414,0,0,79.21,470,641,林興里,NULL
187,1107,13,1120,1496,0,0,74.87,447,660,成德村,NULL
0,1107,13,1120,1496,0,0,74.87,447,660,成德村,NULL
574,1110,9,1119,2240,0,0,49.96,915,195,西村里,NULL
775,1109,10,1119,1372,0,0,81.56,790,319,秀山里,NULL
833,1108,11,1119,1424,0,0,78.58,784,324,大平里,NULL
140,1107,12,1119,1406,0,0,79.59,748,359,明德里,NULL
26,1110,9,1119,1494,0,0,74.9,743,367,逢甲里,NULL
263,1105,14,1119,1480,0,0,75.61,721,384,平山里,NULL
472,1107,12,1119,1495,0,0,74.85,714,393,仁愛里,NULL
450,1111,8,1119,1485,0,0,75.35,676,435,瑞城里,NULL
407,1112,7,1119,1580,0,0,70.82,630,482,永興里,NULL
0,1112,7,1119,1580,0,0,70.82,630,482,永興里,NULL
93,1109,10,1119,1465,0,0,76.38,605,504,新潭村,NULL
89,1108,11,1119,1408,0,0,79.47,587,521,國興里,NULL
0,1108,11,1119,1408,0,0,79.47,587,521,國興里,NULL
757,1104,15,1119,1482,0,0,75.51,575,529,社南村,NULL
146,1112,7,1119,1387,0,0,80.68,542,570,南勢里,NULL
91,1112,7,1119,1498,0,0,74.7,528,584,新達里,NULL
398,1109,10,1119,1449,0,0,77.23,516,593,寶德里,NULL
214,1109,10,1119,1489,0,0,75.15,484,625,海頭里,NULL
0,1109,10,1119,1489,0,0,75.15,484,625,海頭里,NULL
481,1109,10,1119,1514,0,0,73.91,479,630,慶安村,NULL
651,1103,15,1118,1408,0,0,79.4,806,297,景南里,NULL
1207,1112,6,1118,1401,0,0,79.8,799,313,黎和里,NULL
1162,1111,7,1118,1403,0,0,79.69,779,332,五峰里,NULL
1226,1109,9,1118,1368,0,0,81.73,776,333,信義里,NULL
808,1109,9,1118,1440,0,0,77.64,726,383,埤頭里,NULL
449,1106,12,1118,1462,0,0,76.47,711,395,瑞城里,NULL
11,1109,9,1118,1643,0,0,68.05,701,408,中華里,NULL
0,1109,9,1118,1643,0,0,68.05,701,408,中華里,NULL
40,1106,12,1118,1459,0,0,76.63,696,410,和西里,NULL
38,1109,9,1118,1486,0,0,75.24,684,425,和北里,NULL
0,1109,9,1118,1486,0,0,75.24,684,425,和北里,NULL
313,1107,11,1118,1415,0,0,79.01,682,425,花壇村,NULL
723,1110,8,1118,1390,0,0,80.43,651,459,清穗里,NULL
1486,1103,15,1118,1449,0,0,77.16,617,486,樓厝里,NULL
235,1103,15,1118,1515,0,0,73.8,596,507,樂善村,NULL
382,1107,11,1118,1566,0,0,71.39,558,549,山鼻村,NULL
0,1107,11,1118,1566,0,0,71.39,558,549,山鼻村,NULL
172,1109,9,1118,1415,0,0,79.01,529,580,福順里,NULL
233,1113,5,1118,1456,0,0,76.79,500,613,武廟里、端正里、大同里,NULL
0,1113,5,1118,1456,0,0,76.79,500,613,武廟里、端正里、大同里,NULL
496,1107,11,1118,1601,0,0,69.83,477,630,船頭里,NULL
79,1109,8,1117,1368,0,0,81.65,904,205,上舘里,NULL
0,1110,7,1117,1749,0,0,63.87,850,260,里壠里,NULL
636,1109,8,1117,1439,0,0,77.62,847,262,華新里,NULL
24,1106,11,1117,1445,0,0,77.3,781,325,真砂里,NULL
0,1106,11,1117,1445,0,0,77.3,781,325,真砂里,NULL
692,1108,9,1117,1399,0,0,79.84,741,367,錦和里,NULL
1400,1106,11,1117,1401,0,0,79.73,734,372,清溪里,NULL
532,1109,8,1117,1402,0,0,79.67,731,378,工學里,NULL
302,1103,14,1117,1365,0,0,81.83,708,395,大昌里,NULL
57,1109,8,1117,1396,0,0,80.01,667,442,西湖里,NULL
0,1109,8,1117,1396,0,0,80.01,667,442,西湖里,NULL
267,1102,15,1117,1426,0,0,78.33,651,451,竹園里,NULL
1967,1111,6,1117,1409,0,0,79.28,639,472,集福村,NULL
13,1109,8,1117,1409,0,0,79.28,624,485,信光里,NULL
999,1110,7,1117,1383,0,0,80.77,589,521,華江里,NULL
790,1114,3,1117,1416,0,0,78.88,568,546,中吉里,NULL
87,1102,15,1117,1406,0,0,79.45,565,537,江翠里,NULL
331,1108,9,1117,1435,0,0,77.84,561,547,德高里,NULL
844,1107,10,1117,1449,0,0,77.09,559,548,雙連里,NULL
442,1108,9,1117,1501,0,0,74.42,548,560,灣愛里,NULL
672,1106,10,1116,1424,0,0,78.37,884,222,仁祥里,NULL
217,1105,11,1116,1405,0,0,79.43,875,230,合興里,NULL
1241,1107,9,1116,1405,0,0,79.43,855,252,景東里,NULL
1184,1107,9,1116,1402,0,0,79.6,831,276,百和里,NULL
231,1105,11,1116,1446,0,0,77.18,785,320,青埔村,NULL
0,1105,11,1116,1446,0,0,77.18,785,320,青埔村,NULL
1184,1105,11,1116,1447,0,0,77.13,778,327,虎嘯里,NULL
128,1104,12,1116,1465,0,0,76.18,773,331,中和里,NULL
152,1105,11,1116,1456,0,0,76.65,736,369,向心里,NULL
43,1103,13,1116,1414,0,0,78.93,715,388,何成里,NULL
261,1107,9,1116,1377,0,0,81.05,703,404,廣德里,NULL
701,1108,8,1116,1422,0,0,78.48,687,421,湧光里,NULL
413,1107,9,1116,1390,0,0,80.29,618,489,東興里,NULL
516,1108,8,1116,1593,0,0,70.06,560,548,東和村,NULL
239,1102,14,1116,1483,0,0,75.25,533,569,大坑村,NULL
0,1102,14,1116,1483,0,0,75.25,533,569,大坑村,NULL
408,1104,12,1116,1441,0,0,77.45,484,620,五權村,NULL
31,1103,12,1115,1554,0,0,71.75,786,317,中心里,NULL
659,1102,13,1115,1333,0,0,83.65,780,322,壽南里,NULL
725,1100,15,1115,1512,0,0,73.74,766,334,廣仁里,NULL
759,1100,15,1115,1353,0,0,82.41,731,369,安和里,NULL
180,1107,8,1115,1413,0,0,78.91,638,469,福壽里,NULL
766,1107,8,1115,1441,0,0,77.38,599,508,中庄里,NULL
0,1110,5,1115,1656,0,0,67.33,547,563,廣林里,NULL
1475,1102,13,1115,1439,0,0,77.48,537,565,永樂里,NULL
882,1107,8,1115,1472,0,0,75.75,520,587,二甲里,NULL
287,1106,9,1115,1515,0,0,73.6,507,599,五結村,NULL
0,1107,8,1115,1668,0,0,66.85,499,608,好收里,NULL
68,1103,12,1115,1451,0,0,76.84,440,663,幸福里,NULL
390,1110,5,1115,1358,0,0,82.11,386,724,劉厝里,NULL
0,1110,5,1115,1358,0,0,82.11,386,724,劉厝里,NULL
154,1103,11,1114,1578,0,0,70.6,806,297,壽豐村,NULL
0,1103,11,1114,1578,0,0,70.6,806,297,壽豐村,NULL
488,1099,15,1114,1414,0,0,78.78,711,388,新東里,NULL
42,1111,3,1114,1433,0,0,77.74,706,405,四張里,NULL
223,1100,14,1114,1364,0,0,81.67,687,413,長安里,NULL
1997,1104,10,1114,1403,0,0,79.4,618,486,水碓村,NULL
678,1103,11,1114,1401,0,0,79.51,613,490,港正里,NULL
0,1101,13,1114,1558,0,0,71.5,573,528,望明村,NULL
149,1110,4,1114,1472,0,0,75.68,569,541,湖內里,NULL
992,1101,13,1114,1563,0,0,71.27,556,545,富林村,NULL
0,1101,13,1114,1563,0,0,71.27,556,545,富林村,NULL
0,1108,6,1114,1727,0,0,64.5,494,614,大有村,NULL
0,1107,7,1114,1442,0,0,77.25,445,662,南花村,NULL
660,1101,12,1113,1379,0,0,80.71,812,289,自強里,NULL
589,1111,2,1113,1430,0,0,77.83,773,338,敦厚里,NULL
1347,1104,9,1113,1419,0,0,78.44,741,363,樟腳里,NULL
310,1109,4,1113,1412,0,0,78.82,710,399,大慶里,NULL
0,1109,4,1113,1412,0,0,78.82,710,399,大慶里,NULL
38,1099,14,1113,1577,0,0,70.58,708,391,永樂里,NULL
0,1099,14,1113,1577,0,0,70.58,708,391,永樂里,NULL
80,1103,10,1113,1399,0,0,79.56,676,427,中正里,NULL
1518,1101,12,1113,1404,0,0,79.27,606,495,樹德里,NULL
643,1102,11,1113,1443,0,0,77.13,595,507,正道里,NULL
585,1107,6,1113,1368,0,0,81.36,591,516,中正里,NULL
259,1107,6,1113,1535,0,0,72.51,588,519,後街村,NULL
0,1107,6,1113,1535,0,0,72.51,588,519,後街村,NULL
200,1103,10,1113,1416,0,0,78.6,539,564,和平里,NULL
88,1106,7,1113,1505,0,0,73.95,504,602,洛陽村,NULL
0,1106,7,1113,1505,0,0,73.95,504,602,洛陽村,NULL
347,1106,7,1113,1480,0,0,75.2,419,687,鹿場里,NULL
0,1106,7,1113,1480,0,0,75.2,419,687,鹿場里,NULL
241,1104,8,1112,1346,0,0,82.62,1025,79,新生里,NULL
332,1106,6,1112,1379,0,0,80.64,852,254,大漢里,NULL
0,1098,14,1112,2562,3176,80.67,43.4,812,286,七美鄉,Qimei Township
10,1106,6,1112,1349,0,0,82.43,779,327,文華里,NULL
150,1106,6,1112,1420,0,0,78.31,770,336,三民里,NULL
600,1099,13,1112,1475,0,0,75.39,742,357,安康里,NULL
326,1105,7,1112,1455,0,0,76.43,708,397,長沙村,NULL
1546,1103,9,1112,1419,0,0,78.37,658,445,新昌里,NULL
234,1099,13,1112,1551,0,0,71.7,640,459,三德村,NULL
586,1105,7,1112,1367,0,0,81.35,619,486,福美里,NULL
4,1103,9,1112,1304,0,0,85.28,618,485,文林里,NULL
59,1106,6,1112,1411,0,0,78.81,610,496,建昌里,NULL
1098,1107,5,1112,1406,0,0,79.09,586,521,後港里,NULL
984,1106,6,1112,1444,0,0,77.01,580,526,青山里,NULL
1424,1099,13,1112,1426,0,0,77.98,575,524,延吉里,NULL
0,1104,8,1112,1404,0,0,79.2,539,565,尚義里,NULL
190,1102,10,1112,1401,0,0,79.37,533,569,社新里,NULL
199,1096,16,1112,1421,0,0,78.25,531,565,和平里,NULL
389,1103,9,1112,1411,0,0,78.81,490,613,坑口村,NULL
258,1104,8,1112,1531,0,0,72.63,452,652,保定村,NULL
232,1096,16,1112,1550,0,0,71.74,425,671,崙東里,NULL
0,1096,16,1112,1550,0,0,71.74,425,671,崙東里,NULL
390,1108,4,1112,1422,0,0,78.2,401,707,大埕里,NULL
3,1101,11,1112,1429,0,0,77.82,330,771,塔樓村,NULL
0,1101,11,1112,1429,0,0,77.82,330,771,塔樓村,NULL
852,1101,10,1111,1385,0,0,80.22,752,349,秀林里,NULL
635,1106,5,1111,1361,0,0,81.63,723,383,松友里,NULL
111,1106,5,1111,1399,0,0,79.41,713,393,高峰里,NULL
1212,1105,6,1111,1434,0,0,77.48,703,402,復興里,NULL
1106,1100,11,1111,1450,0,0,76.62,673,427,南港里,NULL
241,1104,7,1111,1508,0,0,73.67,610,494,山腳村,NULL
363,1108,3,1111,1379,0,0,80.57,598,510,重明里,NULL
527,1101,10,1111,1457,0,0,76.25,596,505,興隆里,NULL
631,1097,14,1111,1447,0,0,76.78,588,509,正言里,NULL
262,1105,6,1111,1467,0,0,75.73,588,517,金華里,NULL
357,1099,12,1111,1395,0,0,79.64,577,522,健行里,NULL
474,1107,4,1111,1444,0,0,76.94,574,533,安發里,NULL
611,1100,11,1111,1453,0,0,76.46,562,538,福隆里,NULL
414,1096,15,1111,1489,0,0,74.61,561,535,光文里,NULL
130,1096,15,1111,1594,0,0,69.7,538,558,興中里,NULL
0,1096,15,1111,1594,0,0,69.7,538,558,興中里,NULL
0,1101,10,1111,1521,0,0,73.04,398,703,三角村,NULL
1180,1105,5,1110,1374,0,0,80.79,941,164,群英里,NULL
1056,1096,14,1110,1355,0,0,81.92,922,174,忠貞里,NULL
0,1097,13,1110,1728,0,0,64.24,761,336,大王村,NULL
214,1101,9,1110,1460,0,0,76.03,742,359,松茂里,NULL
162,1100,10,1110,1449,0,0,76.6,723,377,七賢里,NULL
959,1097,13,1110,1469,0,0,75.56,696,401,文北里,NULL
1873,1095,15,1110,1438,0,0,77.19,675,420,崁頂里,NULL
0,1095,15,1110,1438,0,0,77.19,675,420,崁頂里,NULL
364,1100,10,1110,1457,0,0,76.18,651,449,小東里,NULL
1659,1102,8,1110,1387,0,0,80.03,647,455,潭底里,NULL
364,1101,9,1110,1427,0,0,77.79,634,467,明新里,NULL
243,1102,8,1110,1326,0,0,83.71,628,474,福星里,NULL
322,1099,11,1110,1453,0,0,76.39,594,505,溪福里,NULL
99,1097,13,1110,1453,0,0,76.39,583,514,東埔里,NULL
0,1097,13,1110,1524,0,0,72.83,582,515,泰田里,NULL
175,1098,12,1110,1385,0,0,80.14,544,554,青溪里,NULL
361,1102,8,1110,1444,0,0,76.87,528,574,香社村,NULL
0,1102,8,1110,1444,0,0,76.87,528,574,香社村,NULL
152,1103,7,1110,1392,0,0,79.74,508,595,福中里,NULL
0,1105,5,1110,1639,0,0,67.72,508,597,旭山村,NULL
394,1103,7,1110,1487,0,0,74.65,478,625,社上村,NULL
0,1103,7,1110,1487,0,0,74.65,478,625,社上村,NULL
0,1098,12,1110,1518,0,0,73.12,438,660,水秀里,NULL
378,1101,9,1110,1564,0,0,70.97,436,665,麻園村,NULL
0,1101,9,1110,1564,0,0,70.97,436,665,麻園村,NULL
1072,1104,5,1109,1345,0,0,82.45,834,270,騰雲里,NULL
379,1098,11,1109,1404,0,0,78.99,829,269,崇誨里,NULL
230,1092,17,1109,1479,0,0,74.98,793,299,大崗村,NULL
1562,1102,7,1109,1400,0,0,79.21,743,359,文化里,NULL
1890,1097,12,1109,1474,0,0,75.24,735,362,新興里,NULL
1550,1099,10,1109,1402,0,0,79.1,708,391,福安里,NULL
783,1101,8,1109,1423,0,0,77.93,681,420,江寧里,NULL
103,1102,7,1109,1488,0,0,74.53,663,439,泰安里,NULL
0,1102,7,1109,1488,0,0,74.53,663,439,泰安里,NULL
41,1101,8,1109,1412,0,0,78.54,641,460,何成里,NULL
754,1099,10,1109,1441,0,0,76.96,637,462,新喜里,NULL
1903,1098,11,1109,1448,0,0,76.59,626,472,長庚里,NULL
0,1098,11,1109,1448,0,0,76.59,626,472,長庚里,NULL
473,1098,11,1109,1431,0,0,77.5,609,489,成功里,NULL
405,1098,11,1109,1419,0,0,78.15,603,495,寶興里,NULL
10,1101,8,1109,1362,0,0,81.42,599,502,福興里,NULL
1002,1100,9,1109,1504,0,0,73.74,595,505,華江里,NULL
373,1107,2,1109,1409,0,0,78.71,594,513,前峰里,NULL
765,1102,7,1109,1395,0,0,79.5,545,557,仁義村,NULL
521,1094,15,1109,1439,0,0,77.07,471,623,山東里,NULL
1258,1106,2,1108,1339,0,0,82.75,811,295,萬有里,NULL
1626,1099,9,1108,1371,0,0,80.82,798,301,忠山里,NULL
487,1095,13,1108,1428,0,0,77.59,758,337,光華里,NULL
422,1100,8,1108,1340,0,0,82.69,731,369,中研里,NULL
58,1095,13,1108,1364,0,0,81.23,712,383,何源里,NULL
359,1101,7,1108,1343,0,0,82.5,661,440,東光里,NULL
414,1102,6,1108,1432,0,0,77.37,631,471,三重里,NULL
414,1096,12,1108,1469,0,0,75.43,629,467,忠明里,NULL
1847,1101,7,1108,1426,0,0,77.7,621,480,興仁里,NULL
0,1101,7,1108,1426,0,0,77.7,621,480,興仁里,NULL
503,1099,9,1108,1354,0,0,81.83,619,480,江川里,NULL
752,1099,9,1108,1368,0,0,80.99,574,525,新喜里,NULL
0,1103,5,1108,1426,0,0,77.7,570,533,菁山里,NULL
787,1094,14,1108,1592,0,0,69.6,566,528,三安里,NULL
0,1094,14,1108,1592,0,0,69.6,566,528,三安里,NULL
1039,1102,6,1108,1349,0,0,82.13,549,553,銘德里,NULL
987,1097,11,1108,1417,0,0,78.19,530,567,草漯村,NULL
876,1101,7,1108,1404,0,0,78.92,522,579,保安里,NULL
202,1098,10,1108,1374,0,0,80.64,393,705,富洲里,NULL
154,1100,7,1107,1400,0,0,79.07,790,310,文山里,NULL
68,1101,6,1107,1450,0,0,76.34,776,325,大鵬里,NULL
1136,1104,3,1107,1372,0,0,80.69,739,365,錦泰里,NULL
26,1100,7,1107,1354,0,0,81.76,720,380,公園里,NULL
1252,1098,9,1107,1384,0,0,79.99,713,385,永平里,NULL
128,1093,14,1107,1416,0,0,78.18,711,382,文山里,NULL
177,1098,9,1107,1447,0,0,76.5,702,396,北興里,NULL
572,1093,14,1107,1425,0,0,77.68,671,422,社皮里,NULL
654,1102,5,1107,1450,0,0,76.34,583,519,西橋里,NULL
155,1095,12,1107,1429,0,0,77.47,581,514,懷翠里,NULL
503,1097,10,1107,1427,0,0,77.58,546,551,永豐里,NULL
97,1094,13,1107,1394,0,0,79.41,525,569,中和里,NULL
0,1094,13,1107,1394,0,0,79.41,525,569,中和里,NULL
193,1104,3,1107,1379,0,0,80.28,521,583,忠正里,NULL
864,1097,10,1107,1522,0,0,72.73,501,596,斯文里,NULL
333,1097,10,1107,1422,0,0,77.85,395,702,福權村,NULL
0,1097,10,1107,1422,0,0,77.85,395,702,福權村,NULL
666,1090,16,1106,1451,0,0,76.22,822,268,篤行里,NULL
0,1090,16,1106,1451,0,0,76.22,822,268,篤行里,NULL
1356,1096,10,1106,1333,0,0,82.97,786,310,萬美里,NULL
755,1097,9,1106,1409,0,0,78.5,758,339,新榮里,NULL
230,1102,4,1106,1500,0,0,73.73,735,367,平和里,NULL
173,1100,6,1106,1401,0,0,78.94,726,374,三元里,NULL
487,1099,7,1106,1368,0,0,80.85,701,398,新東里,NULL
553,1097,9,1106,1440,0,0,76.81,663,434,西德里,NULL
104,1095,11,1106,1489,0,0,74.28,648,447,臨江里,NULL
0,1095,11,1106,1489,0,0,74.28,648,447,臨江里,NULL
164,1092,14,1106,1492,0,0,74.13,628,464,大村里,NULL
1051,1096,10,1106,1383,0,0,79.97,597,499,興德里,NULL
1761,1103,3,1106,1411,0,0,78.38,573,530,同慶里,NULL
0,1103,3,1106,1411,0,0,78.38,573,530,同慶里,NULL
575,1093,13,1106,1519,0,0,72.81,553,540,尾厝村,NULL
0,1093,13,1106,1519,0,0,72.81,553,540,尾厝村,NULL
856,1092,14,1106,1444,0,0,76.59,531,561,五甲村,NULL
165,1101,5,1106,1386,0,0,79.8,527,574,振興里,NULL
652,1092,14,1106,1468,0,0,75.34,487,605,東林村,NULL
813,1096,10,1106,1442,0,0,76.7,448,648,瑞竹里,NULL
0,1096,10,1106,1442,0,0,76.7,448,648,瑞竹里,NULL
514,1092,14,1106,1548,0,0,71.45,401,691,新庄村,NULL
0,1092,14,1106,1548,0,0,71.45,401,691,新庄村,NULL
801,1092,13,1105,1441,0,0,76.68,920,172,六寶村,NULL
332,1091,14,1105,1383,0,0,79.9,837,254,鶴岡村,NULL
0,1091,14,1105,1383,0,0,79.9,837,254,鶴岡村,NULL
202,1098,7,1105,1358,0,0,81.37,815,283,中勢村,NULL
319,1099,6,1105,1363,0,0,81.07,788,311,大宏里,NULL
104,1098,7,1105,1399,0,0,78.98,702,396,南屯里,NULL
366,1095,10,1105,1360,0,0,81.25,692,403,錦中村,NULL
782,1098,7,1105,1412,0,0,78.26,643,455,三和村,NULL
834,1095,10,1105,1335,0,0,82.77,566,529,光能里,NULL
257,1099,6,1105,1477,0,0,74.81,566,533,明和里,NULL
0,1099,6,1105,1477,0,0,74.81,566,533,明和里,NULL
650,1092,13,1105,1384,0,0,79.84,549,543,文昌里,NULL
376,1098,7,1105,1512,0,0,73.08,521,577,東安里,NULL
0,1098,7,1105,1512,0,0,73.08,521,577,東安里,NULL
516,1094,11,1105,1488,0,0,74.26,515,579,六根村,NULL
0,1094,11,1105,1488,0,0,74.26,515,579,六根村,NULL
944,1094,11,1105,1465,0,0,75.43,511,583,望間村,NULL
0,1094,11,1105,1465,0,0,75.43,511,583,望間村,NULL
815,1093,12,1105,1441,0,0,76.68,503,590,文化村,NULL
883,1093,12,1105,1365,0,0,80.95,487,606,龍成里,NULL
850,1098,7,1105,1362,0,0,81.13,480,618,老爺里,NULL
862,1096,9,1105,1377,0,0,80.25,475,621,揚雅里,NULL
864,1100,4,1104,1336,0,0,82.63,816,284,民樂里,NULL
861,1094,10,1104,1468,0,0,75.2,761,333,新榮里,NULL
435,1100,4,1104,1349,0,0,81.84,746,354,東新里,NULL
1870,1092,12,1104,1525,0,0,72.39,716,376,竿蓁里,NULL
12,1092,12,1104,1466,0,0,75.31,684,408,敦和里,NULL
358,1091,13,1104,2576,0,0,42.86,675,416,過田里,NULL
206,1089,15,1104,1400,0,0,78.86,674,415,龍華村,NULL
1683,1091,13,1104,1368,0,0,80.7,673,418,樹西里,NULL
1762,1094,10,1104,1494,0,0,73.9,669,425,永昌里,NULL
519,1095,9,1104,1417,0,0,77.91,668,427,民有里,NULL
340,1100,4,1104,1531,0,0,72.11,668,432,延和里,NULL
1378,1093,11,1104,1458,0,0,75.72,663,430,學府里,NULL
327,1089,15,1104,1398,0,0,78.97,655,434,大強里,NULL
150,1090,14,1104,1389,0,0,79.48,635,455,田心里,NULL
109,1099,5,1104,1425,0,0,77.47,631,468,永祥里,NULL
0,1092,12,1104,1590,0,0,69.43,593,499,南興里,NULL
1458,1089,15,1104,1405,0,0,78.58,577,512,中華里,NULL
341,1100,4,1104,1379,0,0,80.06,562,538,博惠里,NULL
479,1094,10,1104,1351,0,0,81.72,558,536,厚德里,NULL
234,1098,6,1104,1445,0,0,76.4,555,543,光榮里、民權里,NULL
0,1098,6,1104,1445,0,0,76.4,555,543,光榮里、民權里,NULL
987,1096,8,1104,1353,0,0,81.6,523,573,富民里,NULL
48,1089,14,1103,1381,0,0,79.87,907,182,建功里,NULL
581,1098,5,1103,1459,0,0,75.6,756,342,興隆里,NULL
165,1092,11,1103,1578,0,0,69.9,739,353,鶯歌里,NULL
265,1090,13,1103,1451,0,0,76.02,739,351,中隘里,NULL
0,1090,13,1103,1451,0,0,76.02,739,351,中隘里,NULL
1376,1093,10,1103,1413,0,0,78.06,732,361,樂利里,NULL
1767,1090,13,1103,1400,0,0,78.79,697,393,永吉里,NULL
665,1095,8,1103,1335,0,0,82.62,690,405,竹西里,NULL
439,1101,2,1103,1486,0,0,74.23,675,426,太平村,NULL
0,1101,2,1103,1486,0,0,74.23,675,426,太平村,NULL
1661,1088,15,1103,1395,0,0,79.07,664,424,文林里,NULL
52,1096,7,1103,1503,0,0,73.39,636,460,南埔里,NULL
291,1093,10,1103,1420,0,0,77.68,627,466,大竹里,NULL
0,1093,10,1103,1420,0,0,77.68,627,466,大竹里,NULL
474,1087,16,1103,1448,0,0,76.17,622,465,東勢里,NULL
1099,1094,9,1103,1427,0,0,77.3,621,473,後港里,NULL
2062,1095,8,1103,1420,0,0,77.68,616,479,中湖村,NULL
98,1098,5,1103,1383,0,0,79.75,608,490,文化里,NULL
753,1100,3,1103,1408,0,0,78.34,568,532,新喜里,NULL
251,1093,10,1103,1425,0,0,77.4,542,551,南寮村,NULL
0,1093,10,1103,1425,0,0,77.4,542,551,南寮村,NULL
1735,1085,18,1103,1468,0,0,75.14,500,585,東園里,NULL
0,1085,18,1103,1468,0,0,75.14,500,585,東園里,NULL
820,1096,7,1103,1428,0,0,77.24,499,597,建明里,NULL
15,1082,20,1102,1374,0,0,80.2,862,220,高苗里,NULL
931,1095,7,1102,1410,0,0,78.16,832,263,河堤里,NULL
249,1087,15,1102,1401,0,0,78.66,812,275,瑞豐里,NULL
0,1087,15,1102,1401,0,0,78.66,812,275,瑞豐里,NULL
736,1099,3,1102,1381,0,0,79.8,704,395,文福里,NULL
392,1079,23,1102,1591,0,0,69.26,691,388,北平里,NULL
283,1092,10,1102,1412,0,0,78.05,687,405,瑞井村,NULL
138,1088,14,1102,1337,0,0,82.42,683,405,吳厝里,NULL
0,1088,14,1102,1337,0,0,82.42,683,405,吳厝里,NULL
228,1093,9,1102,1428,0,0,77.17,677,416,百福里,NULL
448,1088,14,1102,1437,0,0,76.69,638,450,瑞城里,NULL
764,1084,18,1102,1566,0,0,70.37,613,471,仁里村,NULL
0,1084,18,1102,1566,0,0,70.37,613,471,仁里村,NULL
544,1092,10,1102,1367,0,0,80.61,612,480,中陽里,NULL
1507,1098,4,1102,1405,0,0,78.43,594,504,仁德里,NULL
6,1093,9,1102,1382,0,0,79.74,589,504,石牌里,NULL
166,1086,16,1102,1412,0,0,78.05,589,497,新南里,NULL
496,1087,15,1102,1453,0,0,75.84,587,500,宜欣里,NULL
513,1091,11,1102,1426,0,0,77.28,426,665,五和村,NULL
370,1094,7,1101,1434,0,0,76.78,815,279,立人里,NULL
577,1087,14,1101,1390,0,0,79.21,814,273,正和里,NULL
762,1094,7,1101,1326,0,0,83.03,798,296,安順里,NULL
0,1094,7,1101,1535,0,0,71.73,777,317,義和村,NULL
53,1091,10,1101,1461,0,0,75.36,672,419,何德里,NULL
20,1093,8,1101,1425,0,0,77.26,668,425,新厝里,NULL
498,1093,8,1101,1449,0,0,75.98,643,450,明昌里,NULL
722,1087,14,1101,1392,0,0,79.09,636,451,清穗里,NULL
1455,1091,10,1101,1447,0,0,76.09,633,458,九芎里,NULL
232,1092,9,1101,1396,0,0,78.87,624,468,蘭雅里,NULL
36,1090,11,1101,1381,0,0,79.72,614,476,大林里,NULL
181,1085,16,1101,1334,0,0,82.53,605,480,居仁里,NULL
45,1093,8,1101,1349,0,0,81.62,600,493,吉慶里,NULL
532,1087,14,1101,1474,0,0,74.69,594,493,光隆里,NULL
1480,1092,9,1101,1387,0,0,79.38,566,526,永康里,NULL
1060,1089,12,1101,1402,0,0,78.53,546,543,瓊林里,NULL
0,1091,10,1101,1494,0,0,73.69,476,615,開明里,NULL
339,1088,13,1101,1377,0,0,79.96,432,656,中福村,NULL
0,1084,16,1100,1468,0,0,74.93,841,243,石墻村,NULL
585,1093,7,1100,1386,0,0,79.37,765,328,新仁里,NULL
19,1088,12,1100,1377,0,0,79.88,742,346,新厝里,NULL
462,1089,11,1100,1382,0,0,79.59,716,373,成福里,NULL
915,1092,8,1100,1382,0,0,79.59,685,407,永昌里,NULL
561,1085,15,1100,1410,0,0,78.01,673,412,敦化里,NULL
761,1086,14,1100,1437,0,0,76.55,672,414,新貴里,NULL
2163,1093,7,1100,1443,0,0,76.23,667,426,訊塘村,NULL
353,1089,11,1100,1450,0,0,75.86,664,425,育德里,NULL
339,1087,13,1100,1473,0,0,74.68,660,427,長春村,NULL
0,1087,13,1100,1473,0,0,74.68,660,427,長春村,NULL
163,1094,6,1100,1410,0,0,78.01,649,445,新雅里,NULL
1681,1087,13,1100,1377,0,0,79.88,618,469,樹西里,NULL
24,1089,11,1100,1440,0,0,76.39,604,485,碧峰里,NULL
173,1086,14,1100,1357,0,0,81.06,587,499,埔墘里,NULL
975,1090,10,1100,1394,0,0,78.91,562,528,新起里,NULL
488,1088,12,1100,1374,0,0,80.06,536,552,東信里,NULL
197,1095,5,1100,1403,0,0,78.4,530,565,龍井里,NULL
0,1095,5,1100,1403,0,0,78.4,530,565,龍井里,NULL
512,1094,6,1100,1480,0,0,74.32,480,614,竹林村,NULL
407,1091,9,1100,1385,0,0,79.42,478,613,寶中里,NULL
0,1089,11,1100,1515,0,0,72.61,386,703,中洲里,NULL
79,1084,15,1099,1453,0,0,75.64,911,173,永安里,NULL
1302,1094,5,1099,1356,0,0,81.05,863,231,興昌里,NULL
1252,1094,5,1099,1348,0,0,81.53,786,308,景仁里,NULL
790,1085,14,1099,1316,0,0,83.51,772,313,秀峰里,NULL
946,1093,6,1099,1438,0,0,76.43,737,356,梅花里,NULL
645,1092,7,1099,1376,0,0,79.87,696,396,中行里,NULL
242,1082,17,1099,1335,0,0,82.32,674,408,平安里,NULL
226,1094,5,1099,1422,0,0,77.29,659,435,堵北里,NULL
193,1089,10,1099,1356,0,0,81.05,623,466,永生里,NULL
0,1089,10,1099,1356,0,0,81.05,623,466,永生里,NULL
16,1093,6,1099,1398,0,0,78.61,622,471,福林里,NULL
458,1082,17,1099,1425,0,0,77.12,617,465,永成里,NULL
486,1087,12,1099,1412,0,0,77.83,604,483,光華里,NULL
170,1091,8,1099,1386,0,0,79.29,592,499,光復里,NULL
182,1085,14,1099,1443,0,0,76.16,575,510,曾厝村,NULL
0,1085,14,1099,1443,0,0,76.16,575,510,曾厝村,NULL
1705,1088,11,1099,1454,0,0,75.58,553,535,彭興里,NULL
468,1092,7,1099,1413,0,0,77.78,535,557,六福里,NULL
463,1082,17,1099,1396,0,0,78.72,512,570,東門里,NULL
485,1088,11,1099,1362,0,0,80.69,479,609,東信里,NULL
354,1089,10,1099,1467,0,0,74.91,459,630,秀林村,NULL
1399,1088,10,1098,1399,0,0,78.48,744,344,清溪里,NULL
2222,1084,14,1098,1425,0,0,77.05,696,388,金美村,NULL
327,1086,12,1098,1386,0,0,79.22,684,402,金龍里,NULL
241,1089,9,1098,1378,0,0,79.68,660,429,景星里,NULL
109,1093,5,1098,1450,0,0,75.72,659,434,西安里,NULL
421,1090,8,1098,1519,0,0,72.28,658,432,海口村,NULL
0,1090,8,1098,1519,0,0,72.28,658,432,海口村,NULL
430,1087,11,1098,1627,0,0,67.49,654,433,南港村,NULL
130,1077,21,1098,1405,0,0,78.15,616,461,義信里,NULL
217,1082,16,1098,1402,0,0,78.32,612,470,山德村,NULL
166,1089,9,1098,1417,0,0,77.49,597,492,郡王里,NULL
0,1089,9,1098,1417,0,0,77.49,597,492,郡王里,NULL
0,1092,6,1098,1502,0,0,73.1,534,558,三崙村,NULL
857,1086,12,1098,1370,0,0,80.15,518,568,蓬萊里,NULL
851,1088,10,1098,1371,0,0,80.09,485,603,老爺里,NULL
322,1085,13,1098,1354,0,0,81.09,431,654,安和里,NULL
656,1094,3,1097,1376,0,0,79.72,806,288,景新里,NULL
2072,1095,2,1097,1402,0,0,78.25,793,302,麗林村,NULL
145,1090,7,1097,1389,0,0,78.98,769,321,黎明里,NULL
296,1085,12,1097,1479,0,0,74.17,729,356,台鳳里,NULL
1120,1082,15,1097,1434,0,0,76.5,697,385,民有里,NULL
420,1092,5,1097,1390,0,0,78.92,695,397,中研里,NULL
2161,1084,13,1097,1510,0,0,72.65,691,393,舊城村,NULL
703,1087,10,1097,1470,0,0,74.63,682,405,正義里,NULL
160,1087,10,1097,1440,0,0,76.18,643,444,大庄里,NULL
49,1089,8,1097,1376,0,0,79.72,585,504,南華里,NULL
0,1089,8,1097,1376,0,0,79.72,585,504,南華里,NULL
209,1094,3,1097,1449,0,0,75.71,581,513,三共里,NULL
105,1087,10,1097,1447,0,0,75.81,544,543,竹林里,NULL
159,1084,13,1097,1390,0,0,78.92,540,544,百齡里,NULL
93,1086,11,1097,1368,0,0,80.19,540,546,尾北里,NULL
751,1083,14,1097,1392,0,0,78.81,464,619,草衙里,NULL
119,1088,9,1097,1417,0,0,77.42,455,633,正風里,NULL
0,1088,9,1097,1417,0,0,77.42,455,633,正風里,NULL
306,1086,11,1097,1365,0,0,80.37,134,952,東庄村,NULL
0,1086,11,1097,1365,0,0,80.37,134,952,東庄村,NULL
533,1081,15,1096,1409,0,0,77.79,887,194,仁福里,NULL
74,1091,5,1096,1300,0,0,84.31,839,252,新莊里,NULL
583,1087,9,1096,1318,0,0,83.16,743,344,中興村,NULL
488,1084,12,1096,1426,0,0,76.86,727,357,光華里,NULL
1597,1085,11,1096,1392,0,0,78.74,682,403,忠孝里,NULL
2054,1086,10,1096,1487,0,0,73.71,663,423,林口村,NULL
206,1087,9,1096,1489,0,0,73.61,644,443,六路里,NULL
914,1090,6,1096,1451,0,0,75.53,633,457,大平村,NULL
0,1090,6,1096,1451,0,0,75.53,633,457,大平村,NULL
1444,1088,8,1096,1366,0,0,80.23,605,483,光華里,NULL
0,1090,6,1096,1425,0,0,76.91,596,494,龍泉里,NULL
301,1089,7,1096,1540,0,0,71.17,594,495,松山村,NULL
0,1089,7,1096,1540,0,0,71.17,594,495,松山村,NULL
358,1088,8,1096,1549,0,0,70.76,578,510,硘磘里,NULL
0,1088,8,1096,1549,0,0,70.76,578,510,硘磘里,NULL
169,1087,9,1096,1402,0,0,78.17,572,515,明勝里,NULL
629,1090,6,1096,1564,0,0,70.08,568,522,內坑村,NULL
336,1090,6,1096,1370,0,0,80,543,547,和平里,NULL
281,1084,12,1096,1478,0,0,74.15,539,545,上四村,NULL
0,1084,12,1096,1478,0,0,74.15,539,545,上四村,NULL
699,1089,7,1096,1498,0,0,73.16,536,553,順苓里,NULL
64,1088,8,1096,1416,0,0,77.4,518,570,溪東里,NULL
285,1087,9,1096,1338,0,0,81.91,510,577,建南里,NULL
342,1085,11,1096,1380,0,0,79.42,475,610,博惠里,NULL
477,1077,19,1096,1414,0,0,77.51,439,638,長城里,NULL
0,1077,19,1096,1414,0,0,77.51,439,638,長城里,NULL
194,1086,10,1096,1469,0,0,74.61,408,678,龍潭村,NULL
674,1079,16,1095,1346,0,0,81.35,915,164,華勛里,NULL
31,1089,6,1095,1365,0,0,80.22,850,239,竹仁里,NULL
29,1089,6,1095,1578,0,0,69.39,848,241,新生里,NULL
246,1087,8,1095,1359,0,0,80.57,812,275,東香里,NULL
215,1086,9,1095,1389,0,0,78.83,723,363,公明里,NULL
900,1087,8,1095,1360,0,0,80.51,716,371,網溪里,NULL
649,1084,11,1095,1362,0,0,80.4,701,383,大道里,NULL
687,1076,19,1095,1434,0,0,76.36,694,382,南勢里,NULL
204,1088,7,1095,1421,0,0,77.06,685,403,境福里,NULL
436,1090,5,1095,1401,0,0,78.16,582,508,寶玉里,NULL
393,1084,11,1095,1380,0,0,79.35,534,550,週美里,NULL
1017,1086,9,1095,1463,0,0,74.85,527,559,中全里,NULL
819,1082,13,1095,1413,0,0,77.49,526,556,建明里,NULL
259,1082,13,1095,1334,0,0,82.08,521,561,文南里,NULL
868,1083,12,1095,1355,0,0,80.81,515,568,鄰江里,NULL
131,1085,10,1095,1392,0,0,78.66,472,613,新下里,NULL
491,1086,9,1095,1429,0,0,76.63,454,632,仁武村,NULL
526,1089,6,1095,1493,0,0,73.34,436,653,灣內村,NULL
359,1083,12,1095,1470,0,0,74.49,373,710,福田里,NULL
0,1083,12,1095,1470,0,0,74.49,373,710,福田里,NULL
196,1087,7,1094,1359,0,0,80.5,909,178,上埔里,NULL
56,1078,16,1094,1404,0,0,77.92,856,222,文聖里,NULL
54,1080,14,1094,1348,0,0,81.16,844,236,文山里,NULL
831,1088,6,1094,1341,0,0,81.58,809,279,永福里,NULL
668,1085,9,1094,1358,0,0,80.56,762,323,三犁里,NULL
1123,1088,6,1094,1350,0,0,81.04,755,333,龍安里,NULL
660,1087,7,1094,1502,0,0,72.84,742,345,泰昌里,NULL
187,1086,8,1094,1481,0,0,73.87,733,353,桃源里,NULL
158,1079,15,1094,1391,0,0,78.65,700,379,大同里,NULL
966,1089,5,1094,1405,0,0,77.86,697,392,三愛里,NULL
851,1083,11,1094,1418,0,0,77.15,651,432,聚興村,NULL
810,1084,10,1094,1467,0,0,74.57,606,478,興中里,NULL
83,1082,12,1094,1360,0,0,80.44,585,497,華江里,NULL
0,1085,9,1094,1499,0,0,72.98,573,512,五北里,NULL
219,1088,6,1094,1508,0,0,72.55,517,571,永春里,NULL
787,1082,11,1093,1321,0,0,82.74,867,215,秀明里,NULL
317,1084,9,1093,1376,0,0,79.43,844,240,大智里,NULL
1157,1081,12,1093,1385,0,0,78.92,794,287,張北里,NULL
1116,1083,10,1093,1428,0,0,76.54,725,358,古莊里,NULL
43,1086,7,1093,1458,0,0,74.97,700,386,頭前里,NULL
0,1086,7,1093,1458,0,0,74.97,700,386,頭前里,NULL
1866,1087,6,1093,1449,0,0,75.43,688,399,民生里,NULL
654,1082,11,1093,1338,0,0,81.69,674,408,大仁里,NULL
367,1086,7,1093,1338,0,0,81.69,667,419,大學里,NULL
0,1086,7,1093,1338,0,0,81.69,667,419,大學里,NULL
60,1074,19,1093,1403,0,0,77.9,651,423,鐵山里,NULL
1704,1078,15,1093,1539,0,0,71.02,638,440,彭興里,NULL
11,1083,10,1093,1328,0,0,82.3,628,455,福興里,NULL
347,1082,11,1093,1394,0,0,78.41,595,487,鼎盛里,NULL
994,1085,8,1093,1405,0,0,77.79,552,533,思源里,NULL
251,1087,6,1093,1541,0,0,70.93,549,538,嘉安村,NULL
0,1087,6,1093,1541,0,0,70.93,549,538,嘉安村,NULL
100,1079,14,1093,1382,0,0,79.09,548,531,宏翠里,NULL
58,1083,10,1093,1438,0,0,76.01,521,562,梅洲里,NULL
69,1084,9,1093,1466,0,0,74.56,464,620,東寧村,NULL
0,1083,10,1093,1540,0,0,70.97,455,628,忠興村,NULL
198,1087,6,1093,1347,0,0,81.14,439,648,保安村,NULL
152,1082,10,1092,1378,0,0,79.25,777,305,文山里,NULL
307,1081,11,1092,1381,0,0,79.07,771,310,大崎村,NULL
0,1081,11,1092,1381,0,0,79.07,771,310,大崎村,NULL
229,1077,15,1092,1623,0,0,67.28,751,326,中城里,NULL
1886,1085,7,1092,1450,0,0,75.31,731,354,新興里,NULL
908,1085,7,1092,1320,0,0,82.73,687,398,螢雪里,NULL
479,1084,8,1092,1354,0,0,80.65,677,407,三民里,NULL
62,1085,7,1092,1353,0,0,80.71,672,413,宏昌里,NULL
126,1081,11,1092,1446,0,0,75.52,661,420,溝墘里,NULL
407,1087,5,1092,1386,0,0,78.79,657,430,湖元里,NULL
291,1074,18,1092,1433,0,0,76.2,650,424,香山里,NULL
91,1083,9,1092,1414,0,0,77.23,643,440,頂庄里,NULL
83,1087,5,1092,1415,0,0,77.17,623,464,漢民里,NULL
318,1080,12,1092,1384,0,0,78.9,608,472,溪洲里,NULL
184,1082,10,1092,1492,0,0,73.19,606,476,保安里,NULL
524,1081,11,1092,1482,0,0,73.68,579,502,聖和里,NULL
0,1081,11,1092,1482,0,0,73.68,579,502,聖和里,NULL
720,1078,14,1092,1408,0,0,77.56,547,531,廣興村,NULL
826,1084,8,1092,1385,0,0,78.84,516,568,永樂里,NULL
46,1085,7,1092,1520,0,0,71.84,485,600,佃西里,NULL
0,1085,7,1092,1520,0,0,71.84,485,600,佃西里,NULL
42,1080,12,1092,1498,0,0,72.9,402,678,新南村,NULL
0,1080,12,1092,1498,0,0,72.9,402,678,新南村,NULL
342,1085,7,1092,1485,0,0,73.54,377,708,新豐里,NULL
0,1085,7,1092,1485,0,0,73.54,377,708,新豐里,NULL
219,1084,7,1091,1311,0,0,83.22,845,239,後庄里,NULL
769,1078,13,1091,1382,0,0,78.94,747,331,建安里,NULL
128,1080,11,1091,1620,0,0,67.35,735,345,鐵山里,NULL
0,1080,11,1091,1620,0,0,67.35,735,345,鐵山里,NULL
284,1079,12,1091,1386,0,0,78.72,731,348,大德里,NULL
89,1083,8,1091,1599,0,0,68.23,716,367,枇杷里,NULL
310,1080,11,1091,1366,0,0,79.87,687,393,錦村里,NULL
222,1080,11,1091,1406,0,0,77.6,659,421,山福村,NULL
0,1081,10,1091,1653,0,0,66,659,422,新城村,NULL
557,1082,9,1091,1436,0,0,75.97,646,436,光復里,NULL
0,1082,9,1091,1436,0,0,75.97,646,436,光復里,NULL
45,1087,4,1091,1476,0,0,73.92,633,454,富寮里,NULL
111,1079,12,1091,1463,0,0,74.57,627,452,武陵里,NULL
0,1079,12,1091,1463,0,0,74.57,627,452,武陵里,NULL
221,1080,11,1091,1400,0,0,77.93,613,467,芝山里,NULL
327,1080,11,1091,1368,0,0,79.75,606,474,溪北里,NULL
100,1085,6,1091,1444,0,0,75.55,583,502,信義里,NULL
1463,1086,5,1091,1416,0,0,77.05,550,536,長安里,NULL
409,1075,16,1091,1555,0,0,70.16,519,556,和睦村,NULL
490,1083,8,1091,1509,0,0,72.3,413,670,鎮海里,NULL
1069,1082,8,1090,1301,0,0,83.78,860,222,新安里,NULL
862,1080,10,1090,1357,0,0,80.32,727,353,民富里,NULL
72,1084,6,1090,1355,0,0,80.44,715,369,智仁里,NULL
1815,1084,6,1090,1354,0,0,80.5,711,373,安溪里,NULL
726,1077,13,1090,1357,0,0,80.32,671,406,自強里,NULL
583,1086,4,1090,1357,0,0,80.32,663,423,林南里,NULL
762,1076,14,1090,1343,0,0,81.16,635,441,新貴里,NULL
712,1081,9,1090,1414,0,0,77.09,613,468,民安里,NULL
347,1086,4,1090,1474,0,0,73.95,375,711,信和里,NULL
0,1086,4,1090,1474,0,0,73.95,375,711,信和里,NULL
1064,1080,9,1089,1392,0,0,78.23,911,169,新和里,NULL
856,1077,12,1089,1351,0,0,80.61,768,309,秀元里,NULL
42,1079,10,1089,1458,0,0,74.69,717,362,何成里,NULL
1054,1083,6,1089,1331,0,0,81.82,710,373,日祥里,NULL
348,1075,14,1089,1374,0,0,79.26,706,369,梅川里,NULL
623,1080,9,1089,1342,0,0,81.15,669,411,永春里,NULL
344,1082,7,1089,1541,0,0,70.67,643,439,延祥里,NULL
394,1084,5,1089,1366,0,0,79.72,637,447,週美里,NULL
829,1076,13,1089,1419,0,0,76.74,626,450,家福村,NULL
514,1084,5,1089,1357,0,0,80.25,594,490,文昌里,NULL
1729,1078,11,1089,1436,0,0,75.84,557,521,樂山里,NULL
0,1078,11,1089,1436,0,0,75.84,557,521,樂山里,NULL
0,1075,14,1089,1451,0,0,75.05,547,528,山脚里,NULL
338,1077,12,1089,1400,0,0,77.79,486,591,中福村,NULL
132,1080,9,1089,1400,0,0,77.79,482,598,新生里,NULL
0,1080,9,1089,1400,0,0,77.79,482,598,新生里,NULL
436,1078,11,1089,1387,0,0,78.51,333,745,嘉北里,NULL
0,1078,11,1089,1387,0,0,78.51,333,745,嘉北里,NULL
95,1075,13,1088,1349,0,0,80.65,879,196,鷄林里,NULL
104,1076,12,1088,1311,0,0,82.99,872,204,榮華里,NULL
69,1071,17,1088,1309,0,0,83.12,822,249,科園里,NULL
347,1083,5,1088,1352,0,0,80.47,734,349,金湖里,NULL
386,1081,7,1088,1322,0,0,82.3,723,358,內溝里,NULL
957,1076,12,1088,1398,0,0,77.83,702,374,文北里,NULL
685,1079,9,1088,1485,0,0,73.27,684,395,鎮興里,NULL
656,1080,8,1088,1391,0,0,78.22,684,396,三愛里,NULL
100,1082,6,1088,1418,0,0,76.73,669,413,秀山里,NULL
655,1076,12,1088,1426,0,0,76.3,667,409,三橋里,NULL
179,1076,12,1088,1444,0,0,75.35,667,409,三光里,NULL
161,1076,12,1088,1458,0,0,74.62,653,423,興業里,NULL
0,1076,12,1088,1458,0,0,74.62,653,423,興業里,NULL
237,1076,12,1088,1367,0,0,79.59,631,445,蘭興里,NULL
1517,1080,8,1088,1354,0,0,80.35,619,461,樹德里,NULL
98,1080,8,1088,1375,0,0,79.13,617,463,民生里,NULL
0,1080,8,1088,1375,0,0,79.13,617,463,民生里,NULL
606,1081,7,1088,1384,0,0,78.61,593,488,林榮里,NULL
1032,1080,8,1088,1363,0,0,79.82,568,512,忠德里,NULL
513,1077,11,1088,1400,0,0,77.71,530,547,永順里,NULL
739,1082,6,1088,1390,0,0,78.27,459,623,中厝里,NULL
576,1081,6,1087,1325,0,0,82.04,860,221,西村里,NULL
218,1076,11,1087,1340,0,0,81.12,831,245,合興里,NULL
1600,1079,8,1087,1369,0,0,79.4,754,325,忠孝里,NULL
929,1075,12,1087,1348,0,0,80.64,736,339,龍光里,NULL
958,1080,7,1087,1379,0,0,78.83,716,364,文北里,NULL
406,1078,9,1087,1375,0,0,79.05,708,370,湖元里,NULL
772,1080,7,1087,1518,0,0,71.61,702,378,復興里,NULL
0,1080,7,1087,1518,0,0,71.61,702,378,復興里,NULL
693,1080,7,1087,1376,0,0,79,689,391,錦和里,NULL
972,1082,5,1087,1516,0,0,71.7,680,402,萬壽里,NULL
53,1072,15,1087,1399,0,0,77.7,675,397,山犁里,NULL
1664,1076,11,1087,1375,0,0,79.05,650,426,保安里,NULL
1411,1073,14,1087,1416,0,0,76.77,643,430,永富里,NULL
0,1085,2,1087,1494,0,0,72.76,613,472,梅南里,NULL
0,1076,11,1087,1561,0,0,69.63,594,482,合成里,NULL
736,1076,11,1087,1400,0,0,77.64,572,504,神岡村,NULL
415,1074,13,1087,1447,0,0,75.12,567,507,光文里,NULL
332,1078,9,1087,1393,0,0,78.03,565,513,大有里,NULL
569,1080,7,1087,1380,0,0,78.77,549,531,普天里,NULL
806,1080,7,1087,1453,0,0,74.81,523,557,南興村,NULL
807,1077,10,1087,1387,0,0,78.37,516,561,盛豐里,NULL
81,1078,9,1087,1385,0,0,78.48,501,577,中山里,NULL
0,1078,9,1087,1385,0,0,78.48,501,577,中山里,NULL
521,1080,7,1087,1356,0,0,80.16,488,592,赤山村,NULL
428,1076,11,1087,1380,0,0,78.77,460,616,寶龍里,NULL
465,1077,10,1087,1448,0,0,75.07,434,643,安康里,NULL
390,1080,7,1087,1471,0,0,73.9,430,650,龍山村,NULL
73,1079,7,1086,1278,0,0,84.98,986,93,忠誠里,NULL
1189,1080,6,1086,1358,0,0,79.97,843,237,百福里,NULL
0,1075,11,1086,1381,0,0,78.64,814,261,双潭村,NULL
799,1073,13,1086,1309,0,0,82.96,776,297,秀仁里,NULL
780,1075,11,1086,1345,0,0,80.74,761,314,秀福里,NULL
2047,1079,7,1086,1348,0,0,80.56,734,345,貴和村,NULL
299,1071,15,1086,1343,0,0,80.86,692,379,大和里,NULL
644,1078,8,1086,1319,0,0,82.34,685,393,中行里,NULL
245,1075,11,1086,1349,0,0,80.5,671,404,平順里,NULL
358,1073,13,1086,1360,0,0,79.85,637,436,健行里,NULL
1111,1072,14,1086,1387,0,0,78.3,630,442,民全里,NULL
715,1079,7,1086,1461,0,0,74.33,627,452,中山里,NULL
187,1072,14,1086,1357,0,0,80.03,614,458,新路村,NULL
477,1072,14,1086,1379,0,0,78.75,613,459,建國里,NULL
349,1082,4,1086,1396,0,0,77.79,590,492,仁愛里,NULL
231,1074,12,1086,1389,0,0,78.19,574,500,光化里,NULL
0,1074,12,1086,1389,0,0,78.19,574,500,光化里,NULL
396,1073,13,1086,1336,0,0,81.29,567,506,大園村,NULL
57,1076,10,1086,1395,0,0,77.85,557,519,八仙里,NULL
280,1071,15,1086,1574,0,0,69,554,517,濁水村,NULL
0,1071,15,1086,1574,0,0,69,554,517,濁水村,NULL
0,1072,14,1086,1663,0,0,65.3,484,588,赤山村,NULL
102,1074,12,1086,1404,0,0,77.35,455,619,仁翠里,NULL
0,1074,12,1086,1408,0,0,77.13,395,679,溪寮村,NULL
312,1074,12,1086,1502,0,0,72.3,374,700,月潭村,NULL
0,1074,12,1086,1502,0,0,72.3,374,700,月潭村,NULL
1092,1083,2,1085,1382,0,0,78.51,1010,73,義村里,NULL
11,1080,5,1085,1500,0,0,72.33,868,212,民孝里,NULL
652,1077,8,1085,1369,0,0,79.25,806,271,景南里,NULL
65,1079,6,1085,1455,0,0,74.57,806,273,國富里,NULL
605,1076,9,1085,1369,0,0,79.25,727,349,南山里,NULL
270,1076,9,1085,1446,0,0,75.03,722,354,大東村,NULL
1140,1077,8,1085,1379,0,0,78.68,711,366,國校里,NULL
730,1078,7,1085,1404,0,0,77.28,696,382,新庄里,NULL
716,1071,14,1085,1358,0,0,79.9,695,376,安穗里,NULL
395,1057,28,1085,1403,0,0,77.33,695,362,吉龍里,NULL
0,1078,7,1085,1578,0,0,68.76,681,397,北山村,NULL
251,1078,7,1085,1377,0,0,78.79,667,411,豐田里,NULL
24,1080,5,1085,1382,0,0,78.51,639,441,中正里,NULL
3,1072,13,1085,1469,0,0,73.86,635,437,負郭里,NULL
1049,1080,5,1085,1372,0,0,79.08,601,479,立泰里,NULL
721,1075,10,1085,1368,0,0,79.31,597,478,廣興村,NULL
139,1074,11,1085,1393,0,0,77.89,575,499,莒光里,NULL
2025,1074,11,1085,1338,0,0,81.09,555,519,同興村,NULL
967,1075,10,1085,1367,0,0,79.37,548,527,和平里,NULL
643,1077,8,1085,1408,0,0,77.06,528,549,正強里,NULL
1974,1071,14,1085,1410,0,0,76.95,491,580,成州村,NULL
238,1079,6,1085,1407,0,0,77.11,408,671,大埔里、必信里,NULL
0,1079,6,1085,1407,0,0,77.11,408,671,大埔里、必信里,NULL
265,1079,6,1085,1388,0,0,78.17,348,731,湖西里,NULL
0,1079,6,1085,1388,0,0,78.17,348,731,湖西里,NULL
67,1071,13,1084,1467,0,0,73.89,786,285,國裕里,NULL
223,1077,7,1084,1491,0,0,72.7,743,334,幸福村,NULL
2097,1077,7,1084,1381,0,0,78.49,718,359,埔新村,NULL
202,1077,7,1084,1377,0,0,78.72,691,386,境福里,NULL
476,1075,9,1084,1367,0,0,79.3,671,404,合作里,NULL
632,1069,15,1084,1370,0,0,79.12,629,440,新社村,NULL
446,1075,9,1084,1423,0,0,76.18,623,452,瑞城里,NULL
1487,1071,13,1084,1375,0,0,78.84,602,469,樓厝里,NULL
497,1077,7,1084,1393,0,0,77.82,584,493,永盛里,NULL
200,1076,8,1084,1405,0,0,77.15,581,495,永安里,NULL
622,1070,14,1084,1378,0,0,78.66,574,496,忠福里,NULL
731,1075,9,1084,1356,0,0,79.94,559,516,新庄里,NULL
76,1074,10,1084,1494,0,0,72.56,510,564,永和里,NULL
620,1074,10,1084,1339,0,0,80.96,486,588,福地里,NULL
90,1079,5,1084,1433,0,0,75.65,402,677,仁得里,NULL
96,1076,7,1083,1352,0,0,80.1,902,174,朝棟里,NULL
635,1070,13,1083,1374,0,0,78.82,805,265,華新里,NULL
166,1074,9,1083,1435,0,0,75.47,710,364,大興里,NULL
2024,1074,9,1083,1374,0,0,78.82,696,378,同興村,NULL
118,1075,8,1083,1421,0,0,76.21,686,389,柴橋里,NULL
598,1075,8,1083,1341,0,0,80.76,615,460,民主里,NULL
134,1075,8,1083,1400,0,0,77.36,605,470,福德里,NULL
561,1074,9,1083,1427,0,0,75.89,545,529,七星里,NULL
0,1074,9,1083,1427,0,0,75.89,545,529,七星里,NULL
600,1074,9,1083,1361,0,0,79.57,537,537,民主里,NULL
131,1068,15,1083,1502,0,0,72.1,482,586,廉使里,NULL
15,1074,9,1083,1460,0,0,74.18,452,622,土庫村,NULL
2,1076,7,1083,1360,0,0,79.63,446,630,清豐里,NULL
492,1070,13,1083,1431,0,0,75.68,431,639,仁武村,NULL
0,1075,8,1083,1475,0,0,73.42,409,666,新厝村,NULL
136,1068,15,1083,1528,0,0,70.88,362,706,中林村,NULL
0,1068,15,1083,1528,0,0,70.88,362,706,中林村,NULL
1090,1071,11,1082,1496,0,0,72.33,739,332,仁愛里,NULL
688,1074,8,1082,1375,0,0,78.69,728,346,南勢里,NULL
234,1069,13,1082,1473,0,0,73.46,705,364,瑞興村,NULL
0,1069,13,1082,1473,0,0,73.46,705,364,瑞興村,NULL
120,1070,12,1082,1390,0,0,77.84,689,381,關渡里,NULL
221,1073,9,1082,1442,0,0,75.03,679,394,員山村,NULL
385,1072,10,1082,1366,0,0,79.21,674,398,內新里,NULL
717,1068,14,1082,1530,0,0,70.72,668,400,聚盛里,NULL
590,1077,5,1082,1375,0,0,78.69,666,411,敦厚里,NULL
262,1070,12,1082,1423,0,0,76.04,653,417,廣興里,NULL
1094,1071,11,1082,1420,0,0,76.2,638,433,萬安里,NULL
1407,1076,6,1082,1375,0,0,78.69,636,440,清水里,NULL
942,1075,7,1082,1298,0,0,83.36,621,454,全泰里,NULL
0,1067,15,1082,1591,0,0,68.01,619,448,大田村,NULL
1066,1076,6,1082,1376,0,0,78.63,609,467,丹鳳里,NULL
333,1074,8,1082,1335,0,0,81.05,599,475,大有里,NULL
199,1077,5,1082,1331,0,0,81.29,583,494,莊敬里,NULL
798,1071,11,1082,1345,0,0,80.45,559,512,鳳東里,NULL
451,1078,4,1082,1425,0,0,75.93,553,525,東興里,NULL
147,1070,12,1082,1407,0,0,76.9,552,518,港後村,NULL
117,1068,14,1082,1405,0,0,77.01,547,521,劉厝里,NULL
171,1063,19,1082,1404,0,0,77.07,490,573,福順里,NULL
259,1078,4,1082,1470,0,0,73.61,480,598,保定村,NULL
0,1074,8,1082,1472,0,0,73.51,333,741,正義村,NULL
787,1069,12,1081,1339,0,0,80.73,890,179,龍恩里,NULL
1224,1070,11,1081,1311,0,0,82.46,811,259,信義里,NULL
131,1075,6,1081,1358,0,0,79.6,770,305,中泰里,NULL
1259,1074,7,1081,1325,0,0,81.58,737,337,萬祥里,NULL
166,1069,12,1081,1492,0,0,72.45,684,385,拔雅里,NULL
0,1069,12,1081,1492,0,0,72.45,684,385,拔雅里,NULL
1861,1072,9,1081,1397,0,0,77.38,672,400,竹圍里,NULL
1779,1070,11,1081,1470,0,0,73.54,652,418,大湖里,NULL
385,1068,13,1081,1390,0,0,77.77,640,428,藍興里,NULL
267,1072,9,1081,1333,0,0,81.1,638,434,萬安里,NULL
426,1070,11,1081,1343,0,0,80.49,634,436,舊莊里,NULL
144,1074,7,1081,1456,0,0,74.24,629,445,永康里,NULL
40,1069,12,1081,1435,0,0,75.33,622,447,前溪里,NULL
0,1073,8,1081,1493,0,0,72.4,607,466,中正里,NULL
256,1075,6,1081,1376,0,0,78.56,604,471,漳興里,NULL
415,1075,6,1081,1394,0,0,77.55,594,481,寶民里,NULL
526,1068,13,1081,1417,0,0,76.29,590,478,仁忠里,NULL
1023,1072,9,1081,1429,0,0,75.65,584,488,和德里,NULL
357,1069,12,1081,1409,0,0,76.72,566,503,福民里,NULL
534,1073,8,1081,1379,0,0,78.39,541,532,鳥松村,NULL
611,1062,19,1081,1367,0,0,79.08,514,548,南田里,NULL
7,1071,10,1081,1425,0,0,75.86,514,557,安順里,NULL
245,1073,8,1081,1315,0,0,82.21,444,629,藍橋里,NULL
0,1073,8,1081,1315,0,0,82.21,444,629,藍橋里,NULL
443,1071,10,1081,1476,0,0,73.24,412,659,石城村,NULL
0,1071,10,1081,1476,0,0,73.24,412,659,石城村,NULL
683,1068,12,1080,1315,0,0,82.13,842,226,景勤里,NULL
1349,1076,4,1080,1353,0,0,79.82,795,281,萬芳里,NULL
1149,1075,5,1080,1385,0,0,77.98,794,281,中興里,NULL
41,1069,11,1080,1664,0,0,64.9,780,289,豐榮里,NULL
1211,1067,13,1080,1467,0,0,73.62,745,322,建安里,NULL
1280,1068,12,1080,1417,0,0,76.22,709,359,日興里,NULL
575,1075,5,1080,1354,0,0,79.76,662,413,漳和里,NULL
971,1058,22,1080,1511,0,0,71.48,653,405,萬壽里,NULL
1133,1068,12,1080,1539,0,0,70.18,606,462,光華里,NULL
548,1069,11,1080,1318,0,0,81.94,551,518,大華村,NULL
579,1064,16,1080,1402,0,0,77.03,546,518,東勢里,NULL
0,1064,16,1080,1402,0,0,77.03,546,518,東勢里,NULL
309,1071,9,1080,1351,0,0,79.94,528,543,竹東村,NULL
116,1063,17,1080,1373,0,0,78.66,510,553,興北里,NULL
0,1063,17,1080,1373,0,0,78.66,510,553,興北里,NULL
517,1067,13,1080,1373,0,0,78.66,408,659,大灣村,NULL
0,1067,13,1080,1467,0,0,73.62,380,687,大興村,NULL
661,1073,6,1079,1350,0,0,79.93,866,207,自強里,NULL
532,1065,14,1079,1294,0,0,83.38,813,252,仁福里,NULL
920,1065,14,1079,1305,0,0,82.68,807,258,富林村,NULL
585,1075,4,1079,1400,0,0,77.07,764,311,中興村,NULL
178,1072,7,1079,1445,0,0,74.67,733,339,大忠村,NULL
680,1069,10,1079,1327,0,0,81.31,730,339,景聯里,NULL
797,1074,5,1079,1330,0,0,81.13,720,354,民權里,NULL
224,1068,11,1079,1508,0,0,71.55,698,370,幸福村,NULL
947,1072,7,1079,1398,0,0,77.18,627,445,梅花里,NULL
1497,1069,10,1079,1379,0,0,78.25,602,467,鷺江里,NULL
762,1071,8,1079,1400,0,0,77.07,583,488,新生里,NULL
114,1067,12,1079,1459,0,0,73.95,574,493,糠榔里,NULL
422,1064,15,1079,1351,0,0,79.87,534,530,重新里,NULL
0,1064,15,1079,1351,0,0,79.87,534,530,重新里,NULL
441,1063,16,1079,1466,0,0,73.6,417,646,灣愛里,NULL
334,1064,14,1078,1405,0,0,76.73,805,259,尖山村,NULL
0,1064,14,1078,1405,0,0,76.73,805,259,尖山村,NULL
33,1069,9,1078,1399,0,0,77.06,708,361,正義里,NULL
0,1069,9,1078,1399,0,0,77.06,708,361,正義里,NULL
378,1071,7,1078,1325,0,0,81.36,693,378,安湖里,NULL
38,1064,14,1078,1471,0,0,73.28,669,395,新庄里,NULL
145,1063,15,1078,1374,0,0,78.46,666,397,營盤里,NULL
376,1066,12,1078,1347,0,0,80.03,666,400,公民里,NULL
614,1065,13,1078,1413,0,0,76.29,664,401,興南里,NULL
518,1062,16,1078,1377,0,0,78.29,663,399,新高里,NULL
330,1071,7,1078,1396,0,0,77.22,657,414,甲寅村,NULL
1819,1068,10,1078,1446,0,0,74.55,638,430,介壽里,NULL
210,1061,17,1078,1364,0,0,79.03,614,447,舊社里,NULL
439,1068,10,1078,1369,0,0,78.74,600,468,一心里,NULL
13,1069,9,1078,1368,0,0,78.8,584,485,榮光里,NULL
266,1067,11,1078,1419,0,0,75.97,522,545,國宅里,NULL
1506,1073,5,1078,1366,0,0,78.92,500,573,仁德里,NULL
66,1069,9,1078,1465,0,0,73.58,439,630,玉泉村,NULL
0,1069,9,1078,1465,0,0,73.58,439,630,玉泉村,NULL
535,1070,7,1077,1292,0,0,83.36,989,81,自強里,NULL
47,1072,5,1077,1464,0,0,73.57,802,270,國風里,NULL
86,1069,8,1077,1379,0,0,78.1,761,308,福林里,NULL
418,1060,17,1077,1351,0,0,79.72,701,359,公正里,NULL
747,1075,2,1077,1290,0,0,83.49,698,377,北華里,NULL
397,1069,8,1077,1320,0,0,81.59,690,379,行善里,NULL
1362,1068,9,1077,1332,0,0,80.86,687,381,廣福里,NULL
461,1072,5,1077,1308,0,0,82.34,678,394,百福里,NULL
744,1068,9,1077,1367,0,0,78.79,659,409,中興里,NULL
55,1069,8,1077,1343,0,0,80.19,622,447,何福里,NULL
1347,1071,6,1077,1384,0,0,77.82,588,483,日新里,NULL
746,1072,5,1077,1327,0,0,81.16,578,494,和興里,NULL
184,1063,14,1077,1372,0,0,78.5,570,493,海山里,NULL
1975,1074,3,1077,1442,0,0,74.69,545,529,成州村,NULL
664,1068,9,1077,1306,0,0,82.47,531,537,竹西里,NULL
504,1065,12,1077,1413,0,0,76.22,473,592,中華村,NULL
0,1065,12,1077,1413,0,0,76.22,473,592,中華村,NULL
781,1066,11,1077,1386,0,0,77.71,460,606,鎮海里,NULL
607,1057,20,1077,1351,0,0,79.72,459,598,南村里,NULL
129,1070,7,1077,1596,0,0,67.48,413,657,中安里,NULL
0,1070,7,1077,1596,0,0,67.48,413,657,中安里,NULL
297,1063,14,1077,1395,0,0,77.2,386,677,玉成里,NULL
0,1063,14,1077,1395,0,0,77.2,386,677,玉成里,NULL
0,1069,8,1077,1553,0,0,69.35,374,695,三慶里,NULL
97,1059,17,1076,1359,0,0,79.18,877,182,仁愛里,NULL
228,1067,9,1076,1606,0,0,67,808,259,中城里,NULL
190,1068,8,1076,1377,0,0,78.14,804,264,東興村,NULL
55,1070,6,1076,1419,0,0,75.83,787,283,東明里,NULL
113,1064,12,1076,1391,0,0,77.35,747,317,高峰里,NULL
740,1064,12,1076,1405,0,0,76.58,728,336,雙連里,NULL
642,1059,17,1076,1415,0,0,76.04,717,342,南興里,NULL
732,1064,12,1076,1361,0,0,79.06,713,351,義民里,NULL
1053,1065,11,1076,1373,0,0,78.37,701,364,日祥里,NULL
592,1061,15,1076,1382,0,0,77.86,699,362,瓦磘里,NULL
773,1062,14,1076,1484,0,0,72.51,658,404,平和里,NULL
0,1062,14,1076,1484,0,0,72.51,658,404,平和里,NULL
145,1059,17,1076,1393,0,0,77.24,657,402,照門里,NULL
0,1059,17,1076,1393,0,0,77.24,657,402,照門里,NULL
411,1070,6,1076,1351,0,0,79.64,652,418,東興里,NULL
225,1063,13,1076,1365,0,0,78.83,639,424,中埔里,NULL
2040,1067,9,1076,1398,0,0,76.97,628,439,新明村,NULL
420,1072,4,1076,1345,0,0,80,564,508,寶業里,NULL
345,1065,11,1076,1387,0,0,77.58,538,527,中興里,NULL
474,1070,6,1076,1451,0,0,74.16,489,581,興東里,NULL
273,1060,16,1076,1493,0,0,72.07,484,576,復興里,NULL
826,1063,13,1076,1400,0,0,76.86,452,611,看東村,NULL
0,1063,13,1076,1400,0,0,76.86,452,611,看東村,NULL
540,1061,15,1076,1395,0,0,77.13,448,613,洽溪里,NULL
0,1061,15,1076,1395,0,0,77.13,448,613,洽溪里,NULL
1277,1064,11,1075,1447,0,0,74.29,857,207,香坡里,NULL
32,1069,6,1075,1312,0,0,81.94,810,259,竹仁里,NULL
839,1065,10,1075,1302,0,0,82.57,756,309,永元里,NULL
350,1069,6,1075,1326,0,0,81.07,727,342,成功里,NULL
1598,1059,16,1075,1420,0,0,75.7,681,378,忠孝里,NULL
385,1059,16,1075,1365,0,0,78.75,657,402,光明里,NULL
729,1067,8,1075,1412,0,0,76.13,657,410,復興里,NULL
822,1058,17,1075,1427,0,0,75.33,646,412,頭家村,NULL
180,1065,10,1075,1417,0,0,75.86,643,422,三光里,NULL
181,1067,8,1075,1427,0,0,75.33,642,425,興安里,NULL
707,1069,6,1075,1422,0,0,75.6,619,450,山東里,NULL
1000,1066,9,1075,1308,0,0,82.19,585,481,華江里,NULL
1660,1062,13,1075,1359,0,0,79.1,578,484,文林里,NULL
797,1073,2,1075,1383,0,0,77.73,536,537,鳳東里,NULL
419,1063,12,1075,1453,0,0,73.98,388,675,南關里,NULL
0,1063,12,1075,1453,0,0,73.98,388,675,南關里,NULL
652,1062,12,1074,1256,0,0,85.51,863,199,龍岡里,NULL
167,1071,3,1074,1375,0,0,78.11,820,251,鶯安里,NULL
880,1064,10,1074,1304,0,0,82.36,813,251,大新里,NULL
185,1064,10,1074,1287,0,0,83.45,790,274,湳中里,NULL
1250,1060,14,1074,1372,0,0,78.28,764,296,永平里,NULL
687,1056,18,1074,1323,0,0,81.18,736,320,景安里,NULL
1629,1065,9,1074,1364,0,0,78.74,704,361,橫科里,NULL
965,1065,9,1074,1397,0,0,76.88,682,383,昌平里,NULL
25,1063,11,1074,1344,0,0,79.91,682,381,新崙里,NULL
486,1065,9,1074,1333,0,0,80.57,672,393,新東里,NULL
23,1063,11,1074,1365,0,0,78.68,656,407,裕民里,NULL
427,1059,15,1074,1384,0,0,77.6,621,438,舊莊里,NULL
323,1062,12,1074,1288,0,0,83.39,614,448,崇成里,NULL
557,1066,8,1074,1355,0,0,79.26,606,460,美仁里,NULL
508,1062,12,1074,1419,0,0,75.69,531,531,新光里,NULL
72,1063,11,1074,1396,0,0,76.93,518,545,竹圍里,NULL
506,1065,9,1074,1360,0,0,78.97,510,555,永福里,NULL
488,1065,9,1074,1356,0,0,79.2,501,564,立德里,NULL
270,1061,13,1074,1399,0,0,76.77,467,594,光明里,NULL
227,1067,7,1074,1421,0,0,75.58,460,607,鼓岩里,NULL
0,1067,7,1074,1421,0,0,75.58,460,607,鼓岩里,NULL
836,1065,9,1074,1318,0,0,81.49,439,626,大有里,NULL
419,1065,9,1074,1426,0,0,75.32,324,741,南龍村,NULL
0,1065,9,1074,1426,0,0,75.32,324,741,南龍村,NULL
733,1058,15,1073,1369,0,0,78.38,758,300,義民里,NULL
161,1064,9,1073,1380,0,0,77.75,702,362,七賢里,NULL
22,1063,10,1073,1534,0,0,69.95,690,373,西衛里,NULL
236,1055,18,1073,1459,0,0,73.54,685,370,樂善村,NULL
732,1066,7,1073,1443,0,0,74.36,667,399,眉山村,NULL
415,1059,14,1073,1317,0,0,81.47,598,461,三石村,NULL
398,1057,16,1073,1409,0,0,76.15,596,461,平和里,NULL
0,1057,16,1073,1409,0,0,76.15,596,461,平和里,NULL
226,1053,20,1073,1496,0,0,71.72,577,476,怡平里,NULL
63,1063,10,1073,1426,0,0,75.25,554,509,安寮里,NULL
642,1065,8,1073,1409,0,0,76.15,485,580,正強里,NULL
108,1063,10,1073,1386,0,0,77.42,481,582,東崎里,NULL
66,1060,12,1072,1701,0,0,63.02,911,149,建農里,NULL
0,1060,12,1072,1701,0,0,63.02,911,149,建農里,NULL
638,1062,10,1072,1327,0,0,80.78,840,222,東南里,NULL
430,1062,10,1072,1463,0,0,73.27,775,287,好修村,NULL
0,1062,10,1072,1463,0,0,73.27,775,287,好修村,NULL
1220,1066,6,1072,1360,0,0,78.82,739,327,正聲里,NULL
521,1062,10,1072,1438,0,0,74.55,726,336,南和里,NULL
114,1061,11,1072,1388,0,0,77.23,712,349,埤北里,NULL
0,1061,11,1072,1388,0,0,77.23,712,349,埤北里,NULL
802,1067,5,1072,1341,0,0,79.94,708,359,埤頂里,NULL
14,1062,10,1072,1294,0,0,82.84,700,362,復中里,NULL
30,1067,5,1072,1383,0,0,77.51,688,379,進士里,NULL
205,1066,6,1072,1391,0,0,77.07,617,449,龍華村,NULL
62,1058,14,1072,1384,0,0,77.46,604,454,柑井里,NULL
109,1062,10,1072,1457,0,0,73.58,594,468,武鹿里,NULL
1306,1062,10,1072,1365,0,0,78.53,539,523,祖田里,NULL
0,1062,10,1072,1365,0,0,78.53,539,523,祖田里,NULL
732,1060,12,1072,1351,0,0,79.35,534,526,新庄里,NULL
143,1061,11,1072,1357,0,0,79,534,527,和順里,NULL
485,1051,21,1072,1369,0,0,78.31,515,536,瓦南村,NULL
0,1051,21,1072,1369,0,0,78.31,515,536,瓦南村,NULL
149,1059,13,1072,1427,0,0,75.12,504,555,文成里,NULL
460,1061,11,1072,1328,0,0,80.72,470,591,東門里,NULL
0,1062,10,1072,1663,0,0,64.46,448,614,長北村,NULL
644,1067,5,1072,1351,0,0,79.35,440,627,仁愛村,NULL
52,1063,8,1071,1289,0,0,83.09,930,133,武功里,NULL
1091,1062,9,1071,1381,0,0,77.55,924,138,義村里,NULL
7,1067,4,1071,1318,0,0,81.26,865,202,維新里,NULL
480,1065,6,1071,1345,0,0,79.63,674,391,新益里,NULL
126,1064,7,1071,1359,0,0,78.81,649,415,文山里,NULL
976,1057,14,1071,1353,0,0,79.16,645,412,新起里,NULL
318,1062,9,1071,1314,0,0,81.51,642,420,崇德里,NULL
116,1056,15,1071,1410,0,0,75.96,619,437,關渡里,NULL
59,1066,5,1071,1297,0,0,82.58,602,464,漢生里,NULL
1162,1063,8,1071,1320,0,0,81.14,585,478,通化里,NULL
0,1062,9,1071,1492,0,0,71.78,580,482,田心里,NULL
365,1068,3,1071,1367,0,0,78.35,578,490,竹圍里,NULL
396,1060,11,1071,1345,0,0,79.63,576,484,行善里,NULL
286,1065,6,1071,1430,0,0,74.9,545,520,五結村,NULL
57,1065,6,1071,1486,0,0,72.07,526,539,淵中里,NULL
1527,1062,9,1071,1427,0,0,75.05,521,541,水河里,NULL
724,1061,10,1071,1341,0,0,79.87,516,545,文山里,NULL
274,1063,8,1071,1398,0,0,76.61,497,566,廣安村,NULL
0,1063,8,1071,1398,0,0,76.61,497,566,廣安村,NULL
867,1058,13,1071,1336,0,0,80.16,496,562,鄰江里,NULL
202,1060,11,1071,1341,0,0,79.87,449,611,民強里,NULL
714,1064,7,1071,1408,0,0,76.07,444,620,山明里,NULL
39,1056,14,1070,1286,0,0,83.2,845,211,嘉新里,NULL
220,1060,10,1070,1351,0,0,79.2,787,273,後庄里,NULL
304,1058,12,1070,1330,0,0,80.45,785,273,雙溪村,NULL
440,1058,12,1070,1413,0,0,75.73,784,274,新水村,NULL
0,1058,12,1070,1413,0,0,75.73,784,274,新水村,NULL
1080,1063,7,1070,1355,0,0,78.97,783,280,和安里,NULL
814,1063,7,1070,1404,0,0,76.21,772,291,中興里,NULL
247,1063,7,1070,1358,0,0,78.79,755,308,中崙村,NULL
142,1060,10,1070,1378,0,0,77.65,743,317,瑞慶里,NULL
1151,1058,12,1070,1386,0,0,77.2,730,328,龍雲里,NULL
2021,1057,13,1070,1314,0,0,81.43,708,349,同榮村,NULL
625,1062,8,1070,1332,0,0,80.33,687,375,中山里,NULL
2152,1063,7,1070,1338,0,0,79.97,662,401,龍源村,NULL
384,1060,10,1070,1431,0,0,74.77,659,401,內新里,NULL
115,1059,11,1070,1336,0,0,80.09,624,435,德翠里,NULL
45,1065,5,1070,1413,0,0,75.73,602,463,文中里,NULL
701,1061,9,1070,1413,0,0,75.73,586,475,順苓里,NULL
437,1065,5,1070,1405,0,0,76.16,585,480,田心里,NULL
787,1064,6,1070,1347,0,0,79.44,581,483,東門里,NULL
1390,1057,13,1070,1333,0,0,80.27,574,483,青雲里,NULL
945,1061,9,1070,1350,0,0,79.26,573,488,忠孝里,NULL
332,1064,6,1070,1378,0,0,77.65,568,496,溝美里,NULL
510,1063,7,1070,1393,0,0,76.81,540,523,永寧里,NULL
0,1063,7,1070,1393,0,0,76.81,540,523,永寧里,NULL
0,1059,11,1070,1465,0,0,73.04,523,536,中坑里,NULL
694,1063,7,1070,1444,0,0,74.1,511,552,三苓里,NULL
73,1059,11,1070,1346,0,0,79.49,413,646,洽興村,NULL
0,1059,11,1070,1346,0,0,79.49,413,646,洽興村,NULL
13,1061,8,1069,1959,0,0,54.57,1033,28,古城里,NULL
0,1061,8,1069,1959,0,0,54.57,1033,28,古城里,NULL
841,1062,7,1069,1349,0,0,79.24,797,265,民權里,NULL
223,1060,9,1069,1364,0,0,78.37,699,361,裕興里,NULL
180,1056,13,1069,1411,0,0,75.76,693,363,八西里,NULL
0,1056,13,1069,1411,0,0,75.76,693,363,八西里,NULL
280,1058,11,1069,1379,0,0,77.52,692,366,阿夷里,NULL
127,1055,14,1069,1436,0,0,74.44,686,369,溝墘里,NULL
93,1056,13,1069,1360,0,0,78.6,664,392,東門里,NULL
122,1049,20,1069,1444,0,0,74.03,664,385,頭崙里,NULL
75,1060,9,1069,1359,0,0,78.66,656,404,林厝里,NULL
159,1049,20,1069,1355,0,0,78.89,597,452,大同里,NULL
718,1056,13,1069,1323,0,0,80.8,579,477,墩東村,NULL
70,1063,6,1069,1408,0,0,75.92,565,498,清江里,NULL
108,1061,8,1069,1486,0,0,71.94,560,501,武鹿里,NULL
1344,1054,15,1069,1350,0,0,79.19,553,501,日和里,NULL
319,1062,7,1069,1389,0,0,76.96,547,515,崙雅村,NULL
0,1062,7,1069,1389,0,0,76.96,547,515,崙雅村,NULL
552,1061,8,1069,1339,0,0,79.84,490,571,田西里,NULL
0,1061,8,1069,1339,0,0,79.84,490,571,田西里,NULL
382,1062,7,1069,1403,0,0,76.19,413,649,巷口里,NULL
0,1062,7,1069,1403,0,0,76.19,413,649,巷口里,NULL
122,1061,7,1068,1416,0,0,75.42,801,260,新埔里,NULL
167,1059,9,1068,1421,0,0,75.16,793,266,北斗里,NULL
567,1062,6,1068,1320,0,0,80.91,738,324,力行里,NULL
1245,1064,4,1068,1312,0,0,81.4,728,336,景美里,NULL
672,1050,18,1068,1368,0,0,78.07,724,326,六合里,NULL
658,1055,13,1068,1335,0,0,80,718,337,惠安里,NULL
873,1053,15,1068,1345,0,0,79.41,709,344,中山村,NULL
437,1061,7,1068,1334,0,0,80.06,673,388,東明里,NULL
246,1063,5,1068,1363,0,0,78.36,651,412,廣德里,NULL
173,1060,8,1068,1338,0,0,79.82,637,423,居仁里,NULL
0,1060,8,1068,1338,0,0,79.82,637,423,居仁里,NULL
82,1058,10,1068,1416,0,0,75.42,614,444,吉仁里,NULL
187,1058,10,1068,1440,0,0,74.17,611,447,鹿峰里,NULL
803,1062,6,1068,1384,0,0,77.17,561,501,六寶村,NULL
333,1060,7,1067,1397,0,0,76.38,800,260,鶴山村,NULL
0,1060,7,1067,1397,0,0,76.38,800,260,鶴山村,NULL
8,1063,4,1067,1454,0,0,73.38,764,299,新富里,NULL
162,1054,13,1067,1366,0,0,78.11,725,329,寶山里,NULL
252,1055,12,1067,1369,0,0,77.94,724,331,大庄里,NULL
537,1065,2,1067,1317,0,0,81.02,710,355,樹德里,NULL
118,1058,9,1067,1501,0,0,71.09,646,412,南華村,NULL
0,1058,9,1067,1501,0,0,71.09,646,412,南華村,NULL
731,1062,5,1067,1426,0,0,74.82,641,421,眉山村,NULL
48,1060,7,1067,1357,0,0,78.63,624,436,何仁里,NULL
591,1059,8,1067,1354,0,0,78.8,601,458,安祥里,NULL
564,1059,8,1067,1324,0,0,80.59,589,470,敦化里,NULL
383,1052,15,1067,1346,0,0,79.27,582,470,三民里,NULL
944,1057,10,1067,1274,0,0,83.75,573,484,忠孝里,NULL
461,1057,10,1067,1326,0,0,80.47,562,495,東門里,NULL
98,1060,7,1067,1382,0,0,77.21,517,543,公正里,NULL
26,1056,10,1066,1347,0,0,79.14,823,233,正砂里,NULL
1186,1058,8,1066,1315,0,0,81.06,815,243,福德里,NULL
28,1058,8,1066,1331,0,0,80.09,799,259,竹北里,NULL
827,1061,5,1066,1293,0,0,82.44,791,270,得和里,NULL
1242,1061,5,1066,1260,0,0,84.6,780,281,景東里,NULL
539,1063,3,1066,1362,0,0,78.27,736,327,樹德里,NULL
215,1058,8,1066,1334,0,0,79.91,725,333,松茂里,NULL
333,1057,9,1066,1385,0,0,76.97,661,396,崇德里,NULL
588,1053,13,1066,1338,0,0,79.67,657,396,福祥里,NULL
942,1058,8,1066,1363,0,0,78.21,648,410,光復里,NULL
1047,1054,12,1066,1381,0,0,77.19,635,419,立泰里,NULL
37,1058,8,1066,1449,0,0,73.57,633,425,東村里,NULL
63,1055,11,1066,1377,0,0,77.41,624,431,柑井里,NULL
423,1052,14,1066,1458,0,0,73.11,612,440,沙崙村,NULL
1383,1056,10,1066,1295,0,0,82.32,610,446,學士里,NULL
240,1061,5,1066,1440,0,0,74.03,608,453,山腳村,NULL
1357,1055,11,1066,1353,0,0,78.79,594,461,瑞興里,NULL
1473,1057,9,1066,1370,0,0,77.81,541,516,南港里,NULL
470,1059,7,1066,1356,0,0,78.61,539,520,安吉里,NULL
551,1052,14,1066,1388,0,0,76.8,524,528,東湳里,NULL
155,1051,15,1066,1473,0,0,72.37,507,544,南簡里,NULL
0,1059,7,1066,1760,0,0,60.57,493,566,嘉隆村,NULL
835,1057,9,1066,1355,0,0,78.67,492,565,光能里,NULL
241,1064,2,1066,1360,0,0,78.38,484,580,安樂里、平和里,NULL
0,1064,2,1066,1360,0,0,78.38,484,580,安樂里、平和里,NULL
763,1055,11,1066,1335,0,0,79.85,483,572,岸裡村,NULL
838,1056,10,1066,1335,0,0,79.85,443,613,瑞興里,NULL
0,1059,7,1066,1521,0,0,70.09,357,702,中庄村,NULL
35,1057,8,1065,1247,0,0,85.4,904,153,國光里,NULL
165,1061,4,1065,1369,0,0,77.79,713,348,大興里,NULL
0,1058,7,1065,1636,0,0,65.1,680,378,富琦村,NULL
803,1051,14,1065,1340,0,0,79.48,669,382,埤頂里,NULL
216,1056,9,1065,1432,0,0,74.37,648,408,松強里,NULL
54,1058,7,1065,1357,0,0,78.48,623,435,山犁里,NULL
51,1055,10,1065,1302,0,0,81.8,597,458,立賢里,NULL
177,1053,12,1065,1429,0,0,74.53,592,461,福安村,NULL
219,1057,8,1065,1343,0,0,79.3,585,472,久堂村,NULL
78,1058,7,1065,1325,0,0,80.38,579,479,介壽里,NULL
291,1058,7,1065,1368,0,0,77.85,564,494,大觀里,NULL
186,1055,10,1065,1376,0,0,77.4,556,499,鹿峰里,NULL
1052,1059,6,1065,1341,0,0,79.42,549,510,興德里,NULL
4,1056,9,1065,1402,0,0,75.96,354,702,潮厝村,NULL
0,1056,9,1065,1402,0,0,75.96,354,702,潮厝村,NULL
127,1058,6,1064,1421,0,0,74.88,722,336,中和里,NULL
948,1057,7,1064,1358,0,0,78.35,721,336,幸福里,NULL
248,1057,7,1064,1281,0,0,83.06,708,349,廣德里,NULL
141,1051,13,1064,1411,0,0,75.41,654,397,瑞慶里,NULL
375,1058,6,1064,1356,0,0,78.47,643,415,國光里,NULL
432,1056,8,1064,1371,0,0,77.61,601,455,光復里,NULL
121,1046,18,1064,1480,0,0,71.89,586,460,岑海里,NULL
93,1057,7,1064,1421,0,0,74.88,555,502,國華里,NULL
74,1050,14,1064,1385,0,0,76.82,544,506,林厝里,NULL
140,1049,15,1064,1385,0,0,76.82,529,520,西雅里,NULL
291,1052,12,1064,1318,0,0,80.73,446,606,豐裕里,NULL
84,1058,6,1064,1515,0,0,70.23,392,666,新圍村,NULL
0,1054,10,1064,1424,0,0,74.72,285,769,竹新村,NULL
60,1056,7,1063,1283,0,0,82.85,790,266,孝賢里,NULL
271,1053,10,1063,1450,0,0,73.31,753,300,茄明里,NULL
2071,1053,10,1063,1339,0,0,79.39,694,359,仁愛村,NULL
1236,1046,17,1063,1469,0,0,72.36,686,360,頂城里,NULL
0,1046,17,1063,1469,0,0,72.36,686,360,頂城里,NULL
480,1042,21,1063,1419,0,0,74.91,663,379,南興里,NULL
1906,1054,9,1063,1400,0,0,75.93,626,428,協元里,NULL
0,1054,9,1063,1400,0,0,75.93,626,428,協元里,NULL
194,1054,9,1063,1321,0,0,80.47,590,464,光仁里,NULL
2048,1051,12,1063,1381,0,0,76.97,580,471,貴和村,NULL
1396,1053,10,1063,1393,0,0,76.31,575,478,清化里,NULL
0,1053,10,1063,1393,0,0,76.31,575,478,清化里,NULL
198,1057,6,1063,1358,0,0,78.28,517,540,藥王里,NULL
146,1051,12,1063,1406,0,0,75.6,490,561,湖內里,NULL
764,1055,8,1063,1355,0,0,78.45,483,572,岸裡村,NULL
868,1057,5,1062,1340,0,0,79.25,804,253,民治里,NULL
867,1051,11,1062,1343,0,0,79.08,792,259,民治里,NULL
52,1057,5,1062,1416,0,0,75,782,275,龍岡里,NULL
142,1048,14,1062,1355,0,0,78.38,724,324,大厝里,NULL
177,1053,9,1062,1416,0,0,75,692,361,中崙里,NULL
0,1053,9,1062,1416,0,0,75,692,361,中崙里,NULL
1379,1057,5,1062,1306,0,0,81.32,680,377,明德里,NULL
623,1055,7,1062,1288,0,0,82.45,653,402,建和里,NULL
169,1055,7,1062,1265,0,0,83.95,652,403,溝墘里,NULL
355,1053,9,1062,1245,0,0,85.3,651,402,明湖里,NULL
840,1046,16,1062,1370,0,0,77.52,633,413,豐野里,NULL
447,1049,13,1062,1361,0,0,78.03,609,440,瑞城里,NULL
579,1051,11,1062,1482,0,0,71.66,529,522,圳寮村,NULL
0,1051,11,1062,1482,0,0,71.66,529,522,圳寮村,NULL
44,1055,7,1062,1280,0,0,82.97,525,530,宏榮里,NULL
644,1050,12,1062,1415,0,0,75.05,524,526,協成村,NULL
514,1053,9,1062,1340,0,0,79.25,515,538,永順里,NULL
54,1057,4,1061,1338,0,0,79.3,827,230,軍功里,NULL
1355,1060,1,1061,1327,0,0,79.95,803,257,萬美里,NULL
404,1053,8,1061,1366,0,0,77.67,712,341,鎮東里,NULL
452,1053,8,1061,1402,0,0,75.68,636,417,榴中里,NULL
1079,1051,10,1061,1359,0,0,78.07,563,488,龍鳳里,NULL
705,1054,7,1061,1333,0,0,79.59,560,494,西灣里,NULL
691,1054,7,1061,1338,0,0,79.3,523,531,大苓里,NULL
670,1051,10,1061,1389,0,0,76.39,449,602,竹南里,NULL
435,1049,12,1061,1399,0,0,75.84,416,633,牛庄里,NULL
0,1049,12,1061,1399,0,0,75.84,416,633,牛庄里,NULL
895,1052,8,1060,1360,0,0,77.94,749,303,河堤里,NULL
727,1054,6,1060,1284,0,0,82.55,698,356,德穗里,NULL
209,1054,6,1060,1435,0,0,73.87,687,367,南寮里,NULL
271,1046,14,1060,1335,0,0,79.4,662,384,下廍里,NULL
117,1047,13,1060,1446,0,0,73.31,655,392,草中里,NULL
540,1049,11,1060,1352,0,0,78.4,599,450,苓洲里,NULL
0,1049,11,1060,1352,0,0,78.4,599,450,苓洲里,NULL
2157,1050,10,1060,1431,0,0,74.07,589,461,埤頭村,NULL
1575,1046,14,1060,1365,0,0,77.66,561,485,長安里,NULL
0,1046,14,1060,1365,0,0,77.66,561,485,長安里,NULL
132,1048,12,1060,1444,0,0,73.41,546,502,橋頭里,NULL
769,1049,11,1060,1362,0,0,77.83,510,539,信德里,NULL
90,1020,40,1060,1350,0,0,78.52,429,591,南洲里,NULL
0,1020,40,1060,1350,0,0,78.52,429,591,南洲里,NULL
116,1043,17,1060,1434,0,0,73.92,406,637,洋厝里,NULL
883,1054,5,1059,1269,0,0,83.45,766,288,永安里,NULL
510,1053,6,1059,1326,0,0,79.86,713,340,光明里,NULL
0,1056,3,1059,1414,0,0,74.89,682,374,南龍里,NULL
724,1048,11,1059,1368,0,0,77.41,639,409,自強里,NULL
590,1045,14,1059,1359,0,0,77.92,598,447,幸福里,NULL
628,1050,9,1059,1376,0,0,76.96,595,455,五權里,NULL
160,1045,14,1059,1361,0,0,77.81,583,462,港嘴里,NULL
133,1049,10,1059,1339,0,0,79.09,522,527,龍翠里,NULL
350,1045,14,1059,1365,0,0,77.58,497,548,安西里,NULL
837,1047,12,1059,1329,0,0,79.68,473,574,大有里,NULL
17,1053,6,1059,1417,0,0,74.74,454,599,安慶里,NULL
0,1051,8,1059,1431,0,0,74,415,636,港東村,NULL
173,1051,8,1059,1478,0,0,71.65,334,717,太南里,NULL
0,1051,8,1059,1478,0,0,71.65,334,717,太南里,NULL
193,1050,8,1058,1350,0,0,78.37,779,271,德盛村,NULL
1055,1050,8,1058,1319,0,0,80.21,746,304,日祥里,NULL
591,1053,5,1058,1330,0,0,79.55,723,330,敦厚里,NULL
321,1052,6,1058,1391,0,0,76.06,711,341,金龍里,NULL
193,1048,10,1058,1382,0,0,76.56,704,344,暖西里,NULL
211,1042,16,1058,1394,0,0,75.9,695,347,三鹿里,NULL
181,1052,6,1058,1397,0,0,75.73,664,388,六結村,NULL
0,1052,6,1058,1397,0,0,75.73,664,388,六結村,NULL
220,1045,13,1058,1348,0,0,78.49,625,420,頂埔里,NULL
405,1049,9,1058,1408,0,0,75.14,619,430,橫峰村,NULL
598,1050,8,1058,1396,0,0,75.79,612,438,貢旗村,NULL
13,1054,4,1058,1323,0,0,79.97,612,442,潮洋里,NULL
0,1050,8,1058,1396,0,0,75.79,612,438,貢旗村,NULL
36,1042,16,1058,1393,0,0,75.95,606,436,頂店里,NULL
555,1049,9,1058,1423,0,0,74.35,588,461,西德里,NULL
1794,1052,6,1058,1317,0,0,80.33,578,474,永館里,NULL
1037,1047,11,1058,1328,0,0,79.67,569,478,錦德里,NULL
32,1047,10,1057,1266,0,0,83.49,1014,33,鵬程里,NULL
0,1049,8,1057,1638,0,0,64.53,977,72,金崙村,NULL
200,1046,11,1057,1295,0,0,81.62,798,248,孝勢村,NULL
0,1046,11,1057,1295,0,0,81.62,798,248,孝勢村,NULL
379,1053,4,1057,1293,0,0,81.75,732,321,安湖里,NULL
114,1050,7,1057,1321,0,0,80.02,724,326,高峰里,NULL
1439,1048,9,1057,1356,0,0,77.95,671,377,安和里,NULL
394,1050,7,1057,1392,0,0,75.93,663,387,路東里,NULL
0,1050,7,1057,1392,0,0,75.93,663,387,路東里,NULL
558,1046,11,1057,1367,0,0,77.32,659,387,美仁里,NULL
460,1051,6,1057,1340,0,0,78.88,640,411,百福里,NULL
274,1047,10,1057,1396,0,0,75.72,630,417,茄苳里,NULL
79,1049,8,1057,1312,0,0,80.56,616,433,介壽里,NULL
2041,1046,11,1057,1384,0,0,76.37,616,430,新明村,NULL
41,1049,8,1057,1400,0,0,75.5,611,438,延平里,NULL
184,1043,14,1057,1353,0,0,78.12,609,434,斗抵里,NULL
300,1043,14,1057,1387,0,0,76.21,605,438,福山里,NULL
100,1049,8,1057,1350,0,0,78.3,557,492,東埔里,NULL
456,1047,10,1057,1336,0,0,79.12,531,516,旱溪里,NULL
847,1048,9,1057,1359,0,0,77.78,443,605,新富里,NULL
660,1054,3,1057,1425,0,0,74.18,415,639,中厝村,NULL
93,1049,8,1057,1404,0,0,75.28,413,636,前潭里,NULL
0,1049,8,1057,1404,0,0,75.28,413,636,前潭里,NULL
157,1049,8,1057,1430,0,0,73.92,392,657,土庫里,NULL
0,1049,8,1057,1430,0,0,73.92,392,657,土庫里,NULL
478,1047,9,1056,1333,0,0,79.22,991,56,合作里,NULL
242,1048,8,1056,1305,0,0,80.92,849,199,尖山里,NULL
0,1048,8,1056,1305,0,0,80.92,849,199,尖山里,NULL
1219,1047,9,1056,1296,0,0,81.48,848,199,寶福里,NULL
1303,1050,6,1056,1360,0,0,77.65,783,267,興昌里,NULL
630,1044,12,1056,1385,0,0,76.25,714,330,德興村,NULL
0,1044,12,1056,1385,0,0,76.25,714,330,德興村,NULL
402,1042,14,1056,1483,0,0,71.21,698,344,豐田里,NULL
226,1042,14,1056,1395,0,0,75.7,666,376,松和里,NULL
841,1047,9,1056,1395,0,0,75.7,649,398,富岡里,NULL
548,1048,8,1056,1377,0,0,76.69,641,407,北湳里,NULL
249,1048,8,1056,1357,0,0,77.82,632,416,莿桐里,NULL
143,1050,6,1056,1397,0,0,75.59,631,419,三仙里,NULL
248,1050,6,1056,1376,0,0,76.74,538,512,壽星里,NULL
0,1050,6,1056,1376,0,0,76.74,538,512,壽星里,NULL
399,1048,8,1056,1368,0,0,77.19,537,511,泉南里,NULL
1457,1048,8,1056,1365,0,0,77.36,522,526,延平里,NULL
197,1043,12,1055,1280,0,0,82.42,816,227,愛勢村,NULL
7,1050,5,1055,1310,0,0,80.53,797,253,東海里,NULL
768,1043,12,1055,1292,0,0,81.66,783,260,中安里,NULL
1216,1051,4,1055,1315,0,0,80.23,770,281,寶興里,NULL
218,1047,8,1055,1300,0,0,81.15,758,289,松強里,NULL
669,1043,12,1055,1288,0,0,81.91,752,291,吉興里,NULL
866,1040,15,1055,1318,0,0,80.05,739,301,民樂里,NULL
868,1049,6,1055,1402,0,0,75.25,684,365,黃唐村,NULL
1987,1048,7,1055,1357,0,0,77.75,676,372,六福村,NULL
621,1043,12,1055,1337,0,0,78.91,630,413,仁美里,NULL
399,1041,14,1055,1354,0,0,77.92,619,422,石潭里,NULL
0,1041,14,1055,1354,0,0,77.92,619,422,石潭里,NULL
2057,1050,5,1055,1397,0,0,75.52,613,437,西林村,NULL
825,1044,11,1055,1386,0,0,76.12,606,438,頭家東村,NULL
80,1042,13,1055,1378,0,0,76.56,602,440,中庄里,NULL
384,1045,10,1055,1368,0,0,77.12,594,451,光明里,NULL
718,1044,11,1055,1335,0,0,79.03,560,484,社頭村,NULL
0,1042,13,1055,1406,0,0,75.04,556,486,南化村,NULL
288,1046,9,1055,1329,0,0,79.38,525,521,中庄里,NULL
438,1039,16,1055,1333,0,0,79.14,521,518,開元里,NULL
0,1039,16,1055,1333,0,0,79.14,521,518,開元里,NULL
375,1045,10,1055,1348,0,0,78.26,512,533,萬生村,NULL
0,1045,10,1055,1348,0,0,78.26,512,533,萬生村,NULL
621,1043,12,1055,1338,0,0,78.85,500,543,福居里,NULL
829,1041,14,1055,1272,0,0,82.94,485,556,新甲里,NULL
70,1044,11,1055,1447,0,0,72.91,335,709,三塊村,NULL
0,1044,11,1055,1447,0,0,72.91,335,709,三塊村,NULL
0,1047,7,1054,1312,0,0,80.34,924,123,光華里,NULL
306,1048,6,1054,1334,0,0,79.01,802,246,雙溪村,NULL
531,1042,12,1054,1365,0,0,77.22,792,250,龍德里,NULL
850,1046,8,1054,1294,0,0,81.45,734,312,秀成里,NULL
545,1044,10,1054,1300,0,0,81.08,715,329,龍興里,NULL
0,1041,13,1054,1521,0,0,69.3,694,347,明德村,NULL
139,1041,13,1054,1425,0,0,73.96,686,355,龍潭村,NULL
21,1043,11,1054,1420,0,0,74.23,680,363,義和里,NULL
59,1042,12,1054,1348,0,0,78.19,678,364,何源里,NULL
518,1050,4,1054,1359,0,0,77.56,665,385,民有里,NULL
51,1040,14,1054,1285,0,0,82.02,639,401,民權里,NULL
415,1046,8,1054,1346,0,0,78.31,630,416,三重里,NULL
736,1042,12,1054,1307,0,0,80.64,622,420,義興里,NULL
152,1044,10,1054,1360,0,0,77.5,594,450,新民里,NULL
0,1044,10,1054,1360,0,0,77.5,594,450,新民里,NULL
403,1044,10,1054,1279,0,0,82.41,570,474,湖興里,NULL
564,1046,8,1054,1323,0,0,79.67,562,484,普照里,NULL
434,1045,9,1054,1346,0,0,78.31,556,489,龍潭里,NULL
0,1045,9,1054,1346,0,0,78.31,556,489,龍潭里,NULL
857,1042,12,1054,1387,0,0,75.99,488,554,五甲村,NULL
384,1046,8,1054,1372,0,0,76.82,441,605,厦南村,NULL
0,1046,8,1054,1372,0,0,76.82,441,605,厦南村,NULL
459,1046,8,1054,1368,0,0,77.05,430,616,瑞興里,NULL
258,1040,13,1053,1356,0,0,77.65,826,214,松林村,NULL
837,1038,15,1053,1276,0,0,82.52,748,290,秀和里,NULL
577,1044,9,1053,1320,0,0,79.77,732,312,德義里,NULL
409,1047,6,1053,1354,0,0,77.77,683,364,朝陽村,NULL
0,1047,6,1053,1354,0,0,77.77,683,364,朝陽村,NULL
107,1049,4,1053,1427,0,0,73.79,677,372,德興里,NULL
288,1048,5,1053,1317,0,0,79.95,668,380,大明里,NULL
1065,1047,6,1053,1328,0,0,79.29,644,403,丹鳳里,NULL
1867,1042,11,1053,1351,0,0,77.94,634,408,民生里,NULL
323,1042,11,1053,1408,0,0,74.79,630,412,金龍里,NULL
458,1045,8,1053,1297,0,0,81.19,600,445,鴻福里,NULL
298,1041,12,1053,1379,0,0,76.36,600,441,國聖里,NULL
187,1043,10,1053,1312,0,0,80.26,554,489,九如里,NULL
1050,1037,16,1053,1329,0,0,79.23,549,488,立言里,NULL
586,1044,9,1053,1383,0,0,76.14,501,543,山脚里,NULL
0,1044,9,1053,1383,0,0,76.14,501,543,山脚里,NULL
399,1039,14,1053,1348,0,0,78.12,454,585,嘉峰里,NULL
669,1042,11,1053,1324,0,0,79.53,449,593,竹內里,NULL
439,1046,7,1053,1261,0,0,83.51,415,631,梓平村,NULL
0,1046,7,1053,1261,0,0,83.51,415,631,梓平村,NULL
18,1049,4,1053,1344,0,0,78.35,397,652,中陽里,NULL
684,1038,14,1052,1287,0,0,81.74,756,282,景福里,NULL
1370,1045,7,1052,1284,0,0,81.93,745,300,埤林里,NULL
1256,1039,13,1052,1275,0,0,82.51,717,322,萬有里,NULL
114,1041,11,1052,1375,0,0,76.51,708,333,安慶里,NULL
0,1041,11,1052,1375,0,0,76.51,708,333,安慶里,NULL
1141,1046,6,1052,1351,0,0,77.87,684,362,龍圖里,NULL
236,1037,15,1052,1357,0,0,77.52,670,367,忠權里,NULL
456,1043,9,1052,1293,0,0,81.36,662,381,鴻福里,NULL
651,1045,7,1052,1347,0,0,78.1,646,399,大道里,NULL
1630,1045,7,1052,1310,0,0,80.31,640,405,橫科里,NULL
549,1048,4,1052,1438,0,0,73.16,606,442,意誠里,NULL
1002,1043,9,1052,1311,0,0,80.24,600,443,恆安里,NULL
48,1046,6,1052,1365,0,0,77.07,588,458,新開里,NULL
0,1046,6,1052,1365,0,0,77.07,588,458,新開里,NULL
1302,1032,20,1052,1474,0,0,71.37,584,448,龜山里,NULL
0,1032,20,1052,1474,0,0,71.37,584,448,龜山里,NULL
1013,1048,4,1052,1347,0,0,78.1,552,496,中泰里,NULL
754,1046,6,1052,1365,0,0,77.07,551,495,社口村,NULL
535,1047,5,1052,1400,0,0,75.14,507,540,鳥松村,NULL
93,1037,14,1051,1363,0,0,77.11,837,200,商華里,NULL
2074,1046,5,1051,1347,0,0,78.03,793,253,麗林村,NULL
673,1044,7,1051,1341,0,0,78.37,764,280,六合里,NULL
1279,1031,20,1051,1374,0,0,76.49,747,284,日興里,NULL
1278,1041,10,1051,1332,0,0,78.9,723,318,興光里,NULL
156,1039,12,1051,1360,0,0,77.28,706,333,龍鳳里,NULL
1372,1037,14,1051,1344,0,0,78.2,699,338,廣興里,NULL
23,1042,9,1051,1379,0,0,76.21,648,394,上德里,NULL
550,1038,13,1051,1312,0,0,80.11,619,419,碧華里,NULL
818,1043,8,1051,1416,0,0,74.22,602,441,玉泉里,NULL
13,1042,9,1051,2881,0,0,36.48,597,445,社後里,NULL
48,1043,8,1051,1308,0,0,80.35,567,476,尊賢里,NULL
638,1042,9,1051,1324,0,0,79.38,553,489,五福里,NULL
702,1037,14,1051,1376,0,0,76.38,553,484,五汴村,NULL
0,1037,14,1051,1376,0,0,76.38,553,484,五汴村,NULL
447,1041,10,1051,1352,0,0,77.74,515,526,灣華里,NULL
226,1044,7,1051,1470,0,0,71.5,387,657,深溝村,NULL
0,1044,7,1051,1470,0,0,71.5,387,657,深溝村,NULL
363,1040,10,1050,1313,0,0,79.97,865,175,頭屋村,NULL
228,1042,8,1050,1329,0,0,79.01,831,211,蟠桃里,NULL
818,1038,12,1050,1317,0,0,79.73,787,251,裕成里,NULL
922,1040,10,1050,1336,0,0,78.59,769,271,文化里,NULL
634,1038,12,1050,1287,0,0,81.59,747,291,松友里,NULL
903,1041,9,1050,1367,0,0,76.81,726,315,板溪里,NULL
1595,1039,11,1050,1377,0,0,76.25,639,400,金龍里,NULL
170,1045,5,1050,1331,0,0,78.89,615,430,水田里,NULL
855,1045,5,1050,1339,0,0,78.42,553,492,蓬萊里,NULL
543,1030,20,1050,1358,0,0,77.32,531,499,富貴里,NULL
800,1042,8,1050,1356,0,0,77.43,455,587,中生村,NULL
0,1042,8,1050,1356,0,0,77.43,455,587,中生村,NULL
0,1035,14,1049,1884,0,0,55.68,881,154,豐濱村,NULL
305,1036,13,1049,1297,0,0,80.88,808,228,雙溪村,NULL
803,1040,9,1049,1290,0,0,81.32,800,240,復興里,NULL
477,1038,11,1049,1380,0,0,76.01,768,270,三民里,NULL
897,1036,13,1049,1288,0,0,81.44,736,300,和平里,NULL
1313,1041,8,1049,1356,0,0,77.36,735,306,明義里,NULL
58,1041,8,1049,1340,0,0,78.28,719,322,東安里,NULL
509,1046,3,1049,1311,0,0,80.02,710,336,新吉里,NULL
689,1038,11,1049,1310,0,0,80.08,697,341,嘉興里,NULL
522,1042,7,1049,1368,0,0,76.68,683,359,新福里,NULL
641,1037,12,1049,1402,0,0,74.82,676,361,東興里,NULL
269,1044,5,1049,1339,0,0,78.34,669,375,萬安里,NULL
322,1038,11,1049,1444,0,0,72.65,649,389,金龍里,NULL
272,1035,14,1049,1390,0,0,75.47,621,414,華德里,NULL
890,1042,7,1049,1426,0,0,73.56,615,427,上林村,NULL
838,1040,9,1049,1309,0,0,80.14,598,442,新樂里,NULL
746,1039,10,1049,1274,0,0,82.34,596,443,民有里,NULL
1373,1039,10,1049,1308,0,0,80.2,595,444,廣興里,NULL
729,1034,15,1049,1366,0,0,76.79,585,449,東興村,NULL
0,1034,15,1049,1366,0,0,76.79,585,449,東興村,NULL
18,1041,8,1049,1343,0,0,78.11,578,463,長竹里,NULL
1114,1038,11,1049,1333,0,0,78.69,573,465,成德里,NULL
334,1036,13,1049,1300,0,0,80.69,513,523,博愛里,NULL
277,1040,8,1048,1323,0,0,79.21,988,52,鵬程里,NULL
0,1040,8,1048,1323,0,0,79.21,988,52,鵬程里,NULL
709,1037,11,1048,1345,0,0,77.92,730,307,義德村,NULL
40,1041,7,1048,1305,0,0,80.31,728,313,竹義里,NULL
187,1040,8,1048,1299,0,0,80.68,708,332,舊社里,NULL
707,1036,12,1048,1379,0,0,76,694,342,義里村,NULL
293,1042,6,1048,1293,0,0,81.05,661,381,港都里,NULL
725,1042,6,1048,1437,0,0,72.93,655,387,晴光里,NULL
591,1034,14,1048,1348,0,0,77.74,642,392,瓦磘里,NULL
66,1036,12,1048,1309,0,0,80.06,640,396,大鵬里,NULL
579,1031,17,1048,1319,0,0,79.45,634,397,廟美里,NULL
229,1043,5,1048,1377,0,0,76.11,630,413,平和里,NULL
70,1043,5,1048,1350,0,0,77.63,627,416,興仁里,NULL
204,1037,11,1048,1349,0,0,77.69,623,414,晉江里,NULL
0,1037,11,1048,1349,0,0,77.69,623,414,晉江里,NULL
10,1039,9,1048,1375,0,0,76.22,619,420,中山里,NULL
19,1045,3,1048,1349,0,0,77.69,567,478,溪北里,NULL
541,1032,16,1048,1381,0,0,75.89,535,497,苓昇里,NULL
0,1032,16,1048,1381,0,0,75.89,535,497,苓昇里,NULL
459,1043,5,1048,1380,0,0,75.94,519,524,典寶村,NULL
195,1039,9,1048,1280,0,0,81.88,466,573,永倫里,NULL
175,1041,7,1048,1373,0,0,76.33,444,597,永福里,NULL
0,1041,7,1048,1373,0,0,76.33,444,597,永福里,NULL
13,1033,15,1048,1317,0,0,79.57,340,693,頂安里,NULL
320,1035,12,1047,1349,0,0,77.61,719,316,大湖里,NULL
127,1038,9,1047,1418,0,0,73.84,717,321,愛蘭里,NULL
0,1038,9,1047,1418,0,0,73.84,717,321,愛蘭里,NULL
366,1039,8,1047,1310,0,0,79.92,677,362,小東里,NULL
2094,1036,11,1047,1317,0,0,79.5,642,394,深坑村,NULL
604,1037,10,1047,1291,0,0,81.1,641,396,雅祥里,NULL
998,1038,9,1047,1330,0,0,78.72,611,427,華江里,NULL
14,1036,11,1047,1316,0,0,79.56,604,432,社後里,NULL
757,1035,12,1047,1378,0,0,75.98,599,436,新福里,NULL
1694,1027,20,1047,1358,0,0,77.1,558,469,坡內里,NULL
0,1027,20,1047,1358,0,0,77.1,558,469,坡內里,NULL
1438,1037,10,1047,1335,0,0,78.43,557,480,安和里,NULL
1014,1039,8,1047,1330,0,0,78.72,549,490,雙園里,NULL
139,1033,14,1047,1478,0,0,70.84,546,487,牛眠里,NULL
114,1039,8,1047,1336,0,0,78.37,500,539,福全里,NULL
1009,1041,6,1047,1282,0,0,81.67,486,555,頂碩里,NULL
956,1037,10,1047,1327,0,0,78.9,469,568,化成里,NULL
180,1037,10,1047,1396,0,0,75,456,581,公正里,NULL
0,1037,10,1047,1396,0,0,75,456,581,公正里,NULL
75,1038,8,1046,1308,0,0,79.97,807,231,關東里,NULL
144,1037,9,1046,1309,0,0,79.91,704,333,黎明里,NULL
227,1034,12,1046,1261,0,0,82.95,694,340,東山里,NULL
137,1032,14,1046,1377,0,0,75.96,644,388,新西里,NULL
0,1032,14,1046,1377,0,0,75.96,644,388,新西里,NULL
737,1039,7,1046,1373,0,0,76.18,638,401,神岡村,NULL
230,1042,4,1046,1422,0,0,73.56,598,444,埔前里,NULL
508,1042,4,1046,1291,0,0,81.02,575,467,八卦村,NULL
105,1037,9,1046,1356,0,0,77.14,544,493,頂厝里,NULL
1472,1036,10,1046,1334,0,0,78.41,528,508,南港里,NULL
114,1039,7,1046,1334,0,0,78.41,395,644,興南村,NULL
0,1039,7,1046,1334,0,0,78.41,395,644,興南村,NULL
240,1038,8,1046,1370,0,0,76.35,371,667,大坑村,NULL
0,1038,8,1046,1370,0,0,76.35,371,667,大坑村,NULL
0,1033,13,1046,1406,0,0,74.4,346,687,拷潭村,NULL
316,1036,10,1046,1534,0,0,68.19,274,762,楊賢村,NULL
0,1036,10,1046,1534,0,0,68.19,274,762,楊賢村,NULL
815,1035,10,1045,1339,0,0,78.04,776,259,楊明里,NULL
1126,1034,11,1045,1326,0,0,78.81,724,310,錦安里,NULL
1189,1035,10,1045,1294,0,0,80.76,721,314,龍淵里,NULL
1260,1038,7,1045,1316,0,0,79.41,721,317,萬祥里,NULL
225,1025,20,1045,1448,0,0,72.17,713,312,幸福村,NULL
279,1037,8,1045,1312,0,0,79.65,703,334,高城里,NULL
582,1040,5,1045,1382,0,0,75.62,697,343,中興里,NULL
1127,1033,12,1045,1345,0,0,77.7,687,346,福住里,NULL
317,1032,13,1045,1373,0,0,76.11,658,374,中庄村,NULL
596,1040,5,1045,1281,0,0,81.58,656,384,安康里,NULL
925,1034,11,1045,1309,0,0,79.83,644,390,愛國里,NULL
394,1029,16,1045,1410,0,0,74.11,596,433,大園村,NULL
393,1035,10,1045,1334,0,0,78.34,595,440,安龍里,NULL
350,1035,10,1045,1378,0,0,75.83,589,446,福樂村,NULL
199,1038,7,1045,1392,0,0,75.07,559,479,光華里,NULL
440,1038,7,1045,1344,0,0,77.75,508,530,西新里,NULL
455,1039,6,1045,1333,0,0,78.39,492,547,奕壽里,NULL
0,1039,6,1045,1333,0,0,78.39,492,547,奕壽里,NULL
263,1034,11,1045,1452,0,0,71.97,473,561,過溪里,NULL
0,1034,11,1045,1452,0,0,71.97,473,561,過溪里,NULL
520,1030,15,1045,1533,0,0,68.17,419,611,五庄村,NULL
0,1030,15,1045,1533,0,0,68.17,419,611,五庄村,NULL
295,1034,11,1045,1362,0,0,76.73,269,765,二鎮村,NULL
646,1031,13,1044,1333,0,0,78.32,814,217,忠孝里,NULL
404,1038,6,1044,1341,0,0,77.85,814,224,大西村,NULL
884,1031,13,1044,1367,0,0,76.37,791,240,龍祥村,NULL
702,1036,8,1044,1353,0,0,77.16,777,259,湧光里,NULL
1155,1038,6,1044,1372,0,0,76.09,734,304,張北里,NULL
156,1039,5,1044,1475,0,0,70.78,722,317,武營里,NULL
0,1039,5,1044,1475,0,0,70.78,722,317,武營里,NULL
317,1040,4,1044,1358,0,0,76.88,693,347,錦洲里,NULL
188,1032,12,1044,1295,0,0,80.62,666,366,和興村,NULL
74,1033,11,1044,1438,0,0,72.6,660,373,大東村,NULL
1398,1034,10,1044,1330,0,0,78.5,659,375,清溪里,NULL
823,1035,9,1044,1307,0,0,79.88,633,402,頭家村,NULL
1553,1036,8,1044,1331,0,0,78.44,629,407,秀峰里,NULL
729,1035,9,1044,1375,0,0,75.93,613,422,文德里,NULL
617,1031,13,1044,1280,0,0,81.56,611,420,仁和里,NULL
771,1029,15,1044,1342,0,0,77.79,560,469,溪洲村,NULL
1519,1029,15,1044,1302,0,0,80.18,549,480,民和里,NULL
472,1037,7,1044,1399,0,0,74.62,462,575,尚義村,NULL
179,1028,16,1044,1422,0,0,73.42,451,577,赤嵌里,NULL
0,1028,16,1044,1422,0,0,73.42,451,577,赤嵌里,NULL
337,1037,7,1044,1342,0,0,77.79,444,593,港東里,NULL
0,1037,7,1044,1342,0,0,77.79,444,593,港東里,NULL
130,1042,2,1044,1485,0,0,70.3,391,651,東安里,NULL
0,1042,2,1044,1485,0,0,70.3,391,651,東安里,NULL
200,1034,10,1044,1330,0,0,78.5,315,719,福安里,NULL
4,1037,6,1043,1977,0,0,52.76,975,62,南門里,NULL
211,1039,4,1043,1379,0,0,75.63,813,226,上興里,NULL
0,1039,4,1043,1379,0,0,75.63,813,226,上興里,NULL
661,1027,16,1043,1242,0,0,83.98,736,291,惠安里,NULL
813,1034,9,1043,1271,0,0,82.06,725,309,中興里,NULL
1173,1038,5,1043,1336,0,0,78.07,723,315,全安里,NULL
60,1036,7,1043,1336,0,0,78.07,704,332,何源里,NULL
2129,1034,9,1043,1531,0,0,68.13,700,334,埔坪村,NULL
213,1032,11,1043,1361,0,0,76.63,698,334,公明里,NULL
134,1036,7,1043,1399,0,0,74.55,688,348,台溪里,NULL
0,1036,7,1043,1399,0,0,74.55,688,348,台溪里,NULL
1990,1037,6,1043,1309,0,0,79.68,614,423,民義村,NULL
509,1031,12,1043,1312,0,0,79.5,596,435,三民里,NULL
443,1039,4,1043,1286,0,0,81.1,591,448,玉成里,NULL
245,1031,12,1043,1349,0,0,77.32,559,472,天祿里,NULL
118,1035,8,1043,1406,0,0,74.18,537,498,劉厝里,NULL
34,1036,7,1043,1374,0,0,75.91,527,509,新豐里,NULL
140,1037,6,1043,1518,0,0,68.71,526,511,西屯里,NULL
0,1037,6,1043,1518,0,0,68.71,526,511,西屯里,NULL
194,1032,11,1043,1331,0,0,78.36,494,538,忠正里,NULL
101,1037,6,1043,1407,0,0,74.13,453,584,復興村,NULL
0,1037,6,1043,1407,0,0,74.13,453,584,復興村,NULL
478,1038,5,1043,1356,0,0,76.92,437,601,興東里,NULL
293,1035,8,1043,1425,0,0,73.19,393,642,錦眾村,NULL
0,1035,8,1043,1425,0,0,73.19,393,642,錦眾村,NULL
125,1031,11,1042,1268,0,0,82.18,825,206,二重里,NULL
1179,1035,7,1042,1286,0,0,81.03,809,226,建國里,NULL
1172,1031,11,1042,1316,0,0,79.18,787,244,中正里,NULL
205,1034,8,1042,1379,0,0,75.56,732,302,長興里,NULL
614,1035,7,1042,1307,0,0,79.72,636,399,信和里,NULL
445,1039,3,1042,1392,0,0,74.86,634,405,瑞城里,NULL
1709,1028,14,1042,1313,0,0,79.36,620,408,大同里,NULL
336,1033,9,1042,1326,0,0,78.58,619,414,新興村,NULL
386,1026,16,1042,1416,0,0,73.59,594,432,林北村,NULL
1788,1029,13,1042,1380,0,0,75.51,568,461,八張里,NULL
710,1032,10,1042,1338,0,0,77.88,558,474,民安里,NULL
1103,1031,11,1042,1338,0,0,77.88,552,479,四維里,NULL
424,1032,10,1042,1300,0,0,80.15,540,492,公益里,NULL
1117,1029,13,1042,1394,0,0,74.75,534,495,民安里,NULL
290,1030,12,1042,1303,0,0,79.97,507,523,豐裕里,NULL
164,1037,5,1042,1352,0,0,77.07,493,544,新雅里,NULL
213,1030,12,1042,1341,0,0,77.7,407,623,港仔里,NULL
0,1030,12,1042,1341,0,0,77.7,407,623,港仔里,NULL
671,1031,10,1041,1278,0,0,81.46,847,184,仁祥里,NULL
1171,1031,10,1041,1253,0,0,83.08,822,209,中正里,NULL
669,1032,9,1041,1344,0,0,77.46,782,250,仁和里,NULL
1635,1029,12,1041,1274,0,0,81.71,724,305,宜興里,NULL
898,1027,14,1041,1288,0,0,80.82,717,310,和平里,NULL
1142,1028,13,1041,1334,0,0,78.04,711,317,龍圖里,NULL
1291,1037,4,1041,1350,0,0,77.11,704,333,青潭里,NULL
1131,1035,6,1041,1315,0,0,79.16,696,339,永康里,NULL
668,1032,9,1041,1274,0,0,81.71,678,354,中興里,NULL
275,1034,7,1041,1364,0,0,76.32,664,370,磺溪村,NULL
0,1034,7,1041,1364,0,0,76.32,664,370,磺溪村,NULL
129,1033,8,1041,1332,0,0,78.15,636,397,義信里,NULL
593,1035,6,1041,1303,0,0,79.89,636,399,陽明里,NULL
135,1033,8,1041,1365,0,0,76.26,633,400,福德里,NULL
357,1037,4,1041,1321,0,0,78.8,627,410,東光里,NULL
584,1033,8,1041,1290,0,0,80.7,606,427,中正里,NULL
1127,1028,13,1041,1329,0,0,78.33,594,434,光正里,NULL
1755,1032,9,1041,1340,0,0,77.69,562,470,尖山里,NULL
78,1036,5,1041,1268,0,0,82.1,554,482,成功里,NULL
0,1036,5,1041,1268,0,0,82.1,554,482,成功里,NULL
116,1032,9,1041,1371,0,0,75.93,535,497,北新里,NULL
937,1033,8,1041,1329,0,0,78.33,522,511,社子村,NULL
0,1033,8,1041,1329,0,0,78.33,522,511,社子村,NULL
632,1031,10,1041,1321,0,0,78.8,485,546,正言里,NULL
233,1032,9,1041,1407,0,0,73.99,449,583,溪東村,NULL
0,1032,9,1041,1407,0,0,73.99,449,583,溪東村,NULL
524,1030,11,1041,1306,0,0,79.71,436,594,灣內村,NULL
344,1033,8,1041,1432,0,0,72.7,405,628,鎮山里,NULL
762,1029,12,1041,1359,0,0,76.6,388,641,仁愛里,NULL
0,1029,12,1041,1359,0,0,76.6,388,641,仁愛里,NULL
184,1036,4,1040,1360,0,0,76.47,858,178,流東里,NULL
775,1028,12,1040,1312,0,0,79.27,810,218,東安里,NULL
1619,1034,6,1040,1370,0,0,75.91,744,290,湖興里,NULL
261,1022,18,1040,1378,0,0,75.47,713,309,新民里,NULL
0,1022,18,1040,1378,0,0,75.47,713,309,新民里,NULL
2241,1031,9,1040,1397,0,0,74.45,648,383,野柳村,NULL
377,1031,9,1040,1298,0,0,80.12,615,416,公民里,NULL
774,1033,7,1040,1275,0,0,81.57,614,419,誠義里,NULL
1083,1021,19,1040,1376,0,0,75.58,583,438,裕民里,NULL
268,1035,5,1040,1355,0,0,76.75,581,454,大湖村,NULL
91,1034,6,1040,1369,0,0,75.97,581,453,進興村,NULL
122,1031,9,1040,1406,0,0,73.97,493,538,興南里,NULL
0,1031,9,1040,1406,0,0,73.97,493,538,興南里,NULL
33,1026,13,1039,1254,0,0,82.85,970,56,鵬程里,NULL
216,1035,4,1039,1332,0,0,78,802,233,合興里,NULL
412,1031,8,1039,1346,0,0,77.19,707,324,鎮北里,NULL
53,1028,11,1039,1342,0,0,77.42,700,328,聯興里,NULL
6,1033,6,1039,1358,0,0,76.51,650,383,建軍里,NULL
501,1031,8,1039,1297,0,0,80.11,605,426,德生里,NULL
1768,1037,2,1039,1309,0,0,79.37,585,452,永吉里,NULL
734,1028,11,1039,1379,0,0,75.34,576,452,新厝村,NULL
0,1028,11,1039,1379,0,0,75.34,576,452,新厝村,NULL
468,1029,10,1039,1367,0,0,76.01,571,458,東英里,NULL
561,1028,11,1039,1292,0,0,80.42,568,460,內定里,NULL
403,1028,11,1039,1515,0,0,68.58,554,474,鎮西里,NULL
649,1025,14,1039,1303,0,0,79.74,525,500,文昌里,NULL
1009,1028,11,1039,1353,0,0,76.79,506,522,中和里,NULL
1493,1031,8,1039,1364,0,0,76.17,470,561,復興里,NULL
186,1029,9,1038,1271,0,0,81.67,802,227,湳中里,NULL
331,1028,10,1038,1346,0,0,77.12,677,351,白沙村,NULL
2095,1027,11,1038,1326,0,0,78.28,673,354,埔新村,NULL
95,1026,12,1038,1330,0,0,78.05,669,357,福中里,NULL
924,1030,8,1038,1314,0,0,79,633,397,愛國里,NULL
391,1027,11,1038,1315,0,0,78.94,620,407,東昇里,NULL
1348,1029,9,1038,1322,0,0,78.52,614,415,日新里,NULL
272,1033,5,1038,1396,0,0,74.36,594,439,湖內村,NULL
623,1035,3,1038,1318,0,0,78.76,586,449,萬安村,NULL
0,1035,3,1038,1318,0,0,78.76,586,449,萬安村,NULL
801,1034,4,1038,1284,0,0,80.84,580,454,良和里,NULL
174,1034,4,1038,1440,0,0,72.08,561,473,白雲村,NULL
0,1034,4,1038,1440,0,0,72.08,561,473,白雲村,NULL
285,1023,15,1038,1343,0,0,77.29,530,493,華中里,NULL
38,1023,15,1038,1310,0,0,79.24,527,496,港尾里,NULL
370,1028,10,1038,1393,0,0,74.52,508,520,大美村,NULL
1514,1023,15,1038,1322,0,0,78.52,506,517,得仁里,NULL
220,1032,6,1038,1371,0,0,75.71,493,539,員山村,NULL
531,1034,4,1038,1340,0,0,77.46,442,592,三舍村,NULL
0,1034,4,1038,1340,0,0,77.46,442,592,三舍村,NULL
706,1032,6,1038,1371,0,0,75.71,439,593,南灣里,NULL
654,1029,9,1038,1321,0,0,78.58,413,616,復國里,NULL
188,1032,6,1038,1265,0,0,82.06,401,631,光榮里,NULL
240,1028,10,1038,1405,0,0,73.88,396,632,維生里,NULL
0,1028,10,1038,1405,0,0,73.88,396,632,維生里,NULL
275,1032,6,1038,1307,0,0,79.42,386,646,中華里,NULL
0,1032,6,1038,1307,0,0,79.42,386,646,中華里,NULL
15,1023,15,1038,1261,0,0,82.32,382,641,享平里,NULL
2003,1030,7,1037,1259,0,0,82.37,815,215,貿商村,NULL
298,1027,10,1037,1310,0,0,79.16,739,288,大華里,NULL
1139,1031,6,1037,1329,0,0,78.03,728,303,錦華里,NULL
618,1031,6,1037,1314,0,0,78.92,678,353,中正里,NULL
143,1027,10,1037,1276,0,0,81.27,657,370,忠翠里,NULL
126,1029,8,1037,1307,0,0,79.34,620,409,玉山里,NULL
437,1024,13,1037,1407,0,0,73.7,620,404,立仁里,NULL
545,1030,7,1037,1283,0,0,80.83,602,428,大華村,NULL
65,1033,4,1037,1377,0,0,75.31,585,448,大道里,NULL
0,1033,4,1037,1377,0,0,75.31,585,448,大道里,NULL
1,1032,5,1037,1348,0,0,76.93,568,464,朝陽里,NULL
0,1032,5,1037,1348,0,0,76.93,568,464,朝陽里,NULL
130,1028,9,1037,1395,0,0,74.34,560,468,橋頭里,NULL
343,1025,12,1037,1294,0,0,80.14,547,478,博惠里,NULL
670,1031,6,1037,1287,0,0,80.57,508,523,塩洲里,NULL
103,1024,13,1037,1314,0,0,78.92,501,523,仁翠里,NULL
752,1029,8,1037,1594,0,0,65.06,488,541,新興里,NULL
0,1029,8,1037,1594,0,0,65.06,488,541,新興里,NULL
0,1026,11,1037,1458,0,0,71.12,486,540,荷苞村,NULL
866,1027,10,1037,1336,0,0,77.62,469,558,過埤里,NULL
685,1027,10,1037,1359,0,0,76.31,378,649,王行里,NULL
1178,1031,5,1036,1294,0,0,80.06,801,230,建國里,NULL
170,1029,7,1036,1407,0,0,73.63,747,282,興寮里,NULL
8,1022,14,1036,1292,0,0,80.19,732,290,東海里,NULL
739,1024,12,1036,1279,0,0,81,716,308,雙連里,NULL
1149,1032,4,1036,1313,0,0,78.9,696,336,龍雲里,NULL
319,1027,9,1036,1313,0,0,78.9,667,360,大湖里,NULL
836,1026,10,1036,1338,0,0,77.43,666,360,東寶村,NULL
494,1027,9,1036,1306,0,0,79.33,648,379,介壽里,NULL
230,1019,17,1036,1451,0,0,71.4,613,406,龍津村,NULL
565,1027,9,1036,1444,0,0,71.75,608,419,文昌里,NULL
266,1028,8,1036,1413,0,0,73.32,608,420,新興里,NULL
223,1021,15,1036,1345,0,0,77.03,587,434,西安里,NULL
19,1028,8,1036,1288,0,0,80.43,574,454,三民里,NULL
154,1028,8,1036,1417,0,0,73.11,568,460,新東里,NULL
112,1022,14,1036,1404,0,0,73.79,531,491,糠榔里,NULL
743,1026,10,1036,1334,0,0,77.66,493,533,光明里,NULL
0,1026,10,1036,1334,0,0,77.66,493,533,光明里,NULL
147,1026,10,1036,1330,0,0,77.89,366,660,湖內里,NULL
0,1019,17,1036,1289,0,0,80.37,316,703,新興村,NULL
220,1028,7,1035,1288,0,0,80.36,911,117,中興村,NULL
578,1027,8,1035,1264,0,0,81.88,776,251,正和里,NULL
57,1026,9,1035,1329,0,0,77.88,771,255,東安里,NULL
1073,1033,2,1035,1275,0,0,81.18,692,341,騰雲里,NULL
1781,1024,11,1035,1316,0,0,78.65,660,364,大湖里,NULL
319,1027,8,1035,1362,0,0,75.99,659,368,錦祥里,NULL
149,1026,9,1035,1344,0,0,77.01,612,414,嘉仁里,NULL
780,1024,11,1035,1360,0,0,76.1,609,415,西路里,NULL
419,1025,10,1035,1370,0,0,75.55,605,420,八德里,NULL
29,1028,7,1035,1323,0,0,78.23,594,434,南門里,NULL
828,1023,12,1035,1269,0,0,81.56,557,466,瑞平里,NULL
412,1026,9,1035,1354,0,0,76.44,555,471,坐駕里,NULL
571,1028,7,1035,1342,0,0,77.12,518,510,中庄村,NULL
1011,1018,17,1035,1289,0,0,80.29,495,523,中泰里,NULL
238,1028,7,1035,1367,0,0,75.71,484,544,忠和村,NULL
3,1027,7,1034,1826,0,0,56.63,973,54,清水村、仁愛村、津沙村、馬祖村、珠螺村、四維村,NULL
0,1027,7,1034,1826,0,0,56.63,973,54,清水村、仁愛村、津沙村、馬祖村、珠螺村、四維村,NULL
192,1025,9,1034,1287,0,0,80.34,848,177,新華里,NULL
195,1024,10,1034,1355,0,0,76.31,765,259,卦山里,NULL
466,1027,7,1034,1312,0,0,78.81,761,266,仁福里,NULL
159,1024,10,1034,1380,0,0,74.93,747,277,大有里,NULL
892,1028,6,1034,1351,0,0,76.54,735,293,林興里,NULL
903,1025,9,1034,1290,0,0,80.16,726,299,中溪里,NULL
644,1023,11,1034,1277,0,0,80.97,693,330,普慶里,NULL
1247,1025,9,1034,1301,0,0,79.48,690,335,永安里,NULL
117,1026,8,1034,1478,0,0,69.96,673,353,清新里,NULL
209,1025,9,1034,1312,0,0,78.81,670,355,正明里,NULL
1122,1024,10,1034,1306,0,0,79.17,652,372,龍安里,NULL
213,1028,6,1034,1367,0,0,75.64,623,405,康壽里,NULL
0,1028,6,1034,1367,0,0,75.64,623,405,康壽里,NULL
977,1025,9,1034,1285,0,0,80.47,593,432,昌信里,NULL
101,1026,8,1034,1305,0,0,79.23,593,433,東埔里,NULL
110,1024,10,1034,1252,0,0,82.59,590,434,桃源里,NULL
491,1021,13,1034,1324,0,0,78.1,588,433,長榮里,NULL
398,1030,4,1034,1318,0,0,78.45,256,774,埤頭里,NULL
0,1030,4,1034,1318,0,0,78.45,256,774,埤頭里,NULL
144,1025,8,1033,1413,0,0,73.11,805,220,仁和村,NULL
33,1026,7,1033,1416,0,0,72.95,763,263,馬蘭里,NULL
51,1025,8,1033,1298,0,0,79.58,747,278,龍岡里,NULL
1270,1021,12,1033,1312,0,0,78.73,733,288,萬盛里,NULL
774,1023,10,1033,1290,0,0,80.08,696,327,秀山里,NULL
636,1026,7,1033,1298,0,0,79.58,689,337,松友里,NULL
666,1025,8,1033,1374,0,0,75.18,685,340,大饒里,NULL
778,1017,16,1033,1264,0,0,81.72,672,345,秀義里,NULL
228,1032,1,1033,1333,0,0,77.49,659,373,平和里,NULL
1051,1028,5,1033,1284,0,0,80.45,645,383,立言里,NULL
58,1030,3,1033,1264,0,0,81.72,642,388,漢生里,NULL
594,1021,12,1033,1301,0,0,79.4,629,392,福和里,NULL
641,1022,11,1033,1254,0,0,82.38,627,395,中坡里,NULL
977,1019,14,1033,1432,0,0,72.14,616,403,新起里,NULL
647,1021,12,1033,1281,0,0,80.64,613,408,中行里,NULL
560,1025,8,1033,1309,0,0,78.92,612,413,豐圳里,NULL
142,1026,7,1033,1396,0,0,74,597,429,客雅里,NULL
816,1025,8,1033,1317,0,0,78.44,557,468,潭陽村,NULL
1971,1023,10,1033,1389,0,0,74.37,539,484,集賢村,NULL
863,1024,9,1033,1859,0,0,55.57,532,492,揚雅里,NULL
1019,1027,6,1033,1312,0,0,78.73,528,499,和平里,NULL
613,1019,14,1033,1275,0,0,81.02,528,491,福祥里,NULL
0,1019,14,1033,1275,0,0,81.02,528,491,福祥里,NULL
459,1022,11,1033,1325,0,0,77.96,515,507,福安里,NULL
740,1028,5,1033,1339,0,0,77.15,492,536,鳳鳴里,NULL
784,1025,8,1033,1334,0,0,77.44,492,533,田厝村,NULL
0,1025,8,1033,1334,0,0,77.44,492,533,田厝村,NULL
172,1021,12,1033,1334,0,0,77.44,469,552,西勢村,NULL
333,1029,4,1033,1322,0,0,78.14,467,562,同德里,NULL
145,1026,7,1033,1323,0,0,78.08,456,570,安民里,NULL
0,1026,7,1033,1323,0,0,78.08,456,570,安民里,NULL
242,1026,7,1033,1382,0,0,74.75,396,630,珍珠村,NULL
0,1026,7,1033,1382,0,0,74.75,396,630,珍珠村,NULL
198,1020,13,1033,1320,0,0,78.26,270,750,福安里,NULL
1182,1018,14,1032,1290,0,0,80,773,245,百忍里,NULL
50,1023,9,1032,1262,0,0,81.77,715,308,龍岡里,NULL
728,1027,5,1032,1317,0,0,78.36,648,379,文德里,NULL
1891,1021,11,1032,1312,0,0,78.66,636,385,新興里,NULL
124,1017,15,1032,1393,0,0,74.08,624,393,頂番里,NULL
467,1021,11,1032,1347,0,0,76.61,602,419,湖東里,NULL
223,1020,12,1032,1305,0,0,79.08,581,439,松安里,NULL
85,1024,8,1032,1377,0,0,74.95,571,453,維揚里,NULL
35,1025,7,1032,1309,0,0,78.84,549,476,雲霄里,NULL
0,1025,7,1032,1309,0,0,78.84,549,476,雲霄里,NULL
0,1015,17,1032,1334,0,0,77.36,431,584,鹽樹村,NULL
187,1024,8,1032,1311,0,0,78.72,430,594,光榮里,NULL
422,1022,10,1032,1374,0,0,75.11,426,596,文正里,NULL
0,1022,10,1032,1374,0,0,75.11,426,596,文正里,NULL
825,1026,5,1031,1278,0,0,80.67,766,260,楊梅里,NULL
640,1016,15,1031,1300,0,0,79.31,761,255,華南里,NULL
891,1025,6,1031,1314,0,0,78.46,724,301,林興里,NULL
241,1020,11,1031,1347,0,0,76.54,659,361,蘆竹里,NULL
0,1020,11,1031,1347,0,0,76.54,659,361,蘆竹里,NULL
705,1021,10,1031,1277,0,0,80.74,645,376,嘉穗里,NULL
369,1016,15,1031,1559,0,0,66.13,625,391,初鄉村,NULL
0,1016,15,1031,1559,0,0,66.13,625,391,初鄉村,NULL
605,1023,8,1031,1482,0,0,69.57,621,402,網紗里,NULL
784,1023,8,1031,1294,0,0,79.68,619,404,瑞興里,NULL
1789,1019,12,1031,1350,0,0,76.37,608,411,八張里,NULL
1112,1027,4,1031,1343,0,0,76.77,587,440,八德里,NULL
75,1019,12,1031,1400,0,0,73.64,573,446,宮北里,NULL
0,1019,12,1031,1400,0,0,73.64,573,446,宮北里,NULL
701,1024,7,1031,1229,0,0,83.89,569,455,民享里,NULL
414,1022,9,1031,1310,0,0,78.7,540,482,寶民里,NULL
175,1023,8,1031,1400,0,0,73.64,538,485,南紙里,NULL
612,1018,13,1031,1274,0,0,80.93,533,485,福隆里,NULL
35,1022,9,1031,1345,0,0,76.65,524,498,黎明里,NULL
0,1022,9,1031,1345,0,0,76.65,524,498,黎明里,NULL
186,1023,8,1031,1407,0,0,73.28,510,513,三民村,NULL
130,1021,10,1031,1378,0,0,74.82,441,580,長德里,NULL
0,1021,10,1031,1378,0,0,74.82,441,580,長德里,NULL
240,1019,11,1030,1243,0,0,82.86,769,250,員山村,NULL
765,1017,13,1030,1263,0,0,81.55,767,250,安平里,NULL
29,1022,8,1030,1356,0,0,75.96,739,283,正船里,NULL
0,1022,8,1030,1356,0,0,75.96,739,283,正船里,NULL
41,1022,8,1030,1380,0,0,74.64,725,297,竹義里,NULL
798,1022,8,1030,1311,0,0,78.57,692,330,秀仁里,NULL
508,1019,11,1030,1378,0,0,74.75,666,353,新吉里,NULL
920,1017,13,1030,1316,0,0,78.27,664,353,忠勤里,NULL
389,1022,8,1030,1372,0,0,75.07,647,375,同安里,NULL
0,1022,8,1030,1372,0,0,75.07,647,375,同安里,NULL
1408,1024,6,1030,1345,0,0,76.58,643,381,永豐里,NULL
1631,1020,10,1030,1297,0,0,79.41,629,391,橫科里,NULL
265,1018,12,1030,1334,0,0,77.21,599,419,五權里,NULL
350,1021,9,1030,1365,0,0,75.46,599,422,賴村里,NULL
740,1016,14,1030,1278,0,0,80.59,584,432,文福里,NULL
50,1018,12,1030,1321,0,0,77.97,584,434,何仁里,NULL
189,1016,14,1030,1311,0,0,78.57,549,467,舊社里,NULL
1015,1025,5,1030,1285,0,0,80.16,520,505,雙園里,NULL
9,1019,11,1030,1284,0,0,80.22,508,511,清豐里,NULL
481,1017,13,1030,1284,0,0,80.22,474,543,維德里,NULL
658,1022,8,1030,1320,0,0,78.03,472,550,潭頭村,NULL
32,1017,13,1030,1528,0,0,67.41,396,621,新豐村,NULL
0,1017,13,1030,1528,0,0,67.41,396,621,新豐村,NULL
313,1013,17,1030,1434,0,0,71.83,325,688,溪北村,NULL
0,1013,17,1030,1434,0,0,71.83,325,688,溪北村,NULL
199,1019,11,1030,1298,0,0,79.35,279,740,福安里,NULL
81,1019,10,1029,1250,0,0,82.32,812,207,金山里,NULL
367,1024,5,1029,1216,0,0,84.62,775,249,瑞光里,NULL
198,1020,9,1029,1319,0,0,78.01,775,245,碇祥里,NULL
1170,1022,7,1029,1278,0,0,80.52,749,273,法治里,NULL
763,1021,8,1029,1260,0,0,81.67,734,287,安順里,NULL
741,1015,14,1029,1315,0,0,78.25,716,299,雙連里,NULL
166,1022,7,1029,1364,0,0,75.44,700,322,鶯歌里,NULL
1615,1020,9,1029,1229,0,0,83.73,676,344,湖光里,NULL
395,1019,10,1029,1391,0,0,73.98,654,365,南光村,NULL
0,1019,10,1029,1391,0,0,73.98,654,365,南光村,NULL
510,1015,14,1029,1401,0,0,73.45,640,375,新城里,NULL
199,1022,7,1029,1326,0,0,77.6,634,388,福林里,NULL
646,1018,11,1029,1301,0,0,79.09,631,387,仁愛里,NULL
0,1018,11,1029,1301,0,0,79.09,631,387,仁愛里,NULL
646,1023,6,1029,1235,0,0,83.32,625,398,中行里,NULL
395,1012,17,1029,1336,0,0,77.02,600,412,吉利里,NULL
419,1023,6,1029,1255,0,0,81.99,600,423,永隆里,NULL
0,1012,17,1029,1336,0,0,77.02,600,412,吉利里,NULL
340,1022,7,1029,1336,0,0,77.02,588,434,北興里,NULL
361,1013,16,1029,1420,0,0,72.46,558,455,金興村,NULL
341,1019,10,1029,1285,0,0,80.08,557,462,北勢里,NULL
478,1015,14,1029,1321,0,0,77.9,550,465,東門村,NULL
64,1022,7,1029,1473,0,0,69.86,541,481,中勝村,NULL
0,1022,7,1029,1473,0,0,69.86,541,481,中勝村,NULL
192,1024,5,1029,1305,0,0,78.85,521,503,玉光里,NULL
702,1020,9,1029,1340,0,0,76.79,485,535,西灣里,NULL
0,1024,5,1029,1299,0,0,79.21,443,581,新莊村,NULL
335,1017,12,1029,1476,0,0,69.72,440,577,三股村,NULL
0,1017,12,1029,1476,0,0,69.72,440,577,三股村,NULL
173,1016,13,1029,1362,0,0,75.55,429,587,香湖里,NULL
0,1016,13,1029,1362,0,0,75.55,429,587,香湖里,NULL
775,1017,12,1029,1322,0,0,77.84,401,616,後壁村,NULL
919,1021,8,1029,1302,0,0,79.03,377,644,福祥里,NULL
271,1019,10,1029,1352,0,0,76.11,354,665,光明里,NULL
18,1017,11,1028,1362,0,0,75.48,782,235,民立里,NULL
0,1017,11,1028,1362,0,0,75.48,782,235,民立里,NULL
67,1018,10,1028,1246,0,0,82.5,755,263,科園里,NULL
1092,1022,6,1028,1278,0,0,80.44,673,349,後德里,NULL
13,1017,11,1028,1293,0,0,79.51,667,350,思源里,NULL
85,1013,15,1028,1512,0,0,67.99,666,347,枇杷里,NULL
27,1021,7,1028,1338,0,0,76.83,640,381,進士里,NULL
1,1019,9,1028,1319,0,0,77.94,639,380,留侯里,NULL
0,1019,9,1028,1319,0,0,77.94,639,380,留侯里,NULL
608,1021,7,1028,1307,0,0,78.65,621,400,村上村,NULL
0,1021,7,1028,1307,0,0,78.65,621,400,村上村,NULL
455,1025,3,1028,1280,0,0,80.31,592,433,長億里,NULL
48,1016,12,1028,1408,0,0,73.01,591,425,北勢里,NULL
951,1024,4,1028,1326,0,0,77.53,552,472,永安村,NULL
655,1015,13,1028,1358,0,0,75.7,527,488,西橋里,NULL
264,1023,5,1028,1264,0,0,81.33,515,508,陸橋里,NULL
0,1023,5,1028,1264,0,0,81.33,515,508,陸橋里,NULL
644,1022,6,1028,1234,0,0,83.31,514,508,正義里,NULL
840,1021,7,1028,1348,0,0,76.26,479,542,瑞誠里,NULL
0,1021,7,1028,1348,0,0,76.26,472,549,頭港里,NULL
178,1015,13,1028,1368,0,0,75.15,436,579,三民里,NULL
0,1015,13,1028,1368,0,0,75.15,436,579,三民里,NULL
378,1024,4,1028,1284,0,0,80.06,414,610,東角里,NULL
1317,1022,5,1027,1302,0,0,78.88,752,270,明興里,NULL
1093,1022,5,1027,1295,0,0,79.31,732,290,義村里,NULL
821,1022,5,1027,1260,0,0,81.51,730,292,光明里,NULL
333,1020,7,1027,1366,0,0,75.18,654,366,溝美里,NULL
1868,1018,9,1027,1333,0,0,77.04,645,373,八勢里,NULL
165,1021,6,1027,1286,0,0,79.86,641,380,大業里,NULL
0,1013,14,1027,1321,0,0,77.74,602,411,福翠里,NULL
751,1015,12,1027,1397,0,0,73.51,561,454,北曾村,NULL
0,1015,12,1027,1397,0,0,73.51,561,454,北曾村,NULL
39,1020,7,1027,1359,0,0,75.57,497,523,布袋里,NULL
0,1020,7,1027,1359,0,0,75.57,497,523,布袋里,NULL
303,1015,12,1027,1429,0,0,71.87,477,538,崙東村,NULL
0,1015,12,1027,1429,0,0,71.87,477,538,崙東村,NULL
550,1012,15,1027,1323,0,0,77.63,445,567,東湳里,NULL
326,1019,8,1027,1490,0,0,68.93,415,604,大埕村,NULL
0,1019,8,1027,1490,0,0,68.93,415,604,大埕村,NULL
454,1014,13,1027,1315,0,0,78.1,390,624,干城里,NULL
482,1022,5,1027,1405,0,0,73.1,363,659,南海村,NULL
193,1015,11,1026,1273,0,0,80.6,851,164,新興村,NULL
60,1016,10,1026,1525,0,0,67.28,797,219,國盛里,NULL
480,1019,7,1026,1337,0,0,76.74,750,269,富仁里,NULL
5,1013,13,1026,1304,0,0,78.68,605,408,大同村,NULL
0,1013,13,1026,1304,0,0,78.68,605,408,大同村,NULL
381,1011,15,1026,1400,0,0,73.29,600,411,永隆村,NULL
0,1011,15,1026,1400,0,0,73.29,600,411,永隆村,NULL
1115,1019,7,1026,1349,0,0,76.06,598,421,成德里,NULL
43,1020,6,1026,1399,0,0,73.34,591,429,北投里,NULL
723,1014,12,1026,1318,0,0,77.85,588,426,墩北村,NULL
786,1019,7,1026,1270,0,0,80.79,579,440,瑞興里,NULL
92,1020,6,1026,1307,0,0,78.5,570,450,國華里,NULL
463,1014,12,1026,1316,0,0,77.96,558,456,幸福里,NULL
1022,1016,10,1026,1385,0,0,74.08,554,462,和德里,NULL
1449,1012,14,1026,1302,0,0,78.8,535,477,中路里,NULL
127,1016,10,1026,1262,0,0,81.3,509,507,明翠里,NULL
103,1008,18,1026,1376,0,0,74.56,478,530,頂厝里,NULL
68,1013,13,1026,1374,0,0,74.67,474,539,大新里,NULL
0,1013,13,1026,1374,0,0,74.67,474,539,大新里,NULL
620,1020,6,1026,1376,0,0,74.56,469,551,六合里,NULL
1732,1020,6,1026,1378,0,0,74.46,449,571,西園里,NULL
0,1020,6,1026,1378,0,0,74.46,449,571,西園里,NULL
812,1012,14,1026,1275,0,0,80.47,447,565,後市村,NULL
445,1018,8,1026,1347,0,0,76.17,440,578,灣中里,NULL
716,1015,11,1026,1371,0,0,74.84,431,584,竹子村,NULL
0,1015,11,1026,1371,0,0,74.84,431,584,竹子村,NULL
0,1016,10,1026,1539,0,0,66.67,413,603,東正村,NULL
139,1013,12,1025,1277,0,0,80.27,693,320,三和里,NULL
312,1013,12,1025,1384,0,0,74.06,680,333,建成里,NULL
705,1013,12,1025,1357,0,0,75.53,641,372,正義里,NULL
2031,1014,11,1025,1293,0,0,79.27,616,398,義學村,NULL
650,1014,11,1025,1294,0,0,79.21,613,401,大道里,NULL
510,1017,8,1025,1292,0,0,79.33,601,416,八卦村,NULL
780,1010,15,1025,1314,0,0,78.01,596,414,三和村,NULL
377,1015,10,1025,1325,0,0,77.36,596,419,新東里,NULL
254,1013,12,1025,1360,0,0,75.37,588,425,平林里,NULL
342,1017,8,1025,1298,0,0,78.97,561,456,上竹村,NULL
866,1018,7,1025,1306,0,0,78.48,552,466,斯文里,NULL
0,1016,9,1025,1423,0,0,72.03,538,478,竹圍村,NULL
383,1016,9,1025,1333,0,0,76.89,517,499,裕農里,NULL
722,1016,9,1025,1306,0,0,78.48,491,525,松山里,NULL
253,1017,8,1025,1311,0,0,78.18,410,607,太和村,NULL
0,1017,8,1025,1311,0,0,78.18,410,607,太和村,NULL
140,1015,10,1025,1308,0,0,78.36,350,665,番社村,NULL
0,1015,10,1025,1308,0,0,78.36,350,665,番社村,NULL
195,1010,14,1024,1315,0,0,77.87,750,260,德盛村,NULL
863,1012,12,1024,1233,0,0,83.05,723,289,民富里,NULL
357,1019,5,1024,1261,0,0,81.21,711,308,明湖里,NULL
169,1015,9,1024,1303,0,0,78.59,628,387,水田里,NULL
31,1021,3,1024,1314,0,0,77.93,616,405,港通里,NULL
0,1021,3,1024,1314,0,0,77.93,616,405,港通里,NULL
262,1017,7,1024,1367,0,0,74.91,615,402,平山里,NULL
805,1020,4,1024,1293,0,0,79.2,604,416,盛興里,NULL
577,1004,20,1024,1297,0,0,78.95,599,405,廟美里,NULL
0,1012,12,1024,1357,0,0,75.46,589,423,英仁里,NULL
1716,1018,6,1024,1322,0,0,77.46,574,444,東昇里,NULL
29,1015,9,1024,1281,0,0,79.94,569,446,自立里,NULL
1097,1018,6,1024,1359,0,0,75.35,549,469,後港里,NULL
490,1018,6,1024,1323,0,0,77.4,547,471,舊舘村,NULL
0,1018,6,1024,1323,0,0,77.4,547,471,舊舘村,NULL
704,1009,15,1024,1362,0,0,75.18,501,508,宏亮里,NULL
142,1021,3,1024,1391,0,0,73.62,489,532,青旗村,NULL
0,1021,3,1024,1391,0,0,73.62,489,532,青旗村,NULL
269,1022,2,1024,1322,0,0,77.46,443,579,光明里,NULL
881,1016,8,1024,1254,0,0,81.66,441,575,保安里,NULL
277,1011,13,1024,1418,0,0,72.21,403,608,甲東村,NULL
25,1008,16,1024,1368,0,0,74.85,403,605,安東里,NULL
0,1013,11,1024,1357,0,0,75.46,358,655,土溝村,NULL
502,1015,8,1023,1322,0,0,77.38,745,270,龍田里,NULL
37,1012,11,1023,1298,0,0,78.81,744,268,仁義里,NULL
0,1012,11,1023,1298,0,0,78.81,744,268,仁義里,NULL
120,1015,8,1023,1251,0,0,81.77,713,302,柴橋里,NULL
377,1011,12,1023,1340,0,0,76.34,663,348,營盤村,NULL
220,1015,8,1023,1399,0,0,73.12,639,376,竹坑村,NULL
756,1011,12,1023,1675,0,0,61.07,638,373,新富里,NULL
1308,1012,11,1023,1360,0,0,75.22,630,382,頂福里,NULL
236,1017,6,1023,1235,0,0,82.83,581,436,蘭興里,NULL
761,1014,9,1023,1261,0,0,81.13,547,467,新生里,NULL
1044,1016,7,1023,1256,0,0,81.45,543,473,保德里,NULL
185,1011,12,1023,1359,0,0,75.28,502,509,鹿峰里,NULL
236,1015,8,1023,1367,0,0,74.84,486,529,維新里,NULL
714,1011,12,1023,1349,0,0,75.83,457,554,忠誠里,NULL
184,1017,6,1023,1543,0,0,66.3,435,582,下寮村,NULL
0,1017,6,1023,1543,0,0,66.3,435,582,下寮村,NULL
500,1012,11,1023,1370,0,0,74.67,421,591,安定村,NULL
0,1012,11,1023,1370,0,0,74.67,421,591,安定村,NULL
553,1013,10,1023,1300,0,0,78.69,390,623,仁美村,NULL
362,1012,11,1023,1352,0,0,75.67,334,678,興化里,NULL
0,1012,11,1023,1352,0,0,75.67,334,678,興化里,NULL
637,1009,13,1022,1240,0,0,82.42,922,87,東南里,NULL
1305,1015,7,1022,1308,0,0,78.13,764,251,興昌里,NULL
1198,1011,11,1022,1266,0,0,80.73,754,257,中央里,NULL
189,1014,8,1022,1391,0,0,73.47,720,294,暖同里,NULL
164,1017,5,1022,1280,0,0,79.84,690,327,大業里,NULL
67,1014,8,1022,1324,0,0,77.19,680,334,大鵬里,NULL
295,1015,7,1022,1305,0,0,78.31,672,343,台鳳里,NULL
378,1014,8,1022,1534,0,0,66.62,650,364,竹林村,NULL
0,1014,8,1022,1534,0,0,66.62,650,364,竹林村,NULL
1913,1016,6,1022,1321,0,0,77.37,649,367,油車里,NULL
492,1006,16,1022,1708,0,0,59.84,639,367,中山里,NULL
2,1010,12,1022,1418,0,0,72.07,639,371,民族里,NULL
0,1010,12,1022,1418,0,0,72.07,639,371,民族里,NULL
45,1018,4,1022,1388,0,0,73.63,635,383,慈安里,NULL
729,1010,12,1022,1249,0,0,81.83,602,408,德穗里,NULL
298,1017,5,1022,1272,0,0,80.35,583,434,麗山里,NULL
278,1010,12,1022,1332,0,0,76.73,562,448,山陽村,NULL
0,1010,12,1022,1332,0,0,76.73,562,448,山陽村,NULL
292,1010,12,1022,1338,0,0,76.38,556,454,香山里,NULL
464,1011,11,1022,1290,0,0,79.22,500,511,幸福里,NULL
382,1012,10,1022,1323,0,0,77.25,497,515,三民里,NULL
203,1019,3,1022,1381,0,0,74,487,532,新榮里,NULL
0,1019,3,1022,1381,0,0,74,487,532,新榮里,NULL
237,1013,9,1022,1329,0,0,76.9,484,529,大忠里,NULL
187,1017,5,1022,1314,0,0,77.78,480,537,社新里,NULL
479,1016,6,1022,1367,0,0,74.76,441,575,慶安村,NULL
279,1009,13,1022,1362,0,0,75.04,410,599,甲南村,NULL
0,1009,13,1022,1362,0,0,75.04,410,599,甲南村,NULL
686,1007,14,1021,1227,0,0,83.21,796,211,景安里,NULL
657,1011,10,1021,1298,0,0,78.66,781,230,景新里,NULL
27,1015,6,1021,1273,0,0,80.2,744,271,竹北里,NULL
849,1011,10,1021,1279,0,0,79.83,718,293,秀成里,NULL
1885,1016,5,1021,1308,0,0,78.06,714,302,新興里,NULL
1098,1012,9,1021,1359,0,0,75.13,658,354,民輝里,NULL
447,1009,12,1021,1385,0,0,73.72,655,354,東寮里,NULL
237,1010,11,1021,1312,0,0,77.82,640,370,長庚村,NULL
388,1014,7,1021,1285,0,0,79.46,638,376,安泰里,NULL
1405,1015,6,1021,1336,0,0,76.42,599,416,清水里,NULL
247,1015,6,1021,1354,0,0,75.41,583,432,內新里,NULL
0,1015,6,1021,1354,0,0,75.41,583,432,內新里,NULL
183,1009,12,1021,1277,0,0,79.95,582,427,斗抵里,NULL
1724,1006,15,1021,1328,0,0,76.88,565,441,山佳里,NULL
47,1013,8,1021,1288,0,0,79.27,564,449,尊賢里,NULL
471,1015,6,1021,1431,0,0,71.35,531,484,豐田村,NULL
0,1015,6,1021,1431,0,0,71.35,531,484,豐田村,NULL
101,1016,5,1021,1363,0,0,74.91,511,505,信義里,NULL
151,1015,6,1021,1320,0,0,77.35,493,522,湖內里,NULL
1698,1010,11,1021,1374,0,0,74.31,484,526,彭福里,NULL
743,1016,5,1021,1326,0,0,77,443,573,龍鳳里,NULL
672,1016,5,1021,1336,0,0,76.42,411,605,塩洲里,NULL
299,1016,5,1021,1348,0,0,75.74,244,772,喜南里,NULL
0,1016,5,1021,1348,0,0,75.74,244,772,喜南里,NULL
803,1016,4,1020,1259,0,0,81.02,837,179,龍洲里,NULL
245,1005,15,1020,1308,0,0,77.98,812,193,尖下里,NULL
846,1010,10,1020,1284,0,0,79.44,754,256,民族里,NULL
1290,1018,2,1020,1266,0,0,80.57,740,278,青潭里,NULL
1118,1015,5,1020,1294,0,0,78.83,632,383,民安里,NULL
265,1010,10,1020,1355,0,0,75.28,626,384,營埔村,NULL
0,1010,10,1020,1355,0,0,75.28,626,384,營埔村,NULL
63,1013,7,1020,1434,0,0,71.13,618,395,埔姜村,NULL
0,1013,7,1020,1434,0,0,71.13,618,395,埔姜村,NULL
1793,1014,6,1020,1308,0,0,77.98,613,401,永館里,NULL
2,1003,17,1020,1288,0,0,79.19,605,398,西安里,NULL
1110,1012,8,1020,1281,0,0,79.63,604,408,民全里,NULL
835,1012,8,1020,1263,0,0,80.76,593,419,東寶村,NULL
1640,1009,11,1020,1462,0,0,69.77,558,451,三興里,NULL
451,1013,7,1020,1287,0,0,79.25,520,493,龍濱里,NULL
1835,1008,12,1020,1295,0,0,78.76,518,490,溪南里,NULL
0,1008,12,1020,1295,0,0,78.76,518,490,溪南里,NULL
364,1013,7,1020,1265,0,0,80.63,515,498,竹圍里,NULL
232,1010,10,1020,1474,0,0,69.2,483,527,振興里,NULL
1978,1009,11,1020,1355,0,0,75.28,479,530,成功村,NULL
121,1009,11,1020,1369,0,0,74.51,439,570,東寧村,NULL
89,1015,5,1020,1364,0,0,74.78,418,597,北成里,NULL
776,1007,13,1020,1255,0,0,81.27,367,640,鎮榮里,NULL
20,1011,9,1020,1481,0,0,68.87,365,646,蘇厝村,NULL
0,1011,9,1020,1481,0,0,68.87,365,646,蘇厝村,NULL
231,1010,9,1019,1310,0,0,77.79,800,210,東庄里,NULL
1812,1011,8,1019,1409,0,0,72.32,619,392,礁溪里,NULL
202,1012,7,1019,1282,0,0,79.49,576,436,和平里,NULL
1818,1005,14,1019,1383,0,0,73.68,545,460,介壽里,NULL
743,1010,9,1019,1283,0,0,79.42,541,469,圳前村,NULL
176,1007,12,1019,1344,0,0,75.82,475,532,永華里,NULL
0,1007,12,1019,1344,0,0,75.82,475,532,永華里,NULL
294,1006,13,1019,1277,0,0,79.8,455,551,千北里,NULL
0,1006,13,1019,1277,0,0,79.8,455,551,千北里,NULL
479,1011,8,1019,1278,0,0,79.73,427,584,白樹村,NULL
168,1015,4,1019,1316,0,0,77.43,422,593,頭崙村,NULL
0,1015,4,1019,1316,0,0,77.43,422,593,頭崙村,NULL
494,1009,10,1019,1294,0,0,78.75,382,627,文武村,NULL
1354,1009,9,1018,1315,0,0,77.41,774,235,萬美里,NULL
80,1005,13,1018,1306,0,0,77.95,744,261,金山里,NULL
1209,1014,4,1018,1236,0,0,82.36,715,299,黎和里,NULL
667,1008,10,1018,1419,0,0,71.74,646,362,隆興里,NULL
0,1008,10,1018,1419,0,0,71.74,646,362,隆興里,NULL
1846,1012,6,1018,1337,0,0,76.14,635,377,賢孝里,NULL
0,1012,6,1018,1337,0,0,76.14,635,377,賢孝里,NULL
316,1005,13,1018,1357,0,0,75.02,590,415,成和里,NULL
603,1009,9,1018,1264,0,0,80.54,587,422,雅祥里,NULL
19,1008,10,1018,1260,0,0,80.79,547,461,香社里,NULL
1014,1012,6,1018,1295,0,0,78.61,546,466,中宏里,NULL
139,1009,9,1018,1359,0,0,74.91,532,477,車店里,NULL
48,1004,14,1018,1257,0,0,80.99,528,476,鎮平里,NULL
971,1012,6,1018,1329,0,0,76.6,501,511,幸福里,NULL
756,1009,9,1018,1329,0,0,76.6,456,553,社南村,NULL
306,1007,11,1018,1258,0,0,80.92,433,574,安邦里,NULL
0,1002,15,1017,1503,0,0,67.66,827,175,富世村,NULL
116,1008,9,1017,1238,0,0,82.15,788,220,三重里,NULL
907,1014,3,1017,1231,0,0,82.62,746,268,保安里,NULL
490,1011,6,1017,1324,0,0,76.81,735,276,富泰里,NULL
26,1006,11,1017,1240,0,0,82.02,684,322,自強里,NULL
489,1010,7,1017,1291,0,0,78.78,653,357,富泰里,NULL
260,1008,9,1017,1279,0,0,79.52,629,379,和平里,NULL
0,1008,9,1017,1279,0,0,79.52,629,379,和平里,NULL
980,1010,7,1017,1262,0,0,80.59,603,407,昌明里,NULL
40,1010,7,1017,1376,0,0,73.91,585,425,西門里,NULL
0,1010,7,1017,1376,0,0,73.91,585,425,西門里,NULL
502,1007,10,1017,1256,0,0,80.97,555,452,青埔里,NULL
0,1007,10,1017,1256,0,0,80.97,555,452,青埔里,NULL
315,1012,5,1017,1276,0,0,79.7,548,464,崇學里,NULL
97,1013,4,1017,1318,0,0,77.16,529,484,公正里,NULL
1123,1000,17,1017,1314,0,0,77.4,523,477,民本里,NULL
23,1013,4,1017,1333,0,0,76.29,490,523,溪頂里,NULL
237,1009,8,1017,1403,0,0,72.49,473,536,維新里,NULL
676,1006,10,1016,1303,0,0,77.97,825,181,仁德里,NULL
920,1010,6,1016,1258,0,0,80.76,690,320,仁愛里,NULL
1734,1006,10,1016,1300,0,0,78.15,689,317,南園里,NULL
283,1008,8,1016,1226,0,0,82.87,678,330,西康里,NULL
233,1009,7,1016,1278,0,0,79.5,670,339,國泰里,NULL
921,1010,6,1016,1360,0,0,74.71,657,353,高平村,NULL
330,1007,9,1016,1331,0,0,76.33,637,370,白沙村,NULL
55,1007,9,1016,1310,0,0,77.56,615,392,山犁里,NULL
775,1011,5,1016,1274,0,0,79.75,606,405,北路里,NULL
328,1007,9,1016,1288,0,0,78.88,593,414,大勇里,NULL
169,1008,8,1016,1279,0,0,79.44,589,419,法華里,NULL
730,1015,1,1016,1327,0,0,76.56,578,437,文德里,NULL
697,1000,16,1016,1395,0,0,72.83,577,423,五福村,NULL
55,1010,6,1016,1420,0,0,71.55,577,433,芳草里,NULL
0,1000,16,1016,1395,0,0,72.83,577,423,五福村,NULL
180,1007,9,1016,1361,0,0,74.65,574,433,興安里,NULL
2007,1006,10,1016,1298,0,0,78.27,569,437,黎明村,NULL
393,999,17,1016,1367,0,0,74.32,555,444,大園村,NULL
53,1006,10,1016,1349,0,0,75.32,516,490,建興里,NULL
0,1006,10,1016,1349,0,0,75.32,516,490,建興里,NULL
1358,1003,13,1016,1289,0,0,78.82,510,493,瑞興里,NULL
1016,1004,12,1016,1294,0,0,78.52,490,514,雙園里,NULL
1033,1006,10,1016,1254,0,0,81.02,480,526,忠德里,NULL
17,1007,9,1016,1270,0,0,80,423,584,中陽里,NULL
386,1012,4,1016,1269,0,0,80.06,359,653,外社村,NULL
0,1012,4,1016,1269,0,0,80.06,359,653,外社村,NULL
6,998,17,1015,1247,0,0,81.4,762,236,維新里,NULL
795,1006,9,1015,1322,0,0,76.78,682,324,誠智里,NULL
73,1003,12,1015,1285,0,0,78.99,673,330,糖友里,NULL
27,1004,11,1015,1323,0,0,76.72,652,352,逢甲里,NULL
274,1011,4,1015,1272,0,0,79.8,643,368,華德里,NULL
372,1011,4,1015,1294,0,0,78.44,615,396,中達里,NULL
226,1004,11,1015,1304,0,0,77.84,583,421,田中村,NULL
249,1002,13,1015,1279,0,0,79.36,580,422,廣德里,NULL
1823,1005,10,1015,1393,0,0,72.86,570,435,大埔里,NULL
383,1008,7,1015,1373,0,0,73.93,565,443,林中村,NULL
19,1005,10,1015,1380,0,0,73.55,535,470,後庄里,NULL
989,995,20,1015,1361,0,0,74.58,531,464,自立里,NULL
0,998,17,1015,1745,0,0,58.17,526,472,崙北村,NULL
887,1005,10,1015,1350,0,0,75.19,487,518,鎮南里,NULL
35,1000,15,1015,1434,0,0,70.78,392,608,外角里,NULL
0,1000,15,1015,1434,0,0,70.78,392,608,外角里,NULL
1,1006,8,1014,1317,0,0,76.99,786,220,民德里,NULL
0,1006,8,1014,1317,0,0,76.99,786,220,民德里,NULL
757,1006,8,1014,1231,0,0,82.37,769,237,新富里,NULL
46,1006,8,1014,1466,0,0,69.17,749,257,豐谷里,NULL
889,1008,6,1014,1270,0,0,79.84,700,308,協和里,NULL
113,1005,9,1014,1407,0,0,72.07,660,345,居仁里,NULL
0,1005,9,1014,1407,0,0,72.07,660,345,居仁里,NULL
419,1008,6,1014,1332,0,0,76.13,621,387,竹圍村,NULL
405,1010,4,1014,1303,0,0,77.82,589,421,鎮東里,NULL
380,1007,7,1014,1277,0,0,79.4,572,435,崇誨里,NULL
454,1005,9,1014,1417,0,0,71.56,543,462,榴南里,NULL
0,1005,9,1014,1417,0,0,71.56,543,462,榴南里,NULL
295,1008,6,1014,1280,0,0,79.22,515,493,立德里,NULL
0,1008,6,1014,1280,0,0,79.22,515,493,立德里,NULL
546,1001,13,1014,1373,0,0,73.85,502,499,東海村,NULL
358,996,18,1014,1274,0,0,79.59,475,521,六股村,NULL
340,1003,11,1014,1315,0,0,77.11,459,544,維新村,NULL
1,1005,9,1014,1291,0,0,78.54,455,550,清豐里,NULL
639,1004,10,1014,1394,0,0,72.74,389,615,埔園里,NULL
85,997,16,1013,1304,0,0,77.68,814,183,大鄉里,NULL
78,1007,6,1013,1247,0,0,81.23,789,218,金山里,NULL
1140,1000,13,1013,1305,0,0,77.62,736,264,龍圖里,NULL
24,1010,3,1013,1279,0,0,79.2,720,290,自強里,NULL
303,1001,12,1013,1319,0,0,76.8,709,292,大昌里,NULL
73,1005,8,1013,1328,0,0,76.28,696,309,大同村,NULL
92,1003,10,1013,1292,0,0,78.41,695,308,振興里,NULL
168,1010,3,1013,1314,0,0,77.09,671,339,鶯安里,NULL
1617,1009,4,1013,1314,0,0,77.09,666,343,湖光里,NULL
457,1005,8,1013,1241,0,0,81.63,642,363,鴻福里,NULL
510,1008,5,1013,1277,0,0,79.33,632,376,東勢里,NULL
222,1006,7,1013,1303,0,0,77.74,625,381,三和里,NULL
384,1008,5,1013,1394,0,0,72.67,616,392,林中村,NULL
177,998,15,1013,1268,0,0,79.89,550,448,長壽里,NULL
744,1002,11,1013,1371,0,0,73.89,546,456,湳雅村,NULL
0,1002,11,1013,1371,0,0,73.89,546,456,湳雅村,NULL
589,1005,8,1013,1302,0,0,77.8,540,465,鎌村里,NULL
308,1001,12,1013,1311,0,0,77.27,538,463,聚安里,NULL
527,1000,13,1013,1294,0,0,78.28,536,464,仁忠里,NULL
966,997,16,1013,1339,0,0,75.65,532,465,坑尾村,NULL
0,997,16,1013,1339,0,0,75.65,532,465,坑尾村,NULL
478,998,15,1013,1362,0,0,74.38,508,490,南興里,NULL
540,996,17,1013,1268,0,0,79.89,499,497,慈祐里,NULL
195,1002,11,1013,1315,0,0,77.03,401,601,龍潭村,NULL
447,1001,12,1013,1333,0,0,75.99,379,622,赤東村,NULL
41,1008,5,1013,1357,0,0,74.65,352,656,南興里,NULL
0,1008,5,1013,1357,0,0,74.65,352,656,南興里,NULL
88,1003,10,1013,1342,0,0,75.48,351,652,大山里,NULL
0,1003,10,1013,1342,0,0,75.48,351,652,大山里,NULL
880,1010,2,1012,1288,0,0,78.57,827,183,百年村,NULL
184,1001,11,1012,1242,0,0,81.48,739,262,湳中里,NULL
66,1000,12,1012,1363,0,0,74.25,735,265,海墘村,NULL
0,1000,12,1012,1363,0,0,74.25,735,265,海墘村,NULL
668,1002,10,1012,1288,0,0,78.57,716,286,仁愛里,NULL
859,1006,6,1012,1235,0,0,81.94,689,317,民生里,NULL
474,1001,11,1012,1257,0,0,80.51,656,345,仁武里,NULL
731,1007,5,1012,1330,0,0,76.09,614,393,文德里,NULL
164,1001,11,1012,1289,0,0,78.51,598,403,福華里,NULL
647,1001,11,1012,1286,0,0,78.69,595,406,正仁里,NULL
495,1010,2,1012,1261,0,0,80.25,595,415,宜欣里,NULL
1778,1001,11,1012,1332,0,0,75.98,592,409,鳳福里,NULL
364,1006,6,1012,1354,0,0,74.74,582,424,東湖里,NULL
1813,1004,8,1012,1333,0,0,75.92,562,442,安溪里,NULL
458,994,18,1012,1308,0,0,77.37,525,469,福安里,NULL
1010,1005,7,1012,1241,0,0,81.55,518,487,中和里,NULL
256,1007,5,1012,1395,0,0,72.54,476,531,仁里村,NULL
28,1005,7,1012,1218,0,0,83.09,328,677,玉屏里,NULL
655,1003,8,1011,1246,0,0,81.14,793,210,中興里,NULL
603,1000,11,1011,1327,0,0,76.19,694,306,普仁里,NULL
893,998,13,1011,1297,0,0,77.95,667,331,河堤里,NULL
451,996,15,1011,1369,0,0,73.85,626,370,大突里,NULL
418,1000,11,1011,1262,0,0,80.11,613,387,永隆里,NULL
111,1004,7,1011,1396,0,0,72.42,588,416,通南里,NULL
138,1004,7,1011,1377,0,0,73.42,585,419,下溪里,NULL
0,1004,7,1011,1377,0,0,73.42,585,419,下溪里,NULL
641,1000,11,1011,1311,0,0,77.12,553,447,正道里,NULL
646,1006,5,1011,1245,0,0,81.2,549,457,正仁里,NULL
67,1002,9,1011,1318,0,0,76.71,525,477,大德里,NULL
542,996,15,1011,1319,0,0,76.65,512,484,富華里,NULL
5,998,13,1011,1408,0,0,71.8,475,523,州南里,NULL
716,998,13,1011,1301,0,0,77.71,427,571,北灣里,NULL
0,998,13,1011,1396,0,0,72.42,319,679,神農村,NULL
886,1005,5,1010,1285,0,0,78.6,865,140,富水里,NULL
504,1003,7,1010,1270,0,0,79.53,801,202,華愛里,NULL
19,996,14,1010,1349,0,0,74.87,724,272,中濱里,NULL
0,996,14,1010,1349,0,0,74.87,724,272,中濱里,NULL
232,1005,5,1010,1277,0,0,79.09,722,283,松竹里,NULL
46,1000,10,1010,1410,0,0,71.63,699,301,富寮里,NULL
193,1002,8,1010,1297,0,0,77.87,652,350,竹林里,NULL
390,1003,7,1010,1368,0,0,73.83,624,379,海湖村,NULL
186,999,11,1010,1322,0,0,76.4,618,381,新路村,NULL
860,1002,8,1010,1241,0,0,81.39,613,389,新榮里,NULL
1901,998,12,1010,1347,0,0,74.98,602,396,中興里,NULL
338,1000,10,1010,1357,0,0,74.43,595,405,北興里,NULL
248,1001,9,1010,1274,0,0,79.28,554,447,田寮里,NULL
698,1003,7,1010,1320,0,0,76.52,525,478,正苓里,NULL
1496,997,13,1010,1280,0,0,78.91,524,473,福安里,NULL
77,1002,8,1010,1289,0,0,78.36,493,509,南豪里,NULL
0,1002,8,1010,1289,0,0,78.36,493,509,南豪里,NULL
217,998,12,1010,1247,0,0,80.99,485,513,九曲村,NULL
0,1001,9,1010,1625,0,0,62.15,402,599,瓦磘村,NULL
101,1005,4,1009,1214,0,0,83.11,911,94,長榮里,NULL
129,1002,7,1009,1283,0,0,78.64,797,205,頭重里,NULL
92,975,34,1009,1356,0,0,74.41,768,207,商華里,NULL
1202,1001,8,1009,1233,0,0,81.83,729,272,明德里,NULL
286,1003,6,1009,1255,0,0,80.4,698,305,大德里,NULL
609,996,13,1009,1237,0,0,81.57,639,357,平河里,NULL
83,1000,9,1009,1352,0,0,74.63,633,367,吉仁里,NULL
54,998,11,1009,1240,0,0,81.37,632,366,何福里,NULL
481,1005,4,1009,1285,0,0,78.52,610,395,新益里,NULL
360,1002,7,1009,1370,0,0,73.65,595,407,健行里,NULL
74,1002,7,1009,1250,0,0,80.72,586,416,陽明里,NULL
327,1002,7,1009,1333,0,0,75.69,585,417,文德村,NULL
1697,998,11,1009,1379,0,0,73.17,582,416,彭福里,NULL
264,999,10,1009,1408,0,0,71.66,565,434,新興里,NULL
306,998,11,1009,1299,0,0,77.68,562,436,聚安里,NULL
639,999,10,1009,1320,0,0,76.44,560,439,南平里,NULL
154,1000,9,1009,1307,0,0,77.2,512,488,青翠里,NULL
980,996,13,1009,1279,0,0,78.89,502,494,新坡村,NULL
231,1004,5,1009,1264,0,0,79.83,486,518,埔前里,NULL
66,999,10,1009,1339,0,0,75.35,460,539,西平里,NULL
0,999,10,1009,1339,0,0,75.35,460,539,西平里,NULL
317,997,12,1009,1335,0,0,75.58,321,676,大洲村,NULL
0,997,12,1009,1335,0,0,75.58,321,676,大洲村,NULL
639,1001,7,1008,1230,0,0,81.95,908,93,東南里,NULL
340,1004,4,1008,1312,0,0,76.83,832,172,銅鑼村,NULL
257,999,9,1008,1245,0,0,80.96,813,186,豐富里,NULL
0,999,9,1008,1245,0,0,80.96,813,186,豐富里,NULL
163,1002,6,1008,1237,0,0,81.49,684,318,大業里,NULL
13,1001,7,1008,1270,0,0,79.37,677,324,復中里,NULL
2146,1003,5,1008,1336,0,0,75.45,673,330,尖鹿村,NULL
0,1003,5,1008,1336,0,0,75.45,673,330,尖鹿村,NULL
1414,1000,8,1008,1290,0,0,78.14,663,337,廷寮里,NULL
1261,1000,8,1008,1183,0,0,85.21,650,350,萬祥里,NULL
215,998,10,1008,1276,0,0,79,635,363,聖山里,NULL
268,1002,6,1008,1278,0,0,78.87,612,390,萬安里,NULL
269,998,10,1008,1254,0,0,80.38,561,437,華貴里,NULL
932,1000,8,1008,1336,0,0,75.45,542,458,後湖村,NULL
0,1000,8,1008,1336,0,0,75.45,542,458,後湖村,NULL
768,1003,5,1008,1329,0,0,75.85,538,465,仁義村,NULL
47,995,13,1008,1356,0,0,74.34,527,468,鎮平里,NULL
1511,999,9,1008,1259,0,0,80.06,526,473,得勝里,NULL
420,1000,8,1008,1307,0,0,77.12,506,494,民生里,NULL
526,994,14,1008,1368,0,0,73.68,491,503,西平村,NULL
0,994,14,1008,1368,0,0,73.68,491,503,西平村,NULL
351,1000,8,1008,1348,0,0,74.78,464,536,安西里,NULL
128,1003,5,1008,1319,0,0,76.42,450,553,磚磘里,NULL
538,1000,8,1008,1284,0,0,78.5,419,581,東坡里,NULL
758,996,12,1008,1278,0,0,78.87,419,577,三角村,NULL
254,998,10,1008,1244,0,0,81.03,419,579,廣州里,NULL
0,1000,8,1008,1284,0,0,78.5,419,581,東坡里,NULL
241,998,10,1008,1359,0,0,74.17,400,598,惠安里,NULL
0,998,10,1008,1359,0,0,74.17,400,598,惠安里,NULL
596,1005,3,1008,1306,0,0,77.18,398,607,琉球村,NULL
321,1004,4,1008,1234,0,0,81.69,385,619,安和里,NULL
241,997,11,1008,1412,0,0,71.39,335,662,湖西村,NULL
0,997,11,1008,1412,0,0,71.39,335,662,湖西村,NULL
773,999,8,1007,1300,0,0,77.46,812,187,華安里,NULL
1228,997,10,1007,1284,0,0,78.43,776,221,忠孝里,NULL
77,988,19,1007,1272,0,0,79.17,765,223,關東里,NULL
875,999,8,1007,1238,0,0,81.34,743,256,潭墘里,NULL
683,995,12,1007,1283,0,0,78.49,698,297,景福里,NULL
496,997,10,1007,1345,0,0,74.87,684,313,精忠里,NULL
1443,998,9,1007,1298,0,0,77.58,679,319,延和里,NULL
697,1001,6,1007,1218,0,0,82.68,667,334,黎忠里,NULL
204,992,15,1007,1242,0,0,81.08,661,331,建寶里,NULL
60,1000,7,1007,1300,0,0,77.46,622,378,建國里,NULL
1583,1001,6,1007,1317,0,0,76.46,607,394,江北里,NULL
2016,999,8,1007,1313,0,0,76.69,605,394,福興村,NULL
117,995,12,1007,1406,0,0,71.62,587,408,吉和里,NULL
0,995,12,1007,1406,0,0,71.62,587,408,吉和里,NULL
269,1004,3,1007,1342,0,0,75.04,586,418,福興里,NULL
274,995,12,1007,1389,0,0,72.5,581,414,復興里,NULL
763,999,8,1007,1420,0,0,70.92,578,421,海豐村,NULL
0,999,8,1007,1420,0,0,70.92,578,421,海豐村,NULL
782,997,10,1007,1275,0,0,78.98,566,431,南路里,NULL
0,997,10,1007,1275,0,0,78.98,566,431,南路里,NULL
186,993,14,1007,1339,0,0,75.21,559,434,東光里,NULL
851,1003,4,1007,1290,0,0,78.06,453,550,香洋村,NULL
0,995,11,1006,1821,0,0,55.24,828,167,梨山村,NULL
41,999,7,1006,1273,0,0,79.03,765,234,福星里,NULL
261,1000,6,1006,1308,0,0,76.91,643,357,內湖里,NULL
188,1000,6,1006,1275,0,0,78.9,638,362,舊社里,NULL
1720,998,8,1006,1331,0,0,75.58,630,368,東陽里,NULL
633,990,16,1006,1291,0,0,77.92,615,375,三義里,NULL
738,1002,4,1006,1260,0,0,79.84,602,400,文福里,NULL
118,992,14,1006,1336,0,0,75.3,556,436,高南里,NULL
0,992,14,1006,1336,0,0,75.3,556,436,高南里,NULL
416,1003,3,1006,1276,0,0,78.84,539,464,寶慶里,NULL
357,1000,6,1006,1295,0,0,77.68,455,545,麟趾村,NULL
209,1001,5,1006,1309,0,0,76.85,446,555,元安里,NULL
0,1001,5,1006,1309,0,0,76.85,446,555,元安里,NULL
788,987,18,1005,1272,0,0,79.01,791,196,龍恩里,NULL
295,998,7,1005,1252,0,0,80.27,780,218,南興村,NULL
0,998,7,1005,1252,0,0,80.27,780,218,南興村,NULL
0,996,9,1005,1831,0,0,54.89,780,216,外垵村,NULL
274,996,9,1005,1268,0,0,79.26,775,221,翠山里,NULL
109,989,16,1005,1445,0,0,69.55,775,214,太昌村,NULL
42,999,6,1005,1480,0,0,67.91,598,401,上平村,NULL
0,999,6,1005,1480,0,0,67.91,598,401,上平村,NULL
1770,990,15,1005,1356,0,0,74.12,595,395,鳳祥里,NULL
1991,993,12,1005,1280,0,0,78.52,581,412,民義村,NULL
161,988,17,1005,1307,0,0,76.89,570,418,大誠里,NULL
86,1000,5,1005,1288,0,0,78.03,526,474,維揚里,NULL
418,999,6,1005,1369,0,0,73.41,454,545,義仁村,NULL
0,999,6,1005,1369,0,0,73.41,454,545,義仁村,NULL
824,991,14,1005,1280,0,0,78.52,427,564,建泰里,NULL
203,999,6,1005,1279,0,0,78.58,425,574,厚生里,NULL
0,994,11,1005,1447,0,0,69.45,402,592,馬鳴村,NULL
788,996,8,1004,1184,0,0,84.8,934,62,東門里,NULL
98,986,18,1004,1481,0,0,67.79,877,109,秀林村,NULL
0,986,18,1004,1481,0,0,67.79,877,109,秀林村,NULL
760,992,12,1004,1231,0,0,81.56,730,262,安和里,NULL
1156,994,10,1004,1283,0,0,78.25,692,302,住安里,NULL
23,996,8,1004,1500,0,0,66.93,650,346,西衛里,NULL
543,995,9,1004,1292,0,0,77.71,605,390,夢裡村,NULL
106,992,12,1004,1407,0,0,71.36,601,391,北梅里,NULL
1883,999,5,1004,1287,0,0,78.01,594,405,新興里,NULL
1,992,12,1004,1320,0,0,76.06,587,405,短竹里,NULL
1435,997,7,1004,1269,0,0,79.12,586,411,平和里,NULL
94,999,5,1004,1333,0,0,75.32,574,425,賢文里,NULL
717,996,8,1004,1360,0,0,73.82,571,425,墩東村,NULL
790,1001,3,1004,1258,0,0,79.81,558,443,東門里,NULL
781,995,9,1004,1260,0,0,79.68,555,440,三和村,NULL
355,989,15,1004,1301,0,0,77.17,536,453,淡溝里,NULL
499,994,10,1004,1254,0,0,80.06,524,470,永吉里,NULL
992,991,13,1004,1661,0,0,60.45,486,505,富福里,NULL
476,998,6,1004,1377,0,0,72.91,470,528,興東里,NULL
909,996,8,1004,1281,0,0,78.38,402,594,大德里,NULL
62,994,10,1004,1282,0,0,78.32,373,621,九塊村,NULL
0,994,10,1004,1282,0,0,78.32,373,621,九塊村,NULL
537,994,10,1004,1314,0,0,76.41,327,667,大社村,NULL
23,995,8,1003,1245,0,0,80.56,769,226,勝利里,NULL
1214,996,7,1003,1216,0,0,82.48,747,249,寶興里,NULL
832,990,13,1003,1246,0,0,80.5,708,282,永福里,NULL
1416,996,7,1003,1309,0,0,76.62,692,304,金城里,NULL
2125,995,8,1003,1344,0,0,74.63,687,308,埔頭村,NULL
284,996,7,1003,1257,0,0,79.79,634,362,和調里,NULL
978,997,6,1003,1271,0,0,78.91,620,377,昌信里,NULL
239,991,12,1003,1396,0,0,71.85,613,378,山腳村,NULL
252,995,8,1003,1319,0,0,76.04,613,382,東芳里,NULL
1099,998,5,1003,1300,0,0,77.15,590,408,昌隆里,NULL
2164,991,12,1003,1358,0,0,73.86,569,422,荖阡村,NULL
0,991,12,1003,1358,0,0,73.86,569,422,荖阡村,NULL
1161,996,7,1003,1305,0,0,76.86,563,433,通化里,NULL
49,988,15,1003,1251,0,0,80.18,506,482,尊賢里,NULL
851,991,12,1003,1314,0,0,76.33,496,495,景星里,NULL
834,994,9,1003,1291,0,0,77.69,495,499,東寶村,NULL
469,997,6,1003,1237,0,0,81.08,469,528,東英里,NULL
295,996,7,1003,1281,0,0,78.3,462,534,龍華里,NULL
338,995,8,1003,1350,0,0,74.3,449,546,漢光里,NULL
10,994,9,1003,1292,0,0,77.63,401,593,鐵店村,NULL
0,994,9,1003,1292,0,0,77.63,401,593,鐵店村,NULL
794,994,8,1002,1241,0,0,80.74,856,138,龍興里,NULL
1264,995,7,1002,1307,0,0,76.66,806,189,達觀里,NULL
610,992,10,1002,1235,0,0,81.13,760,232,水尾里,NULL
890,990,12,1002,1277,0,0,78.47,718,272,林興里,NULL
969,990,12,1002,1334,0,0,75.11,717,273,福星里,NULL
226,992,10,1002,1305,0,0,76.78,702,290,裕豐里,NULL
436,994,8,1002,1231,0,0,81.4,673,321,東明里,NULL
239,993,9,1002,1300,0,0,77.08,667,326,平昌里,NULL
578,995,7,1002,1246,0,0,80.42,661,334,廟美里,NULL
1100,996,6,1002,1241,0,0,80.74,604,392,後港里,NULL
618,996,6,1002,1286,0,0,77.92,592,404,中正里,NULL
789,993,9,1002,1254,0,0,79.9,588,405,成功村,NULL
268,993,9,1002,1342,0,0,74.66,585,408,永豐里,NULL
130,992,10,1002,1250,0,0,80.16,559,433,興南里,NULL
0,992,10,1002,1250,0,0,80.16,559,433,興南里,NULL
190,995,7,1002,1543,0,0,64.94,541,454,東池村,NULL
0,995,7,1002,1543,0,0,64.94,541,454,東池村,NULL
210,999,3,1002,1392,0,0,71.98,519,480,三共里,NULL
284,992,10,1002,1405,0,0,71.32,495,497,西榮村,NULL
0,992,10,1002,1405,0,0,71.32,495,497,西榮村,NULL
211,994,8,1002,1325,0,0,75.62,492,502,三共里,NULL
488,994,8,1002,1326,0,0,75.57,307,687,後營村,NULL
0,994,8,1002,1326,0,0,75.57,307,687,後營村,NULL
128,994,7,1001,1201,0,0,83.35,799,195,頭重里,NULL
368,994,7,1001,1202,0,0,83.28,787,207,瑞光里,NULL
47,996,5,1001,1248,0,0,80.21,724,272,新社里,NULL
949,994,7,1001,1249,0,0,80.14,697,297,幸福里,NULL
1380,994,7,1001,1264,0,0,79.19,654,340,明德里,NULL
711,995,6,1001,1286,0,0,77.84,601,394,后里村,NULL
256,988,13,1001,1256,0,0,79.7,579,409,新興里,NULL
768,991,10,1001,1221,0,0,81.98,567,424,忠孝里,NULL
89,990,11,1001,1323,0,0,75.66,561,429,福德里,NULL
0,990,11,1001,1323,0,0,75.66,561,429,福德里,NULL
1817,992,9,1001,1507,0,0,66.42,547,445,介壽里,NULL
966,993,8,1001,1309,0,0,76.47,528,465,和平里,NULL
712,991,10,1001,1255,0,0,79.76,493,498,武松里,NULL
848,994,7,1001,1261,0,0,79.38,464,530,瑞昌里,NULL
727,992,9,1001,1289,0,0,77.66,335,657,孔宅里,NULL
127,993,7,1000,1240,0,0,80.65,748,245,頭重里,NULL
218,990,10,1000,1330,0,0,75.19,743,247,柳新村,NULL
579,989,11,1000,1283,0,0,77.94,719,270,正和里,NULL
854,993,7,1000,1270,0,0,78.74,670,323,高山里,NULL
475,992,8,1000,1311,0,0,76.28,659,333,東勢里,NULL
572,994,6,1000,1254,0,0,79.74,654,340,德行里,NULL
57,990,10,1000,1206,0,0,82.92,611,379,漢生里,NULL
554,985,15,1000,1265,0,0,79.05,599,386,西德里,NULL
1104,993,7,1000,1294,0,0,77.28,598,395,南港里,NULL
390,985,15,1000,1358,0,0,73.64,597,388,西平里,NULL
0,985,15,1000,1358,0,0,73.64,597,388,西平里,NULL
10,992,8,1000,1257,0,0,79.55,579,413,湳興里,NULL
41,994,6,1000,1313,0,0,76.16,567,427,石川里,NULL
0,994,6,1000,1313,0,0,76.16,567,427,石川里,NULL
5,995,5,1000,1233,0,0,81.1,560,435,文林里,NULL
162,989,11,1000,1255,0,0,79.68,559,430,磐石里,NULL
492,994,6,1000,1228,0,0,81.43,556,438,長榮里,NULL
394,983,17,1000,1463,0,0,68.35,503,480,廣興里,NULL
0,983,17,1000,1463,0,0,68.35,503,480,廣興里,NULL
764,994,6,1000,1249,0,0,80.06,492,502,忠義里,NULL
372,989,11,1000,1312,0,0,76.22,490,499,埔尾村,NULL
0,989,11,1000,1312,0,0,76.22,490,499,埔尾村,NULL
854,995,5,1000,1286,0,0,77.76,475,520,隆和里,NULL
645,994,6,1000,1343,0,0,74.46,422,572,仁愛村,NULL
0,997,3,1000,1706,0,0,58.62,390,607,崙中村,NULL
746,995,5,1000,1294,0,0,77.28,384,611,鳳林里,NULL
83,996,4,1000,1355,0,0,73.8,294,702,明宜里,NULL
0,988,11,999,1707,0,0,58.52,711,277,德高里,NULL
55,994,5,999,1315,0,0,75.97,667,327,卑南里,NULL
362,990,9,999,1298,0,0,76.96,586,404,東湖里,NULL
1680,991,8,999,1228,0,0,81.35,578,413,樹福里,NULL
50,991,8,999,1456,0,0,68.61,571,420,東南村,NULL
0,991,8,999,1456,0,0,68.61,571,420,東南村,NULL
256,993,6,999,1279,0,0,78.11,565,428,豐源里,NULL
753,993,6,999,1342,0,0,74.44,531,462,社口村,NULL
46,994,5,999,1268,0,0,78.79,488,506,初陽里,NULL
0,994,5,999,1268,0,0,78.79,488,506,初陽里,NULL
509,991,8,999,1258,0,0,79.41,479,512,八卦村,NULL
897,993,6,999,1287,0,0,77.62,457,536,南和里,NULL
507,991,8,999,1328,0,0,75.23,417,574,港口村,NULL
183,994,5,999,1399,0,0,71.41,412,582,時潮村,NULL
0,994,5,999,1399,0,0,71.41,412,582,時潮村,NULL
342,990,8,998,1273,0,0,78.4,772,218,樟樹村,NULL
0,990,8,998,1273,0,0,78.4,772,218,樟樹村,NULL
820,994,4,998,1282,0,0,77.85,712,282,大同里,NULL
1217,988,10,998,1260,0,0,79.21,666,322,寶福里,NULL
71,994,4,998,1278,0,0,78.09,661,333,大同村,NULL
1881,987,11,998,1243,0,0,80.29,590,397,新興里,NULL
438,992,6,998,1274,0,0,78.34,543,449,一心里,NULL
42,988,10,998,1188,0,0,84.01,534,454,新生里,NULL
299,993,5,998,1517,0,0,65.79,510,483,草湖村,NULL
0,993,5,998,1517,0,0,65.79,510,483,草湖村,NULL
613,986,12,998,1324,0,0,75.38,502,484,南嵩里,NULL
863,986,12,998,1257,0,0,79.4,496,490,過埤里,NULL
106,988,10,998,1337,0,0,74.64,484,504,竹林里,NULL
101,988,10,998,1366,0,0,73.06,468,520,南社里,NULL
301,987,10,997,1374,0,0,72.56,741,246,富興村,NULL
0,987,10,997,1374,0,0,72.56,741,246,富興村,NULL
39,991,6,997,1203,0,0,82.88,692,299,義幸里,NULL
1246,983,14,997,1307,0,0,76.28,658,325,永安里,NULL
220,990,7,997,1220,0,0,81.72,623,367,松勇里,NULL
391,980,17,997,1387,0,0,71.88,622,358,海湖村,NULL
1101,993,4,997,1296,0,0,76.93,610,383,誠安里,NULL
49,987,10,997,1262,0,0,79,602,385,久昌里,NULL
864,991,6,997,1231,0,0,80.99,591,400,過埤里,NULL
443,986,11,997,1280,0,0,77.89,590,396,光平里,NULL
0,986,11,997,1280,0,0,77.89,590,396,光平里,NULL
138,986,11,997,1331,0,0,74.91,585,401,橋頭村,NULL
244,992,5,997,1310,0,0,76.11,585,407,崙平里,NULL
1839,986,11,997,1356,0,0,73.53,579,407,溪東里,NULL
555,988,9,997,1308,0,0,76.22,573,415,仁政里,NULL
0,988,9,997,1308,0,0,76.22,573,415,仁政里,NULL
219,988,9,997,1379,0,0,72.3,572,416,三興里,NULL
605,985,12,997,1275,0,0,78.2,549,436,北陽里,NULL
122,988,9,997,1380,0,0,72.25,511,477,東寧村,NULL
511,982,15,997,1306,0,0,76.34,483,499,八卦村,NULL
1122,985,12,997,1327,0,0,75.13,468,517,民本里,NULL
1503,984,13,997,1274,0,0,78.26,423,561,溪墘里,NULL
264,982,15,997,1426,0,0,69.92,422,560,新街里,NULL
522,991,6,997,1233,0,0,80.86,420,571,仁和村,NULL
0,983,14,997,1384,0,0,72.04,350,633,篤農村,NULL
278,987,9,996,1230,0,0,80.98,807,180,橫山村,NULL
1313,981,15,996,1291,0,0,77.15,746,235,頂埔里,NULL
1599,981,15,996,1335,0,0,74.61,683,298,忠孝里,NULL
333,982,14,996,1302,0,0,76.5,679,303,大漢里,NULL
807,988,8,996,1224,0,0,81.37,666,322,海光里,NULL
356,988,8,996,1204,0,0,82.72,628,360,明湖里,NULL
141,988,8,996,1226,0,0,81.24,627,361,新南里,NULL
203,979,17,996,1269,0,0,78.49,593,386,境福里,NULL
12,989,7,996,1268,0,0,78.55,563,426,潮洋里,NULL
1050,986,10,996,1262,0,0,78.92,531,455,興德里,NULL
856,980,16,996,1299,0,0,76.67,517,463,高榮里,NULL
537,979,17,996,1452,0,0,68.6,509,470,永豊村,NULL
137,989,7,996,1261,0,0,78.98,509,480,南蓮村,NULL
0,979,17,996,1452,0,0,68.6,509,470,永豊村,NULL
545,991,5,996,1388,0,0,71.76,506,485,東海村,NULL
285,990,6,996,1335,0,0,74.61,459,531,蔗廍村,NULL
53,992,3,995,1222,0,0,81.42,888,104,軍功里,NULL
113,990,5,995,1242,0,0,80.11,851,139,五豐里,NULL
899,984,11,995,1276,0,0,77.98,811,173,上華村,NULL
808,983,12,995,1281,0,0,77.67,788,195,瑞坪里,NULL
767,992,3,995,1201,0,0,82.85,747,245,中安里,NULL
858,988,7,995,1201,0,0,82.85,681,307,民生里,NULL
1172,990,5,995,1253,0,0,79.41,670,320,法治里,NULL
515,988,7,995,1261,0,0,78.91,636,352,新光里,NULL
246,975,20,995,1401,0,0,71.02,588,387,龍崗村,NULL
351,990,5,995,1226,0,0,81.16,568,422,福祉里,NULL
2056,988,7,995,1282,0,0,77.61,551,437,西林村,NULL
525,977,18,995,1296,0,0,76.77,525,452,五福里,NULL
203,985,10,995,1321,0,0,75.32,519,466,大涼里,NULL
615,985,10,995,1290,0,0,77.13,506,479,翁子里,NULL
668,988,7,995,1259,0,0,79.03,461,527,竹內里,NULL
314,982,13,995,1490,0,0,66.78,429,553,大隱村,NULL
224,987,8,995,1314,0,0,75.72,371,616,惠好村,NULL
0,987,8,995,1314,0,0,75.72,371,616,惠好村,NULL
853,980,14,994,1213,0,0,81.95,741,239,秀得里,NULL
1279,987,7,994,1235,0,0,80.49,729,258,興光里,NULL
694,986,8,994,1223,0,0,81.28,683,303,黎平里,NULL
954,981,13,994,1224,0,0,81.21,673,308,東門里,NULL
165,987,7,994,1314,0,0,75.65,663,324,中英里,NULL
0,987,7,994,1314,0,0,75.65,663,324,中英里,NULL
643,986,8,994,1298,0,0,76.58,659,327,南興里,NULL
2162,992,2,994,1356,0,0,73.3,631,361,訊塘村,NULL
1992,990,4,994,1275,0,0,77.96,629,361,德音村,NULL
165,987,7,994,1283,0,0,77.47,621,366,莊雅村,NULL
572,985,9,994,1260,0,0,78.89,620,365,福成里,NULL
1,989,5,994,1300,0,0,76.46,602,387,新港村,NULL
1871,986,8,994,1274,0,0,78.02,596,390,竿蓁里,NULL
499,981,13,994,1247,0,0,79.71,588,393,德義里,NULL
263,985,9,994,1303,0,0,76.29,586,399,內湖里,NULL
315,987,7,994,1422,0,0,69.9,584,403,八張里,NULL
0,987,7,994,1422,0,0,69.9,584,403,八張里,NULL
1677,980,14,994,1218,0,0,81.61,574,406,樹德里,NULL
1765,982,12,994,1258,0,0,79.01,565,417,永昌里,NULL
171,984,10,994,1276,0,0,77.9,552,432,光復里,NULL
403,983,11,994,1348,0,0,73.74,522,461,橫峰村,NULL
172,985,9,994,1261,0,0,78.83,521,464,進學里,NULL
0,985,9,994,1261,0,0,78.83,521,464,進學里,NULL
721,988,6,994,1222,0,0,81.34,494,494,文華里,NULL
173,986,8,994,1320,0,0,75.3,465,521,建國里,NULL
0,986,8,994,1320,0,0,75.3,465,521,建國里,NULL
251,985,9,994,1219,0,0,81.54,461,524,教仁里,NULL
79,981,13,994,1354,0,0,73.41,459,522,大鄉里,NULL
837,988,6,994,1305,0,0,76.17,427,561,瑞崗里,NULL
124,987,7,994,1369,0,0,72.61,416,571,獅山里,NULL
6,983,10,993,1819,0,0,54.59,928,55,西門里,NULL
27,983,10,993,1245,0,0,79.76,794,189,清華里,NULL
34,987,6,993,1313,0,0,75.63,665,322,何厝里,NULL
21,982,11,993,1247,0,0,79.63,658,324,三民里,NULL
49,983,10,993,1279,0,0,77.64,643,340,大霞里,NULL
0,983,10,993,1279,0,0,77.64,643,340,大霞里,NULL
116,986,7,993,1223,0,0,81.19,629,357,德翠里,NULL
1395,983,10,993,1274,0,0,77.94,611,372,清和里,NULL
1401,980,13,993,1247,0,0,79.63,605,375,青山里,NULL
1431,975,18,993,1264,0,0,78.56,590,385,延祿里,NULL
1038,985,8,993,1273,0,0,78,571,414,中平里,NULL
1020,983,10,993,1247,0,0,79.63,543,440,立廷里,NULL
818,988,5,993,1249,0,0,79.5,488,500,瑞豐里,NULL
573,987,6,993,1238,0,0,80.21,475,512,中庄村,NULL
69,983,10,993,1325,0,0,74.94,421,562,東安里,NULL
708,989,4,993,1312,0,0,75.69,385,604,鎮北里,NULL
50,984,8,992,1166,0,0,85.08,909,75,武功里,NULL
261,988,4,992,1248,0,0,79.49,786,202,松林村,NULL
114,982,10,992,1438,0,0,68.98,765,217,吉安村,NULL
534,986,6,992,1323,0,0,74.98,764,222,仁福里,NULL
54,986,6,992,1530,0,0,64.84,757,229,岩灣里,NULL
0,986,6,992,1530,0,0,64.84,757,229,岩灣里,NULL
781,977,15,992,1334,0,0,74.36,726,251,東勢里,NULL
0,986,6,992,1526,0,0,65.01,692,294,海豐村,NULL
0,981,11,992,1412,0,0,70.25,622,359,內城村,NULL
922,980,12,992,1300,0,0,76.31,584,396,高平村,NULL
497,977,15,992,1298,0,0,76.43,581,396,宜欣里,NULL
1446,980,12,992,1262,0,0,78.61,569,411,光華里,NULL
1995,984,8,992,1293,0,0,76.72,529,455,水碓村,NULL
555,983,9,992,1272,0,0,77.99,515,468,西湳里,NULL
352,984,8,992,1228,0,0,80.78,456,528,新田村,NULL
884,969,23,992,1270,0,0,78.11,435,534,龍成里,NULL
310,990,2,992,1225,0,0,80.98,431,559,安泰里,NULL
1965,982,10,992,1249,0,0,79.42,406,576,興珍村,NULL
231,987,5,992,1363,0,0,72.78,397,590,西華村,NULL
0,987,5,992,1363,0,0,72.78,397,590,西華村,NULL
301,987,5,992,1317,0,0,75.32,386,601,厚生里,NULL
981,977,15,992,1303,0,0,76.13,377,600,新坡村,NULL
313,982,10,992,1378,0,0,71.99,274,708,永定村,NULL
0,982,10,992,1378,0,0,71.99,274,708,永定村,NULL
0,986,5,991,1795,0,0,55.21,959,27,瓊林里,NULL
881,985,6,991,1195,0,0,82.93,697,288,永安里,NULL
1594,979,12,991,1285,0,0,77.12,655,324,金龍里,NULL
421,985,6,991,1260,0,0,78.65,626,359,公正里,NULL
533,978,13,991,1249,0,0,79.34,623,355,工學里,NULL
351,985,6,991,1274,0,0,77.79,612,373,賴村里,NULL
137,983,8,991,1274,0,0,77.79,611,372,正南里,NULL
263,976,15,991,1361,0,0,72.81,610,366,東明里,NULL
0,976,15,991,1361,0,0,72.81,610,366,東明里,NULL
658,985,6,991,1485,0,0,66.73,602,383,安康里,NULL
620,983,8,991,1314,0,0,75.42,588,395,仁美里,NULL
161,983,8,991,1270,0,0,78.03,557,426,港嘴里,NULL
254,986,5,991,1260,0,0,78.65,524,462,豐榮里,NULL
40,980,11,991,1269,0,0,78.09,523,457,新生里,NULL
608,978,13,991,1316,0,0,75.3,511,467,南村里,NULL
645,985,6,991,1223,0,0,81.03,497,488,正義里,NULL
400,987,4,991,1348,0,0,73.52,451,536,仙吉村,NULL
769,984,6,990,1226,0,0,80.75,757,227,中安里,NULL
1267,980,10,990,1193,0,0,82.98,752,228,小城里,NULL
562,983,7,990,1276,0,0,77.59,616,367,居仁里,NULL
0,983,7,990,1276,0,0,77.59,616,367,居仁里,NULL
371,985,5,990,1291,0,0,76.68,554,431,中達里,NULL
288,981,9,990,1221,0,0,81.08,476,505,裕民里,NULL
0,981,9,990,1221,0,0,81.08,476,505,裕民里,NULL
451,985,5,990,1303,0,0,75.98,467,518,榴中里,NULL
152,985,4,989,1222,0,0,80.93,741,244,壯觀里,NULL
28,982,7,989,1453,0,0,68.07,738,244,新生里,NULL
35,981,8,989,1155,0,0,85.63,720,261,綠水里,NULL
651,982,7,989,1317,0,0,75.09,689,293,北興里,NULL
0,982,7,989,1317,0,0,75.09,689,293,北興里,NULL
1397,979,10,989,1346,0,0,73.48,622,357,清溪里,NULL
534,984,5,989,1222,0,0,80.93,606,378,工學里,NULL
167,978,11,989,1282,0,0,77.15,554,424,仙草里,NULL
636,981,8,989,1694,0,0,58.38,544,437,永康里,NULL
205,986,3,989,1317,0,0,75.09,533,453,三星里,NULL
699,985,4,989,1233,0,0,80.21,527,458,鎮西里,NULL
345,975,14,989,1234,0,0,80.15,522,453,五福村,NULL
0,983,6,989,1333,0,0,74.19,418,565,後堀村,NULL
0,984,4,988,1491,0,0,66.26,660,324,泰和村,NULL
1800,978,10,988,1431,0,0,69.04,613,365,鳶山里,NULL
170,982,6,988,1320,0,0,74.85,610,372,頂埔里,NULL
0,982,6,988,1320,0,0,74.85,610,372,頂埔里,NULL
1726,974,14,988,1308,0,0,75.54,561,413,中山里,NULL
817,982,6,988,1270,0,0,77.8,558,424,玉泉里,NULL
237,979,9,988,1320,0,0,74.85,552,427,埔和村,NULL
51,983,5,988,1297,0,0,76.18,532,451,菜園里,NULL
0,983,5,988,1297,0,0,76.18,532,451,菜園里,NULL
17,977,11,988,1270,0,0,77.8,513,464,香社里,NULL
539,972,16,988,1292,0,0,76.47,484,488,慈祐里,NULL
645,977,11,988,1332,0,0,74.17,482,495,正強里,NULL
1042,981,7,988,1201,0,0,82.26,470,511,孝德里,NULL
132,976,12,988,1432,0,0,68.99,458,518,廉使里,NULL
23,980,8,988,1310,0,0,75.42,315,665,長榮村,NULL
0,980,8,988,1310,0,0,75.42,315,665,長榮村,NULL
14,981,7,988,1315,0,0,75.13,306,675,載興村,NULL
641,970,17,987,1207,0,0,81.77,756,214,華南里,NULL
2130,978,9,987,1393,0,0,70.85,683,295,埔坪村,NULL
1257,978,9,987,1252,0,0,78.83,671,307,萬有里,NULL
584,978,9,987,1136,0,0,86.88,668,310,和平里,NULL
264,982,5,987,1270,0,0,77.72,661,321,仁愛里,NULL
0,982,5,987,1270,0,0,77.72,661,321,仁愛里,NULL
759,977,10,987,1191,0,0,82.87,657,320,協和里,NULL
710,976,11,987,1240,0,0,79.6,640,336,義德村,NULL
191,982,5,987,1283,0,0,76.93,580,402,水景里,NULL
111,974,13,987,1344,0,0,73.44,578,396,健民里,NULL
0,974,13,987,1344,0,0,73.44,578,396,健民里,NULL
1437,979,8,987,1276,0,0,77.35,557,422,安和里,NULL
748,983,4,987,1224,0,0,80.64,557,426,和興里,NULL
267,980,7,987,1338,0,0,73.77,522,458,新街里,NULL
637,971,16,987,1262,0,0,78.21,513,458,五福里,NULL
99,980,7,987,1474,0,0,66.96,418,562,新庄里,NULL
0,980,7,987,1474,0,0,66.96,418,562,新庄里,NULL
203,973,14,987,1284,0,0,76.87,405,568,觀音村,NULL
291,980,7,987,1336,0,0,73.88,382,598,大吉村,NULL
613,980,6,986,1263,0,0,78.07,729,251,普忠里,NULL
727,977,9,986,1224,0,0,80.56,701,276,復旦里,NULL
663,970,16,986,2629,0,0,37.5,694,276,外南里,NULL
162,977,9,986,1234,0,0,79.9,665,312,大誠里,NULL
2061,983,3,986,1232,0,0,80.03,654,329,菁湖村,NULL
750,975,11,986,1253,0,0,78.69,590,385,嘉慶里,NULL
1365,980,6,986,1240,0,0,79.52,575,405,學成里,NULL
254,974,12,986,1322,0,0,74.58,572,402,磚磘里,NULL
49,977,9,986,1286,0,0,76.67,536,441,何仁里,NULL
86,974,12,986,1264,0,0,78.01,528,446,江翠里,NULL
563,981,5,986,1242,0,0,79.39,477,504,普照里,NULL
125,976,10,986,1310,0,0,75.27,460,516,埒內里,NULL
2064,977,9,986,1220,0,0,80.82,451,526,湖北村,NULL
0,977,9,986,1220,0,0,80.82,451,526,湖北村,NULL
845,981,5,986,1267,0,0,77.82,450,531,栗林村,NULL
836,978,8,986,1202,0,0,82.03,416,562,瑞崗里,NULL
206,974,12,986,1279,0,0,77.09,407,567,神農村,NULL
210,979,7,986,1414,0,0,69.73,196,783,台子村,NULL
121,980,5,985,1195,0,0,82.43,951,29,自助里,NULL
356,972,13,985,1343,0,0,73.34,820,152,南江村,NULL
0,972,13,985,1343,0,0,73.34,820,152,南江村,NULL
73,978,7,985,1547,0,0,63.67,789,189,忠仁里、忠智里,NULL
0,978,7,985,1547,0,0,63.67,789,189,忠仁里、忠智里,NULL
1618,978,7,985,1270,0,0,77.56,709,269,湖光里,NULL
332,970,15,985,1264,0,0,77.93,679,291,頂厝里,NULL
25,980,5,985,1227,0,0,80.28,660,320,上德里,NULL
1121,978,7,985,1243,0,0,79.24,636,342,龍安里,NULL
884,973,12,985,1260,0,0,78.17,628,345,水源里,NULL
190,976,9,985,1245,0,0,79.12,607,369,水景里,NULL
135,979,6,985,1276,0,0,77.19,606,373,照南里,NULL
1311,975,10,985,1286,0,0,76.59,587,388,頂埔里,NULL
260,978,7,985,1264,0,0,77.93,546,432,鹽水里,NULL
0,978,7,985,1264,0,0,77.93,546,432,鹽水里,NULL
703,979,6,985,1245,0,0,79.12,541,438,員山里,NULL
53,975,10,985,1329,0,0,74.12,498,477,芳草里,NULL
972,973,12,985,1307,0,0,75.36,489,484,大同村,NULL
208,976,9,985,1504,0,0,65.49,480,496,東山村,NULL
0,976,9,985,1504,0,0,65.49,480,496,東山村,NULL
686,975,10,985,1400,0,0,70.36,472,503,明正里,NULL
0,975,10,985,1400,0,0,70.36,472,503,明正里,NULL
265,979,6,985,1420,0,0,69.37,450,529,崎漏村,NULL
334,978,7,985,1253,0,0,78.61,391,587,新興村,NULL
424,980,5,985,1336,0,0,73.73,281,699,胡厝里,NULL
195,971,13,984,1253,0,0,78.53,766,205,興隆里,NULL
2124,978,6,984,1307,0,0,75.29,664,314,埔頭村,NULL
726,976,8,984,1231,0,0,79.94,655,321,復國里,NULL
175,978,6,984,1229,0,0,80.07,652,326,東光里,NULL
0,978,6,984,1229,0,0,80.07,652,326,東光里,NULL
682,974,10,984,1229,0,0,80.07,628,346,景勤里,NULL
788,975,9,984,1213,0,0,81.12,609,366,成功村,NULL
991,965,19,984,1457,0,0,67.54,599,366,樹林村,NULL
378,974,10,984,1429,0,0,68.86,578,396,草湖村,NULL
0,974,10,984,1429,0,0,68.86,578,396,草湖村,NULL
155,969,15,984,1265,0,0,77.79,571,398,同心里,NULL
1008,974,10,984,1254,0,0,78.47,558,416,中和里,NULL
21,968,16,984,1254,0,0,78.47,556,412,香雅里,NULL
691,972,12,984,1224,0,0,80.39,548,424,平安里,NULL
496,973,11,984,1286,0,0,76.52,500,473,文東里,NULL
717,976,8,984,1312,0,0,75,500,476,社頭村,NULL
0,973,11,984,1286,0,0,76.52,500,473,文東里,NULL
1,974,10,984,1315,0,0,74.83,484,490,蒜頭村,NULL
0,974,10,984,1315,0,0,74.83,484,490,蒜頭村,NULL
96,975,9,984,1257,0,0,78.28,421,554,玉順里,NULL
0,975,9,984,1257,0,0,78.28,421,554,玉順里,NULL
627,975,9,984,1385,0,0,71.05,409,566,內坑村,NULL
172,976,8,984,1351,0,0,72.83,398,578,護鎮里,NULL
0,976,8,984,1351,0,0,72.83,398,578,護鎮里,NULL
274,976,7,983,1254,0,0,78.39,781,195,崇武里,NULL
670,976,7,983,1277,0,0,76.98,765,211,仁和里,NULL
773,978,5,983,1211,0,0,81.17,650,328,秀山里,NULL
331,973,10,983,1210,0,0,81.24,625,348,甲寅村,NULL
511,976,7,983,1341,0,0,73.3,617,359,新城里,NULL
1369,977,6,983,1191,0,0,82.54,597,380,埤林里,NULL
226,979,4,983,1217,0,0,80.77,596,383,中埔里,NULL
1409,972,11,983,1270,0,0,77.4,590,382,永豐里,NULL
175,973,10,983,1208,0,0,81.37,590,383,洛泉里,NULL
1328,979,4,983,1289,0,0,76.26,586,393,埤塘里,NULL
635,976,7,983,1306,0,0,75.27,579,397,中正村,NULL
0,976,7,983,1306,0,0,75.27,579,397,中正村,NULL
332,973,10,983,1293,0,0,76.02,570,403,岩竹村,NULL
0,973,10,983,1293,0,0,76.02,570,403,岩竹村,NULL
727,976,7,983,1342,0,0,73.25,569,407,晴光里,NULL
386,967,16,983,1250,0,0,78.64,560,407,光明里,NULL
657,972,11,983,1253,0,0,78.45,552,420,興平里,NULL
243,969,14,983,1398,0,0,70.31,552,417,龍泉村,NULL
153,971,12,983,1316,0,0,74.7,550,421,草湳里,NULL
155,978,5,983,1281,0,0,76.74,535,443,光路里,NULL
969,977,6,983,1328,0,0,74.02,533,444,藍埔村,NULL
684,976,7,983,1302,0,0,75.5,533,443,龍潭里,NULL
1979,978,5,983,1260,0,0,78.02,527,451,成功村,NULL
605,974,9,983,1202,0,0,81.78,515,459,林榮里,NULL
202,965,18,983,1349,0,0,72.87,501,464,安海里,NULL
0,965,18,983,1349,0,0,72.87,501,464,安海里,NULL
512,976,7,983,1319,0,0,74.53,478,498,永順里,NULL
0,975,8,983,1299,0,0,75.67,469,506,南和村,NULL
34,977,6,983,1432,0,0,68.65,459,518,型厝村,NULL
0,977,6,983,1432,0,0,68.65,459,518,型厝村,NULL
207,970,13,983,1552,0,0,63.34,437,533,港東村,NULL
0,970,13,983,1552,0,0,63.34,437,533,港東村,NULL
288,977,6,983,1338,0,0,73.47,407,570,協和村,NULL
786,973,9,982,1180,0,0,83.22,672,301,北富里,NULL
2090,973,9,982,1228,0,0,79.97,612,361,土庫村,NULL
2240,978,4,982,1338,0,0,73.39,608,370,龜吼村,NULL
487,973,9,982,1275,0,0,77.02,589,384,北銘里,NULL
0,973,9,982,1275,0,0,77.02,589,384,北銘里,NULL
1576,975,7,982,1265,0,0,77.63,577,398,保安里,NULL
0,975,7,982,1265,0,0,77.63,577,398,保安里,NULL
528,971,11,982,1273,0,0,77.14,563,408,福隆里,NULL
72,971,11,982,1408,0,0,69.74,488,483,城東里,NULL
0,971,11,982,1408,0,0,69.74,488,483,城東里,NULL
132,970,12,982,1228,0,0,79.97,471,499,龍翠里,NULL
429,974,8,982,1219,0,0,80.56,462,512,寶龍里,NULL
273,975,7,982,1271,0,0,77.26,457,518,溪山里,NULL
0,975,7,982,1271,0,0,77.26,457,518,溪山里,NULL
164,974,8,982,1288,0,0,76.24,427,547,長安里,NULL
0,974,8,982,1288,0,0,76.24,427,547,長安里,NULL
0,973,9,982,1331,0,0,73.78,332,641,侯伯村,NULL
192,978,3,981,1279,0,0,76.7,699,279,暖西里,NULL
342,974,7,981,1268,0,0,77.37,641,333,賴旺里,NULL
121,968,13,981,1314,0,0,74.66,618,350,高美里,NULL
0,968,13,981,1314,0,0,74.66,618,350,高美里,NULL
746,972,9,981,1280,0,0,76.64,574,398,協和村,NULL
330,971,10,981,1283,0,0,76.46,529,442,正興里,NULL
711,977,4,981,1215,0,0,80.74,449,528,泰山里,NULL
621,974,6,980,1189,0,0,82.42,679,295,忠福里,NULL
46,969,11,980,1181,0,0,82.98,647,322,文中里,NULL
191,969,11,980,1313,0,0,74.64,642,327,暖西里,NULL
810,970,10,980,1307,0,0,74.98,596,374,朱崙里,NULL
156,971,9,980,1294,0,0,75.73,568,403,二港村,NULL
0,971,9,980,1294,0,0,75.73,568,403,二港村,NULL
20,972,8,980,1247,0,0,78.59,557,415,惠楠里,NULL
717,970,10,980,1274,0,0,76.92,543,427,安穗里,NULL
282,970,10,980,1319,0,0,74.3,489,481,浮洲里,NULL
72,973,7,980,1224,0,0,80.07,468,505,廣福里,NULL
789,972,8,980,1233,0,0,79.48,465,507,中吉里,NULL
496,971,9,980,1286,0,0,76.21,461,510,二重村,NULL
0,971,9,980,1286,0,0,76.21,461,510,二重村,NULL
406,970,10,980,1365,0,0,71.79,447,523,金蘭村,NULL
0,970,10,980,1365,0,0,71.79,447,523,金蘭村,NULL
249,970,10,980,1354,0,0,72.38,444,526,嘉賜村,NULL
110,976,4,980,1338,0,0,73.24,443,533,內埔村,NULL
478,978,2,980,1320,0,0,74.24,433,545,白樹村,NULL
839,972,8,980,1210,0,0,80.99,420,552,瑞興里,NULL
77,975,5,980,1303,0,0,75.21,420,555,城北里,NULL
0,975,5,980,1303,0,0,75.21,420,555,城北里,NULL
83,971,9,980,1415,0,0,69.26,391,580,新圍村,NULL
386,970,10,980,1301,0,0,75.33,363,607,灣內村,NULL
0,970,10,980,1301,0,0,75.33,363,607,灣內村,NULL
71,974,6,980,1264,0,0,77.53,345,629,耆老村,NULL
0,974,6,980,1264,0,0,77.53,345,629,耆老村,NULL
1315,973,6,979,1339,0,0,73.11,743,230,明義里,NULL
122,973,6,979,1305,0,0,75.02,737,236,稻香村,NULL
894,970,9,979,1290,0,0,75.89,646,324,河堤里,NULL
1382,972,7,979,1171,0,0,83.6,643,329,學士里,NULL
137,965,14,979,1320,0,0,74.17,634,331,曲溪里,NULL
230,972,7,979,1212,0,0,80.78,599,373,民族里,NULL
70,970,9,979,1212,0,0,80.78,597,373,埔頂里,NULL
410,969,10,979,1210,0,0,80.91,558,411,永興里,NULL
0,969,10,979,1210,0,0,80.91,558,411,永興里,NULL
416,968,11,979,1164,0,0,84.11,540,428,國隆里,NULL
133,965,14,979,1271,0,0,77.03,462,503,三汴村,NULL
0,965,14,979,1271,0,0,77.03,462,503,三汴村,NULL
870,967,12,979,1215,0,0,80.58,442,525,鄰江里,NULL
826,977,2,979,1224,0,0,79.98,404,573,瑞平里,NULL
207,947,32,979,1254,0,0,78.07,389,558,神農村,NULL
0,970,9,979,1476,0,0,66.33,310,660,長沙村,NULL
34,974,4,978,1476,0,0,66.26,646,328,東衛里,NULL
0,974,4,978,1476,0,0,66.26,646,328,東衛里,NULL
140,967,11,978,1235,0,0,79.19,611,356,定邦里,NULL
0,967,11,978,1235,0,0,79.19,611,356,定邦里,NULL
1799,973,5,978,1279,0,0,76.47,573,400,鳶山里,NULL
636,971,7,978,1201,0,0,81.43,567,404,五福里,NULL
23,964,14,978,1254,0,0,77.99,564,400,中正里,NULL
152,968,10,978,1240,0,0,78.87,548,420,文翠里,NULL
696,971,7,978,1340,0,0,72.99,532,439,正苓里,NULL
747,968,10,978,1228,0,0,79.64,505,463,和興里,NULL
109,969,9,978,1266,0,0,77.25,492,477,永安里,NULL
701,973,5,978,1256,0,0,77.87,489,484,鎮西里,NULL
141,968,10,978,1192,0,0,82.05,487,481,和順里,NULL
988,970,8,978,1292,0,0,75.7,474,496,自立里,NULL
345,967,11,978,1240,0,0,78.87,435,532,宏竹村,NULL
853,970,8,978,1256,0,0,77.87,423,547,北勢村,NULL
197,973,5,978,1206,0,0,81.09,402,571,保安村,NULL
51,968,10,978,1400,0,0,69.86,363,605,大竹里,NULL
0,968,10,978,1400,0,0,69.86,363,605,大竹里,NULL
799,972,6,978,1278,0,0,76.53,356,616,中洲村,NULL
0,972,6,978,1278,0,0,76.53,356,616,中洲村,NULL
354,970,8,978,1336,0,0,73.2,334,636,公館里,NULL
0,970,8,978,1336,0,0,73.2,334,636,公館里,NULL
1134,970,7,977,1229,0,0,79.5,794,176,錦泰里,NULL
30,973,4,977,1304,0,0,74.92,709,264,中船里,NULL
0,973,4,977,1304,0,0,74.92,709,264,中船里,NULL
883,968,9,977,1286,0,0,75.97,703,265,龍祥村,NULL
159,964,13,977,1324,0,0,73.79,696,268,山佳里,NULL
476,962,15,977,1289,0,0,75.8,667,295,建國里,NULL
945,974,3,977,1300,0,0,75.15,658,316,黎明里,NULL
313,969,8,977,1389,0,0,70.34,643,326,建成里,NULL
657,968,9,977,1247,0,0,78.35,624,344,三愛里,NULL
795,970,7,977,1192,0,0,81.96,591,379,民權里,NULL
105,970,7,977,1342,0,0,72.8,580,390,合和里,NULL
1419,968,9,977,1242,0,0,78.66,556,412,峯廷里,NULL
547,972,5,977,1222,0,0,79.95,554,418,大湳里,NULL
126,970,7,977,1327,0,0,73.62,542,428,聖湖里,NULL
2050,974,3,977,1270,0,0,76.93,498,476,東林村,NULL
363,970,7,977,1407,0,0,69.44,497,473,永興村,NULL
0,970,7,977,1407,0,0,69.44,497,473,永興村,NULL
0,965,12,977,1424,0,0,68.61,492,473,大林里,NULL
869,971,6,977,1267,0,0,77.11,462,509,鄰江里,NULL
846,973,4,977,1241,0,0,78.73,426,547,新富里,NULL
591,973,4,977,1213,0,0,80.54,314,659,翁園村,NULL
260,965,11,976,1247,0,0,78.27,734,231,松林村,NULL
950,968,8,976,1206,0,0,80.93,667,301,興漢里,NULL
889,969,7,976,1275,0,0,76.55,637,332,聖德村,NULL
615,968,8,976,1213,0,0,80.46,621,347,長春里,NULL
1820,966,10,976,1336,0,0,73.05,613,353,中正里,NULL
1164,964,12,976,1255,0,0,77.77,600,364,通化里,NULL
330,962,14,976,1408,0,0,69.32,596,366,竹圍里,NULL
381,960,16,976,1298,0,0,75.19,570,390,祥興里,NULL
782,970,6,976,1229,0,0,79.41,558,412,江寧里,NULL
168,964,12,976,1262,0,0,77.34,554,410,明勝里,NULL
1442,967,9,976,1256,0,0,77.71,554,413,延和里,NULL
515,973,3,976,1214,0,0,80.4,536,437,文昌里,NULL
715,963,13,976,1209,0,0,80.73,534,429,安穗里,NULL
426,959,17,976,1293,0,0,75.48,530,429,豐澤村,NULL
0,959,17,976,1293,0,0,75.48,530,429,豐澤村,NULL
195,968,8,976,1188,0,0,82.15,527,441,光仁里,NULL
152,966,10,976,1293,0,0,75.48,518,448,王公里,NULL
390,966,10,976,1353,0,0,72.14,498,468,九芎村,NULL
265,961,15,976,1281,0,0,76.19,476,485,群英村,NULL
277,966,10,976,1277,0,0,76.43,458,508,府南里,NULL
263,966,10,976,1297,0,0,75.25,431,535,群英村,NULL
0,969,7,976,1297,0,0,75.25,357,612,新樹里,NULL
341,967,9,976,1311,0,0,74.45,320,647,新安里,NULL
0,967,9,976,1311,0,0,74.45,320,647,新安里,NULL
750,969,6,975,1229,0,0,79.33,716,253,北安里,NULL
119,968,7,975,1205,0,0,80.91,716,252,柴橋里,NULL
772,965,10,975,1225,0,0,79.59,658,307,泰安里,NULL
763,962,13,975,1240,0,0,78.63,618,344,北興里,NULL
613,962,13,975,1256,0,0,77.63,613,349,信和里,NULL
1821,965,10,975,1290,0,0,75.58,610,355,中正里,NULL
2158,967,8,975,1267,0,0,76.95,570,397,頂罟村,NULL
0,967,8,975,1267,0,0,76.95,570,397,頂罟村,NULL
49,966,9,975,1202,0,0,81.11,559,407,港德里,NULL
322,968,7,975,1242,0,0,78.5,556,412,崇成里,NULL
684,954,21,975,1254,0,0,77.75,523,431,鎮興里,NULL
620,963,12,975,1233,0,0,79.08,506,457,忠福里,NULL
299,967,8,975,1305,0,0,74.71,495,472,五常里,NULL
0,967,8,975,1305,0,0,74.71,495,472,五常里,NULL
867,970,5,975,1245,0,0,78.31,469,501,過埤里,NULL
97,965,10,975,1255,0,0,77.69,462,503,西社里,NULL
882,965,10,975,1199,0,0,81.32,448,517,保安里,NULL
408,968,6,974,1140,0,0,85.44,939,29,忠孝里,NULL
32,968,6,974,1758,0,0,55.4,905,63,新湖里,NULL
4,963,11,974,1220,0,0,79.84,803,160,民勤里,NULL
256,961,13,974,1226,0,0,79.45,743,218,重興村,NULL
900,967,7,974,1252,0,0,77.8,728,239,九龍村,NULL
1153,968,6,974,1267,0,0,76.87,657,311,新德里,NULL
767,962,12,974,1185,0,0,82.19,640,322,金陵里,NULL
1112,969,5,974,1293,0,0,75.33,614,355,龍泉里,NULL
177,965,9,974,1208,0,0,80.63,602,363,青溪里,NULL
929,968,6,974,1295,0,0,75.21,595,373,新屋村,NULL
388,964,10,974,1214,0,0,80.23,586,378,協榮里,NULL
745,962,12,974,1193,0,0,81.64,558,404,北勢里,NULL
599,958,16,974,1312,0,0,74.24,554,404,加錫村,NULL
0,958,16,974,1312,0,0,74.24,554,404,加錫村,NULL
848,967,7,974,1307,0,0,74.52,493,474,新富里,NULL
335,965,9,974,1369,0,0,71.15,468,497,頂崙村,NULL
0,965,9,974,1369,0,0,71.15,468,497,頂崙村,NULL
830,971,3,974,1290,0,0,75.5,439,532,新甲里,NULL
664,970,4,974,1287,0,0,75.68,437,533,塩行里,NULL
436,960,14,974,1254,0,0,77.67,408,552,田心里,NULL
18,965,9,974,1241,0,0,78.49,396,569,溪北里,NULL
242,968,5,973,1193,0,0,81.56,768,200,員山村,NULL
955,965,8,973,1244,0,0,78.22,731,234,東門里,NULL
491,968,5,973,1266,0,0,76.86,723,245,富泰里,NULL
631,962,11,973,1196,0,0,81.35,713,249,頂南里,NULL
42,968,5,973,1330,0,0,73.16,688,280,義和里,NULL
0,968,5,973,1330,0,0,73.16,688,280,義和里,NULL
161,961,12,973,1191,0,0,81.7,665,296,佳興里,NULL
400,961,12,973,1296,0,0,75.08,660,301,後厝里,NULL
441,962,11,973,1304,0,0,74.62,653,309,三省村,NULL
0,962,11,973,1304,0,0,74.62,653,309,三省村,NULL
222,957,16,973,1237,0,0,78.66,625,332,松安里,NULL
169,965,8,973,1264,0,0,76.98,623,342,安東村,NULL
211,963,10,973,1242,0,0,78.34,620,343,舊社里,NULL
279,963,10,973,1235,0,0,78.79,609,354,信義里,NULL
171,968,5,973,1233,0,0,78.91,605,363,永安里,NULL
160,966,7,973,1229,0,0,79.17,590,376,大同里,NULL
81,969,4,973,1248,0,0,77.96,585,384,仁義里,NULL
6,970,3,973,1356,0,0,71.76,544,426,碧砂里,NULL
0,970,3,973,1356,0,0,71.76,544,426,碧砂里,NULL
264,965,8,973,1203,0,0,80.88,528,437,五權里,NULL
1043,971,2,973,1197,0,0,81.29,525,446,保德里,NULL
195,969,4,973,1188,0,0,81.9,519,450,忠正里,NULL
182,964,9,973,1273,0,0,76.43,517,447,居仁里,NULL
937,964,9,973,1176,0,0,82.74,505,459,全安里,NULL
60,962,11,973,1249,0,0,77.9,496,466,公館里,NULL
409,958,15,973,1256,0,0,77.47,483,475,五權村,NULL
839,965,8,973,1215,0,0,80.08,483,482,東寶村,NULL
188,964,9,973,1280,0,0,76.02,454,510,深水村,NULL
776,965,8,973,1302,0,0,74.73,437,528,後壁村,NULL
837,967,6,973,1194,0,0,81.49,413,554,七甲村,NULL
292,966,7,973,1359,0,0,71.6,351,615,孝威村,NULL
0,966,7,973,1359,0,0,71.6,351,615,孝威村,NULL
756,967,6,973,1218,0,0,79.89,281,686,土庫村,NULL
32,965,7,972,1363,0,0,71.31,736,229,馬蘭里,NULL
1167,968,4,972,1206,0,0,80.6,719,249,忠誠里,NULL
1634,965,7,972,1202,0,0,80.87,670,295,宜興里,NULL
475,963,9,972,1270,0,0,76.54,654,309,仁文里,NULL
678,963,9,972,1218,0,0,79.8,636,327,景聯里,NULL
928,964,8,972,1219,0,0,79.74,604,360,新屋村,NULL
2,964,8,972,1317,0,0,73.8,579,385,砂子里,NULL
442,968,4,972,1267,0,0,76.72,563,405,久安里,NULL
190,964,8,972,1148,0,0,84.67,554,410,正泰里,NULL
237,962,10,972,1262,0,0,77.02,547,415,福德里,NULL
1783,961,11,972,1316,0,0,73.86,528,433,中湖里,NULL
174,962,10,972,1239,0,0,78.45,507,455,馬興村,NULL
139,963,9,972,1386,0,0,70.13,506,457,社尾村,NULL
0,963,9,972,1386,0,0,70.13,506,457,社尾村,NULL
97,963,9,972,1210,0,0,80.33,488,475,文化里,NULL
700,966,6,972,1257,0,0,77.33,476,490,鎮西里,NULL
854,964,8,972,1317,0,0,73.8,451,513,中民里,NULL
0,962,10,972,1508,0,0,64.46,439,523,崙內里,NULL
177,960,12,972,1301,0,0,74.71,434,526,鹿草村,NULL
0,960,12,972,1301,0,0,74.71,434,526,鹿草村,NULL
337,969,3,972,1319,0,0,73.69,432,537,中興里,NULL
189,962,10,972,1323,0,0,73.47,416,546,東昇村,NULL
278,967,5,972,1319,0,0,73.69,411,556,梅北村,NULL
190,962,10,972,1305,0,0,74.48,395,567,八翁村,NULL
0,962,10,972,1305,0,0,74.48,395,567,八翁村,NULL
876,969,2,971,1158,0,0,83.85,733,236,潭墘里,NULL
902,960,11,971,1245,0,0,77.99,721,239,武漢村,NULL
928,960,11,971,1238,0,0,78.43,686,274,頂溪里,NULL
2145,965,6,971,1274,0,0,76.22,672,293,石門村,NULL
0,965,6,971,1274,0,0,76.22,672,293,石門村,NULL
1593,967,4,971,1298,0,0,74.81,611,356,金龍里,NULL
953,962,9,971,1194,0,0,81.32,601,361,幸市里,NULL
0,957,14,971,1374,0,0,70.67,587,370,白東里,NULL
1689,965,6,971,1194,0,0,81.32,577,388,育英里,NULL
301,961,10,971,1237,0,0,78.5,560,401,大安里,NULL
1003,964,7,971,1231,0,0,78.88,547,417,恆安里,NULL
621,969,2,971,1262,0,0,76.94,512,457,大寮村,NULL
218,960,11,971,1199,0,0,80.98,508,452,東丘里,NULL
389,965,6,971,1236,0,0,78.56,503,462,社口村,NULL
0,965,6,971,1236,0,0,78.56,503,462,社口村,NULL
332,965,6,971,1313,0,0,73.95,489,476,德高里,NULL
700,966,5,971,1281,0,0,75.8,478,488,順苓里,NULL
417,964,7,971,1262,0,0,76.94,471,493,寶慶里,NULL
913,959,12,971,1313,0,0,73.95,471,488,三坑村,NULL
0,959,12,971,1313,0,0,73.95,471,488,三坑村,NULL
634,961,10,971,1294,0,0,75.04,454,507,永康里,NULL
668,962,9,971,1271,0,0,76.4,454,508,塩行里,NULL
443,961,10,971,1194,0,0,81.32,431,530,大舍村,NULL
330,967,4,971,1226,0,0,79.2,428,539,德智里,NULL
880,965,6,971,1295,0,0,74.98,414,551,二甲里,NULL
20,960,10,970,1228,0,0,78.99,716,244,恭敬里,NULL
0,960,10,970,1228,0,0,78.99,716,244,恭敬里,NULL
1623,964,6,970,1223,0,0,79.31,676,288,北山里,NULL
2014,961,9,970,1230,0,0,78.86,626,335,福泰村,NULL
743,963,7,970,1221,0,0,79.44,608,355,中華里,NULL
95,963,7,970,1249,0,0,77.66,590,373,中和里,NULL
1359,960,10,970,1292,0,0,75.08,550,410,復興里,NULL
99,964,6,970,1274,0,0,76.14,548,416,南社里,NULL
380,965,5,970,1393,0,0,69.63,540,425,鳳凰村,NULL
0,965,5,970,1393,0,0,69.63,540,425,鳳凰村,NULL
976,959,11,970,1228,0,0,78.99,538,421,崙坪村,NULL
625,964,6,970,1268,0,0,76.5,528,436,金星村,NULL
0,964,6,970,1268,0,0,76.5,528,436,金星村,NULL
1531,963,7,970,1256,0,0,77.23,510,453,仁愛里,NULL
113,962,8,970,1319,0,0,73.54,504,458,福全里,NULL
410,963,7,970,1334,0,0,72.71,479,484,和睦村,NULL
735,956,14,970,1262,0,0,76.86,477,479,泰安村,NULL
0,956,14,970,1262,0,0,76.86,477,479,泰安村,NULL
996,961,9,970,1202,0,0,80.7,460,501,柳鄉里,NULL
1972,959,11,970,1275,0,0,76.08,404,555,觀音村,NULL
0,959,11,970,1275,0,0,76.08,404,555,觀音村,NULL
242,967,3,970,1231,0,0,78.8,394,573,金泉里、勝豐里,NULL
0,967,3,970,1231,0,0,78.8,394,573,金泉里、勝豐里,NULL
639,961,9,970,1264,0,0,76.74,318,643,昭明村,NULL
2004,964,5,969,1154,0,0,83.97,896,68,貿商村,NULL
330,961,8,969,1250,0,0,77.52,645,316,頂厝里,NULL
1381,961,8,969,1203,0,0,80.55,644,317,明德里,NULL
1727,959,10,969,1243,0,0,77.96,588,371,中山里,NULL
341,962,7,969,1325,0,0,73.13,574,388,大埔村,NULL
0,962,7,969,1325,0,0,73.13,574,388,大埔村,NULL
592,957,12,969,1202,0,0,80.62,568,389,陽明里,NULL
498,959,10,969,1242,0,0,78.02,559,400,宜欣里,NULL
214,959,10,969,1203,0,0,80.55,553,406,西安里,NULL
740,952,17,969,1235,0,0,78.46,532,420,北庄村,NULL
1012,959,10,969,1244,0,0,77.89,500,459,中泰里,NULL
0,961,8,969,1560,0,0,62.12,470,491,龍門村,NULL
684,962,7,969,1233,0,0,78.59,402,560,港興里,NULL
275,963,5,968,1206,0,0,80.27,817,146,凌雲里,NULL
0,963,5,968,1206,0,0,80.27,817,146,凌雲里,NULL
217,959,9,968,1230,0,0,78.7,761,198,湖鏡村,NULL
804,960,8,968,1216,0,0,79.61,704,256,中正里,NULL
0,960,8,968,1216,0,0,79.61,704,256,中正里,NULL
265,965,3,968,1339,0,0,72.29,602,363,新興里,NULL
1928,959,9,968,1324,0,0,73.11,599,360,新峰里,NULL
420,960,8,968,1248,0,0,77.56,580,380,竹圍村,NULL
628,959,9,968,1305,0,0,74.18,575,384,二王里,NULL
1650,965,3,968,1347,0,0,71.86,564,401,獇寮里,NULL
540,960,8,968,1264,0,0,76.58,559,401,鳥松村,NULL
109,960,8,968,1380,0,0,70.14,519,441,福安里,NULL
141,955,13,968,1231,0,0,78.64,512,443,西雅里,NULL
1806,952,16,968,1308,0,0,74.01,504,448,龍埔里,NULL
760,962,6,968,1276,0,0,75.86,504,458,大社村,NULL
94,958,10,968,1208,0,0,80.13,447,511,溪頭里,NULL
254,963,5,968,1276,0,0,75.86,435,528,光明里,NULL
638,959,9,968,1289,0,0,75.1,435,524,會結村,NULL
0,963,5,968,1276,0,0,75.86,435,528,光明里,NULL
0,959,9,968,1289,0,0,75.1,435,524,會結村,NULL
1983,959,9,968,1228,0,0,78.83,377,582,五龍村,NULL
0,959,9,968,1228,0,0,78.83,377,582,五龍村,NULL
0,960,7,967,1944,0,0,49.74,843,117,信義里,NULL
797,950,17,967,1184,0,0,81.67,755,195,秀水里,NULL
44,955,12,967,1504,0,0,64.3,729,226,豐谷里,NULL
62,956,11,967,1256,0,0,76.99,705,251,龍祥里,NULL
234,955,12,967,1297,0,0,74.56,684,271,平興里,NULL
664,957,10,967,1167,0,0,82.86,677,280,外南里,NULL
1246,960,7,967,1185,0,0,81.6,649,311,景美里,NULL
38,954,13,967,1245,0,0,77.67,597,357,孟春里,NULL
1993,965,2,967,1184,0,0,81.67,597,368,德音村,NULL
178,959,8,967,1222,0,0,79.13,581,378,興仁里,NULL
56,954,13,967,1216,0,0,79.52,576,378,何福里,NULL
349,961,6,967,1208,0,0,80.05,531,430,成功里,NULL
453,957,10,967,1299,0,0,74.44,525,432,北勢里,NULL
0,957,10,967,1299,0,0,74.44,525,432,北勢里,NULL
811,959,8,967,1225,0,0,78.94,513,446,朱崙里,NULL
151,961,6,967,1286,0,0,75.19,483,478,王公里,NULL
495,961,6,967,1228,0,0,78.75,447,514,永發里,NULL
342,957,10,967,1332,0,0,72.6,419,538,鎮山里,NULL
47,958,9,967,1297,0,0,74.56,417,541,港墘村,NULL
0,958,9,967,1297,0,0,74.56,417,541,港墘村,NULL
578,953,14,967,1348,0,0,71.74,388,565,舊眉村,NULL
0,953,14,967,1348,0,0,71.74,388,565,舊眉村,NULL
422,963,4,967,1319,0,0,73.31,324,639,鹽埔村,NULL
12,954,12,966,1220,0,0,79.18,763,191,玉華里,NULL
120,957,9,966,1246,0,0,77.53,757,200,三重里,NULL
0,958,8,966,1385,0,0,69.75,684,274,新城村,NULL
50,955,11,966,1214,0,0,79.57,671,284,新國里,NULL
888,953,13,966,1177,0,0,82.07,655,298,水源里,NULL
251,954,12,966,1186,0,0,81.45,620,334,大豐里,NULL
163,959,7,966,1224,0,0,78.92,615,344,大南里,NULL
0,959,7,966,1224,0,0,78.92,615,344,大南里,NULL
29,961,5,966,1285,0,0,75.18,605,356,文武里,NULL
5,952,14,966,1490,0,0,64.83,603,349,麥津村,NULL
805,955,11,966,1281,0,0,75.41,592,363,瑞塘里,NULL
11,957,9,966,1292,0,0,74.77,592,365,敦和里,NULL
482,963,3,966,1215,0,0,79.51,590,373,新益里,NULL
70,951,15,966,1218,0,0,79.31,562,389,文德里,NULL
336,958,8,966,1297,0,0,74.48,557,401,中崎里,NULL
0,958,8,966,1297,0,0,74.48,557,401,中崎里,NULL
521,949,17,966,1284,0,0,75.23,546,403,新福里,NULL
603,958,8,966,1319,0,0,73.24,519,439,擺塘村,NULL
103,957,9,966,1341,0,0,72.04,510,447,裕嘉里,NULL
0,957,9,966,1341,0,0,72.04,510,447,裕嘉里,NULL
1393,953,13,966,1263,0,0,76.48,509,444,清和里,NULL
142,953,13,966,1307,0,0,73.91,402,551,三仙里,NULL
827,959,7,966,1200,0,0,80.5,401,558,瑞平里,NULL
423,959,7,966,1270,0,0,76.06,239,720,胡家里,NULL
0,959,7,966,1270,0,0,76.06,239,720,胡家里,NULL
0,950,15,965,1457,0,0,66.23,807,143,景美村,NULL
276,959,6,965,1316,0,0,73.33,733,226,實踐里,NULL
0,959,6,965,1316,0,0,73.33,733,226,實踐里,NULL
109,958,7,965,1250,0,0,77.2,635,323,中興里,NULL
0,958,7,965,1250,0,0,77.2,635,323,中興里,NULL
749,956,9,965,1226,0,0,78.71,591,365,新勢里,NULL
502,962,3,965,1234,0,0,78.2,546,416,振華里,NULL
0,962,3,965,1234,0,0,78.2,546,416,振華里,NULL
52,955,10,965,1302,0,0,74.12,540,415,雅溝里,NULL
0,955,10,965,1302,0,0,74.12,540,415,雅溝里,NULL
2015,958,7,965,1234,0,0,78.2,540,418,福泰村,NULL
970,957,8,965,1238,0,0,77.95,524,433,幸福里,NULL
136,956,9,965,1260,0,0,76.59,487,469,下湳里,NULL
9,954,11,965,1217,0,0,79.29,487,467,西墩里,NULL
487,949,16,965,1179,0,0,81.85,482,467,東信里,NULL
189,961,4,965,1260,0,0,76.59,480,481,北湖里,NULL
1102,948,17,965,1317,0,0,73.27,476,472,四維里,NULL
51,954,11,965,1249,0,0,77.26,431,523,興南里,NULL
0,954,11,965,1249,0,0,77.26,431,523,興南里,NULL
673,960,5,965,1327,0,0,72.72,417,543,中門村,NULL
74,954,10,964,1198,0,0,80.47,800,154,員崠里,NULL
153,958,6,964,1185,0,0,81.35,773,185,文山里,NULL
31,955,9,964,1231,0,0,78.31,719,236,北苗里,NULL
2073,959,5,964,1285,0,0,75.02,707,252,麗林村,NULL
23,955,9,964,1176,0,0,81.97,699,256,新崙里,NULL
320,954,10,964,1257,0,0,76.69,643,311,富興村,NULL
0,954,10,964,1257,0,0,76.69,643,311,富興村,NULL
92,953,11,964,1278,0,0,75.43,616,337,東門里,NULL
297,955,9,964,1314,0,0,73.36,594,361,大華里,NULL
594,961,3,964,1234,0,0,78.12,561,400,大村村,NULL
2153,951,13,964,1314,0,0,73.36,537,414,米倉村,NULL
187,950,14,964,1212,0,0,79.54,532,418,東光里,NULL
385,958,6,964,1210,0,0,79.67,517,441,本安里,NULL
457,952,12,964,1246,0,0,77.37,483,469,湖山里,NULL
0,952,12,964,1246,0,0,77.37,483,469,湖山里,NULL
831,955,9,964,1237,0,0,77.93,445,510,瑞隆里,NULL
0,957,7,964,1359,0,0,70.93,431,526,保吉村,NULL
204,957,7,964,1198,0,0,80.47,407,550,觀音村,NULL
526,954,10,964,1276,0,0,75.55,398,556,新和村,NULL
501,953,11,964,1229,0,0,78.44,373,580,後安村,NULL
0,948,15,963,1638,0,0,58.79,754,194,觀音里,NULL
16,956,7,963,1308,0,0,73.62,728,228,海濱里,NULL
0,956,7,963,1308,0,0,73.62,728,228,海濱里,NULL
254,954,9,963,1245,0,0,77.35,725,229,重興村,NULL
874,949,14,963,1194,0,0,80.65,719,230,潭墘里,NULL
1204,958,5,963,1202,0,0,80.12,691,267,明德里,NULL
326,956,7,963,1251,0,0,76.98,623,333,吉峰村,NULL
1103,955,8,963,1223,0,0,78.74,616,339,誠安里,NULL
527,956,7,963,1324,0,0,72.73,610,346,樹義里,NULL
538,955,8,963,1315,0,0,73.23,608,347,合興村,NULL
493,955,8,963,1234,0,0,78.04,590,365,介壽里,NULL
645,956,7,963,1264,0,0,76.19,574,382,東興村,NULL
0,956,7,963,1264,0,0,76.19,574,382,東興村,NULL
1711,955,8,963,1300,0,0,74.08,573,382,中華里,NULL
612,962,1,963,1246,0,0,77.29,573,389,會社村,NULL
1436,954,9,963,1260,0,0,76.43,565,389,平和里,NULL
139,959,4,963,1208,0,0,79.72,557,402,曲溪里,NULL
212,956,7,963,1186,0,0,81.2,555,401,舊社里,NULL
2165,952,11,963,1221,0,0,78.87,544,408,長坑村,NULL
0,952,11,963,1221,0,0,78.87,544,408,長坑村,NULL
286,952,11,963,1270,0,0,75.83,536,416,蔗廍村,NULL
816,959,4,963,1269,0,0,75.89,506,453,國光里,NULL
193,953,10,963,1207,0,0,79.78,499,454,玉光里,NULL
960,951,12,963,1196,0,0,80.52,492,459,福基里,NULL
494,951,12,963,1252,0,0,76.92,469,482,榮復里,NULL
0,951,12,963,1252,0,0,76.92,469,482,榮復里,NULL
305,953,10,963,1319,0,0,73.01,457,496,永安里,NULL
326,952,11,963,1157,0,0,83.23,454,498,北嶺村,NULL
0,952,11,963,1157,0,0,83.23,454,498,北嶺村,NULL
484,955,8,963,1231,0,0,78.23,421,534,東信里,NULL
228,959,4,963,1243,0,0,77.47,403,556,小坪村,NULL
0,959,4,963,1243,0,0,77.47,403,556,小坪村,NULL
481,960,3,963,1174,0,0,82.03,333,627,芋寮村,NULL
0,960,3,963,1174,0,0,82.03,333,627,芋寮村,NULL
273,952,10,962,1184,0,0,81.25,905,47,崇武里,NULL
124,955,7,962,1261,0,0,76.29,766,189,二重里,NULL
84,951,11,962,1282,0,0,75.04,764,187,林泉里,NULL
859,948,14,962,1215,0,0,79.18,661,287,雙榮里,NULL
139,953,9,962,1239,0,0,77.64,616,337,明德里,NULL
201,951,11,962,1299,0,0,74.06,612,339,北勢里,NULL
225,954,8,962,1258,0,0,76.47,593,361,松和里,NULL
123,952,10,962,1323,0,0,72.71,581,371,五南里,NULL
0,952,10,962,1323,0,0,72.71,581,371,五南里,NULL
569,951,11,962,1257,0,0,76.53,573,378,中興里,NULL
106,949,13,962,1300,0,0,74,563,386,新光里,NULL
1368,956,6,962,1234,0,0,77.96,553,403,埤林里,NULL
2049,955,7,962,1284,0,0,74.92,531,424,貴和村,NULL
801,954,8,962,1210,0,0,79.5,525,429,埤頂里,NULL
579,954,8,962,1286,0,0,74.81,520,434,後庄村,NULL
185,949,13,962,1221,0,0,78.79,519,430,鳳雄村,NULL
310,954,8,962,1236,0,0,77.83,502,452,龍安里,NULL
792,949,13,962,1345,0,0,71.52,454,495,梅州里,NULL
0,949,13,962,1345,0,0,71.52,454,495,梅州里,NULL
920,955,7,962,1237,0,0,77.77,445,510,福祥里,NULL
849,957,5,962,1267,0,0,75.93,398,559,老爺里,NULL
462,949,13,962,1214,0,0,79.24,398,551,東門里,NULL
272,949,13,962,1198,0,0,80.3,280,669,平等里,NULL
0,949,13,962,1198,0,0,80.3,280,669,平等里,NULL
279,947,14,961,1241,0,0,77.44,708,239,新平里,NULL
55,945,16,961,1197,0,0,80.28,694,251,聯興里,NULL
61,951,10,961,1479,0,0,64.98,670,281,新園里,NULL
0,951,10,961,1479,0,0,64.98,670,281,新園里,NULL
189,953,8,961,1223,0,0,78.58,626,327,和興村,NULL
387,957,4,961,1238,0,0,77.63,602,355,後協里,NULL
1578,954,7,961,1242,0,0,77.38,589,365,保長里,NULL
112,952,9,961,1271,0,0,75.61,584,368,立仁里,NULL
739,956,5,961,1257,0,0,76.45,565,391,文福里,NULL
45,949,12,961,1188,0,0,80.89,530,419,金華里,NULL
150,945,16,961,1229,0,0,78.19,527,418,文翠里,NULL
70,958,3,961,1269,0,0,75.73,521,437,竹圍里,NULL
439,950,11,961,1218,0,0,78.9,517,433,西新里,NULL
631,950,11,961,1216,0,0,79.03,512,438,二王里,NULL
494,942,19,961,1323,0,0,72.64,482,460,羅厝村,NULL
0,942,19,961,1323,0,0,72.64,482,460,羅厝村,NULL
732,952,9,961,1181,0,0,81.37,444,508,合作里,NULL
943,954,7,961,1290,0,0,74.5,433,521,大坡村,NULL
0,954,7,961,1290,0,0,74.5,433,521,大坡村,NULL
663,953,8,961,1201,0,0,80.02,391,562,竹西里,NULL
322,957,4,961,1387,0,0,69.29,342,615,大庄村,NULL
0,957,4,961,1387,0,0,69.29,342,615,大庄村,NULL
155,956,5,961,1304,0,0,73.7,333,623,頭竹村,NULL
0,956,5,961,1304,0,0,73.7,333,623,頭竹村,NULL
266,956,5,961,1277,0,0,75.25,295,661,茅港村,NULL
0,956,5,961,1277,0,0,75.25,295,661,茅港村,NULL
1174,952,8,960,1175,0,0,81.7,727,225,中華里,NULL
759,955,5,960,1226,0,0,78.3,720,235,新英里,NULL
806,951,9,960,1285,0,0,74.71,668,283,瑞塘里,NULL
830,953,7,960,1418,0,0,67.7,650,303,永寧里,NULL
272,957,3,960,1218,0,0,78.82,621,336,下廍里,NULL
1585,950,10,960,1330,0,0,72.18,616,334,拱北里,NULL
203,950,10,960,1294,0,0,74.19,586,364,北勢里,NULL
116,953,7,960,1220,0,0,78.69,586,367,湖濱里,NULL
785,945,15,960,1234,0,0,77.8,576,369,北富里,NULL
178,954,6,960,1261,0,0,76.13,569,385,福安村,NULL
306,958,2,960,1235,0,0,77.73,551,407,大竹里,NULL
283,944,16,960,1276,0,0,75.24,551,393,東明村,NULL
0,944,16,960,1276,0,0,75.24,551,393,東明村,NULL
162,949,11,960,1259,0,0,76.25,536,413,港嘴里,NULL
80,949,11,960,1377,0,0,69.72,517,432,高朗村,NULL
676,953,7,960,1192,0,0,80.54,405,548,尚頂里,NULL
0,951,9,960,1396,0,0,68.77,364,587,河東里,NULL
745,951,9,960,1260,0,0,76.19,335,616,鳳林里,NULL
886,954,5,959,1190,0,0,80.59,760,194,水源里,NULL
887,949,10,959,1235,0,0,77.65,741,208,富水里,NULL
933,954,5,959,1181,0,0,81.2,692,262,新廍里,NULL
548,959,0,959,1198,0,0,80.05,675,284,中央里,NULL
117,950,9,959,1317,0,0,72.82,648,302,高西里,NULL
0,950,9,959,1317,0,0,72.82,648,302,高西里,NULL
583,954,5,959,1302,0,0,73.66,633,321,中興里,NULL
218,954,5,959,1234,0,0,77.71,611,343,八德里,NULL
61,954,5,959,1205,0,0,79.59,610,344,宏昌里,NULL
642,947,12,959,1226,0,0,78.22,579,368,東興里,NULL
0,948,11,959,1264,0,0,75.87,573,375,上天里,NULL
327,949,10,959,1299,0,0,73.83,537,412,雲林里,NULL
1700,948,11,959,1183,0,0,81.07,520,428,和平里,NULL
1708,949,10,959,1271,0,0,75.45,507,442,彭厝里,NULL
558,949,10,959,1217,0,0,78.8,484,465,美田里,NULL
0,949,10,959,1217,0,0,78.8,484,465,美田里,NULL
153,940,19,959,1274,0,0,75.27,478,462,青翠里,NULL
549,940,19,959,1245,0,0,77.03,478,462,碧華里,NULL
547,944,15,959,1372,0,0,69.9,403,541,中和村,NULL
0,944,15,959,1372,0,0,69.9,403,541,中和村,NULL
173,948,11,959,1244,0,0,77.09,379,569,西勢村,NULL
196,948,11,959,1286,0,0,74.57,377,571,水仙里,NULL
0,948,11,959,1286,0,0,74.57,377,571,水仙里,NULL
489,947,12,959,1304,0,0,73.54,345,602,營西村,NULL
0,947,12,959,1304,0,0,73.54,345,602,營西村,NULL
1,956,2,958,1519,0,0,63.07,913,43,介壽村,NULL
0,956,2,958,1519,0,0,63.07,913,43,介壽村,NULL
771,941,17,958,1206,0,0,79.44,784,157,華安里,NULL
874,948,10,958,1186,0,0,80.78,675,273,中山村,NULL
43,942,16,958,1245,0,0,76.95,666,276,泰和里,NULL
324,952,6,958,1618,0,0,59.21,657,295,勝利里,NULL
565,948,10,958,1173,0,0,81.67,652,296,福德里,NULL
907,952,6,958,1175,0,0,81.53,623,329,螢雪里,NULL
509,953,5,958,1211,0,0,79.11,591,362,東勢里,NULL
1071,946,12,958,1260,0,0,76.03,560,386,合鳳里,NULL
616,939,19,958,1221,0,0,78.46,530,409,翁子里,NULL
437,952,6,958,1340,0,0,71.49,494,458,石埤村,NULL
0,952,6,958,1340,0,0,71.49,494,458,石埤村,NULL
881,952,6,958,1193,0,0,80.3,478,474,二甲里,NULL
908,950,8,958,1225,0,0,78.2,443,507,大德里,NULL
1963,947,11,958,1235,0,0,77.57,428,519,興珍村,NULL
842,950,8,958,1267,0,0,75.61,404,546,瑞文里,NULL
205,950,8,958,1541,0,0,62.17,397,553,崙東村,NULL
0,950,8,958,1541,0,0,62.17,397,553,崙東村,NULL
772,948,10,958,1226,0,0,78.14,396,552,溪洲村,NULL
339,949,9,958,1243,0,0,77.07,387,562,忠仁里,NULL
365,953,5,958,1381,0,0,69.37,365,588,海澄里,NULL
0,953,5,958,1381,0,0,69.37,365,588,海澄里,NULL
1266,948,9,957,1191,0,0,80.35,778,170,明城里,NULL
1274,948,9,957,1184,0,0,80.83,716,232,香坡里,NULL
119,950,7,957,1372,0,0,69.75,680,270,大城里,NULL
634,947,10,957,1230,0,0,77.8,664,283,普義里,NULL
27,944,13,957,1359,0,0,70.42,653,291,新生里,NULL
1007,948,9,957,1238,0,0,77.3,596,352,綠堤里,NULL
492,948,9,957,1246,0,0,76.81,578,370,介壽里,NULL
627,950,7,957,1281,0,0,74.71,577,373,五權里,NULL
1389,950,7,957,1213,0,0,78.9,561,389,中正里,NULL
451,951,6,957,1241,0,0,77.12,557,394,瑞城里,NULL
394,939,18,957,1202,0,0,79.62,531,408,中正里,NULL
0,939,18,957,1202,0,0,79.62,531,408,中正里,NULL
440,948,9,957,1276,0,0,75,509,439,一心里,NULL
137,950,7,957,1339,0,0,71.47,479,471,中溪里,NULL
0,950,7,957,1339,0,0,71.47,479,471,中溪里,NULL
823,948,9,957,1194,0,0,80.15,423,525,瑞東里,NULL
484,955,2,957,1297,0,0,73.79,415,540,東隆里,NULL
0,955,2,957,1297,0,0,73.79,415,540,東隆里,NULL
0,951,6,957,1542,0,0,62.06,408,543,山海里,NULL
116,952,5,957,1374,0,0,69.65,402,550,橋南里,NULL
353,953,4,957,1205,0,0,79.42,252,701,大遼里,NULL
0,953,4,957,1205,0,0,79.42,252,701,大遼里,NULL
88,944,12,956,1304,0,0,73.31,823,121,嘉里村,NULL
8,947,9,956,1212,0,0,78.88,733,214,維新里,NULL
580,948,8,956,1194,0,0,80.07,723,225,中原里,NULL
25,949,7,956,1268,0,0,75.39,674,275,圳頭里,NULL
65,941,15,956,1382,0,0,69.18,626,315,孝深里,NULL
1911,940,16,956,1248,0,0,76.6,603,337,油車里,NULL
96,946,10,956,1240,0,0,77.1,597,349,中和里,NULL
951,944,12,956,1226,0,0,77.98,584,360,興漢里,NULL
284,940,16,956,1297,0,0,73.71,554,386,瑞井村,NULL
88,948,8,956,1287,0,0,74.28,494,454,頂庄里,NULL
360,946,10,956,1304,0,0,73.31,487,459,莿桐村,NULL
346,949,7,956,1240,0,0,77.1,476,473,平安里,NULL
0,949,7,956,1240,0,0,77.1,476,473,平安里,NULL
710,951,5,956,1192,0,0,80.2,475,476,鎮北里,NULL
201,949,7,956,1210,0,0,79.01,453,496,中正里,NULL
0,949,7,956,1210,0,0,79.01,453,496,中正里,NULL
190,948,8,956,1293,0,0,73.94,449,499,北湖里,NULL
131,949,7,956,1290,0,0,74.11,442,507,三德里,NULL
0,949,7,956,1290,0,0,74.11,442,507,三德里,NULL
843,951,5,956,1244,0,0,76.85,437,514,大廟村,NULL
334,951,5,956,1258,0,0,75.99,412,539,三山里,NULL
0,951,5,956,1258,0,0,75.99,412,539,三山里,NULL
191,944,12,956,1256,0,0,76.11,404,540,文賢里,NULL
0,944,12,956,1256,0,0,76.11,404,540,文賢里,NULL
88,952,4,956,1291,0,0,74.05,382,570,仁得里,NULL
486,948,8,956,1313,0,0,72.81,322,626,盛漁里,NULL
0,948,8,956,1313,0,0,72.81,322,626,盛漁里,NULL
89,944,12,956,1361,0,0,70.24,246,698,松華里,NULL
0,944,12,956,1361,0,0,70.24,246,698,松華里,NULL
0,952,3,955,1276,1753,72.79,74.84,859,93,茂林鄉,Maolin Township
2131,950,5,955,1290,0,0,74.03,674,276,埔坪村,NULL
175,950,5,955,1298,0,0,73.57,647,303,武崙里,NULL
341,938,17,955,1277,0,0,74.78,643,295,賴旺里,NULL
4,949,6,955,1307,0,0,73.07,622,327,自強里,NULL
1688,945,10,955,1183,0,0,80.73,598,347,樹人里,NULL
1662,941,14,955,1264,0,0,75.55,592,349,文林里,NULL
270,950,5,955,1281,0,0,74.55,553,397,福興里,NULL
232,944,11,955,1201,0,0,79.52,544,400,山下里,NULL
0,944,11,955,1201,0,0,79.52,544,400,山下里,NULL
363,951,4,955,1251,0,0,76.34,534,417,竹圍里,NULL
1163,948,7,955,1189,0,0,80.32,523,425,通化里,NULL
2063,953,2,955,1188,0,0,80.39,519,434,中湖村,NULL
1415,949,6,955,1253,0,0,76.22,517,432,廷寮里,NULL
311,943,12,955,1241,0,0,76.95,470,473,福田里,NULL
0,943,12,955,1241,0,0,76.95,470,473,福田里,NULL
104,948,7,955,1374,0,0,69.51,452,496,繁榮村,NULL
0,948,7,955,1374,0,0,69.51,452,496,繁榮村,NULL
59,944,11,955,1230,0,0,77.64,427,517,八仙里,NULL
187,945,10,955,1252,0,0,76.28,394,551,新厝里,NULL
407,948,6,954,1157,0,0,82.45,932,16,忠孝里,NULL
836,945,9,954,1179,0,0,80.92,663,282,秀和里,NULL
203,946,8,954,1167,0,0,81.75,652,294,中正村,NULL
1174,944,10,954,1232,0,0,77.44,648,296,全安里,NULL
690,943,11,954,1163,0,0,82.03,633,310,景文里,NULL
1361,951,3,954,1170,0,0,81.54,631,320,復興里,NULL
388,949,5,954,1284,0,0,74.3,622,327,南光里,NULL
821,942,12,954,1175,0,0,81.19,616,326,頭家村,NULL
248,950,4,954,1270,0,0,75.12,602,348,莿桐里,NULL
84,944,10,954,1320,0,0,72.27,595,349,馬鳴村,NULL
0,944,10,954,1320,0,0,72.27,595,349,馬鳴村,NULL
127,951,3,954,1288,0,0,74.07,591,360,聖湖里,NULL
182,946,8,954,1232,0,0,77.44,579,367,斗抵里,NULL
1420,946,8,954,1232,0,0,77.44,569,377,峯廷里,NULL
1690,946,8,954,1217,0,0,78.39,557,389,育英里,NULL
67,944,10,954,1185,0,0,80.51,544,400,幸福里,NULL
24,943,11,954,1396,0,0,68.34,539,404,中興村,NULL
0,943,11,954,1396,0,0,68.34,539,404,中興村,NULL
236,945,9,954,1240,0,0,76.94,524,421,忠和村,NULL
223,946,8,954,1306,0,0,73.05,522,424,富春里,NULL
0,946,8,954,1306,0,0,73.05,522,424,富春里,NULL
628,944,10,954,1216,0,0,78.45,506,438,永康里,NULL
379,951,3,954,1351,0,0,70.61,500,451,紫雲村,NULL
0,951,3,954,1351,0,0,70.61,500,451,紫雲村,NULL
692,948,6,954,1257,0,0,75.89,485,463,西勢里,NULL
800,948,6,954,1189,0,0,80.24,485,463,埤頂里,NULL
706,943,11,954,1190,0,0,80.17,454,489,北門里,NULL
354,949,5,954,1238,0,0,77.06,438,511,安西里,NULL
446,950,4,954,1252,0,0,76.2,430,520,灣華里,NULL
770,951,3,954,1191,0,0,80.1,310,641,明道里,NULL
0,951,3,954,1191,0,0,80.1,310,641,明道里,NULL
372,948,6,954,1309,0,0,72.88,298,650,民安里,NULL
0,948,6,954,1309,0,0,72.88,298,650,民安里,NULL
123,939,14,953,1193,0,0,79.88,751,188,二重里,NULL
32,946,7,953,1241,0,0,76.79,674,272,綠水里,NULL
405,943,10,953,1294,0,0,73.65,635,308,健民里,NULL
1113,946,7,953,1238,0,0,76.98,631,315,龍泉里,NULL
1441,940,13,953,1234,0,0,77.23,594,346,延和里,NULL
471,945,8,953,1215,0,0,78.44,587,358,東南里,NULL
40,940,13,953,1201,0,0,79.35,581,359,何南里,NULL
395,940,13,953,1209,0,0,78.83,527,413,大園村,NULL
650,947,6,953,1235,0,0,77.17,527,420,大橋里,NULL
795,945,8,953,1228,0,0,77.61,516,429,興亞里,NULL
7,944,9,953,1225,0,0,77.8,508,436,盧厝里,NULL
856,948,5,953,1222,0,0,77.99,485,463,蓬萊里,NULL
648,950,3,953,1190,0,0,80.08,455,495,文昌里,NULL
324,946,7,953,1177,0,0,80.97,451,495,新達村,NULL
0,946,7,953,1177,0,0,80.97,451,495,新達村,NULL
532,949,4,953,1300,0,0,73.31,450,499,烏林村,NULL
474,942,11,953,1338,0,0,71.23,433,509,嘉興村,NULL
557,950,3,953,1182,0,0,80.63,420,530,仁美村,NULL
414,941,12,953,1212,0,0,78.63,315,626,烏龍村,NULL
0,941,12,953,1212,0,0,78.63,315,626,烏龍村,NULL
911,948,4,952,1168,0,0,81.51,843,105,佳安村,NULL
1285,944,8,952,1200,0,0,79.33,754,190,吉祥里,NULL
916,944,8,952,1175,0,0,81.02,753,191,三林村,NULL
40,949,3,952,1299,0,0,73.29,731,218,主權里,NULL
209,941,11,952,1185,0,0,80.34,707,234,信義村,NULL
786,944,8,952,1133,0,0,84.02,703,241,秀景里,NULL
1271,940,12,952,1179,0,0,80.75,679,261,萬盛里,NULL
52,942,10,952,1189,0,0,80.07,632,310,新國里,NULL
1406,949,3,952,1201,0,0,79.27,591,358,清水里,NULL
673,947,5,952,1217,0,0,78.23,582,365,崙雅里,NULL
511,943,9,952,1197,0,0,79.53,571,372,東勢里,NULL
885,940,12,952,1270,0,0,74.96,549,391,水源里,NULL
245,937,15,952,1213,0,0,78.48,508,429,鄉雲里,NULL
1509,944,8,952,1765,0,0,53.94,503,441,仁義里,NULL
394,945,7,952,1244,0,0,76.53,493,452,安龍里,NULL
360,944,8,952,1318,0,0,72.23,490,454,金興村,NULL
204,942,10,952,1226,0,0,77.65,485,457,大涼里,NULL
841,947,5,952,1215,0,0,78.35,451,496,瑞誠里,NULL
522,937,15,952,1198,0,0,79.47,450,487,五常里,NULL
124,945,7,952,1277,0,0,74.55,418,527,豐田村,NULL
741,945,7,952,1277,0,0,74.55,402,543,鳳鳴里,NULL
113,937,14,951,1209,0,0,78.66,741,196,光武里,NULL
0,937,14,951,1209,0,0,78.66,741,196,光武里,NULL
76,940,11,951,1219,0,0,78.01,721,219,關東里,NULL
145,934,17,951,1343,0,0,70.81,712,222,仁和村,NULL
30,943,8,951,1167,0,0,81.49,711,232,竹仁里,NULL
47,945,6,951,1169,0,0,81.35,676,269,豐功里,NULL
1212,942,9,951,1211,0,0,78.53,664,278,建安里,NULL
209,945,6,951,1237,0,0,76.88,632,313,舊社里,NULL
38,947,4,951,1239,0,0,76.76,629,318,何南里,NULL
163,946,5,951,1207,0,0,78.79,584,362,大庄里,NULL
0,945,6,951,1238,0,0,76.82,549,396,檜村里,NULL
2093,938,13,951,1238,0,0,76.82,538,400,深坑村,NULL
65,945,6,951,1232,0,0,77.19,510,435,興村里,NULL
116,941,10,951,1188,0,0,80.05,501,440,中和里,NULL
993,941,10,951,1184,0,0,80.32,493,448,富福里,NULL
284,949,2,951,1256,0,0,75.72,462,487,四結村,NULL
1010,943,8,951,1252,0,0,75.96,404,539,頂碩里,NULL
586,945,5,950,1205,0,0,78.84,695,250,中興村,NULL
1929,941,9,950,1368,0,0,69.44,689,252,新峰里,NULL
212,937,13,950,1177,0,0,80.71,679,258,長嶺村,NULL
25,937,13,950,1165,0,0,81.55,678,259,自強里,NULL
23,944,6,950,1307,0,0,72.69,650,294,民生里,NULL
0,944,6,950,1307,0,0,72.69,650,294,民生里,NULL
750,941,9,950,1197,0,0,79.37,639,302,新勢里,NULL
390,936,14,950,1220,0,0,77.87,638,298,安泰里,NULL
120,946,4,950,1268,0,0,74.92,629,317,大城里,NULL
275,944,6,950,1178,0,0,80.65,623,321,華德里,NULL
268,944,6,950,1223,0,0,77.68,618,326,新興村,NULL
485,937,13,950,1173,0,0,80.99,587,350,富錦里,NULL
888,944,6,950,1197,0,0,79.37,584,360,文盛里,NULL
500,947,3,950,1225,0,0,77.55,584,363,德義里,NULL
538,934,16,950,1213,0,0,78.32,560,374,樹德里,NULL
136,941,9,950,1155,0,0,82.25,542,399,照南里,NULL
79,940,10,950,1238,0,0,76.74,537,403,月眉里,NULL
951,944,6,950,1260,0,0,75.4,526,418,幸市里,NULL
362,944,6,950,1177,0,0,80.71,525,419,明德里,NULL
100,941,9,950,1239,0,0,76.67,522,419,通東里,NULL
0,941,9,950,1239,0,0,76.67,522,419,通東里,NULL
811,943,7,950,1220,0,0,77.87,516,427,忠孝里,NULL
791,942,8,950,1208,0,0,78.64,489,453,中原里,NULL
721,940,10,950,1261,0,0,75.34,482,458,松金里,NULL
137,943,7,950,1273,0,0,74.63,480,463,龍泉村,NULL
465,938,12,950,1288,0,0,73.76,451,487,東溪里,NULL
0,938,12,950,1288,0,0,73.76,451,487,東溪里,NULL
775,944,5,949,1141,0,0,83.17,642,302,誠義里,NULL
324,936,13,949,1259,0,0,75.38,593,343,長沙村,NULL
344,938,11,949,1206,0,0,78.69,588,350,五福村,NULL
8,942,7,949,1212,0,0,78.3,580,362,和平里,NULL
0,942,7,949,1212,0,0,78.3,580,362,和平里,NULL
1707,943,6,949,1224,0,0,77.53,578,365,彭厝里,NULL
749,940,9,949,1182,0,0,80.29,572,368,嘉慶里,NULL
1312,941,8,949,1296,0,0,73.23,568,373,頂埔里,NULL
40,947,2,949,1222,0,0,77.66,535,412,加老里,NULL
178,939,10,949,1133,0,0,83.76,529,410,長壽里,NULL
358,942,7,949,1253,0,0,75.74,515,427,六安里,NULL
1067,939,10,949,1252,0,0,75.8,514,425,丹鳳里,NULL
557,932,17,949,1197,0,0,79.28,509,423,過嶺里,NULL
748,940,9,949,1280,0,0,74.14,451,489,新庄村,NULL
0,939,10,949,1255,0,0,75.62,381,558,興桐村,NULL
505,943,6,949,1249,0,0,75.98,375,568,八卦村,NULL
1230,942,6,948,1100,0,0,86.18,868,74,大鵬里,NULL
275,939,9,948,1225,0,0,77.39,781,158,翠山里,NULL
872,941,7,948,1170,0,0,81.03,721,220,潭安里,NULL
898,939,9,948,1216,0,0,77.96,671,268,上華村,NULL
1154,943,5,948,1174,0,0,80.75,662,281,新德里,NULL
1236,940,8,948,1276,0,0,74.29,658,282,學府里,NULL
386,943,5,948,1239,0,0,76.51,608,335,後協里,NULL
1795,936,12,948,1223,0,0,77.51,581,355,永館里,NULL
772,942,6,948,1162,0,0,81.58,576,366,中和里,NULL
1069,943,5,948,1290,0,0,73.49,533,410,合鳳里,NULL
1980,938,10,948,1339,0,0,70.8,517,421,成功村,NULL
163,934,14,948,1169,0,0,81.09,509,425,港嘴里,NULL
99,945,3,948,1209,0,0,78.41,497,448,宏翠里,NULL
108,940,8,948,1215,0,0,78.02,484,456,永安里,NULL
1837,939,9,948,1208,0,0,78.48,463,476,溪北里,NULL
770,938,10,948,1224,0,0,77.45,445,493,神洲村,NULL
261,941,7,948,1228,0,0,77.2,430,511,江西里,NULL
246,939,9,948,1272,0,0,74.53,430,509,東城村,NULL
0,941,7,948,1228,0,0,77.2,430,511,江西里,NULL
0,939,9,948,1272,0,0,74.53,430,509,東城村,NULL
689,942,6,948,1246,0,0,76.08,407,535,西勢里,NULL
125,943,5,948,1259,0,0,75.3,390,553,西平里,NULL
0,943,5,948,1259,0,0,75.3,390,553,西平里,NULL
233,938,10,948,1222,0,0,77.58,368,570,檨腳村,NULL
200,938,10,948,1480,0,0,64.05,317,621,蚵寮村,NULL
0,938,10,948,1480,0,0,64.05,317,621,蚵寮村,NULL
191,939,8,947,1192,0,0,79.45,764,175,新華里,NULL
40,944,3,947,1238,0,0,76.49,747,197,福星里,NULL
413,937,10,947,1193,0,0,79.38,709,228,三灣村,NULL
314,943,4,947,1180,0,0,80.25,682,261,湖濱里,NULL
923,939,8,947,1176,0,0,80.53,657,282,信義里,NULL
231,938,9,947,1260,0,0,75.16,603,335,實踐里,NULL
721,935,12,947,1254,0,0,75.52,580,355,墩南村,NULL
1740,940,7,947,1209,0,0,78.33,576,364,北鶯里,NULL
104,940,7,947,1252,0,0,75.64,576,364,公安里,NULL
6,935,12,947,1220,0,0,77.62,575,360,同安里,NULL
746,936,11,947,1306,0,0,72.51,550,386,勝利里,NULL
1665,936,11,947,1214,0,0,78.01,541,395,保安里,NULL
50,946,1,947,1248,0,0,75.88,539,407,小東里,NULL
186,938,9,947,1223,0,0,77.43,539,399,桃源里,NULL
0,946,1,947,1248,0,0,75.88,539,407,小東里,NULL
612,935,12,947,1264,0,0,74.92,519,416,五王里,NULL
105,937,10,947,1282,0,0,73.87,511,426,秀水里,NULL
454,935,12,947,1153,0,0,82.13,509,426,秀江里,NULL
0,935,12,947,1153,0,0,82.13,509,426,秀江里,NULL
627,936,11,947,1265,0,0,74.86,504,432,二王里,NULL
559,940,7,947,1166,0,0,81.22,493,447,圳寮里,NULL
0,940,7,947,1166,0,0,81.22,493,447,圳寮里,NULL
774,938,9,947,1262,0,0,75.04,489,449,頂潭里,NULL
0,938,9,947,1262,0,0,75.04,489,449,頂潭里,NULL
465,937,10,947,1210,0,0,78.26,474,463,幸福里,NULL
898,943,4,947,1232,0,0,76.87,414,529,南和里,NULL
232,941,6,947,1311,0,0,72.23,371,570,國姓村,NULL
0,941,6,947,1311,0,0,72.23,371,570,國姓村,NULL
65,938,9,947,1230,0,0,76.99,367,571,玉水村,NULL
0,938,9,947,1230,0,0,76.99,367,571,玉水村,NULL
429,934,13,947,1238,0,0,76.49,362,572,力社村,NULL
0,934,13,947,1238,0,0,76.49,362,572,力社村,NULL
366,937,10,947,1277,0,0,74.16,317,620,中央村,NULL
0,937,10,947,1277,0,0,74.16,317,620,中央村,NULL
772,943,3,946,1133,0,0,83.5,738,205,華安里,NULL
41,937,9,946,1314,0,0,71.99,725,212,主權里,NULL
1168,945,1,946,1153,0,0,82.05,709,236,忠誠里,NULL
495,938,8,946,1221,0,0,77.48,634,304,精忠里,NULL
739,935,11,946,1194,0,0,79.23,596,339,明德里,NULL
712,934,12,946,1184,0,0,79.9,575,359,后里村,NULL
20,936,10,946,1361,0,0,69.51,568,368,義和里,NULL
1609,938,8,946,1208,0,0,78.31,560,378,福德里,NULL
1758,941,5,946,1193,0,0,79.3,543,398,南靖里,NULL
97,935,11,946,1274,0,0,74.25,538,397,山柑里,NULL
0,935,11,946,1274,0,0,74.25,538,397,山柑里,NULL
91,939,7,946,1170,0,0,80.85,511,428,國華里,NULL
1706,941,5,946,1218,0,0,77.67,504,437,彭厝里,NULL
814,937,9,946,1217,0,0,77.73,502,435,國泰里,NULL
225,939,7,946,1269,0,0,74.55,491,448,民生村,NULL
516,934,12,946,1198,0,0,78.96,490,444,光耀里,NULL
3,940,6,946,1180,0,0,80.17,482,458,文林里,NULL
961,938,8,946,1292,0,0,73.22,469,469,大潭村,NULL
0,938,8,946,1292,0,0,73.22,469,469,大潭村,NULL
559,936,10,946,1206,0,0,78.44,459,477,華美村,NULL
843,938,8,946,1150,0,0,82.26,409,529,瑞文里,NULL
595,938,8,946,1204,0,0,78.57,370,568,琉球村,NULL
301,939,7,946,1291,0,0,73.28,344,595,水尾村,NULL
0,939,7,946,1291,0,0,73.28,344,595,水尾村,NULL
45,941,4,945,1821,0,0,51.89,900,41,林湖村,NULL
0,941,4,945,1821,0,0,51.89,900,41,林湖村,NULL
0,935,10,945,1279,0,0,73.89,795,140,桃山村,NULL
52,932,13,945,1295,0,0,72.97,692,240,國光里,NULL
0,932,13,945,1295,0,0,72.97,692,240,國光里,NULL
323,942,3,945,1133,0,0,83.41,676,266,大福里,NULL
834,941,4,945,1179,0,0,80.15,660,281,河濱里,NULL
734,937,8,945,1244,0,0,75.96,638,299,義民里,NULL
677,940,5,945,1205,0,0,78.42,625,315,港正里,NULL
233,941,4,945,1251,0,0,75.54,619,322,實踐里,NULL
160,931,14,945,1185,0,0,79.75,618,313,佳興里,NULL
175,929,16,945,1310,0,0,72.14,604,325,大埔里,NULL
398,937,8,945,1297,0,0,72.86,590,347,東興里,NULL
0,937,8,945,1297,0,0,72.86,590,347,東興里,NULL
273,935,10,945,1278,0,0,73.94,576,359,龍坑里,NULL
0,935,10,945,1278,0,0,73.94,576,359,龍坑里,NULL
165,937,8,945,1201,0,0,78.68,561,376,新雅里,NULL
1113,934,11,945,1245,0,0,75.9,546,388,八德里,NULL
346,935,10,945,1235,0,0,76.52,528,407,茄荖村,NULL
169,940,5,945,1278,0,0,73.94,493,447,民榮里,NULL
89,935,10,945,1179,0,0,80.15,489,446,泰興里,NULL
0,935,10,945,1179,0,0,80.15,489,446,泰興里,NULL
499,941,4,945,1252,0,0,75.48,485,456,振成里,NULL
0,941,4,945,1252,0,0,75.48,485,456,振成里,NULL
990,938,7,945,1266,0,0,74.64,473,465,自強里,NULL
142,936,9,945,1231,0,0,76.77,463,473,車店里,NULL
135,941,4,945,1202,0,0,78.62,458,483,成功里,NULL
0,933,12,945,1366,0,0,69.18,427,506,福興村,NULL
376,937,8,945,1179,0,0,80.15,425,512,仁壽里,NULL
128,939,6,945,1358,0,0,69.59,408,531,廣德里,NULL
0,939,6,945,1358,0,0,69.59,408,531,廣德里,NULL
180,935,10,945,1257,0,0,75.18,343,592,萬巒村,NULL
0,935,10,945,1257,0,0,75.18,343,592,萬巒村,NULL
103,939,5,944,1166,0,0,80.96,903,36,合群里,NULL
0,939,5,944,1166,0,0,80.96,903,36,合群里,NULL
0,938,6,944,1408,0,0,67.05,856,82,石門村,NULL
658,937,7,944,1229,0,0,76.81,701,236,興仁里,NULL
1188,935,9,944,1176,0,0,80.27,692,243,百福里,NULL
0,930,14,944,1420,0,0,66.48,680,250,永安村,NULL
303,927,17,944,1141,0,0,82.73,673,254,福安里,NULL
66,936,8,944,1455,0,0,64.88,623,313,長流村,NULL
0,936,8,944,1455,0,0,64.88,623,313,長流村,NULL
362,939,5,944,1196,0,0,78.93,582,357,程香里,NULL
1570,933,11,944,1196,0,0,78.93,580,353,橋東里,NULL
469,932,12,944,1254,0,0,75.28,548,384,湖東里,NULL
140,930,14,944,1209,0,0,78.08,522,408,莒光里,NULL
347,931,13,944,1185,0,0,79.66,509,422,東聖里,NULL
647,932,12,944,1269,0,0,74.39,496,436,大橋里,NULL
960,934,10,944,1267,0,0,74.51,470,464,廣興村,NULL
0,934,10,944,1267,0,0,74.51,470,464,廣興村,NULL
507,936,8,944,1227,0,0,76.94,448,488,永福里,NULL
829,939,5,944,1209,0,0,78.08,410,529,瑞隆里,NULL
264,935,9,944,1230,0,0,76.75,402,533,公館里,NULL
0,935,9,944,1230,0,0,76.75,402,533,公館里,NULL
37,939,4,943,1731,0,0,54.48,907,32,汶沙里,NULL
44,933,10,943,1175,0,0,80.26,679,254,泰和里,NULL
547,937,6,943,1163,0,0,81.08,672,265,龍興里,NULL
16,925,18,943,1234,0,0,76.42,659,266,中山里,NULL
138,937,6,943,1272,0,0,74.14,647,290,西川里,NULL
0,937,6,943,1272,0,0,74.14,647,290,西川里,NULL
508,935,8,943,1181,0,0,79.85,594,341,東昌里,NULL
433,933,10,943,1246,0,0,75.68,573,360,社口里,NULL
936,938,5,943,1239,0,0,76.11,522,416,東明村,NULL
0,938,5,943,1239,0,0,76.11,522,416,東明村,NULL
2059,940,3,943,1197,0,0,78.78,513,427,菁湖村,NULL
515,928,15,943,1214,0,0,77.68,486,442,和平里,NULL
1034,936,7,943,1140,0,0,82.72,485,451,忠德里,NULL
709,936,7,943,1230,0,0,76.67,457,479,崑山里,NULL
174,938,5,943,1239,0,0,76.11,444,494,青年里,NULL
0,938,5,943,1239,0,0,76.11,444,494,青年里,NULL
500,931,12,943,1178,0,0,80.05,443,488,永吉里,NULL
778,936,7,943,1340,0,0,70.37,443,493,後壁村,NULL
1495,931,12,943,1215,0,0,77.61,440,491,福安里,NULL
145,934,9,943,1224,0,0,77.04,425,509,南勢里,NULL
594,934,9,943,1169,0,0,80.67,385,549,福南里,NULL
442,935,8,943,1205,0,0,78.26,379,556,一德里,NULL
86,934,9,943,1156,0,0,81.57,348,586,尾西里,NULL
0,934,9,943,1156,0,0,81.57,348,586,尾西里,NULL
7,933,10,943,1202,0,0,78.45,345,588,春林村,NULL
0,933,10,943,1202,0,0,78.45,345,588,春林村,NULL
465,934,8,942,1124,0,0,83.81,796,138,僑愛里,NULL
45,939,3,942,1170,0,0,80.51,711,228,新社里,NULL
0,925,17,942,1712,0,0,55.02,677,248,碧峰里,NULL
224,933,9,942,1185,0,0,79.49,652,281,頂福里,NULL
73,938,4,942,1215,0,0,77.53,638,300,智仁里,NULL
180,933,9,942,1209,0,0,77.92,633,300,湳雅里,NULL
0,933,9,942,1209,0,0,77.92,633,300,湳雅里,NULL
1710,933,9,942,1247,0,0,75.54,611,322,大同里,NULL
1410,934,8,942,1252,0,0,75.24,592,342,永富里,NULL
481,932,10,942,1246,0,0,75.6,588,344,員林里,NULL
0,932,10,942,1246,0,0,75.6,588,344,員林里,NULL
346,937,5,942,1182,0,0,79.7,587,350,賴明里,NULL
2235,937,5,942,1256,0,0,75,579,358,萬里村,NULL
22,935,7,942,1200,0,0,78.5,568,367,中正里,NULL
302,927,15,942,1194,0,0,78.89,559,368,大安里,NULL
1352,934,8,942,1197,0,0,78.7,551,383,裕生里,NULL
28,931,11,942,1181,0,0,79.76,547,384,文武里,NULL
472,932,10,942,1195,0,0,78.83,533,399,東南里,NULL
1350,932,10,942,1206,0,0,78.11,512,420,裕生里,NULL
444,937,5,942,1170,0,0,80.51,509,428,玉成里,NULL
614,935,7,942,1196,0,0,78.76,503,432,長春里,NULL
1462,931,11,942,1240,0,0,75.97,474,457,長安里,NULL
285,925,17,942,1216,0,0,77.47,412,513,中興里,NULL
528,932,10,942,1181,0,0,79.76,410,522,考潭村,NULL
372,932,10,942,1258,0,0,74.88,369,563,獅埜村,NULL
0,932,10,942,1258,0,0,74.88,369,563,獅埜村,NULL
0,936,5,941,1572,0,0,59.86,694,242,忠仁里,NULL
823,934,7,941,1208,0,0,77.9,684,250,中山里,NULL
5,939,2,941,1232,0,0,76.38,680,259,自強里,NULL
93,934,7,941,1238,0,0,76.01,639,295,振興里,NULL
538,934,7,941,1169,0,0,80.5,638,296,豐原里,NULL
1625,930,11,941,1186,0,0,79.34,637,293,北山里,NULL
244,936,5,941,1228,0,0,76.63,611,325,龍泉村,NULL
909,931,10,941,1218,0,0,77.26,591,340,螢雪里,NULL
2001,930,11,941,1285,0,0,73.23,574,356,福德村,NULL
665,931,10,941,1231,0,0,76.44,547,384,大饒里,NULL
12,931,10,941,1253,0,0,75.1,540,391,泉厝村,NULL
0,931,10,941,1253,0,0,75.1,540,391,泉厝村,NULL
279,934,7,941,1320,0,0,71.29,526,408,中山村,NULL
276,933,8,941,1312,0,0,71.72,500,433,中正村,NULL
350,933,8,941,1252,0,0,75.16,470,463,萬豐村,NULL
520,935,6,941,1211,0,0,77.7,434,501,赤山村,NULL
189,940,1,941,1239,0,0,75.95,421,519,社新里,NULL
711,931,10,941,1236,0,0,76.13,413,518,武松里,NULL
349,932,9,941,1273,0,0,73.92,412,520,安西里,NULL
0,933,8,941,1282,0,0,73.4,389,544,長安村,NULL
468,935,6,941,1161,0,0,81.05,384,551,仕和村,NULL
496,925,16,941,1193,0,0,78.88,378,547,文武村,NULL
388,934,7,941,1189,0,0,79.14,328,606,加興村,NULL
0,934,7,941,1189,0,0,79.14,328,606,加興村,NULL
37,936,4,940,1190,0,0,78.99,735,201,嘉盛里,NULL
1171,928,12,940,1185,0,0,79.32,695,233,法治里,NULL
908,926,14,940,1192,0,0,78.86,693,233,北興村,NULL
88,935,5,940,1311,0,0,71.7,659,276,枇杷里,NULL
1139,935,5,940,1185,0,0,79.32,596,339,張南里,NULL
456,934,6,940,1188,0,0,79.12,596,338,大竹里,NULL
0,935,5,940,1185,0,0,79.32,596,339,張南里,NULL
252,931,9,940,1233,0,0,76.24,573,358,大豐里,NULL
166,925,15,940,1227,0,0,76.61,571,354,大業里,NULL
1803,922,18,940,1217,0,0,77.24,544,378,龍埔里,NULL
656,934,6,940,1195,0,0,78.66,535,399,興平里,NULL
31,928,12,940,1218,0,0,77.18,529,399,光華里,NULL
1691,931,9,940,1199,0,0,78.4,525,406,樹南里,NULL
74,937,3,940,1203,0,0,78.14,504,433,客庄里,NULL
984,929,11,940,1197,0,0,78.53,492,437,仁愛里,NULL
601,930,10,940,1152,0,0,81.6,491,439,永芳村,NULL
454,934,6,940,1276,0,0,73.67,472,462,汴頭里,NULL
329,935,5,940,1166,0,0,80.62,459,476,德智里,NULL
150,927,13,940,1247,0,0,75.38,455,472,王公里,NULL
277,929,11,940,1304,0,0,72.09,454,475,北汕里,NULL
486,930,10,940,1214,0,0,77.43,436,494,瑞源里,NULL
505,933,7,940,1265,0,0,74.31,366,567,中榮村,NULL
0,933,7,940,1265,0,0,74.31,366,567,中榮村,NULL
229,922,17,939,1185,0,0,79.24,821,101,鳳山村,NULL
1163,931,8,939,1138,0,0,82.51,714,217,長春里,NULL
10,933,6,939,1143,0,0,82.15,714,219,玉清里,NULL
464,930,9,939,1155,0,0,81.3,653,277,成福里,NULL
32,930,9,939,1118,0,0,83.99,634,296,光華里,NULL
15,936,3,939,1220,0,0,76.97,608,328,王田里,NULL
471,931,8,939,1278,0,0,73.47,599,332,忠覺里,NULL
0,931,8,939,1278,0,0,73.47,599,332,忠覺里,NULL
380,932,7,939,1158,0,0,81.09,586,346,東昇里,NULL
27,932,7,939,1201,0,0,78.18,584,348,建華里,NULL
328,937,2,939,1159,0,0,81.02,575,362,斯文里,NULL
50,929,10,939,1156,0,0,81.23,572,357,民權里,NULL
166,929,10,939,1228,0,0,76.47,564,365,陝西村,NULL
0,929,10,939,1228,0,0,76.47,564,365,陝西村,NULL
106,923,16,939,1249,0,0,75.18,554,369,秀水里,NULL
958,927,12,939,1200,0,0,78.25,514,413,觀音村,NULL
76,930,9,939,1184,0,0,79.31,505,425,百壽里,NULL
79,930,9,939,1337,0,0,70.23,483,447,高朗村,NULL
558,927,12,939,1201,0,0,78.18,442,485,華美村,NULL
831,927,12,939,1155,0,0,81.3,414,513,新武里,NULL
228,935,4,939,1180,0,0,79.58,355,580,樹德里,NULL
0,935,4,939,1180,0,0,79.58,355,580,樹德里,NULL
244,932,6,938,1200,0,0,78.17,764,168,尖下里,NULL
73,932,6,938,1391,0,0,67.43,700,232,國福里,NULL
0,932,6,938,1391,0,0,67.43,700,232,國福里,NULL
123,925,13,938,1317,0,0,71.22,688,237,稻香村,NULL
27,934,4,938,1219,0,0,76.95,651,283,中砂里,NULL
0,934,4,938,1219,0,0,76.95,651,283,中砂里,NULL
1833,924,14,938,1246,0,0,75.28,639,285,二鬮里,NULL
871,924,14,938,1177,0,0,79.69,630,294,永興村,NULL
566,931,7,938,1198,0,0,78.3,629,302,復源里,NULL
51,925,13,938,1218,0,0,77.01,605,320,何仁里,NULL
1048,928,10,938,1183,0,0,79.29,570,358,立泰里,NULL
342,931,7,938,1290,0,0,72.71,565,366,延和里,NULL
2042,929,9,938,1205,0,0,77.84,562,367,貴子村,NULL
1317,930,8,938,1294,0,0,72.49,558,372,永寧里,NULL
238,930,8,938,1215,0,0,77.2,511,419,大忠里,NULL
737,933,5,938,1202,0,0,78.04,508,425,文福里,NULL
677,931,7,938,1230,0,0,76.26,506,425,林厝里,NULL
1432,929,9,938,1182,0,0,79.36,493,436,延祿里,NULL
572,928,10,938,1216,0,0,77.14,491,437,協興里,NULL
428,928,10,938,1271,0,0,73.8,488,440,北港村,NULL
457,929,9,938,1200,0,0,78.17,485,444,三安里,NULL
102,932,6,938,1328,0,0,70.63,465,467,東門里,NULL
893,925,13,938,1260,0,0,74.44,465,460,善美里,NULL
0,932,6,938,1328,0,0,70.63,465,467,東門里,NULL
447,924,14,938,1197,0,0,78.36,432,492,東橋里,NULL
212,934,4,938,1285,0,0,73,393,541,古亭村,NULL
0,934,4,938,1285,0,0,73,393,541,古亭村,NULL
240,929,8,937,1129,0,0,82.99,834,95,新生里,NULL
817,932,5,937,1179,0,0,79.47,728,204,裕成里,NULL
566,925,12,937,1177,0,0,79.61,687,238,福德里,NULL
44,930,7,937,1263,0,0,74.19,656,274,主力里,NULL
640,933,4,937,1171,0,0,80.02,594,339,中坡里,NULL
1834,928,9,937,1259,0,0,74.42,587,341,二鬮里,NULL
2,932,5,937,1314,0,0,71.31,506,426,短竹里,NULL
222,927,10,937,1153,0,0,81.27,500,427,長安里,NULL
567,931,6,937,1681,0,0,55.74,479,452,晴朗里,NULL
0,931,6,937,1681,0,0,55.74,479,452,晴朗里,NULL
279,933,4,937,1149,0,0,81.55,475,458,新榮里,NULL
0,933,4,937,1149,0,0,81.55,475,458,新榮里,NULL
531,928,9,937,1278,0,0,73.32,473,455,光隆里,NULL
828,930,7,937,1166,0,0,80.36,470,460,武漢里,NULL
191,929,8,937,1140,0,0,82.19,440,489,建國里,NULL
10,928,9,937,1281,0,0,73.15,289,639,嘉民村,NULL
0,928,9,937,1281,0,0,73.15,289,639,嘉民村,NULL
273,927,10,937,1414,0,0,66.27,282,645,草湖里,NULL
0,927,10,937,1414,0,0,66.27,282,645,草湖里,NULL
273,927,10,937,1261,0,0,74.31,277,650,紅厝村,NULL
0,927,10,937,1261,0,0,74.31,277,650,紅厝村,NULL
269,927,9,936,1143,0,0,81.89,806,121,龍友里,NULL
34,927,9,936,1148,0,0,81.53,743,184,北苗里,NULL
761,926,10,936,1116,0,0,83.87,679,247,安順里,NULL
665,921,15,936,1278,0,0,73.24,638,283,福隆里,NULL
170,926,10,936,1275,0,0,73.41,574,352,海口里,NULL
2022,927,9,936,1210,0,0,77.36,563,364,同榮村,NULL
171,932,4,936,1179,0,0,79.39,559,373,光田里,NULL
397,921,15,936,1389,0,0,67.39,554,367,永豐村,NULL
0,921,15,936,1389,0,0,67.39,554,367,永豐村,NULL
2242,929,7,936,1287,0,0,72.73,541,388,野柳村,NULL
578,932,4,936,1160,0,0,80.69,535,397,中原里,NULL
697,926,10,936,1233,0,0,75.91,506,420,正苓里,NULL
590,926,10,936,1484,0,0,63.07,499,427,滿州村,NULL
0,926,10,936,1484,0,0,63.07,499,427,滿州村,NULL
1722,926,10,936,1248,0,0,75,490,436,東山里,NULL
331,925,11,936,1243,0,0,75.3,485,440,大有里,NULL
529,926,10,936,1180,0,0,79.32,485,441,考潭村,NULL
494,928,8,936,1185,0,0,78.99,481,447,永發里,NULL
152,929,7,936,1279,0,0,73.18,451,478,六桂村,NULL
0,929,7,936,1279,0,0,73.18,451,478,六桂村,NULL
641,929,7,936,1286,0,0,72.78,425,504,埔園里,NULL
188,930,6,936,1207,0,0,77.55,376,554,新厝里,NULL
208,925,11,936,1181,0,0,79.25,359,566,舊社里,NULL
111,928,7,935,1185,0,0,78.9,752,176,五豐里,NULL
1175,927,8,935,1180,0,0,79.24,664,263,全安里,NULL
376,928,7,935,1275,0,0,73.33,635,293,營盤村,NULL
422,927,8,935,1216,0,0,76.89,623,304,廍子村,NULL
0,927,8,935,1216,0,0,76.89,623,304,廍子村,NULL
21,930,5,935,1164,0,0,80.33,618,312,後庄里,NULL
329,931,4,935,1261,0,0,74.15,611,320,白沙村,NULL
271,928,7,935,1194,0,0,78.31,567,361,大東村,NULL
107,932,3,935,1209,0,0,77.34,557,375,秀水里,NULL
806,924,11,935,1226,0,0,76.26,536,388,盛興里,NULL
567,929,6,935,1345,0,0,69.52,520,409,西勢里,NULL
613,926,9,935,1151,0,0,81.23,501,425,長春里,NULL
415,924,11,935,1178,0,0,79.37,498,426,大明里,NULL
690,932,3,935,1211,0,0,77.21,453,479,大苓里,NULL
262,928,7,935,1242,0,0,75.28,448,480,華勝里,NULL
835,926,9,935,1153,0,0,81.09,350,576,瑞西里,NULL
26,927,8,935,1247,0,0,74.98,311,616,安東里,NULL
420,928,7,935,1362,0,0,68.65,270,658,鹽埔村,NULL
3,925,9,934,1158,0,0,80.66,754,171,維祥里,NULL
654,925,9,934,1261,0,0,74.07,722,203,中興里,NULL
796,923,11,934,1156,0,0,80.8,704,219,秀水里,NULL
829,926,8,934,1161,0,0,80.45,667,259,紅梅里,NULL
7,927,7,934,1280,0,0,72.97,610,317,建軍里,NULL
369,925,9,934,1209,0,0,77.25,568,357,成大里,NULL
654,925,9,934,1185,0,0,78.82,537,388,三橋里,NULL
726,927,7,934,1196,0,0,78.09,514,413,中和村,NULL
146,926,8,934,1270,0,0,73.54,514,412,秀厝村,NULL
549,916,18,934,1189,0,0,78.55,513,403,北湳里,NULL
315,925,9,934,1253,0,0,74.54,511,414,成和里,NULL
253,932,2,934,1180,0,0,79.15,508,424,豐榮里,NULL
846,927,7,934,1215,0,0,76.87,499,428,栗林村,NULL
0,916,18,934,1269,0,0,73.6,477,439,中正村,NULL
758,925,9,934,1165,0,0,80.17,469,456,協和里,NULL
372,926,8,934,1203,0,0,77.64,450,476,田心里,NULL
289,923,11,934,1132,0,0,82.51,436,487,力行里,NULL
0,923,11,934,1132,0,0,82.51,436,487,力行里,NULL
832,924,10,934,1443,0,0,64.73,428,496,武東村,NULL
0,924,10,934,1443,0,0,64.73,428,496,武東村,NULL
1843,927,7,934,1313,0,0,71.13,406,521,安坑里,NULL
0,927,7,934,1313,0,0,71.13,406,521,安坑里,NULL
284,928,6,934,1263,0,0,73.95,347,581,前進里,NULL
61,927,6,933,1395,0,0,66.88,701,226,國盛里,NULL
115,917,16,933,1272,0,0,73.35,683,234,吉安村,NULL
926,930,3,933,1168,0,0,79.88,682,248,南門里,NULL
84,926,7,933,1226,0,0,76.1,672,254,福雅里,NULL
1816,921,12,933,1166,0,0,80.02,641,280,安溪里,NULL
710,925,8,933,1179,0,0,79.13,638,287,湧安里,NULL
255,929,4,933,1210,0,0,77.11,595,334,豐源里,NULL
770,920,13,933,1216,0,0,76.73,589,331,建安里,NULL
452,924,9,933,1246,0,0,74.88,558,366,大突里,NULL
385,928,5,933,1205,0,0,77.43,523,405,後協里,NULL
45,926,7,933,1668,0,0,55.94,509,417,何安里,NULL
28,927,6,933,1269,0,0,73.52,506,421,復興里,NULL
894,923,10,933,1234,0,0,75.61,504,419,善美里,NULL
709,925,8,933,1277,0,0,73.06,479,446,民安里,NULL
43,925,8,933,1249,0,0,74.7,398,527,七張里,NULL
0,925,8,933,1249,0,0,74.7,398,527,七張里,NULL
57,921,12,933,1261,0,0,73.99,347,574,昇安里,NULL
0,921,12,933,1261,0,0,73.99,347,574,昇安里,NULL
60,926,6,932,1207,0,0,77.22,779,147,光明里,NULL
1233,926,6,932,1172,0,0,79.52,745,181,太平里,NULL
21,921,11,932,1179,0,0,79.05,719,202,水源里,NULL
798,922,10,932,1154,0,0,80.76,678,244,仁美里,NULL
442,924,8,932,1259,0,0,74.03,667,257,南新村,NULL
0,924,8,932,1259,0,0,74.03,667,257,南新村,NULL
174,927,5,932,1217,0,0,76.58,635,292,新崙里,NULL
670,922,10,932,1178,0,0,79.12,634,288,吉興里,NULL
1402,920,12,932,1206,0,0,77.28,566,354,青山里,NULL
812,924,8,932,1157,0,0,80.55,552,372,忠孝里,NULL
263,917,15,932,1205,0,0,77.34,548,369,福山村,NULL
668,920,12,932,1278,0,0,72.93,548,372,新盛里,NULL
2156,925,7,932,1270,0,0,73.39,506,419,埤頭村,NULL
296,924,8,932,1171,0,0,79.59,447,477,千歲里,NULL
0,924,8,932,1171,0,0,79.59,447,477,千歲里,NULL
196,922,10,932,1187,0,0,78.52,421,501,大社村,NULL
107,919,13,932,1236,0,0,75.4,377,542,繁華村,NULL
143,922,10,932,1307,0,0,71.31,293,629,石安村,NULL
0,922,10,932,1307,0,0,71.31,293,629,石安村,NULL
46,928,3,931,1253,0,0,74.3,841,87,三地村,NULL
0,928,3,931,1253,0,0,74.3,841,87,三地村,NULL
138,916,15,931,1302,0,0,71.51,733,183,仁里村,NULL
298,922,9,931,1226,0,0,75.94,719,203,大寮村,NULL
0,922,9,931,1226,0,0,75.94,719,203,大寮村,NULL
844,924,7,931,1165,0,0,79.91,670,254,民族里,NULL
887,924,7,931,1177,0,0,79.1,667,257,水源里,NULL
606,919,12,931,1230,0,0,75.69,618,301,過溝村,NULL
589,919,12,931,1119,0,0,83.2,594,325,福祥里,NULL
1826,915,16,931,1205,0,0,77.26,576,339,嘉添里,NULL
429,921,10,931,1324,0,0,70.32,555,366,北港村,NULL
168,922,9,931,1159,0,0,80.33,552,370,文雅里,NULL
257,925,6,931,1163,0,0,80.05,515,410,豐源里,NULL
1775,919,12,931,1189,0,0,78.3,493,426,鳳鳴里,NULL
75,917,14,931,1175,0,0,79.23,471,446,陽明里,NULL
541,928,3,931,1127,0,0,82.61,460,468,夢裡村,NULL
53,920,11,931,1248,0,0,74.6,453,467,新生里,NULL
252,923,8,931,1188,0,0,78.37,439,484,再興里,NULL
874,925,6,931,1142,0,0,81.52,436,489,保安里,NULL
307,928,3,931,1172,0,0,79.44,426,502,安邦里,NULL
0,925,6,931,1311,0,0,71.01,390,535,大同里,NULL
769,916,15,931,1166,0,0,79.85,377,539,神洲村,NULL
190,922,9,931,1161,0,0,80.19,354,568,內惟里,NULL
0,922,9,931,1161,0,0,80.19,354,568,內惟里,NULL
2,923,8,931,1199,0,0,77.65,327,596,玉田村,NULL
0,921,9,930,1245,0,0,74.7,860,61,大隘村,NULL
259,922,8,930,1119,0,0,83.11,722,200,松林村,NULL
35,918,12,930,1180,0,0,78.81,700,218,嘉盛里,NULL
45,923,7,930,1506,0,0,61.75,680,243,豐谷里,NULL
186,926,4,930,1154,0,0,80.59,655,271,暖暖里,NULL
16,924,6,930,1168,0,0,79.62,608,316,復興里,NULL
403,917,13,930,1409,0,0,66,566,351,頂厝里,NULL
0,917,13,930,1409,0,0,66,566,351,頂厝里,NULL
349,924,6,930,1156,0,0,80.45,562,362,壽天里,NULL
265,922,8,930,1128,0,0,82.45,559,363,廣隆里,NULL
58,925,5,930,1226,0,0,75.86,556,369,東安村,NULL
0,925,5,930,1226,0,0,75.86,556,369,東安村,NULL
1349,924,6,930,1216,0,0,76.48,507,417,日新里,NULL
74,921,9,930,1230,0,0,75.61,498,423,羅莊里,NULL
676,922,8,930,1390,0,0,66.91,495,427,慶福里,NULL
0,922,8,930,1390,0,0,66.91,495,427,慶福里,NULL
216,926,4,930,1165,0,0,79.83,473,453,東丘里,NULL
1392,917,13,930,1240,0,0,75,464,453,清和里,NULL
837,925,5,930,1191,0,0,78.09,456,469,新樂里,NULL
464,922,8,930,1146,0,0,81.15,351,571,仕隆村,NULL
631,920,9,929,1204,0,0,77.16,675,245,和盛村,NULL
0,920,9,929,1204,0,0,77.16,675,245,和盛村,NULL
66,921,8,929,1284,0,0,72.35,656,265,孝深里,NULL
587,924,5,929,1158,0,0,80.22,653,271,中興村,NULL
223,918,11,929,1219,0,0,76.21,602,316,頂福里,NULL
473,924,5,929,1274,0,0,72.92,584,340,大庭里,NULL
0,924,5,929,1274,0,0,72.92,584,340,大庭里,NULL
753,926,3,929,1181,0,0,78.66,569,357,興仁里,NULL
658,922,7,929,1176,0,0,79,473,449,竹北里,NULL
209,924,5,929,1156,0,0,80.36,468,456,深丘里,NULL
474,924,5,929,1275,0,0,72.86,458,466,媽厝里,NULL
0,924,5,929,1275,0,0,72.86,458,466,媽厝里,NULL
841,924,5,929,1155,0,0,80.43,442,482,新強里,NULL
749,920,9,929,1180,0,0,78.73,439,481,和興里,NULL
353,921,8,929,1223,0,0,75.96,398,523,安西里,NULL
214,923,6,929,1236,0,0,75.16,394,529,五魁里,NULL
0,923,6,929,1236,0,0,75.16,394,529,五魁里,NULL
265,919,10,929,1256,0,0,73.96,391,528,新街里,NULL
23,918,11,929,1518,0,0,61.2,390,528,文武村,NULL
0,918,11,929,1518,0,0,61.2,390,528,文武村,NULL
40,920,8,928,1163,0,0,79.79,670,250,義幸里,NULL
242,911,17,928,1267,0,0,73.24,546,365,龍泉村,NULL
678,918,10,928,1282,0,0,72.39,506,412,尚頂里,NULL
42,920,8,928,1274,0,0,72.84,495,425,幸福里,NULL
1465,915,13,928,1180,0,0,78.64,492,423,忠義里,NULL
435,923,5,928,1206,0,0,76.95,480,443,立仁里,NULL
538,923,5,928,1213,0,0,76.5,430,493,慈祐里,NULL
135,921,7,928,1259,0,0,73.71,410,511,頂溪里,NULL
575,924,4,928,1238,0,0,74.96,399,525,中庄村,NULL
430,918,10,928,1210,0,0,76.69,369,549,圍內村,NULL
0,918,10,928,1210,0,0,76.69,369,549,圍內村,NULL
821,924,4,928,1217,0,0,76.25,367,557,新厝村,NULL
50,915,12,927,1518,0,0,61.07,698,217,富岡里,NULL
0,915,12,927,1518,0,0,61.07,698,217,富岡里,NULL
313,916,11,927,1181,0,0,78.49,643,273,館東村,NULL
2250,915,12,927,1196,0,0,77.51,635,280,忠治村,NULL
0,915,12,927,1196,0,0,77.51,635,280,忠治村,NULL
285,921,6,927,1138,0,0,81.46,632,289,西康里,NULL
36,918,9,927,1148,0,0,80.75,625,293,仁壽里,NULL
0,918,9,927,1148,0,0,80.75,625,293,仁壽里,NULL
1587,919,8,927,1266,0,0,73.22,605,314,拱北里,NULL
84,916,11,927,1303,0,0,71.14,579,337,杷城里,NULL
430,923,4,927,1168,0,0,79.37,567,356,鎮南里,NULL
1423,918,9,927,1207,0,0,76.8,562,356,峯廷里,NULL
630,920,7,927,1250,0,0,74.16,551,369,二王里,NULL
410,922,5,927,1251,0,0,74.1,542,380,明德里,NULL
738,916,11,927,1174,0,0,78.96,536,380,明德里,NULL
266,922,5,927,1250,0,0,74.16,507,415,新街里,NULL
380,916,11,927,1254,0,0,73.92,503,413,祥興里,NULL
480,912,15,927,1224,0,0,75.74,472,440,埔心村,NULL
0,912,15,927,1224,0,0,75.74,472,440,埔心村,NULL
521,917,10,927,1154,0,0,80.33,460,457,五常里,NULL
208,923,4,927,1175,0,0,78.89,442,481,神農村,NULL
0,919,8,927,1388,0,0,66.79,430,489,埤腳里,NULL
186,921,6,927,1167,0,0,79.43,429,492,新厝里,NULL
0,918,9,927,1229,0,0,75.43,428,490,三民里,NULL
623,917,10,927,1277,0,0,72.59,362,555,大寮村,NULL
111,922,4,926,1183,0,0,78.28,628,294,立仁里,NULL
31,917,9,926,1131,0,0,81.87,613,304,東山里,NULL
1679,915,11,926,1141,0,0,81.16,569,346,樹福里,NULL
1394,924,2,926,1260,0,0,73.49,535,389,清和里,NULL
229,913,13,926,1191,0,0,77.75,525,388,民權里,NULL
0,913,13,926,1191,0,0,77.75,525,388,民權里,NULL
475,919,7,926,1132,0,0,81.8,429,490,甲南村,NULL
52,918,8,926,1262,0,0,73.38,413,505,豐年里,NULL
0,918,8,926,1262,0,0,73.38,413,505,豐年里,NULL
12,917,9,926,1180,0,0,78.47,305,612,茄苳村,NULL
248,913,12,925,1229,0,0,75.26,694,219,中崙村,NULL
1203,918,7,925,1151,0,0,80.36,643,275,明德里,NULL
728,915,10,925,1159,0,0,79.81,638,277,復旦里,NULL
704,916,9,925,1147,0,0,80.65,588,328,員山里,NULL
321,917,8,925,1167,0,0,79.26,572,345,大正里,NULL
0,919,6,925,1409,0,0,65.65,537,382,同富村,NULL
80,919,6,925,1217,0,0,76.01,493,426,新復里,NULL
0,919,6,925,1217,0,0,76.01,493,426,新復里,NULL
191,919,6,925,1320,0,0,70.08,460,459,下埤里,NULL
0,919,6,925,1320,0,0,70.08,460,459,下埤里,NULL
294,910,15,925,1177,0,0,78.59,456,454,湖日村,NULL
556,914,11,925,1235,0,0,74.9,448,466,西湳里,NULL
519,917,8,925,1190,0,0,77.73,431,486,赤山村,NULL
730,914,11,925,1133,0,0,81.64,369,545,廈莊里,NULL
262,916,9,925,1222,0,0,75.7,338,578,吉定村,NULL
0,916,9,925,1222,0,0,75.7,338,578,吉定村,NULL
350,914,11,925,1338,0,0,69.13,324,590,吳厝里,NULL
0,914,11,925,1338,0,0,69.13,324,590,吳厝里,NULL
854,915,9,924,1151,0,0,80.28,619,296,秀得里,NULL
1924,910,14,924,1278,0,0,72.3,619,291,龍山里,NULL
0,910,14,924,1278,0,0,72.3,619,291,龍山里,NULL
1920,917,7,924,1237,0,0,74.7,587,330,龍鎮里,NULL
0,917,7,924,1237,0,0,74.7,587,330,龍鎮里,NULL
40,919,5,924,1456,0,0,63.46,586,333,永豐村,NULL
0,919,5,924,1456,0,0,63.46,586,333,永豐村,NULL
1333,916,8,924,1155,0,0,80,584,332,員信里,NULL
407,917,7,924,1187,0,0,77.84,581,336,双龍里,NULL
247,913,11,924,1233,0,0,74.94,564,349,平心里,NULL
404,911,13,924,1245,0,0,74.22,550,361,橫峰村,NULL
53,915,9,924,1181,0,0,78.24,535,380,大豐里,NULL
448,916,8,924,1129,0,0,81.84,534,382,合成里,NULL
1040,917,7,924,1166,0,0,79.25,534,383,銘德里,NULL
468,920,4,924,1293,0,0,71.46,525,395,湖東里,NULL
247,911,13,924,1142,0,0,80.91,514,397,天壽里,NULL
91,911,13,924,1185,0,0,77.97,513,398,溪頭里,NULL
531,913,11,924,1318,0,0,70.11,510,403,和豊村,NULL
75,919,5,924,1200,0,0,77,492,427,南昌里,NULL
282,916,8,924,1201,0,0,76.94,482,434,大湳里,NULL
408,913,11,924,1278,0,0,72.3,452,461,西庄里,NULL
0,913,11,924,1278,0,0,72.3,452,461,西庄里,NULL
0,914,10,924,1325,0,0,69.74,403,511,科里村,NULL
379,914,10,924,1350,0,0,68.44,369,545,五華村,NULL
0,914,10,924,1350,0,0,68.44,369,545,五華村,NULL
93,915,9,924,1243,0,0,74.34,362,553,南勝里,NULL
1231,920,3,923,1115,0,0,82.78,844,76,大鵬里,NULL
307,914,9,923,1149,0,0,80.33,814,100,樂英里,NULL
675,909,14,923,1165,0,0,79.23,742,167,仁德里,NULL
48,914,9,923,1156,0,0,79.84,681,233,信綠里,NULL
45,913,10,923,1262,0,0,73.14,662,251,主力里,NULL
808,922,1,923,1170,0,0,78.89,645,277,海光里,NULL
74,921,2,923,1226,0,0,75.29,622,299,和明里,NULL
0,921,2,923,1226,0,0,75.29,622,299,和明里,NULL
7,920,3,923,1329,0,0,69.45,586,334,民生里,NULL
1802,920,3,923,1222,0,0,75.53,582,338,龍埔里,NULL
222,914,9,923,1312,0,0,70.35,569,345,龍東村,NULL
455,913,10,923,1225,0,0,75.35,567,346,汴頭里,NULL
112,916,7,923,1256,0,0,73.49,538,378,高峰里,NULL
834,920,3,923,1154,0,0,79.98,531,389,新泰里,NULL
366,918,5,923,1159,0,0,79.64,523,395,光田里,NULL
517,914,9,923,1148,0,0,80.4,510,404,光耀里,NULL
624,916,7,923,1174,0,0,78.62,503,413,網寮里,NULL
373,914,9,923,1166,0,0,79.16,495,419,田心里,NULL
337,920,3,923,1205,0,0,76.6,471,449,虎尾里,NULL
464,905,18,923,1204,0,0,76.66,470,435,十甲里,NULL
371,915,8,923,1179,0,0,78.29,464,451,大美村,NULL
648,919,4,923,1193,0,0,77.37,441,478,大橋里,NULL
224,918,5,923,1294,0,0,71.33,428,490,光春里,NULL
0,918,5,923,1294,0,0,71.33,428,490,光春里,NULL
361,915,8,923,1198,0,0,77.05,417,498,莿桐村,NULL
407,911,12,923,1155,0,0,79.91,408,503,五權村,NULL
174,912,11,923,1476,0,0,62.53,405,507,子茂村,NULL
0,912,11,923,1476,0,0,62.53,405,507,子茂村,NULL
276,917,6,923,1236,0,0,74.68,394,523,六甲村,NULL
253,916,7,923,1175,0,0,78.55,368,548,廣州里,NULL
792,920,2,922,1074,0,0,85.85,850,70,忠誠里,NULL
356,916,6,922,1196,0,0,77.09,643,273,後紅里,NULL
99,919,3,922,1142,0,0,80.74,583,336,光華里,NULL
223,912,10,922,1226,0,0,75.2,574,338,龍東村,NULL
160,911,11,922,1264,0,0,72.94,554,357,福南村,NULL
1672,913,9,922,1196,0,0,77.09,553,360,圳福里,NULL
728,919,3,922,1180,0,0,78.14,539,380,德穗里,NULL
173,910,12,922,1179,0,0,78.2,532,378,鶴鳴村,NULL
522,916,6,922,1170,0,0,78.8,530,386,成功里,NULL
0,916,6,922,1170,0,0,78.8,530,386,成功里,NULL
1021,912,10,922,1184,0,0,77.87,495,417,立廷里,NULL
124,914,8,922,1313,0,0,70.22,490,424,聖湖里,NULL
488,912,10,922,1202,0,0,76.71,490,422,中天里,NULL
0,912,10,922,1202,0,0,76.71,490,422,中天里,NULL
419,916,6,922,1179,0,0,78.2,475,441,民生里,NULL
875,912,10,922,1167,0,0,79.01,468,444,保安里,NULL
617,915,7,922,1210,0,0,76.2,422,493,三隆村,NULL
207,913,9,922,1199,0,0,76.9,417,496,郡西里,NULL
0,913,9,922,1199,0,0,76.9,417,496,郡西里,NULL
277,915,7,922,1196,0,0,77.09,415,500,梅北村,NULL
236,915,7,922,1245,0,0,74.06,396,519,同樂村,NULL
219,914,8,922,1376,0,0,67.01,367,547,水北村,NULL
391,909,13,922,1198,0,0,76.96,287,622,大埕里,NULL
253,907,14,921,1234,0,0,74.64,626,281,大庄里,NULL
1805,912,9,921,1218,0,0,75.62,614,298,龍埔里,NULL
86,915,6,921,1246,0,0,73.92,610,305,莊敬里,NULL
1006,915,6,921,1141,0,0,80.72,583,332,立德里,NULL
25,917,4,921,1224,0,0,75.25,583,334,塭仔村,NULL
0,917,4,921,1224,0,0,75.25,583,334,塭仔村,NULL
209,913,8,921,1268,0,0,72.63,580,333,埔子里,NULL
572,912,9,921,1119,0,0,82.31,529,383,林圍里,NULL
44,911,10,921,1306,0,0,70.52,520,391,慈安里,NULL
649,912,9,921,1197,0,0,76.94,513,399,大橋里,NULL
0,917,4,921,1192,0,0,77.27,507,410,鯉魚潭村,NULL
491,914,7,921,1196,0,0,77.01,500,414,社西里,NULL
0,914,7,921,1196,0,0,77.01,500,414,社西里,NULL
365,910,11,921,1165,0,0,79.06,455,455,西湖里,NULL
354,913,8,921,1317,0,0,69.93,443,470,中央里,NULL
0,913,8,921,1317,0,0,69.93,443,470,中央里,NULL
142,917,4,921,1224,0,0,75.25,407,510,和順里,NULL
31,901,20,921,1503,0,0,61.28,374,527,荖濃村,NULL
0,901,20,921,1503,0,0,61.28,374,527,荖濃村,NULL
680,912,9,921,1276,0,0,72.18,341,571,龍潭里,NULL
0,911,10,921,1230,0,0,74.88,334,577,布袋村,NULL
491,912,9,921,1221,0,0,75.43,269,643,劉厝村,NULL
0,912,9,921,1221,0,0,75.43,269,643,劉厝村,NULL
679,908,12,920,1087,0,0,84.64,779,129,龍安里,NULL
231,906,14,920,1322,0,0,69.59,662,244,國武里,NULL
0,906,14,920,1322,0,0,69.59,662,244,國武里,NULL
382,913,7,920,1148,0,0,80.14,622,291,民生里,NULL
1082,916,4,920,1182,0,0,77.83,607,309,和安里,NULL
2126,918,2,920,1262,0,0,72.9,601,317,埔頭村,NULL
2223,917,3,920,1270,0,0,72.44,579,338,金美村,NULL
761,908,12,920,1230,0,0,74.8,564,344,大社村,NULL
343,911,9,920,1233,0,0,74.61,564,347,賴旺里,NULL
153,909,11,920,1224,0,0,75.16,555,354,新東里,NULL
1056,908,12,920,1167,0,0,78.83,546,362,泰豐里,NULL
120,916,4,920,1271,0,0,72.38,520,396,新吉里,NULL
15,910,10,920,1161,0,0,79.24,509,401,社後里,NULL
1440,913,7,920,1196,0,0,76.92,502,411,延和里,NULL
289,911,9,920,1296,0,0,70.99,471,440,南華里,NULL
747,911,9,920,1193,0,0,77.12,436,475,新庄村,NULL
119,910,10,920,1278,0,0,71.99,423,487,高東里,NULL
0,910,10,920,1278,0,0,71.99,423,487,高東里,NULL
653,912,8,920,1234,0,0,74.55,354,558,溪州村,NULL
0,913,7,920,1279,0,0,71.93,353,560,柳溝村,NULL
302,912,8,920,1220,0,0,75.41,344,568,省躬里,NULL
109,913,6,919,1194,0,0,76.97,744,169,五豐里,NULL
162,912,7,919,1150,0,0,79.91,656,256,自強里,NULL
734,912,7,919,1137,0,0,80.83,631,281,壽德里,NULL
29,913,6,919,1230,0,0,74.72,614,299,頂犁村,NULL
497,914,5,919,1199,0,0,76.65,602,312,精忠里,NULL
238,913,6,919,1172,0,0,78.41,602,311,營南里,NULL
1539,913,6,919,1194,0,0,76.97,566,347,義民里,NULL
0,913,6,919,1194,0,0,76.97,566,347,義民里,NULL
20,915,4,919,1142,0,0,80.47,543,372,後庄里,NULL
661,912,7,919,1175,0,0,78.21,514,398,中厝村,NULL
627,907,12,919,1157,0,0,79.43,510,397,永康里,NULL
482,910,9,919,1197,0,0,76.78,486,424,維德里,NULL
599,911,8,919,1199,0,0,76.65,466,445,民主里,NULL
110,910,9,919,1275,0,0,72.08,457,453,祿興里,NULL
129,912,7,919,1167,0,0,78.75,439,473,崇禮里,NULL
0,912,7,919,1167,0,0,78.75,439,473,崇禮里,NULL
263,915,4,919,1247,0,0,73.7,435,480,崎漏村,NULL
341,913,6,919,1130,0,0,81.33,430,483,谷王里,NULL
0,913,6,919,1130,0,0,81.33,430,483,谷王里,NULL
691,910,9,919,1204,0,0,76.33,426,484,西勢里,NULL
786,914,5,919,1228,0,0,74.84,412,502,保安村,NULL
405,912,7,919,1233,0,0,74.53,406,506,新東村,NULL
309,912,7,919,1244,0,0,73.87,404,508,湳仔村,NULL
0,912,7,919,1244,0,0,73.87,404,508,湳仔村,NULL
255,915,4,919,1265,0,0,72.65,351,564,丸山村,NULL
0,915,4,919,1265,0,0,72.65,351,564,丸山村,NULL
1294,913,5,918,1082,0,0,84.84,695,218,美潭里,NULL
191,912,6,918,1148,0,0,79.97,656,256,金竹里,NULL
1219,910,8,918,1228,0,0,74.76,645,265,正聲里,NULL
1385,911,7,918,1195,0,0,76.82,628,283,柑林里,NULL
101,913,5,918,1132,0,0,81.1,615,298,光輝里,NULL
869,910,8,918,1208,0,0,75.99,599,311,黃唐村,NULL
1318,904,14,918,1273,0,0,72.11,573,331,永寧里,NULL
176,906,12,918,1131,0,0,81.17,567,339,金華里,NULL
742,909,9,918,1128,0,0,81.38,564,345,錦中里,NULL
9,916,2,918,1155,0,0,79.48,556,360,盧厝里,NULL
343,910,8,918,1145,0,0,80.17,555,355,上竹村,NULL
1070,913,5,918,1242,0,0,73.91,544,369,合鳳里,NULL
23,905,13,918,1481,0,0,61.99,521,384,雷厝村,NULL
0,905,13,918,1481,0,0,61.99,521,384,雷厝村,NULL
590,909,9,918,1180,0,0,77.8,518,391,鎌村里,NULL
821,914,4,918,1147,0,0,80.03,493,421,國富里,NULL
109,905,13,918,1518,0,0,60.47,478,427,豐樂里,NULL
257,913,5,918,1327,0,0,69.18,476,437,仁里村,NULL
719,910,8,918,1212,0,0,75.74,461,449,廣興村,NULL
493,912,6,918,1269,0,0,72.34,425,487,南平里,NULL
13,913,4,917,1078,0,0,85.06,749,164,玉華里,NULL
882,907,10,917,1143,0,0,80.23,676,231,永安里,NULL
122,910,7,917,1137,0,0,80.65,676,234,明湖里,NULL
1283,914,3,917,1182,0,0,77.58,652,262,興家里,NULL
331,901,16,917,1199,0,0,76.48,651,250,玉榖村,NULL
0,901,16,917,1199,0,0,76.48,651,250,玉榖村,NULL
245,906,11,917,1228,0,0,74.67,649,257,興仁里,NULL
22,908,9,917,1198,0,0,76.54,642,266,頂庄村,NULL
0,908,9,917,1198,0,0,76.54,642,266,頂庄村,NULL
915,914,3,917,1137,0,0,80.65,639,275,三林村,NULL
826,912,5,917,1182,0,0,77.58,606,306,楊江里,NULL
0,912,5,917,1182,0,0,77.58,606,306,楊江里,NULL
1388,912,5,917,1183,0,0,77.51,599,313,中正里,NULL
588,914,3,917,1131,0,0,81.08,589,325,同慶里,NULL
1116,905,12,917,1228,0,0,74.67,544,361,成德里,NULL
215,910,7,917,1154,0,0,79.46,511,399,竹寮村,NULL
439,911,6,917,1236,0,0,74.19,496,415,大誠里,NULL
309,908,9,917,1173,0,0,78.18,494,414,龍安里,NULL
824,908,9,917,1141,0,0,80.37,482,426,武慶里,NULL
378,909,8,917,1167,0,0,78.58,481,428,新東里,NULL
421,905,12,917,1149,0,0,79.81,469,436,民生里,NULL
576,911,6,917,1223,0,0,74.98,448,463,北勢里,NULL
0,911,6,917,1223,0,0,74.98,448,463,北勢里,NULL
633,908,9,917,1184,0,0,77.45,436,472,過溪村,NULL
249,909,8,917,1129,0,0,81.22,427,482,中山里,NULL
0,909,8,917,1129,0,0,81.22,427,482,中山里,NULL
87,906,11,917,1228,0,0,74.67,421,485,西安里,NULL
206,906,10,916,1173,0,0,78.09,685,221,信勢村,NULL
335,907,9,916,1204,0,0,76.08,640,267,仁安村,NULL
0,907,9,916,1204,0,0,76.08,640,267,仁安村,NULL
16,909,7,916,1402,0,0,65.34,629,280,建國里,NULL
0,909,7,916,1402,0,0,65.34,629,280,建國里,NULL
194,909,7,916,1147,0,0,79.86,622,287,德盛村,NULL
26,911,5,916,1154,0,0,79.38,590,321,碧洲里,NULL
1004,911,5,916,1133,0,0,80.85,564,347,恆安里,NULL
227,911,5,916,1337,0,0,68.51,556,355,平和里,NULL
634,907,9,916,1165,0,0,78.63,547,360,新生里,NULL
695,910,6,916,1185,0,0,77.3,540,370,鳳崗里,NULL
0,910,6,916,1185,0,0,77.3,540,370,鳳崗里,NULL
476,912,4,916,1273,0,0,71.96,539,373,西勢里,NULL
770,909,7,916,1126,0,0,81.35,505,404,中和里,NULL
225,910,6,916,1099,0,0,83.35,490,420,東安里,NULL
788,905,11,916,1283,0,0,71.4,476,429,大崙里,NULL
0,905,11,916,1283,0,0,71.4,476,429,大崙里,NULL
136,904,12,916,1149,0,0,79.72,473,431,元中村,NULL
0,904,12,916,1149,0,0,79.72,473,431,元中村,NULL
448,908,8,916,1137,0,0,80.56,459,449,東橋里,NULL
336,901,15,916,1142,0,0,80.21,457,444,博愛里,NULL
0,908,8,916,1293,0,0,70.84,438,470,興新里,NULL
720,910,6,916,1150,0,0,79.65,425,485,松金里,NULL
491,910,6,916,1154,0,0,79.38,414,496,永德里,NULL
271,902,14,916,1343,0,0,68.21,313,589,賀建村,NULL
0,902,14,916,1343,0,0,68.21,313,589,賀建村,NULL
90,910,5,915,1123,0,0,81.48,691,219,南華里,NULL
0,910,5,915,1123,0,0,81.48,691,219,南華里,NULL
194,908,7,915,1136,0,0,80.55,680,228,金竹里,NULL
1225,904,11,915,1132,0,0,80.83,643,261,信義里,NULL
37,905,10,915,1370,0,0,66.79,631,274,豐樂里,NULL
0,905,10,915,1370,0,0,66.79,631,274,豐樂里,NULL
1692,909,6,915,1152,0,0,79.43,561,348,樹南里,NULL
11,905,10,915,1165,0,0,78.54,557,348,新美里,NULL
1008,909,6,915,1201,0,0,76.19,548,361,綠堤里,NULL
623,908,7,915,1150,0,0,79.57,487,421,福東里,NULL
233,909,6,915,1133,0,0,80.76,459,450,長樂里,NULL
0,909,6,915,1133,0,0,80.76,459,450,長樂里,NULL
551,905,10,915,1245,0,0,73.49,433,472,中寮里,NULL
489,908,7,915,1271,0,0,71.99,429,479,林子里,NULL
0,908,7,915,1271,0,0,71.99,429,479,林子里,NULL
275,907,8,915,1202,0,0,76.12,365,542,柯林村,NULL
191,908,7,915,1160,0,0,78.88,365,543,保社村,NULL
0,907,8,915,1202,0,0,76.12,365,542,柯林村,NULL
198,906,8,914,1088,0,0,84.01,854,52,武陵里,NULL
791,911,3,914,1075,0,0,85.02,820,91,忠誠里,NULL
42,906,8,914,1225,0,0,74.61,690,216,主權里,NULL
208,906,8,914,1149,0,0,79.55,666,240,信義村,NULL
899,906,8,914,1109,0,0,82.42,645,261,保平里,NULL
513,900,14,914,1198,0,0,76.29,618,282,竹林村,NULL
248,906,8,914,1175,0,0,77.79,614,292,平心里,NULL
166,907,7,914,1210,0,0,75.54,585,322,大村里,NULL
267,908,6,914,1163,0,0,78.59,578,330,社腳村,NULL
100,906,8,914,1191,0,0,76.74,578,328,東仁里,NULL
2236,907,7,914,1249,0,0,73.18,559,348,萬里村,NULL
1642,903,11,914,1176,0,0,77.72,548,355,三福里,NULL
268,899,15,914,1158,0,0,78.93,545,354,華貴里,NULL
1588,908,6,914,1245,0,0,73.41,537,371,烘內里,NULL
0,908,6,914,1245,0,0,73.41,537,371,烘內里,NULL
111,909,5,914,1206,0,0,75.79,533,376,祿興里,NULL
456,903,11,914,1126,0,0,81.17,430,473,茄苳村,NULL
132,904,10,914,1482,0,0,61.67,412,492,五福里,NULL
0,904,10,914,1482,0,0,61.67,412,492,五福里,NULL
136,908,6,914,1286,0,0,71.07,388,520,頂溪里,NULL
335,905,9,914,1122,0,0,81.46,350,555,新興村,NULL
416,908,6,914,1202,0,0,76.04,310,598,興龍村,NULL
318,902,12,914,1198,0,0,76.29,284,618,尾塹村,NULL
0,902,12,914,1198,0,0,76.29,284,618,尾塹村,NULL
486,908,6,914,1147,0,0,79.69,276,632,東林村,NULL
57,902,11,913,1303,0,0,70.07,692,210,南王里,NULL
779,911,2,913,1089,0,0,83.84,656,255,秀義里,NULL
944,905,8,913,1251,0,0,72.98,628,277,黎明里,NULL
147,900,13,913,1251,0,0,72.98,596,304,中正里,NULL
718,906,7,913,1179,0,0,77.44,591,315,廣興里,NULL
66,906,7,913,1252,0,0,72.92,555,351,興村里,NULL
394,904,9,913,1158,0,0,78.84,526,378,大元里,NULL
66,906,7,913,1169,0,0,78.1,512,394,幸福里,NULL
416,904,9,913,1246,0,0,73.27,491,413,原斗里,NULL
0,904,9,913,1246,0,0,73.27,491,413,原斗里,NULL
1648,903,10,913,1214,0,0,75.21,474,429,獇寮里,NULL
515,906,7,913,1270,0,0,71.89,434,472,東和村,NULL
839,904,9,913,1144,0,0,79.81,414,490,新強里,NULL
425,901,12,913,1304,0,0,70.02,412,489,同仁村,NULL
123,904,9,913,1223,0,0,74.65,403,501,豐田村,NULL
71,905,8,913,1196,0,0,76.34,335,570,新群里,NULL
96,898,14,912,1318,0,0,69.2,735,163,富世村,NULL
665,904,8,912,1101,0,0,82.83,650,254,外南里,NULL
790,905,7,912,1189,0,0,76.7,635,270,成功村,NULL
3,907,5,912,1265,0,0,72.09,628,279,自強里,NULL
2,906,6,912,1368,0,0,66.67,627,279,麥豐村,NULL
275,902,10,912,1147,0,0,79.51,559,343,茄南里,NULL
447,904,8,912,1155,0,0,78.96,541,363,合成里,NULL
320,905,7,912,1218,0,0,74.88,541,364,竹山里,NULL
433,904,8,912,1213,0,0,75.19,539,365,大有村,NULL
0,904,8,912,1213,0,0,75.19,539,365,大有村,NULL
93,905,7,912,1148,0,0,79.44,508,397,力行里,NULL
762,901,11,912,1195,0,0,76.32,475,426,仁德村,NULL
748,904,8,912,1116,0,0,81.72,471,433,勝利里,NULL
430,907,5,912,1185,0,0,76.96,457,450,南寮村,NULL
128,907,5,912,1206,0,0,75.62,450,457,六甲里,NULL
367,905,7,912,1165,0,0,78.28,447,458,興全村,NULL
0,905,7,912,1165,0,0,78.28,447,458,興全村,NULL
1510,900,12,912,1177,0,0,77.49,418,482,仁義里,NULL
852,901,11,912,1168,0,0,78.08,414,487,景星里,NULL
679,900,12,912,1254,0,0,72.73,411,489,湖水里,NULL
0,900,12,912,1254,0,0,72.73,411,489,湖水里,NULL
1,902,10,912,1171,0,0,77.88,369,533,玉田村,NULL
593,904,8,912,1325,0,0,68.83,293,611,水尾村,NULL
0,904,8,912,1325,0,0,68.83,293,611,水尾村,NULL
0,904,7,911,1339,0,0,68.04,761,143,鳳信里,NULL
318,907,4,911,1080,0,0,84.35,711,196,大智里,NULL
272,906,5,911,1115,0,0,81.7,704,202,文林村,NULL
27,904,7,911,1117,0,0,81.56,637,267,自強里,NULL
150,899,12,911,1153,0,0,79.01,599,300,內立里,NULL
0,899,12,911,1153,0,0,79.01,599,300,內立里,NULL
26,900,11,911,1197,0,0,76.11,579,321,文武里,NULL
2052,905,6,911,1183,0,0,77.01,562,343,東林村,NULL
1384,900,11,911,1156,0,0,78.81,557,343,學士里,NULL
101,905,6,911,1199,0,0,75.98,547,358,東仁里,NULL
267,906,5,911,1221,0,0,74.61,539,367,永豐里,NULL
192,903,8,911,1146,0,0,79.49,532,371,鹿寮里,NULL
1340,903,8,911,1196,0,0,76.17,515,388,員福里,NULL
286,910,1,911,1268,0,0,71.85,515,395,南陽村,NULL
278,902,9,911,1230,0,0,74.07,506,396,古夷里,NULL
512,904,7,911,1135,0,0,80.26,471,433,八卦村,NULL
626,904,7,911,1234,0,0,73.82,467,437,網寮里,NULL
414,898,13,911,1193,0,0,76.36,437,461,三石村,NULL
748,902,9,911,1174,0,0,77.6,347,555,鳳源里,NULL
886,897,13,910,1191,0,0,76.41,630,267,八德村,NULL
770,906,4,910,1124,0,0,80.96,626,280,泰安里,NULL
171,898,12,910,1145,0,0,79.48,608,290,港墘里,NULL
675,898,12,910,1212,0,0,75.08,573,325,振興里,NULL
213,899,11,910,1166,0,0,78.04,553,346,香丘里,NULL
1360,900,10,910,1205,0,0,75.52,511,389,復興里,NULL
707,901,9,910,1246,0,0,73.03,494,407,崙子村,NULL
0,901,9,910,1246,0,0,73.03,494,407,崙子村,NULL
1355,908,2,910,1187,0,0,76.66,492,416,貨饒里,NULL
602,898,12,910,1189,0,0,76.53,484,414,南勢村,NULL
0,898,12,910,1189,0,0,76.53,484,414,南勢村,NULL
759,898,12,910,1227,0,0,74.16,480,418,溪畔村,NULL
0,898,12,910,1227,0,0,74.16,480,418,溪畔村,NULL
779,904,6,910,1196,0,0,76.09,477,427,後壁村,NULL
806,897,13,910,1238,0,0,73.51,472,425,朱園里,NULL
128,897,13,910,1304,0,0,69.79,431,466,西安里,NULL
0,897,13,910,1304,0,0,69.79,431,466,西安里,NULL
395,902,8,910,1154,0,0,78.86,421,481,行善里,NULL
623,899,11,910,1209,0,0,75.27,417,482,網寮里,NULL
510,904,6,910,1347,0,0,67.56,402,502,崎峯村,NULL
0,904,6,910,1347,0,0,67.56,402,502,崎峯村,NULL
186,903,7,910,1173,0,0,77.58,339,564,光榮里,NULL
2,909,0,909,1596,0,0,56.95,856,53,東門里,NULL
794,903,6,909,1133,0,0,80.23,679,224,秀士里,NULL
26,907,2,909,1387,0,0,65.54,654,253,新生里,NULL
553,899,10,909,1126,0,0,80.73,606,293,振興里,NULL
255,901,8,909,1146,0,0,79.32,606,295,平和里,NULL
288,901,8,909,1169,0,0,77.76,563,338,水湳里,NULL
1810,903,6,909,1163,0,0,78.16,537,366,礁溪里,NULL
372,904,5,909,1128,0,0,80.59,440,464,前峰里,NULL
495,898,11,909,1175,0,0,77.36,414,484,文武村,NULL
622,903,6,909,1192,0,0,76.26,402,501,大寮村,NULL
378,898,11,909,1262,0,0,72.03,398,500,鹿滿村,NULL
0,898,11,909,1262,0,0,72.03,398,500,鹿滿村,NULL
733,905,4,909,1128,0,0,80.59,369,536,合作里,NULL
952,901,7,908,1168,0,0,77.74,567,334,幸市里,NULL
1639,898,10,908,1204,0,0,75.42,564,334,三興里,NULL
4,903,5,908,1183,0,0,76.75,553,350,民族里,NULL
1798,897,11,908,1225,0,0,74.12,534,363,鳶山里,NULL
397,892,16,908,1156,0,0,78.55,533,359,中民里,NULL
0,892,16,908,1156,0,0,78.55,533,359,中民里,NULL
587,899,9,908,1158,0,0,78.41,532,367,福美里,NULL
141,906,2,908,1188,0,0,76.43,531,375,民權里,NULL
302,898,10,908,1230,0,0,73.82,528,370,新北里,NULL
246,899,9,908,1220,0,0,74.43,490,409,興仁里,NULL
1459,906,2,908,1166,0,0,77.87,483,423,中華里,NULL
441,900,8,908,1131,0,0,80.28,464,436,西新里,NULL
613,900,8,908,1186,0,0,76.56,461,439,五王里,NULL
576,892,16,908,1221,0,0,74.37,433,459,後庄村,NULL
143,901,7,908,1289,0,0,70.44,410,491,南建里,NULL
0,901,7,908,1289,0,0,70.44,410,491,南建里,NULL
292,895,13,908,1148,0,0,79.09,392,503,千秋里,NULL
260,902,6,908,1252,0,0,72.52,381,521,華勝里,NULL
779,898,10,908,1180,0,0,76.95,350,548,鎮昌里,NULL
348,898,10,908,1146,0,0,79.23,340,558,富竹村,NULL
0,898,10,908,1146,0,0,79.23,340,558,富竹村,NULL
225,904,4,908,1171,0,0,77.54,292,612,水寮村,NULL
1181,903,4,907,1119,0,0,81.05,686,217,百忍里,NULL
867,899,8,907,1190,0,0,76.22,648,251,黃唐村,NULL
153,900,7,907,1352,0,0,67.09,594,306,更新里,NULL
0,900,7,907,1352,0,0,67.09,594,306,更新里,NULL
660,896,11,907,1177,0,0,77.06,587,309,三多里,NULL
91,900,7,907,1163,0,0,77.99,573,327,振興里,NULL
1097,900,7,907,1201,0,0,75.52,565,335,民輝里,NULL
399,895,12,907,1302,0,0,69.66,563,332,後厝里,NULL
1096,902,5,907,1177,0,0,77.06,522,380,建福里,NULL
65,897,10,907,1150,0,0,78.87,511,386,新庄里,NULL
160,898,9,907,1246,0,0,72.79,510,388,南興里,NULL
55,896,11,907,1142,0,0,79.42,476,420,建國里,NULL
764,902,5,907,1145,0,0,79.21,440,462,仁義村,NULL
147,902,4,906,1249,0,0,72.54,801,101,光華村,NULL
0,902,4,906,1249,0,0,72.54,801,101,光華村,NULL
483,894,12,906,1158,0,0,78.24,713,181,光明里,NULL
126,890,16,906,1235,0,0,73.36,687,203,宜昌村,NULL
38,900,6,906,1207,0,0,75.06,686,214,主安里,NULL
583,892,14,906,1121,0,0,80.82,623,269,和平里,NULL
1611,896,10,906,1165,0,0,77.77,613,283,興福里,NULL
10,896,10,906,1288,0,0,70.34,571,325,定興村,NULL
619,891,15,906,1109,0,0,81.7,566,325,中正里,NULL
46,902,4,906,1215,0,0,74.57,554,348,面前里,NULL
149,897,9,906,1128,0,0,80.32,546,351,巨埔里,NULL
0,897,9,906,1128,0,0,80.32,546,351,巨埔里,NULL
1725,897,9,906,1138,0,0,79.61,538,359,山佳里,NULL
349,898,8,906,1197,0,0,75.69,523,375,南勢村,NULL
0,898,8,906,1197,0,0,75.69,523,375,南勢村,NULL
865,899,7,906,1167,0,0,77.63,510,389,過埤里,NULL
314,900,6,906,1161,0,0,78.04,503,397,竹西村,NULL
625,893,13,906,1173,0,0,77.24,445,448,網寮里,NULL
892,901,5,906,1155,0,0,78.44,396,505,善美里,NULL
506,899,7,906,1118,0,0,81.04,391,508,八卦村,NULL
398,903,3,906,1149,0,0,78.85,339,564,嘉興里,NULL
284,895,11,906,1143,0,0,79.27,278,617,中興里,NULL
134,899,6,905,1138,0,0,79.53,662,237,新民里,NULL
0,899,6,905,1138,0,0,79.53,662,237,新民里,NULL
25,895,10,905,1244,0,0,72.75,588,307,碧峰里,NULL
1102,900,5,905,1191,0,0,75.99,555,345,誠安里,NULL
59,900,5,905,1199,0,0,75.48,544,356,內豊村,NULL
0,900,5,905,1199,0,0,75.48,544,356,內豊村,NULL
441,888,17,905,1134,0,0,79.81,531,357,長元里,NULL
1856,896,9,905,1211,0,0,74.73,525,371,坪頂里,NULL
391,897,8,905,1241,0,0,72.93,525,372,北平里,NULL
0,896,9,905,1211,0,0,74.73,525,371,坪頂里,NULL
1797,889,16,905,1144,0,0,79.11,524,365,鳶山里,NULL
75,901,4,905,1160,0,0,78.02,522,379,客庄里,NULL
300,893,12,905,1175,0,0,77.02,491,402,大安里,NULL
613,901,4,905,1186,0,0,76.31,487,414,平和村,NULL
373,902,3,905,1098,0,0,82.42,486,416,圍下里,NULL
312,894,11,905,1166,0,0,77.62,409,485,前竹村,NULL
257,892,13,905,1236,0,0,73.22,377,515,嘉定村,NULL
0,892,13,905,1236,0,0,73.22,377,515,嘉定村,NULL
871,895,10,905,1170,0,0,77.35,338,557,正義里,NULL
0,902,3,905,1310,0,0,69.08,231,671,光華里,NULL
195,891,13,904,1092,0,0,82.78,827,64,武陵里,NULL
1145,892,12,904,1093,0,0,82.71,618,274,文明里,NULL
35,897,7,904,1179,0,0,76.68,557,340,新豐里,NULL
851,900,4,904,1180,0,0,76.61,543,357,上田里,NULL
0,892,12,904,1494,0,0,60.51,542,350,南灣里,NULL
647,896,8,904,1137,0,0,79.51,537,359,忠孝里,NULL
780,896,8,904,1188,0,0,76.09,508,388,東勢里,NULL
703,900,4,904,1077,0,0,83.94,493,407,六苓里,NULL
166,897,7,904,1137,0,0,79.51,493,404,文雅里,NULL
591,891,13,904,1176,0,0,76.87,490,401,鎌村里,NULL
784,897,7,904,1094,0,0,82.63,470,427,興邦里,NULL
523,896,8,904,1117,0,0,80.93,407,489,新和村,NULL
194,889,15,904,1192,0,0,75.84,371,518,軍功里,NULL
528,899,5,904,1209,0,0,74.77,257,642,社內村,NULL
420,893,10,903,1159,0,0,77.91,629,264,公正里,NULL
143,891,12,903,1117,0,0,80.84,586,305,大厝里,NULL
202,896,7,903,1120,0,0,80.63,584,312,龍山里,NULL
168,900,3,903,1121,0,0,80.55,565,335,溝墘里,NULL
71,895,8,903,1157,0,0,78.05,549,346,埔頂里,NULL
107,896,7,903,1141,0,0,79.14,523,373,新光里,NULL
206,894,9,903,1101,0,0,82.02,502,392,廣新里,NULL
615,899,4,903,1246,0,0,72.47,501,398,五王里,NULL
1996,894,9,903,1193,0,0,75.69,491,403,水碓村,NULL
614,891,12,903,1246,0,0,72.47,472,419,五王里,NULL
281,895,8,903,1132,0,0,79.77,471,424,信義里,NULL
0,896,7,903,1411,0,0,64,418,478,奮起里,NULL
701,894,9,903,1223,0,0,73.83,312,582,西灣里,NULL
86,889,13,902,1178,0,0,76.57,700,189,大鄉里,NULL
694,893,9,902,1200,0,0,75.17,648,245,平南里,NULL
25,894,8,902,1184,0,0,76.18,640,254,公園里,NULL
190,893,9,902,1105,0,0,81.63,612,281,舊社里,NULL
260,892,10,902,1262,0,0,71.47,607,285,埔頂里,NULL
356,898,4,902,1138,0,0,79.26,600,298,淡溝里,NULL
431,894,8,902,1321,0,0,68.28,573,321,南港村,NULL
24,895,7,902,1128,0,0,79.96,563,332,上德里,NULL
82,894,8,902,1142,0,0,78.98,557,337,福安里,NULL
16,895,7,902,1146,0,0,78.71,541,354,社後里,NULL
794,892,10,902,1137,0,0,79.33,538,354,雅楓村,NULL
817,898,4,902,1122,0,0,80.39,524,374,國光里,NULL
957,897,5,902,1169,0,0,77.16,512,385,觀音村,NULL
168,896,6,902,1139,0,0,79.19,502,394,振義里,NULL
561,895,7,902,1165,0,0,77.42,479,416,日中里,NULL
983,890,12,902,1166,0,0,77.36,472,418,仁愛里,NULL
253,895,7,902,1124,0,0,80.25,462,433,大庄里,NULL
891,898,4,902,1138,0,0,79.26,433,465,善美里,NULL
263,892,10,902,1203,0,0,74.98,403,489,永福里,NULL
0,892,10,902,1203,0,0,74.98,403,489,永福里,NULL
31,898,4,902,1339,0,0,67.36,385,513,舊寮村,NULL
0,898,4,902,1339,0,0,67.36,385,513,舊寮村,NULL
838,892,10,902,1157,0,0,77.96,380,512,七甲村,NULL
275,895,7,902,1242,0,0,72.62,374,521,梅東村,NULL
707,896,6,902,1184,0,0,76.18,300,596,南灣里,NULL
9,894,7,901,1135,0,0,79.38,731,163,玉清里,NULL
35,893,8,901,1188,0,0,75.84,670,223,主農里,NULL
22,891,10,901,1166,0,0,77.27,600,291,武陵里,NULL
0,891,10,901,1166,0,0,77.27,600,291,武陵里,NULL
311,892,9,901,1245,0,0,72.37,567,325,田寮里,NULL
0,892,9,901,1245,0,0,72.37,567,325,田寮里,NULL
46,890,11,901,1199,0,0,75.15,555,335,日南里,NULL
858,894,7,901,1128,0,0,79.88,548,346,雙榮里,NULL
1101,892,9,901,1249,0,0,72.14,514,378,四維里,NULL
546,895,6,901,1131,0,0,79.66,503,392,大華村,NULL
789,891,10,901,1155,0,0,78.01,490,401,東門里,NULL
358,895,6,901,1188,0,0,75.84,438,457,興南村,NULL
211,894,7,901,1234,0,0,73.01,420,474,忠孝村,NULL
515,895,6,901,1191,0,0,75.65,390,505,海寮村,NULL
205,891,10,901,1165,0,0,77.34,385,506,觀音村,NULL
513,891,10,901,1161,0,0,77.61,365,526,新吉村,NULL
467,888,13,901,1137,0,0,79.24,313,575,仕和村,NULL
492,888,13,901,1182,0,0,76.23,261,627,竹林村,NULL
0,888,13,901,1182,0,0,76.23,261,627,竹林村,NULL
196,891,9,900,1060,0,0,84.91,866,25,武陵里,NULL
1234,892,8,900,1163,0,0,77.39,671,221,美城里,NULL
873,896,4,900,1116,0,0,80.65,667,229,潭安里,NULL
34,893,7,900,1104,0,0,81.52,654,239,竹仁里,NULL
184,897,3,900,1354,0,0,66.47,654,243,大華村,NULL
0,897,3,900,1354,0,0,66.47,654,243,大華村,NULL
39,896,4,900,1173,0,0,76.73,637,259,主安里,NULL
1118,892,8,900,1148,0,0,78.4,588,304,古莊里,NULL
1319,891,9,900,1182,0,0,76.14,563,328,永寧里,NULL
1771,895,5,900,1234,0,0,72.93,529,366,鳳祥里,NULL
643,895,5,900,1209,0,0,74.44,488,407,協成村,NULL
754,894,6,900,1182,0,0,76.14,481,413,新生村,NULL
0,894,6,900,1182,0,0,76.14,481,413,新生村,NULL
133,889,11,900,1299,0,0,69.28,471,418,合成里,NULL
391,890,10,900,1237,0,0,72.76,443,447,九芎村,NULL
682,889,11,900,1207,0,0,74.57,438,451,興隆里,NULL
0,889,11,900,1207,0,0,74.57,438,451,興隆里,NULL
527,898,2,900,1124,0,0,80.07,423,475,南港里,NULL
733,896,4,900,1142,0,0,78.81,418,478,文衡里,NULL
293,894,6,900,1142,0,0,78.81,413,481,千秋里,NULL
711,893,7,900,1125,0,0,80,413,480,崑山里,NULL
145,889,11,900,1210,0,0,74.38,392,497,延平里,NULL
0,889,11,900,1210,0,0,74.38,392,497,延平里,NULL
0,890,10,900,1207,0,0,74.57,389,501,赤水村,NULL
872,889,11,900,1133,0,0,79.44,388,501,正義里,NULL
521,892,8,900,1245,0,0,72.29,378,514,玉光村,NULL
277,895,5,900,1135,0,0,79.3,369,526,海山村,NULL
0,895,5,900,1135,0,0,79.3,369,526,海山村,NULL
537,893,7,900,1279,0,0,70.37,365,528,隆山村,NULL
876,890,10,900,1183,0,0,76.08,344,546,崎頂村,NULL
0,890,10,900,1183,0,0,76.08,344,546,崎頂村,NULL
291,888,12,900,1339,0,0,67.21,332,556,港尾村,NULL
0,888,12,900,1339,0,0,67.21,332,556,港尾村,NULL
843,888,11,899,1129,0,0,79.63,642,246,民權里,NULL
193,889,10,899,1136,0,0,79.14,585,304,金竹里,NULL
345,896,3,899,1181,0,0,76.12,574,322,賴明里,NULL
78,892,7,899,1119,0,0,80.34,545,347,博愛里,NULL
731,891,8,899,1204,0,0,74.67,539,352,復華里,NULL
409,892,7,899,1185,0,0,75.86,535,357,明德里,NULL
1902,891,8,899,1164,0,0,77.23,531,360,中興里,NULL
582,898,1,899,1157,0,0,77.7,506,392,前庄村,NULL
1776,891,8,899,1130,0,0,79.56,500,391,鳳福里,NULL
264,896,3,899,1247,0,0,72.09,431,465,崎漏村,NULL
259,890,9,899,1187,0,0,75.74,401,489,華勝里,NULL
274,888,11,899,1178,0,0,76.32,393,495,明亮里,NULL
0,890,9,899,1358,0,0,66.2,364,526,鰲鼓村,NULL
285,888,11,899,1148,0,0,78.31,269,619,大洲里,NULL
0,888,11,899,1148,0,0,78.31,269,619,大洲里,NULL
117,890,8,898,1131,0,0,79.4,710,180,三重里,NULL
410,882,16,898,1206,0,0,74.46,645,237,華崙里,NULL
225,888,10,898,1084,0,0,82.84,641,247,裕豐里,NULL
1808,890,8,898,1107,0,0,81.12,635,255,龍埔里,NULL
3,889,9,898,1219,0,0,73.67,629,260,麥豐村,NULL
256,890,8,898,1430,0,0,62.8,623,267,富里村,NULL
0,890,8,898,1430,0,0,62.8,623,267,富里村,NULL
413,890,8,898,1285,0,0,69.88,599,291,萬合里,NULL
0,890,8,898,1285,0,0,69.88,599,291,萬合里,NULL
208,888,10,898,1137,0,0,78.98,596,292,正光里,NULL
155,878,20,898,1217,0,0,73.79,581,297,福寶村,NULL
0,878,20,898,1217,0,0,73.79,581,297,福寶村,NULL
17,886,12,898,1233,0,0,72.83,564,322,中山里,NULL
259,889,9,898,1199,0,0,74.9,545,344,埔頂里,NULL
43,887,11,898,1134,0,0,79.19,543,344,水源里,NULL
62,892,6,898,1164,0,0,77.15,504,388,安寮里,NULL
412,890,8,898,1116,0,0,80.47,494,396,中山里,NULL
128,892,6,898,1217,0,0,73.79,477,415,田寮里,NULL
289,885,13,898,1155,0,0,77.75,458,427,大安里,NULL
719,891,7,898,1237,0,0,72.59,455,436,北灣里,NULL
0,891,7,898,1266,0,0,70.93,448,443,石硦村,NULL
536,890,8,898,1290,0,0,69.61,442,448,隆山村,NULL
168,892,6,898,1129,0,0,79.54,435,457,東燕村,NULL
57,886,12,898,1177,0,0,76.3,412,474,芳安里,NULL
810,887,11,898,1161,0,0,77.35,405,482,歸南村,NULL
525,895,3,898,1152,0,0,77.95,400,495,新和村,NULL
512,889,9,898,1113,0,0,80.68,390,499,順昌里,NULL
508,896,2,898,1246,0,0,72.07,381,515,港南村,NULL
742,889,9,898,1188,0,0,75.59,353,536,龍鳳里,NULL
32,896,1,897,1107,0,0,81.03,708,188,北苗里,NULL
68,888,9,897,1232,0,0,72.81,706,182,國裕里,NULL
1827,878,19,897,1239,0,0,72.4,676,202,嘉添里,NULL
271,887,10,897,1128,0,0,79.52,668,219,文林村,NULL
194,891,6,897,1164,0,0,77.06,660,231,碇內里,NULL
48,887,10,897,1185,0,0,75.7,654,233,新社里,NULL
1176,889,8,897,1145,0,0,78.34,649,240,仁愛里,NULL
2166,883,14,897,1109,0,0,80.88,615,268,下罟村,NULL
0,883,14,897,1109,0,0,80.88,615,268,下罟村,NULL
727,893,4,897,1234,0,0,72.69,581,312,復國里,NULL
249,891,6,897,1145,0,0,78.34,572,319,平心里,NULL
110,887,10,897,1221,0,0,73.46,569,318,通南里,NULL
1900,886,11,897,1201,0,0,74.69,560,326,中興里,NULL
184,888,9,897,1159,0,0,77.39,532,356,下崙村,NULL
238,894,3,897,1131,0,0,79.31,507,387,忠孝里,NULL
0,894,3,897,1131,0,0,79.31,507,387,忠孝里,NULL
33,887,10,897,1246,0,0,71.99,505,382,御史里,NULL
390,889,8,897,1221,0,0,73.46,498,391,和龍里,NULL
1007,889,8,897,1124,0,0,79.8,487,402,立德里,NULL
51,887,10,897,1263,0,0,71.02,477,410,銅安里,NULL
0,887,10,897,1263,0,0,71.02,477,410,銅安里,NULL
139,889,8,897,1216,0,0,73.77,467,422,南成里,NULL
0,889,8,897,1216,0,0,73.77,467,422,南成里,NULL
216,889,8,897,1162,0,0,77.19,451,438,海濱里,NULL
833,888,9,897,1122,0,0,79.95,438,450,新泰里,NULL
140,890,7,897,1238,0,0,72.46,426,464,海風里,NULL
0,890,7,897,1238,0,0,72.46,426,464,海風里,NULL
366,891,6,897,1126,0,0,79.66,394,497,竹圍里,NULL
0,891,6,897,1254,0,0,71.53,358,533,嘉苳村,NULL
535,888,9,897,1180,0,0,76.02,304,584,大社村,NULL
9,886,10,896,1183,0,0,75.74,760,126,民享里,NULL
48,889,7,896,1110,0,0,80.72,697,192,豐功里,NULL
36,889,7,896,1092,0,0,82.05,658,231,綠水里,NULL
738,887,9,896,1184,0,0,75.68,627,260,義興里,NULL
56,889,7,896,1225,0,0,73.14,626,263,國魂里,NULL
85,892,4,896,1165,0,0,76.91,611,281,福雅里,NULL
610,890,6,896,1165,0,0,76.91,571,319,美港村,NULL
388,886,10,896,1124,0,0,79.72,568,318,中新里,NULL
365,889,7,896,1220,0,0,73.44,543,346,明新里,NULL
239,888,8,896,1104,0,0,81.16,539,349,蘭興里,NULL
2008,890,6,896,1140,0,0,78.6,498,392,黎明村,NULL
418,883,13,896,1241,0,0,72.2,395,488,文昌里,NULL
58,889,7,896,1227,0,0,73.02,379,510,淵中里,NULL
462,890,6,896,1132,0,0,79.15,355,535,橋南村,NULL
0,890,6,896,1132,0,0,79.15,355,535,橋南村,NULL
0,886,10,896,1237,0,0,72.43,317,569,南安村,NULL
105,893,3,896,1075,0,0,83.35,287,606,頂西里,NULL
0,893,3,896,1075,0,0,83.35,287,606,頂西里,NULL
296,893,3,896,1204,0,0,74.42,271,622,二鎮村,NULL
294,884,11,895,1146,0,0,78.1,675,209,北埔村,NULL
0,884,11,895,1146,0,0,78.1,675,209,北埔村,NULL
802,888,7,895,1143,0,0,78.3,652,236,六寶村,NULL
258,885,10,895,1176,0,0,76.11,612,273,校椅里,NULL
0,885,10,895,1176,0,0,76.11,612,273,校椅里,NULL
863,894,1,895,1155,0,0,77.49,591,303,水美里,NULL
652,882,13,895,1119,0,0,79.98,579,303,大仁里,NULL
116,888,7,895,1197,0,0,74.77,555,333,平和里,NULL
749,882,13,895,1244,0,0,71.95,548,334,新庄村,NULL
1351,891,4,895,1169,0,0,76.56,495,396,裕生里,NULL
11,883,12,895,1183,0,0,75.66,490,393,新興里,NULL
242,888,7,895,1158,0,0,77.29,478,410,虎山里,NULL
699,889,6,895,1122,0,0,79.77,464,425,福林里,NULL
291,887,8,895,1260,0,0,71.03,388,499,田仔村,NULL
555,887,8,895,1211,0,0,73.91,388,499,仁美村,NULL
0,887,8,895,1260,0,0,71.03,388,499,田仔村,NULL
358,887,8,895,1146,0,0,78.1,340,547,田中村,NULL
0,887,8,895,1146,0,0,78.1,340,547,田中村,NULL
573,889,5,894,1242,0,0,71.98,725,164,至善里,NULL
794,881,13,894,1134,0,0,78.84,640,241,仁愛村,NULL
698,884,10,894,1129,0,0,79.19,634,250,山峰里,NULL
166,889,5,894,1117,0,0,80.04,626,263,北斗里,NULL
30,888,6,894,1177,0,0,75.96,626,262,德興村,NULL
0,888,6,894,1177,0,0,75.96,626,262,德興村,NULL
39,891,3,894,1122,0,0,79.68,620,271,何南里,NULL
667,891,3,894,1125,0,0,79.47,612,279,仁愛里,NULL
192,887,7,894,1148,0,0,77.87,596,291,金竹里,NULL
1111,892,2,894,1168,0,0,76.54,577,315,龍泉里,NULL
274,885,9,894,1170,0,0,76.41,558,327,茄南里,NULL
41,886,8,894,1134,0,0,78.84,522,364,前溪里,NULL
315,877,17,894,1131,0,0,79.05,495,382,光明村,NULL
385,886,8,894,1376,0,0,64.97,480,406,漢寶村,NULL
249,887,7,894,1146,0,0,78.01,436,451,新興里,NULL
466,885,9,894,1090,0,0,82.02,417,468,仕豐村,NULL
383,883,11,894,1185,0,0,75.44,400,483,山腳村,NULL
637,889,5,894,1197,0,0,74.69,391,498,埔園里,NULL
188,887,7,894,1190,0,0,75.13,349,538,東昇村,NULL
15,885,8,893,1707,0,0,52.31,859,26,古寧村,NULL
0,885,8,893,1707,0,0,52.31,859,26,古寧村,NULL
221,889,4,893,1090,0,0,81.93,733,156,建國里,NULL
10,884,9,893,1260,0,0,70.87,732,152,民享里,NULL
105,885,8,893,1075,0,0,83.07,713,172,榮華里,NULL
699,882,11,893,1140,0,0,78.33,670,212,黎安里,NULL
31,883,10,893,1148,0,0,77.79,633,250,龍山里,NULL
28,886,7,893,1300,0,0,68.69,556,330,案山里,NULL
0,886,7,893,1300,0,0,68.69,556,330,案山里,NULL
5,885,8,893,1140,0,0,78.33,555,330,民族里,NULL
63,886,7,893,1162,0,0,76.85,550,336,新民里,NULL
1699,875,18,893,1170,0,0,76.32,544,331,彭福里,NULL
943,888,5,893,1144,0,0,78.06,522,366,忠孝里,NULL
950,888,5,893,1181,0,0,75.61,476,412,幸福里,NULL
656,885,8,893,1163,0,0,76.78,471,414,安康里,NULL
781,892,1,893,1171,0,0,76.26,439,453,上崙村,NULL
340,885,8,893,1160,0,0,76.98,428,457,博愛里,NULL
0,885,8,893,1160,0,0,76.98,428,457,博愛里,NULL
75,883,10,893,1321,0,0,67.6,404,479,青草里,NULL
0,883,10,893,1321,0,0,67.6,404,479,青草里,NULL
128,881,12,893,1290,0,0,69.22,390,491,新埔里,NULL
0,881,12,893,1290,0,0,69.22,390,491,新埔里,NULL
827,886,7,893,1195,0,0,74.73,359,527,崙頂村,NULL
487,888,5,893,1097,0,0,81.4,332,556,德松村,NULL
0,888,5,893,1097,0,0,81.4,332,556,德松村,NULL
782,883,10,893,1149,0,0,77.72,301,582,上崙村,NULL
71,879,13,892,1209,0,0,73.78,708,171,國興里,NULL
20,884,8,892,1168,0,0,76.37,668,216,建國里,NULL
165,889,3,892,1140,0,0,78.25,665,224,北斗里,NULL
53,880,12,892,1419,0,0,62.86,646,234,南榮里,NULL
1335,884,8,892,1163,0,0,76.7,587,297,員信里,NULL
36,886,6,892,1170,0,0,76.24,586,300,和東里,NULL
2142,888,4,892,1180,0,0,75.59,563,325,富基村,NULL
0,888,4,892,1180,0,0,75.59,563,325,富基村,NULL
1078,890,2,892,1134,0,0,78.66,561,329,仁慈里,NULL
57,888,4,892,1253,0,0,71.19,549,339,中庄村,NULL
1670,885,7,892,1170,0,0,76.24,517,368,圳福里,NULL
7,885,7,892,1151,0,0,77.5,501,384,平安里,NULL
805,884,8,892,1146,0,0,77.84,492,392,秀山村,NULL
176,881,11,892,1157,0,0,77.1,489,392,義興村,NULL
0,881,11,892,1157,0,0,77.1,489,392,義興村,NULL
168,887,5,892,1171,0,0,76.17,470,417,仙草里,NULL
752,882,10,892,1242,0,0,71.82,454,428,南曾村,NULL
0,882,10,892,1242,0,0,71.82,454,428,南曾村,NULL
147,884,8,892,1278,0,0,69.8,451,433,復興里,NULL
649,882,10,892,1171,0,0,76.17,450,432,文賢村,NULL
25,880,12,892,1262,0,0,70.68,419,461,頂安村,NULL
0,880,12,892,1262,0,0,70.68,419,461,頂安村,NULL
354,885,7,892,1222,0,0,73,392,493,同安村,NULL
0,885,7,892,1222,0,0,73,392,493,同安村,NULL
551,887,5,892,1110,0,0,80.36,378,509,鼓中里,NULL
0,887,5,892,1110,0,0,80.36,378,509,鼓中里,NULL
469,887,5,892,1065,0,0,83.76,376,511,仕和村,NULL
50,884,8,892,1253,0,0,71.19,372,512,玉豐里,NULL
0,884,8,892,1253,0,0,71.19,372,512,玉豐里,NULL
297,885,7,892,1075,0,0,82.98,338,547,鳳南里,NULL
0,885,7,892,1075,0,0,82.98,338,547,鳳南里,NULL
103,882,10,892,1217,0,0,73.29,320,562,新埤里,NULL
0,882,10,892,1217,0,0,73.29,320,562,新埤里,NULL
793,881,10,891,1109,0,0,80.34,714,167,龍興里,NULL
354,889,2,891,1183,0,0,75.32,702,187,東村,NULL
0,889,2,891,1183,0,0,75.32,702,187,東村,NULL
21,885,6,891,1237,0,0,72.03,673,212,東海里,NULL
0,881,10,891,1315,0,0,67.76,659,222,望美村,NULL
26,882,9,891,1122,0,0,79.41,621,261,圳頭里,NULL
117,886,5,891,1284,0,0,69.39,579,307,福興村,NULL
160,885,6,891,1144,0,0,77.88,577,308,磐石里,NULL
149,883,8,891,1156,0,0,77.08,559,324,文化里,NULL
0,883,8,891,1156,0,0,77.08,559,324,文化里,NULL
482,884,7,891,1135,0,0,78.5,545,339,大興里,NULL
263,881,10,891,1125,0,0,79.2,543,338,五權里,NULL
888,883,8,891,1196,0,0,74.5,542,341,聖德村,NULL
122,871,20,891,1177,0,0,75.7,535,336,坪頂里,NULL
0,871,20,891,1177,0,0,75.7,535,336,坪頂里,NULL
571,881,10,891,1122,0,0,79.41,534,347,林圍里,NULL
485,881,10,891,1155,0,0,77.14,518,363,瑞源里,NULL
698,880,11,891,1131,0,0,78.78,490,390,曹公里,NULL
134,884,7,891,1182,0,0,75.38,464,420,成功里,NULL
1464,884,7,891,1218,0,0,73.15,462,422,長安里,NULL
1466,882,9,891,1110,0,0,80.27,462,420,忠義里,NULL
32,884,7,891,1208,0,0,73.76,438,446,建業里,NULL
0,884,7,891,1208,0,0,73.76,438,446,建業里,NULL
178,880,11,891,1226,0,0,72.68,434,446,西井村,NULL
0,880,11,891,1226,0,0,72.68,434,446,西井村,NULL
192,885,6,891,1084,0,0,82.2,422,463,建國里,NULL
260,878,13,891,1158,0,0,76.94,418,460,港都里,NULL
0,878,13,891,1158,0,0,76.94,418,460,港都里,NULL
55,880,11,891,1320,0,0,67.5,386,494,網寮村,NULL
0,880,11,891,1320,0,0,67.5,386,494,網寮村,NULL
10,886,5,891,1153,0,0,77.28,365,521,東寧里,NULL
76,881,10,891,1215,0,0,73.33,363,518,湖內里,NULL
0,881,10,891,1215,0,0,73.33,363,518,湖內里,NULL
381,884,7,891,1198,0,0,74.37,322,562,晋江里,NULL
755,884,7,891,1092,0,0,81.59,289,595,土庫村,NULL
99,880,10,890,1085,0,0,82.03,836,44,復興里,NULL
0,880,10,890,1085,0,0,82.03,836,44,復興里,NULL
139,882,8,890,1204,0,0,73.92,683,199,仁里村,NULL
822,881,9,890,1129,0,0,78.83,649,232,中山里,NULL
1612,881,9,890,1182,0,0,75.3,571,310,興福里,NULL
842,881,9,890,1151,0,0,77.32,562,319,富岡里,NULL
595,884,6,890,1168,0,0,76.2,558,326,大村村,NULL
161,879,11,890,1223,0,0,72.77,557,322,大庄里,NULL
66,883,7,890,1098,0,0,81.06,549,334,新庄里,NULL
96,879,11,890,1171,0,0,76,530,349,福中里,NULL
742,883,7,890,1082,0,0,82.26,526,357,中華里,NULL
354,882,8,890,1126,0,0,79.04,494,388,後甲里,NULL
1976,884,6,890,1188,0,0,74.92,449,435,成德村,NULL
255,880,10,890,1179,0,0,75.49,430,450,新昌里,NULL
741,883,7,890,1192,0,0,74.66,417,466,庄後村,NULL
132,881,9,890,1164,0,0,76.46,409,472,外埔村,NULL
0,881,9,890,1164,0,0,76.46,409,472,外埔村,NULL
218,883,7,890,1210,0,0,73.55,406,477,港北里,NULL
0,883,7,890,1210,0,0,73.55,406,477,港北里,NULL
343,886,4,890,1195,0,0,74.48,372,514,鎮山里,NULL
268,885,5,890,1189,0,0,74.85,369,516,旗下里,NULL
0,885,5,890,1189,0,0,74.85,369,516,旗下里,NULL
494,881,9,890,1160,0,0,76.72,357,524,阿丹里,NULL
0,881,9,890,1160,0,0,76.72,357,524,阿丹里,NULL
14,882,8,890,1152,0,0,77.26,314,568,蚵寮村,NULL
0,882,8,890,1152,0,0,77.26,314,568,蚵寮村,NULL
751,885,5,890,1189,0,0,74.85,311,574,太子村,NULL
343,882,7,889,1186,0,0,74.96,700,182,九湖村,NULL
0,882,7,889,1186,0,0,74.96,700,182,九湖村,NULL
1208,877,12,889,1159,0,0,76.7,669,208,黎和里,NULL
201,884,5,889,1097,0,0,81.04,663,221,中勢村,NULL
795,880,9,889,1103,0,0,80.6,662,218,秀水里,NULL
774,880,9,889,1109,0,0,80.16,660,220,東安里,NULL
30,880,9,889,1301,0,0,68.33,644,236,中心里,NULL
24,886,3,889,1268,0,0,70.11,632,254,臺西村,NULL
0,886,3,889,1268,0,0,70.11,632,254,臺西村,NULL
579,874,15,889,1129,0,0,78.74,579,295,中原里,NULL
329,876,13,889,1160,0,0,76.64,570,306,大勇里,NULL
280,883,6,889,1119,0,0,79.45,551,332,信義里,NULL
1336,875,14,889,1092,0,0,81.41,550,325,員林里,NULL
723,878,11,889,1171,0,0,75.92,549,329,廣仁里,NULL
232,880,9,889,1130,0,0,78.67,530,350,公西村,NULL
0,880,9,889,1130,0,0,78.67,530,350,公西村,NULL
546,878,11,889,1125,0,0,79.02,480,398,大湳里,NULL
351,877,12,889,1192,0,0,74.58,478,399,萬豐村,NULL
220,885,4,889,1076,0,0,82.62,466,419,久堂村,NULL
838,884,5,889,1125,0,0,79.02,463,421,東寶村,NULL
203,885,4,889,1218,0,0,72.99,436,449,下寮村,NULL
702,884,5,889,1156,0,0,76.9,434,450,鎮西里,NULL
223,883,6,889,1143,0,0,77.78,395,488,水安村,NULL
41,881,8,889,1464,0,0,60.72,392,489,山水里,NULL
0,881,8,889,1464,0,0,60.72,392,489,山水里,NULL
135,881,8,889,1166,0,0,76.24,376,505,外中村,NULL
0,881,8,889,1166,0,0,76.24,376,505,外中村,NULL
637,880,9,889,1162,0,0,76.51,368,512,崑山村,NULL
0,880,9,889,1162,0,0,76.51,368,512,崑山村,NULL
852,879,10,889,1157,0,0,76.84,351,528,北勢村,NULL
0,878,11,889,1237,0,0,71.87,280,598,果毅村,NULL
410,886,3,889,1152,0,0,77.17,208,678,磚井里,NULL
0,886,3,889,1152,0,0,77.17,208,678,磚井里,NULL
653,876,12,888,1159,0,0,76.62,613,263,東安里,NULL
0,876,12,888,1159,0,0,76.62,613,263,東安里,NULL
187,884,4,888,1177,0,0,75.45,587,297,暖暖里,NULL
167,878,10,888,1106,0,0,80.29,569,309,文雅里,NULL
299,881,7,888,1147,0,0,77.42,552,329,榮泉村,NULL
1301,879,9,888,1218,0,0,72.91,543,336,屈尺里,NULL
363,875,13,888,1142,0,0,77.76,517,358,東湖里,NULL
353,881,7,888,1153,0,0,77.02,513,368,大崎村,NULL
566,878,10,888,1077,0,0,82.45,492,386,和煦里,NULL
218,881,7,888,1151,0,0,77.15,490,391,九曲村,NULL
129,885,3,888,1241,0,0,71.56,486,399,番婆村,NULL
1822,877,11,888,1171,0,0,75.83,474,403,中正里,NULL
685,880,8,888,1122,0,0,79.14,401,479,港興里,NULL
110,878,10,888,1228,0,0,72.31,388,490,龍德里,NULL
458,878,10,888,1131,0,0,78.51,349,529,典寶村,NULL
761,878,10,888,1101,0,0,80.65,342,536,明義里,NULL
204,879,8,887,1073,0,0,82.67,681,198,中正村,NULL
65,878,9,887,1088,0,0,81.53,641,237,龍山里,NULL
857,879,8,887,1101,0,0,80.56,622,257,民生里,NULL
1643,882,5,887,1128,0,0,78.63,561,321,三福里,NULL
679,877,10,887,1165,0,0,76.14,521,356,粵寧里,NULL
259,878,9,887,1215,0,0,73,520,358,王田村,NULL
90,870,17,887,1180,0,0,75.17,504,366,振興里,NULL
64,875,12,887,1074,0,0,82.59,479,396,新民里,NULL
362,882,5,887,1155,0,0,76.8,479,403,南崁村,NULL
81,876,11,887,1097,0,0,80.86,478,398,新埔里,NULL
140,878,9,887,1191,0,0,74.48,478,400,民權里,NULL
92,877,10,887,1151,0,0,77.06,475,402,力行里,NULL
969,876,11,887,1166,0,0,76.07,473,403,幸福里,NULL
523,870,17,887,1100,0,0,80.64,464,406,五常里,NULL
1516,877,10,887,1130,0,0,78.5,461,416,保和里,NULL
798,882,5,887,1167,0,0,76.01,373,509,大甲村,NULL
469,881,6,887,1149,0,0,77.2,359,522,新勝里,NULL
231,882,5,887,1207,0,0,73.49,356,526,大樹村,NULL
810,881,5,886,1085,0,0,81.66,854,27,海風里,NULL
52,879,7,886,1253,0,0,70.71,646,233,福麗里,NULL
322,883,3,886,1147,0,0,77.24,609,274,大正里,NULL
101,876,10,886,1175,0,0,75.4,599,277,北門里,NULL
292,880,6,886,1154,0,0,76.78,590,290,大興里,NULL
28,878,8,886,1144,0,0,77.45,539,339,逢甲里,NULL
68,877,9,886,1135,0,0,78.06,537,340,犁盛里,NULL
1324,867,19,886,1130,0,0,78.41,515,352,員仁里,NULL
796,876,10,886,1162,0,0,76.25,501,375,興亞里,NULL
247,870,16,886,1101,0,0,80.47,501,369,廣德里,NULL
1666,876,10,886,1107,0,0,80.04,493,383,保安里,NULL
71,881,5,886,1160,0,0,76.38,482,399,興仁里,NULL
758,881,5,886,1163,0,0,76.18,423,458,一甲村,NULL
869,880,6,886,1157,0,0,76.58,407,473,正義里,NULL
206,872,14,886,1181,0,0,75.02,404,468,保安里,NULL
0,872,14,886,1181,0,0,75.02,404,468,保安里,NULL
554,883,3,886,1103,0,0,80.33,403,480,仁美村,NULL
49,874,12,886,1209,0,0,73.28,403,471,海西里,NULL
136,877,8,885,1207,0,0,73.32,675,202,仁里村,NULL
229,880,5,885,1133,0,0,78.11,618,262,牛埔里,NULL
1714,877,8,885,1136,0,0,77.9,523,354,太順里,NULL
786,877,8,885,1132,0,0,78.18,522,355,新庄里,NULL
476,875,10,885,1128,0,0,78.46,497,378,草江里,NULL
0,875,10,885,1128,0,0,78.46,497,378,草江里,NULL
805,880,5,885,1116,0,0,79.3,453,427,朱園里,NULL
1513,868,17,885,1115,0,0,79.37,451,417,得仁里,NULL
63,878,7,885,1171,0,0,75.58,444,434,西門里,NULL
0,878,7,885,1171,0,0,75.58,444,434,西門里,NULL
520,878,7,885,1210,0,0,73.14,418,460,水碓村,NULL
0,878,7,885,1210,0,0,73.14,418,460,水碓村,NULL
82,877,8,885,1161,0,0,76.23,401,476,大有里,NULL
0,877,8,885,1161,0,0,76.23,401,476,大有里,NULL
677,879,6,885,1139,0,0,77.7,377,502,尚頂里,NULL
0,874,10,884,1266,0,0,69.83,813,61,精英村,NULL
364,874,10,884,1093,0,0,80.88,703,171,頭屋村,NULL
1068,873,11,884,1142,0,0,77.41,611,262,新安里,NULL
190,877,7,884,1173,0,0,75.36,567,310,大同村,NULL
115,877,7,884,1092,0,0,80.95,558,319,湖濱里,NULL
862,876,8,884,1163,0,0,76.01,555,321,水美里,NULL
16,879,5,884,1123,0,0,78.72,536,343,王田里,NULL
378,875,9,884,1151,0,0,76.8,528,347,仁壽里,NULL
728,875,9,884,1171,0,0,75.49,524,351,孔宅里,NULL
215,878,6,884,1109,0,0,79.71,496,382,西安里,NULL
286,875,9,884,1499,0,0,58.97,428,447,南都里,NULL
370,876,8,884,1138,0,0,77.68,426,450,東門里,NULL
542,877,7,884,1154,0,0,76.6,416,461,人和村,NULL
552,869,15,884,1108,0,0,79.78,411,458,東湳里,NULL
712,872,12,884,1116,0,0,79.21,410,462,崑山里,NULL
316,880,4,884,1082,0,0,81.7,374,506,德行里,NULL
0,880,4,884,1082,0,0,81.7,374,506,德行里,NULL
656,879,5,884,1180,0,0,74.92,326,553,五福村,NULL
524,879,5,884,1179,0,0,74.98,313,566,大同村,NULL
0,879,5,884,1179,0,0,74.98,313,566,大同村,NULL
22,876,8,884,1210,0,0,73.06,284,592,高樹村,NULL
221,867,16,883,1082,0,0,81.61,791,76,中興村,NULL
50,872,11,883,1075,0,0,82.14,739,133,福麗里,NULL
277,876,7,883,1099,0,0,80.35,663,213,下山村,NULL
0,876,7,883,1099,0,0,80.35,663,213,下山村,NULL
1371,877,6,883,1042,0,0,84.74,634,243,埤林里,NULL
719,871,12,883,1129,0,0,78.21,611,260,廣興里,NULL
102,876,7,883,1088,0,0,81.16,550,326,樹林里,NULL
98,880,3,883,1201,0,0,73.52,544,336,光華里,NULL
56,876,7,883,1192,0,0,74.08,527,349,中庄村,NULL
683,875,8,883,1148,0,0,76.92,503,372,浮圳里,NULL
290,871,12,883,1120,0,0,78.84,477,394,僑中里,NULL
336,878,5,883,1141,0,0,77.39,447,431,長明里,NULL
0,878,5,883,1141,0,0,77.39,447,431,長明里,NULL
765,876,7,883,1132,0,0,78,440,436,忠孝里,NULL
759,877,6,883,1184,0,0,74.58,429,448,仁德村,NULL
444,880,3,883,1156,0,0,76.38,368,512,月眉里,NULL
0,880,3,883,1156,0,0,76.38,368,512,月眉里,NULL
82,871,11,882,1302,0,0,67.74,773,98,大漢村,NULL
380,871,11,882,1144,0,0,77.1,641,230,勝興村,NULL
205,875,7,882,1131,0,0,77.98,637,238,信勢村,NULL
156,878,4,882,1078,0,0,81.82,629,249,四維里,NULL
2091,877,5,882,1146,0,0,76.96,544,333,土庫村,NULL
226,874,8,882,1099,0,0,80.25,527,347,福丘里,NULL
321,872,10,882,1113,0,0,79.25,504,368,南里村,NULL
0,872,10,882,1113,0,0,79.25,504,368,南里村,NULL
93,875,7,882,1122,0,0,78.61,470,405,景福里,NULL
411,876,6,882,1154,0,0,76.43,470,406,鎮北里,NULL
0,875,7,882,1122,0,0,78.61,470,405,景福里,NULL
550,876,6,882,1169,0,0,75.45,465,411,中寮里,NULL
465,866,16,882,1133,0,0,77.85,462,404,十甲里,NULL
1655,870,12,882,1162,0,0,75.9,456,414,金寮里,NULL
108,875,7,882,1176,0,0,75,455,420,福安里,NULL
271,865,17,882,1149,0,0,76.76,390,475,慈愛里,NULL
59,874,8,882,1181,0,0,74.68,384,490,梅洲里,NULL
822,872,10,882,1112,0,0,79.32,365,507,瑞東里,NULL
670,880,2,882,1205,0,0,73.2,362,518,林家村,NULL
0,880,2,882,1205,0,0,73.2,362,518,林家村,NULL
451,872,10,882,1148,0,0,76.83,350,522,禮蚵村,NULL
30,874,8,882,1566,0,0,56.32,342,532,溪頂村,NULL
0,874,8,882,1566,0,0,56.32,342,532,溪頂村,NULL
753,871,11,882,1120,0,0,78.75,309,562,太子村,NULL
245,873,8,881,1098,0,0,80.24,669,204,員山村,NULL
1,870,11,881,1098,0,0,80.24,663,207,中苗里,NULL
0,870,11,881,1098,0,0,80.24,663,207,中苗里,NULL
121,873,8,881,1076,0,0,81.88,648,225,二重里,NULL
100,876,5,881,1252,0,0,70.37,617,259,北門里,NULL
429,873,8,881,1201,0,0,73.36,554,319,瓦磘村,NULL
0,873,8,881,1201,0,0,73.36,554,319,瓦磘村,NULL
161,869,12,881,1105,0,0,79.73,551,318,磐石里,NULL
210,869,12,881,1192,0,0,73.91,504,365,嶺頂村,NULL
749,874,7,881,1135,0,0,77.62,503,371,勝利里,NULL
664,876,5,881,1107,0,0,79.58,466,410,王公村,NULL
1425,868,13,881,1106,0,0,79.66,461,407,延吉里,NULL
260,877,4,881,1224,0,0,71.98,449,428,大定村,NULL
0,877,4,881,1224,0,0,71.98,449,428,大定村,NULL
236,867,14,881,1159,0,0,76.01,448,419,埔和村,NULL
34,874,7,881,1167,0,0,75.49,421,453,凱旋里,NULL
0,874,7,881,1167,0,0,75.49,421,453,凱旋里,NULL
1011,875,6,881,1640,0,0,53.72,412,463,頂碩里,NULL
426,874,7,881,1209,0,0,72.87,403,471,圳頭村,NULL
456,876,5,881,1343,0,0,65.6,392,484,餉潭村,NULL
0,876,5,881,1343,0,0,65.6,392,484,餉潭村,NULL
284,871,10,881,1159,0,0,76.01,305,566,文賢村,NULL
266,874,7,881,1133,0,0,77.76,305,569,歸心里,NULL
0,871,10,881,1159,0,0,76.01,305,566,文賢村,NULL
0,874,7,881,1133,0,0,77.76,305,569,歸心里,NULL
828,870,10,880,1094,0,0,80.44,648,222,得和里,NULL
54,877,3,880,1219,0,0,72.19,632,245,國華里,NULL
744,871,9,880,1115,0,0,78.92,581,290,北勢里,NULL
72,870,10,880,1184,0,0,74.32,576,294,大同村,NULL
387,873,7,880,1149,0,0,76.59,525,348,東和里,NULL
34,876,4,880,1137,0,0,77.4,523,353,光榮里,NULL
211,868,12,880,1088,0,0,80.88,504,364,香丘里,NULL
1091,873,7,880,1152,0,0,76.39,504,369,後德里,NULL
61,873,7,880,1102,0,0,79.85,499,374,鐵山里,NULL
156,878,2,880,1152,0,0,76.39,485,393,民富里,NULL
0,874,6,880,1345,0,0,65.43,485,389,新城村,NULL
63,871,9,880,1180,0,0,74.58,476,395,永安村,NULL
259,875,5,880,1125,0,0,78.22,453,422,南端里,NULL
0,875,5,880,1125,0,0,78.22,453,422,南端里,NULL
344,874,6,880,1108,0,0,79.42,410,464,宏竹村,NULL
700,878,2,880,1162,0,0,75.73,407,471,東灣里,NULL
481,873,7,880,1180,0,0,74.58,386,487,朝安里,NULL
257,873,7,880,1224,0,0,71.9,375,498,順安村,NULL
273,866,14,880,1176,0,0,74.83,366,500,明亮里,NULL
446,874,6,880,1092,0,0,80.59,357,517,康安里,NULL
0,874,6,880,1092,0,0,80.59,357,517,康安里,NULL
550,871,9,880,1136,0,0,77.46,356,515,坔埔村,NULL
476,876,4,880,1256,0,0,70.06,355,521,三結村,NULL
0,876,4,880,1256,0,0,70.06,355,521,三結村,NULL
1966,868,12,880,1136,0,0,77.46,337,531,更寮村,NULL
0,868,12,880,1136,0,0,77.46,337,531,更寮村,NULL
336,875,5,880,1305,0,0,67.43,335,540,十份村,NULL
0,875,5,880,1305,0,0,67.43,335,540,十份村,NULL
227,872,7,879,1036,0,0,84.85,799,73,勝利村,NULL
621,871,8,879,1024,0,0,85.84,771,100,建和里,NULL
378,873,6,879,1056,0,0,83.24,668,205,廣盛村,NULL
173,872,7,879,1158,0,0,75.91,660,212,公舘里,NULL
0,872,7,879,1158,0,0,75.91,660,212,公舘里,NULL
2132,873,6,879,1198,0,0,73.37,640,233,埔坪村,NULL
1235,873,6,879,1103,0,0,79.69,632,241,美城里,NULL
297,863,16,879,1144,0,0,76.84,594,269,台鳳里,NULL
32,864,15,879,1164,0,0,75.52,585,279,龍山里,NULL
64,874,5,879,1072,0,0,82,536,338,和昌里,NULL
325,872,7,879,1137,0,0,77.31,517,355,大福里,NULL
649,872,7,879,1168,0,0,75.26,480,392,三條里,NULL
754,859,20,879,1109,0,0,79.26,474,385,國華里,NULL
200,867,12,879,1147,0,0,76.63,436,431,粗溪村,NULL
359,877,2,879,1123,0,0,78.27,434,443,碧紅里,NULL
164,869,10,879,1152,0,0,76.3,423,446,銀同里,NULL
0,869,10,879,1152,0,0,76.3,423,446,銀同里,NULL
171,868,11,879,1128,0,0,77.93,404,464,福安里,NULL
0,868,11,879,1128,0,0,77.93,404,464,福安里,NULL
752,871,8,879,1113,0,0,78.98,382,489,太子村,NULL
878,870,9,879,1172,0,0,75,382,488,一甲里,NULL
197,870,8,878,1056,0,0,83.14,778,92,武陵里,NULL
71,871,7,878,1035,0,0,84.83,676,195,忠誠里,NULL
956,868,10,878,1134,0,0,77.43,666,202,東門里,NULL
1185,872,6,878,1138,0,0,77.15,666,206,福德里,NULL
72,868,10,878,1054,0,0,83.3,633,235,忠誠里,NULL
885,872,6,878,1089,0,0,80.62,584,288,永樂里,NULL
118,874,4,878,1133,0,0,77.49,542,332,薰化里,NULL
0,874,4,878,1133,0,0,77.49,542,332,薰化里,NULL
1552,872,6,878,1159,0,0,75.75,526,346,秀峰里,NULL
747,865,13,878,1228,0,0,71.5,515,350,田尾村,NULL
0,865,13,878,1228,0,0,71.5,515,350,田尾村,NULL
779,869,9,878,1055,0,0,83.22,484,385,瑞竹里,NULL
384,867,11,878,1108,0,0,79.24,462,405,後協里,NULL
492,864,14,878,1104,0,0,79.53,458,406,永煇里,NULL
311,870,8,878,1077,0,0,81.52,457,413,前竹村,NULL
1454,870,8,878,1118,0,0,78.53,441,429,九芎里,NULL
44,872,6,878,1201,0,0,73.11,405,467,佃東里,NULL
452,869,9,878,1230,0,0,71.38,366,503,福安里,NULL
442,875,3,878,1112,0,0,78.96,312,563,大舍村,NULL
51,867,10,877,1086,0,0,80.76,721,146,福麗里,NULL
182,869,8,877,1095,0,0,80.09,623,246,雄峰里,NULL
6,871,6,877,1120,0,0,78.3,577,294,炎峰里,NULL
0,868,9,877,1196,0,0,73.33,557,311,彰雅村,NULL
416,864,13,877,1171,0,0,74.89,537,327,大明里,NULL
1777,871,6,877,1135,0,0,77.27,513,358,鳳福里,NULL
1693,865,12,877,1083,0,0,80.98,498,367,樹南里,NULL
345,860,17,877,1151,0,0,76.19,486,374,社口村,NULL
2051,869,8,877,1127,0,0,77.82,481,388,東林村,NULL
153,870,7,877,1164,0,0,75.34,477,393,長和里,NULL
0,870,7,877,1164,0,0,75.34,477,393,長和里,NULL
170,868,9,877,1164,0,0,75.34,476,392,永寧里,NULL
140,871,6,877,1197,0,0,73.27,464,407,車店里,NULL
379,871,6,877,1089,0,0,80.53,455,416,本文里,NULL
113,865,12,877,1095,0,0,80.09,453,412,吉翠里,NULL
524,867,10,877,1117,0,0,78.51,438,429,五福里,NULL
455,873,4,877,1112,0,0,78.87,422,451,信蚵村,NULL
99,873,4,877,1115,0,0,78.65,410,463,自治里,NULL
0,873,4,877,1115,0,0,78.65,410,463,自治里,NULL
916,868,9,877,1142,0,0,76.8,368,500,福興里,NULL
478,869,8,877,1186,0,0,73.95,315,554,西港村,NULL
243,870,7,877,1258,0,0,69.71,257,613,土厝村,NULL
0,870,7,877,1258,0,0,69.71,257,613,土厝村,NULL
42,866,10,876,1067,0,0,82.1,696,170,福星里,NULL
63,870,6,876,1190,0,0,73.61,655,215,孝忠里,NULL
22,869,7,876,1166,0,0,75.13,641,228,砂灣里,NULL
609,870,6,876,1203,0,0,72.82,587,283,北寮村,NULL
0,870,6,876,1203,0,0,72.82,587,283,北寮村,NULL
725,871,5,876,1107,0,0,79.13,573,298,復國里,NULL
432,869,7,876,1154,0,0,75.91,562,307,西湖村,NULL
1695,868,8,876,1088,0,0,80.51,545,323,樹東里,NULL
0,868,8,876,1088,0,0,80.51,545,323,樹東里,NULL
700,863,13,876,1055,0,0,83.03,510,353,民享里,NULL
1421,870,6,876,1169,0,0,74.94,503,367,峯廷里,NULL
87,872,4,876,1169,0,0,74.94,500,372,鰲峰里,NULL
0,872,4,876,1169,0,0,74.94,500,372,鰲峰里,NULL
86,867,9,876,1126,0,0,77.8,453,414,開元里,NULL
45,872,4,876,1178,0,0,74.36,429,443,佃東里,NULL
0,862,14,876,1211,0,0,72.34,421,441,導民里,NULL
111,867,9,876,1075,0,0,81.49,414,453,吉翠里,NULL
367,867,9,876,1249,0,0,70.14,390,477,竹崎村,NULL
195,868,8,876,1080,0,0,81.11,374,494,大社村,NULL
852,868,8,876,1150,0,0,76.17,360,508,老爺里,NULL
36,869,6,875,1061,0,0,82.47,638,231,福德里,NULL
864,867,8,875,1166,0,0,75.04,570,297,水美里,NULL
405,864,11,875,1305,0,0,67.05,563,301,振興里,NULL
0,864,11,875,1305,0,0,67.05,563,301,振興里,NULL
4,866,9,875,1274,0,0,68.68,559,307,麥津村,NULL
507,866,9,875,1103,0,0,79.33,515,351,東昌里,NULL
371,866,9,875,1082,0,0,80.87,503,363,田心里,NULL
331,868,7,875,1167,0,0,74.98,502,366,頂厝里,NULL
1654,865,10,875,1091,0,0,80.2,492,373,金寮里,NULL
30,863,12,875,1104,0,0,79.26,481,382,自立里,NULL
151,861,14,875,1083,0,0,80.79,479,382,文翠里,NULL
199,865,10,875,1120,0,0,78.13,459,406,水頭村,NULL
766,873,2,875,1137,0,0,76.96,428,445,仁義村,NULL
883,864,11,875,1104,0,0,79.26,415,449,保安里,NULL
42,870,5,875,1105,0,0,79.19,412,458,水源里,NULL
787,870,5,875,1138,0,0,76.89,394,476,保安村,NULL
375,865,10,875,1237,0,0,70.74,393,472,饒平村,NULL
0,865,10,875,1237,0,0,70.74,393,472,饒平村,NULL
507,870,5,875,1140,0,0,76.75,391,479,新光里,NULL
682,869,6,875,1135,0,0,77.09,365,504,龍潭里,NULL
783,869,6,875,1088,0,0,80.42,355,514,鎮陽里,NULL
0,869,6,875,1088,0,0,80.42,355,514,鎮陽里,NULL
141,869,6,875,1129,0,0,77.5,318,551,和蓮村,NULL
28,868,6,874,1163,0,0,75.15,609,259,入船里,NULL
0,868,6,874,1163,0,0,75.15,609,259,入船里,NULL
337,869,5,874,1137,0,0,76.87,578,291,北興里,NULL
0,859,15,874,1299,0,0,67.28,572,287,平和村,NULL
13,864,10,874,1171,0,0,74.64,564,300,敦和里,NULL
169,868,6,874,1136,0,0,76.94,552,316,仁安里,NULL
0,868,6,874,1136,0,0,76.94,552,316,仁安里,NULL
1325,865,9,874,1125,0,0,77.69,551,314,員仁里,NULL
1341,869,5,874,1098,0,0,79.6,545,324,員福里,NULL
246,864,10,874,1133,0,0,77.14,510,354,天壽里,NULL
73,869,5,874,1139,0,0,76.73,483,386,客庄里,NULL
147,865,9,874,1131,0,0,77.28,477,388,嵐翠里,NULL
360,870,4,874,1069,0,0,81.76,449,421,程香里,NULL
56,866,8,874,1183,0,0,73.88,413,453,茭白里,NULL
731,862,12,874,1129,0,0,77.41,402,460,橋頭村,NULL
21,863,11,874,1336,0,0,65.42,396,467,施厝村,NULL
62,865,9,874,1121,0,0,77.97,375,490,新港里,NULL
0,865,9,874,1121,0,0,77.97,375,490,新港里,NULL
214,864,10,874,1270,0,0,68.82,209,655,梧北村,NULL
0,864,10,874,1270,0,0,68.82,209,655,梧北村,NULL
464,866,7,873,1024,0,0,85.25,846,20,僑愛里,NULL
225,867,6,873,1094,0,0,79.8,710,157,成功里,NULL
252,868,5,873,1174,0,0,74.36,704,164,重興村,NULL
18,866,7,873,1306,0,0,66.85,612,254,朝陽里,NULL
411,869,4,873,1191,0,0,73.3,576,293,華崙里,NULL
69,867,6,873,1101,0,0,79.29,558,309,花崗里,NULL
0,867,6,873,1101,0,0,79.29,558,309,花崗里,NULL
131,862,11,873,1138,0,0,76.71,511,351,大崙村,NULL
0,862,11,873,1138,0,0,76.71,511,351,大崙村,NULL
248,860,13,873,1163,0,0,75.06,494,366,香村里,NULL
254,867,6,873,1132,0,0,77.12,479,388,大庄里,NULL
195,865,8,873,1289,0,0,67.73,463,402,湖東村,NULL
0,865,8,873,1289,0,0,67.73,463,402,湖東村,NULL
218,865,7,872,1045,0,0,83.44,714,151,湖鏡村,NULL
101,868,4,872,1083,0,0,80.52,602,266,宏翠里,NULL
136,861,11,872,1104,0,0,78.99,590,271,曲溪里,NULL
347,867,5,872,1126,0,0,77.44,576,291,梅川里,NULL
328,868,4,872,1154,0,0,75.56,562,306,文德村,NULL
11,865,7,872,1175,0,0,74.21,542,323,西墩里,NULL
706,867,5,872,1146,0,0,76.09,540,327,山東里,NULL
133,861,11,872,1257,0,0,69.37,540,321,惠來里,NULL
154,861,11,872,1194,0,0,73.03,531,330,頂粘村,NULL
86,867,5,872,1193,0,0,73.09,518,349,廍子村,NULL
0,867,5,872,1193,0,0,73.09,518,349,廍子村,NULL
111,867,5,872,1172,0,0,74.4,416,451,龍德里,NULL
604,867,5,872,1089,0,0,80.07,402,465,興和里,NULL
489,864,8,872,1183,0,0,73.71,391,473,鎮海里,NULL
535,870,2,872,1256,0,0,69.43,387,483,隆山村,NULL
450,867,5,872,1108,0,0,78.7,370,497,美華里,NULL
396,863,9,872,1082,0,0,80.59,271,592,嘉興里,NULL
222,859,13,872,1101,0,0,79.2,262,597,水安村,NULL
96,864,8,872,1207,0,0,72.25,249,615,豐和里,NULL
0,864,8,872,1207,0,0,72.25,249,615,豐和里,NULL
402,859,13,872,1163,0,0,74.98,235,624,港尾里,NULL
0,859,13,872,1163,0,0,74.98,235,624,港尾里,NULL
751,862,9,871,1126,0,0,77.35,550,312,嘉慶里,NULL
76,864,7,871,1215,0,0,71.69,529,335,鹽中村,NULL
137,855,16,871,1131,0,0,77.01,526,329,東山里,NULL
0,855,16,871,1131,0,0,77.01,526,329,東山里,NULL
2,861,10,871,1144,0,0,76.14,496,365,流芳里,NULL
457,861,10,871,1133,0,0,76.88,496,365,大竹里,NULL
0,861,10,871,1144,0,0,76.14,496,365,流芳里,NULL
43,857,14,871,1124,0,0,77.49,483,374,金華里,NULL
149,863,8,871,1153,0,0,75.54,430,433,大宏里,NULL
509,866,5,871,1139,0,0,76.47,429,437,田頭里,NULL
5,864,7,871,1086,0,0,80.2,406,458,大平村,NULL
0,864,7,871,1086,0,0,80.2,406,458,大平村,NULL
723,869,2,871,1115,0,0,78.12,399,470,松山里,NULL
306,867,3,870,1092,0,0,79.67,761,106,樂英里,NULL
256,858,12,870,1159,0,0,75.06,596,262,溪洲里,NULL
219,863,7,870,1151,0,0,75.59,578,285,松勇里,NULL
746,865,5,870,1124,0,0,77.4,573,292,圳堵村,NULL
42,861,9,870,1143,0,0,76.12,567,294,延平里,NULL
502,868,2,870,1281,0,0,67.92,566,302,東城村,NULL
0,868,2,870,1281,0,0,67.92,566,302,東城村,NULL
0,864,6,870,1273,0,0,68.34,561,303,房里里,NULL
939,861,9,870,1158,0,0,75.13,530,331,埔頂村,NULL
24,862,8,870,1125,0,0,77.33,463,399,溪頂里,NULL
465,863,7,870,1097,0,0,79.31,446,417,平安里,NULL
315,861,9,870,1126,0,0,77.26,430,431,文南村,NULL
440,850,20,870,1125,0,0,77.33,429,421,長元里,NULL
617,864,6,870,1098,0,0,79.23,414,450,福人里,NULL
178,865,5,870,1167,0,0,74.55,383,482,大湖村,NULL
0,865,5,870,1167,0,0,74.55,383,482,大湖村,NULL
702,867,3,870,1154,0,0,75.39,379,488,六苓里,NULL
48,861,9,870,1066,0,0,81.61,373,488,西埔里,NULL
858,865,5,870,1114,0,0,78.1,347,518,國順里,NULL
202,863,7,870,1058,0,0,82.23,341,522,觀音村,NULL
787,859,11,870,1076,0,0,80.86,326,533,鎮北里,NULL
0,859,11,870,1076,0,0,80.86,326,533,鎮北里,NULL
809,861,8,869,1058,0,0,82.14,816,45,海風里,NULL
5,865,4,869,1069,0,0,81.29,656,209,維祥里,NULL
55,865,4,869,1161,0,0,74.85,651,214,文聖里,NULL
143,864,5,869,1152,0,0,75.43,626,238,瑞慶里,NULL
693,857,12,869,1099,0,0,79.07,617,240,平安里,NULL
655,858,11,869,1146,0,0,75.83,599,259,南平里,NULL
76,866,3,869,1153,0,0,75.37,581,285,南昌里,NULL
203,858,11,869,1041,0,0,83.48,578,280,建寶里,NULL
726,856,13,869,1231,0,0,70.59,551,305,晴光里,NULL
36,865,4,869,1176,0,0,73.89,507,358,東村里,NULL
374,864,5,869,1120,0,0,77.59,504,360,壽峰里,NULL
482,858,11,869,1106,0,0,78.57,500,358,油車村,NULL
0,858,11,869,1106,0,0,78.57,500,358,油車村,NULL
133,862,7,869,1137,0,0,76.43,498,364,育英里,NULL
442,861,8,869,1111,0,0,78.22,495,366,新庄里,NULL
715,863,6,869,1105,0,0,78.64,488,375,厚里村,NULL
109,864,5,869,1246,0,0,69.74,487,377,大湳里,NULL
0,864,5,869,1246,0,0,69.74,487,377,大湳里,NULL
122,857,12,869,1214,0,0,71.58,421,436,興中里,NULL
0,857,12,869,1214,0,0,71.58,421,436,興中里,NULL
651,860,9,869,1132,0,0,76.77,393,467,東林村,NULL
542,860,9,869,1147,0,0,75.76,357,503,港墘村,NULL
595,860,9,869,1130,0,0,76.9,333,527,福南里,NULL
477,854,15,869,1069,0,0,81.29,330,524,頂鹽村,NULL
0,854,15,869,1069,0,0,81.29,330,524,頂鹽村,NULL
142,858,10,868,1280,0,0,67.81,712,146,東昌村,NULL
85,864,4,868,1180,0,0,73.56,706,158,北埔村,NULL
628,846,22,868,1134,0,0,76.54,655,191,正南里,NULL
929,858,10,868,1023,0,0,84.85,591,267,頂溪里,NULL
309,861,7,868,1118,0,0,77.64,589,272,新城村,NULL
0,861,7,868,1118,0,0,77.64,589,272,新城村,NULL
142,865,3,868,1066,0,0,81.43,583,282,四座里,NULL
196,857,11,868,1103,0,0,78.69,579,278,愛勢村,NULL
643,858,10,868,1077,0,0,80.59,558,300,普慶里,NULL
110,853,15,868,1091,0,0,79.56,558,295,光鎮里,NULL
620,863,5,868,1102,0,0,78.77,540,323,中正里,NULL
674,857,11,868,1145,0,0,75.81,517,340,振興里,NULL
81,863,5,868,1192,0,0,72.82,494,369,顯宮里,NULL
0,863,5,868,1192,0,0,72.82,494,369,顯宮里,NULL
181,860,8,868,1123,0,0,77.29,475,385,埔崙村,NULL
1064,865,3,868,1074,0,0,80.82,466,399,營盤里,NULL
127,858,10,868,1147,0,0,75.68,464,394,六甲里,NULL
497,862,6,868,1093,0,0,79.41,454,408,文武村,NULL
528,864,4,868,1212,0,0,71.62,441,423,塭豐村,NULL
45,861,7,868,1279,0,0,67.87,416,445,月美村,NULL
0,861,7,868,1279,0,0,67.87,416,445,月美村,NULL
450,864,4,868,1213,0,0,71.56,411,453,榴中里,NULL
346,863,5,868,1110,0,0,78.2,398,465,丁臺村,NULL
681,857,11,868,1165,0,0,74.51,383,474,龍潭里,NULL
828,866,2,868,1085,0,0,80,370,496,崙頂村,NULL
835,860,8,868,1155,0,0,75.15,364,496,八甲村,NULL
975,857,11,868,1115,0,0,77.85,352,505,崙坪村,NULL
270,855,12,867,1017,0,0,85.25,756,99,龍友里,NULL
45,857,10,867,1008,0,0,86.01,691,166,宏榮里,NULL
630,852,15,867,1080,0,0,80.28,652,200,正南里,NULL
266,848,19,867,1105,0,0,78.46,569,279,社腳村,NULL
117,861,6,867,1068,0,0,81.18,562,299,德翠里,NULL
277,860,7,867,1130,0,0,76.73,533,327,臨溪里,NULL
490,857,10,867,1114,0,0,77.83,520,337,長春里,NULL
497,858,9,867,1093,0,0,79.32,507,351,浩然里,NULL
208,863,4,867,1158,0,0,74.87,503,360,南寮里,NULL
8,859,8,867,1130,0,0,76.73,492,367,湳興里,NULL
822,860,7,867,1068,0,0,81.18,481,379,國富里,NULL
171,855,12,867,1167,0,0,74.29,472,383,安東村,NULL
481,858,9,867,1154,0,0,75.13,453,405,東仁里,NULL
0,858,9,867,1154,0,0,75.13,453,405,東仁里,NULL
868,857,10,867,1188,0,0,72.98,423,434,過埤里,NULL
159,859,8,867,1154,0,0,75.13,420,439,南興里,NULL
115,862,5,867,1198,0,0,72.37,399,463,橋南里,NULL
67,864,3,867,1172,0,0,73.98,389,475,興安里,NULL
0,857,10,867,1136,0,0,76.32,388,469,建功村,NULL
375,860,7,867,1250,0,0,69.36,385,475,灣橋村,NULL
261,856,11,867,1145,0,0,75.72,382,474,永美村,NULL
125,858,9,867,1100,0,0,78.82,364,494,正覺里,NULL
844,852,15,867,1134,0,0,76.46,278,574,大廟村,NULL
36,859,7,866,1030,0,0,84.08,783,76,國光里,NULL
0,845,21,866,1314,0,0,65.91,729,116,嘉新村,NULL
192,862,4,866,1093,0,0,79.23,668,194,東興村,NULL
33,856,10,866,1107,0,0,78.23,578,278,光榮里,NULL
1610,860,6,866,1200,0,0,72.17,567,293,福德里,NULL
102,863,3,866,1143,0,0,75.77,535,328,通西里,NULL
741,858,8,866,1071,0,0,80.86,519,339,錦中里,NULL
842,860,6,866,1048,0,0,82.63,499,361,新強里,NULL
414,853,13,866,1170,0,0,74.02,495,358,大明里,NULL
34,864,2,866,1208,0,0,71.69,487,377,頂店里,NULL
534,859,7,866,1164,0,0,74.4,476,383,永隆里,NULL
362,861,5,866,1141,0,0,75.9,386,475,莿桐村,NULL
873,862,4,866,1116,0,0,77.6,370,492,正義里,NULL
289,860,6,866,1186,0,0,73.02,361,499,協和村,NULL
32,860,5,865,1140,0,0,75.88,579,281,義重里,NULL
0,860,5,865,1140,0,0,75.88,579,281,義重里,NULL
599,854,11,865,1083,0,0,79.87,574,280,佳和里,NULL
121,861,4,865,1237,0,0,69.93,568,293,大城里,NULL
269,853,12,865,1155,0,0,74.89,561,292,新興村,NULL
387,852,13,865,1145,0,0,75.55,525,327,中新里,NULL
17,858,7,865,1143,0,0,75.68,524,334,七嘉村,NULL
129,855,10,865,1219,0,0,70.96,522,333,蘇西里,NULL
604,855,10,865,1321,0,0,65.48,513,342,山脚里,NULL
251,859,6,865,1139,0,0,75.94,507,352,香山里,NULL
646,858,7,865,1142,0,0,75.74,499,359,正強里,NULL
956,857,8,865,1131,0,0,76.48,478,379,赤欄村,NULL
0,857,8,865,1131,0,0,76.48,478,379,赤欄村,NULL
541,847,18,865,1108,0,0,78.07,473,374,富華里,NULL
618,854,11,865,1091,0,0,79.29,463,391,翁社里,NULL
768,856,9,865,1135,0,0,76.21,435,421,建安里,NULL
735,855,10,865,1153,0,0,75.02,429,426,張厝村,NULL
0,855,10,865,1153,0,0,75.02,429,426,張厝村,NULL
1537,854,11,865,1095,0,0,79,423,431,保新里,NULL
195,858,7,865,1145,0,0,75.55,421,437,普濟里,NULL
0,858,7,865,1145,0,0,75.55,421,437,普濟里,NULL
444,858,7,865,1128,0,0,76.68,411,447,振興里,NULL
87,850,15,865,1323,0,0,65.38,387,463,後埔里,NULL
282,860,5,865,1121,0,0,77.16,329,531,葉厝村,NULL
249,856,8,864,1103,0,0,78.33,590,266,香村里,NULL
711,854,10,864,1139,0,0,75.86,573,281,湧安里,NULL
22,855,9,864,1079,0,0,80.07,551,304,自強里,NULL
44,859,5,864,1387,0,0,62.29,535,324,蚊港村,NULL
326,859,5,864,1116,0,0,77.42,529,330,建興里,NULL
0,855,9,864,1214,0,0,71.17,524,331,福興村,NULL
23,855,9,864,1154,0,0,74.87,521,334,碧峰里,NULL
0,860,4,864,1192,0,0,72.48,515,345,永福村,NULL
1084,858,6,864,1117,0,0,77.35,476,382,裕民里,NULL
172,858,6,864,1155,0,0,74.81,468,390,永安里,NULL
42,849,15,864,1168,0,0,73.97,464,385,北投里,NULL
414,862,2,864,1120,0,0,77.14,455,407,大園里,NULL
50,853,11,864,1124,0,0,76.87,454,399,中原里,NULL
142,852,12,864,1183,0,0,73.03,452,400,同安村,NULL
495,857,7,864,1065,0,0,81.13,421,436,文西里,NULL
0,857,7,864,1065,0,0,81.13,421,436,文西里,NULL
35,855,9,864,1241,0,0,69.62,401,454,三家村,NULL
0,855,9,864,1241,0,0,69.62,401,454,三家村,NULL
516,853,11,864,1174,0,0,73.59,392,461,海寮村,NULL
323,859,5,864,1182,0,0,73.1,377,482,頂寮村,NULL
0,859,5,864,1182,0,0,73.1,377,482,頂寮村,NULL
449,855,9,864,1097,0,0,78.76,367,488,東橋里,NULL
145,852,12,864,1197,0,0,72.18,346,506,黎明村,NULL
699,855,9,864,1148,0,0,75.26,343,512,東灣里,NULL
825,857,7,864,1099,0,0,78.62,312,545,瑞和里,NULL
611,857,6,863,1072,0,0,80.5,605,252,平河里,NULL
210,856,7,863,1067,0,0,80.88,583,273,和平里,NULL
0,856,7,863,1067,0,0,80.88,583,273,和平里,NULL
766,856,7,863,1051,0,0,82.11,579,277,金陵里,NULL
177,852,11,863,1106,0,0,78.03,577,275,頂埔里,NULL
535,857,6,863,1257,0,0,68.66,577,280,豊崙村,NULL
792,859,4,863,1076,0,0,80.2,555,304,誠德里,NULL
653,857,6,863,1079,0,0,79.98,512,345,衛武里,NULL
211,855,8,863,1202,0,0,71.8,504,351,嶺頂村,NULL
470,850,13,863,1083,0,0,79.69,504,346,東英里,NULL
262,853,10,863,1128,0,0,76.51,494,359,內湖里,NULL
44,852,11,863,1111,0,0,77.68,484,368,金華里,NULL
90,858,5,863,1107,0,0,77.96,473,385,清水里,NULL
188,846,17,863,1070,0,0,80.65,452,394,九如里,NULL
243,857,6,863,1138,0,0,75.83,436,421,哨船頭里,NULL
0,857,6,863,1138,0,0,75.83,436,421,哨船頭里,NULL
99,855,8,863,1138,0,0,75.83,432,423,協和里,NULL
574,857,6,863,1131,0,0,76.3,423,434,中庄村,NULL
1303,859,4,863,1136,0,0,75.97,385,474,廣興里,NULL
0,859,4,863,1136,0,0,75.97,385,474,廣興里,NULL
67,858,5,863,1124,0,0,76.78,350,508,苑港里,NULL
0,858,5,863,1124,0,0,76.78,350,508,苑港里,NULL
99,852,11,863,1115,0,0,77.4,333,519,德榮村,NULL
0,852,11,863,1115,0,0,77.4,333,519,德榮村,NULL
304,846,17,863,1192,0,0,72.4,236,610,古民村,NULL
0,846,17,863,1192,0,0,72.4,236,610,古民村,NULL
389,854,9,863,1167,0,0,73.95,164,690,北勢里,NULL
0,854,9,863,1167,0,0,73.95,164,690,北勢里,NULL
119,856,6,862,1037,0,0,83.12,794,62,海勝里,NULL
0,859,3,862,1105,0,0,78.01,670,189,明德村,NULL
1569,855,7,862,1122,0,0,76.83,562,293,橋東里,NULL
126,853,9,862,1272,0,0,67.77,559,294,南村里,NULL
0,853,9,862,1272,0,0,67.77,559,294,南村里,NULL
76,860,2,862,1123,0,0,76.76,530,330,玉田里,NULL
0,860,2,862,1123,0,0,76.76,530,330,玉田里,NULL
157,859,3,862,1212,0,0,71.12,514,345,大坑里,NULL
0,859,3,862,1212,0,0,71.12,514,345,大坑里,NULL
27,859,3,862,1077,0,0,80.04,502,357,南門里,NULL
141,859,3,862,1119,0,0,77.03,487,372,車店里,NULL
67,851,11,862,1104,0,0,78.08,475,376,犁盛里,NULL
528,858,4,862,1324,0,0,65.11,467,391,中東里,NULL
266,858,4,862,1262,0,0,68.3,454,404,灣寶里,NULL
0,858,4,862,1262,0,0,68.3,454,404,灣寶里,NULL
427,855,7,862,1073,0,0,80.34,445,410,文化里,NULL
59,856,6,862,1148,0,0,75.09,439,417,福興村,NULL
0,856,6,862,1148,0,0,75.09,439,417,福興村,NULL
384,854,8,862,1129,0,0,76.35,436,418,山腳村,NULL
465,857,5,862,1073,0,0,80.34,402,455,仕豐村,NULL
383,856,6,862,1347,0,0,63.99,399,457,新生村,NULL
0,856,6,862,1347,0,0,63.99,399,457,新生村,NULL
233,860,2,862,1170,0,0,73.68,398,462,頭分村,NULL
0,860,2,862,1170,0,0,73.68,398,462,頭分村,NULL
166,852,10,862,1110,0,0,77.66,392,460,北榮里,NULL
1977,851,11,862,1119,0,0,77.03,380,471,成德村,NULL
374,855,7,862,1364,0,0,63.2,329,526,興仁村,NULL
0,855,7,862,1364,0,0,63.2,329,526,興仁村,NULL
380,854,8,862,1139,0,0,75.68,266,588,晋江里,NULL
82,853,8,861,1076,0,0,80.02,660,193,東寧里,NULL
152,852,9,861,1302,0,0,66.13,634,218,豐裡村,NULL
0,852,9,861,1302,0,0,66.13,634,218,豐裡村,NULL
697,853,8,861,1099,0,0,78.34,608,245,山峰里,NULL
1326,859,2,861,1111,0,0,77.5,601,258,員仁里,NULL
474,851,10,861,1211,0,0,71.1,531,320,東勢村,NULL
26,853,8,861,1274,0,0,67.58,531,322,東文里,NULL
1403,856,5,861,1068,0,0,80.62,486,370,清水里,NULL
1838,846,15,861,1137,0,0,75.73,480,366,溪東里,NULL
456,853,8,861,1115,0,0,77.22,479,374,三安里,NULL
88,852,9,861,1178,0,0,73.09,479,373,西安里,NULL
417,858,3,861,1111,0,0,77.5,467,391,仁愛里,NULL
0,858,3,861,1111,0,0,77.5,467,391,仁愛里,NULL
128,855,6,861,1151,0,0,74.8,459,396,蘇西里,NULL
760,853,8,861,1050,0,0,82,430,423,明義里,NULL
421,851,10,861,1109,0,0,77.64,408,443,光和村,NULL
0,851,10,861,1109,0,0,77.64,408,443,光和村,NULL
0,853,8,861,1233,0,0,69.83,386,467,新置村,NULL
282,854,7,861,1191,0,0,72.29,382,472,中興村,NULL
0,854,7,861,1191,0,0,72.29,382,472,中興村,NULL
260,850,11,861,1183,0,0,72.78,379,471,永美村,NULL
780,853,8,861,1169,0,0,73.65,363,490,上崙村,NULL
714,855,6,861,1126,0,0,76.47,355,500,北灣里,NULL
496,849,12,861,1164,0,0,73.97,339,510,蘇林村,NULL
256,855,6,861,1168,0,0,73.72,335,520,和協村,NULL
0,855,6,861,1168,0,0,73.72,335,520,和協村,NULL
514,856,5,861,1149,0,0,74.93,306,550,鎮安村,NULL
0,856,5,861,1149,0,0,74.93,306,550,鎮安村,NULL
377,856,4,860,1074,0,0,80.07,642,214,廣盛村,NULL
57,854,6,860,1120,0,0,76.79,637,217,新川里,NULL
0,854,6,860,1120,0,0,76.79,637,217,新川里,NULL
53,857,3,860,1117,0,0,76.99,629,228,東光里,NULL
29,854,6,860,1092,0,0,78.75,626,228,竹仁里,NULL
927,855,5,860,1089,0,0,78.97,613,242,南門里,NULL
30,849,11,860,1046,0,0,82.22,606,243,東山里,NULL
654,847,13,860,1082,0,0,79.48,597,250,景本里,NULL
228,852,8,860,1186,0,0,72.51,588,264,麗水村,NULL
715,845,15,860,1148,0,0,74.91,573,272,福興村,NULL
0,845,15,860,1148,0,0,74.91,573,272,福興村,NULL
217,850,10,860,1132,0,0,75.97,563,287,海濱里,NULL
750,850,10,860,1116,0,0,77.06,541,309,勝利里,NULL
624,849,11,860,1126,0,0,76.38,537,312,九房村,NULL
0,849,11,860,1126,0,0,76.38,537,312,九房村,NULL
622,847,13,860,1113,0,0,77.27,518,329,石岡村,NULL
0,847,13,860,1113,0,0,77.27,518,329,石岡村,NULL
484,853,7,860,1093,0,0,78.68,513,340,尚德里,NULL
516,856,4,860,1089,0,0,78.97,499,357,新明里,NULL
344,853,7,860,1113,0,0,77.27,477,376,社口村,NULL
547,856,4,860,1161,0,0,74.07,463,393,城東里,NULL
106,850,10,860,1167,0,0,73.69,436,414,勝安里,NULL
0,850,10,860,1167,0,0,73.69,436,414,勝安里,NULL
531,855,5,860,1080,0,0,79.63,427,428,慈生里,NULL
288,853,7,860,1160,0,0,74.14,425,428,南華里,NULL
833,844,16,860,1101,0,0,78.11,421,423,歸仁村,NULL
220,852,8,860,1161,0,0,74.07,421,431,永春里,NULL
305,854,6,860,1360,0,0,63.24,392,462,安邦里,NULL
129,845,15,860,1240,0,0,69.35,390,455,興隆里,NULL
0,845,15,860,1240,0,0,69.35,390,455,興隆里,NULL
591,848,12,860,1196,0,0,71.91,387,461,三圳村,NULL
536,852,8,860,1072,0,0,80.22,387,465,鳥松村,NULL
0,848,12,860,1196,0,0,71.91,387,461,三圳村,NULL
723,857,3,860,1112,0,0,77.34,360,497,文山里,NULL
0,849,11,860,1289,0,0,66.72,335,514,新湖村,NULL
912,853,6,859,984,0,0,87.3,715,138,佳安村,NULL
49,852,7,859,1116,0,0,76.97,678,174,福麗里,NULL
2,849,10,859,1098,0,0,78.23,597,252,玉峰里,NULL
163,852,7,859,1090,0,0,78.81,554,298,自強里,NULL
1270,850,9,859,1087,0,0,79.02,547,303,雙城里,NULL
1851,849,10,859,1149,0,0,74.76,534,315,義山里,NULL
656,853,6,859,1124,0,0,76.42,513,340,延平里,NULL
1579,851,8,859,1120,0,0,76.7,502,349,保長里,NULL
196,851,8,859,1196,0,0,71.82,492,359,竹林里,NULL
393,848,11,859,1131,0,0,75.95,477,371,烏塗村,NULL
0,848,11,859,1131,0,0,75.95,477,371,烏塗村,NULL
179,854,5,859,1092,0,0,78.66,464,390,鳳明村,NULL
0,854,5,859,1092,0,0,78.66,464,390,鳳明村,NULL
67,851,8,859,1081,0,0,79.46,450,401,清江里,NULL
115,849,10,859,1092,0,0,78.66,437,412,埤東里,NULL
0,849,10,859,1092,0,0,78.66,437,412,埤東里,NULL
87,853,6,859,1092,0,0,78.66,400,453,中成里,NULL
287,854,5,859,1163,0,0,73.86,399,455,德西里,NULL
0,854,5,859,1163,0,0,73.86,399,455,德西里,NULL
6,849,10,859,1260,0,0,68.17,383,466,灣北村,NULL
0,849,10,859,1260,0,0,68.17,383,466,灣北村,NULL
445,853,6,859,1104,0,0,77.81,350,503,赤崁村,NULL
214,857,2,859,1088,0,0,78.95,346,511,竹寮村,NULL
525,848,11,859,1109,0,0,77.46,342,506,灣內村,NULL
146,853,6,859,1124,0,0,76.42,325,528,峯山村,NULL
0,853,6,859,1124,0,0,76.42,325,528,峯山村,NULL
201,848,11,859,1192,0,0,72.06,285,563,神農村,NULL
12,853,5,858,1188,0,0,72.22,731,122,光榮里,NULL
813,849,9,858,1206,0,0,71.14,661,188,金溪里,NULL
49,849,9,858,1115,0,0,76.95,605,244,信綠里,NULL
54,855,3,858,1061,0,0,80.87,550,305,聯興里,NULL
1649,849,9,858,1139,0,0,75.33,489,360,獇寮里,NULL
130,848,10,858,1115,0,0,76.95,471,377,蘇北里,NULL
0,848,10,858,1115,0,0,76.95,471,377,蘇北里,NULL
159,844,14,858,1098,0,0,78.14,457,387,磐石里,NULL
135,852,6,858,1150,0,0,74.61,368,484,阿蓮村,NULL
268,853,5,858,1193,0,0,71.92,325,528,劉厝里,NULL
0,853,5,858,1193,0,0,71.92,325,528,劉厝里,NULL
503,851,7,858,1114,0,0,77.02,260,591,竹後村,NULL
9,850,8,858,1190,0,0,72.1,256,594,嘉田村,NULL
0,850,8,858,1190,0,0,72.1,256,594,嘉田村,NULL
791,848,9,857,1061,0,0,80.77,631,217,秀峰里,NULL
79,846,11,857,1198,0,0,71.54,622,224,康樂村,NULL
107,849,8,857,1127,0,0,76.04,574,275,中信里,NULL
174,847,10,857,1121,0,0,76.45,560,287,光華里,NULL
113,847,10,857,1161,0,0,73.82,557,290,同聲里,NULL
1622,854,3,857,1019,0,0,84.1,524,330,北山里,NULL
807,850,7,857,1131,0,0,75.77,497,353,朱園里,NULL
361,853,4,857,1107,0,0,77.42,497,356,程香里,NULL
1769,849,8,857,1133,0,0,75.64,487,362,永吉里,NULL
323,854,3,857,1144,0,0,74.91,481,373,桐林村,NULL
0,854,3,857,1144,0,0,74.91,481,373,桐林村,NULL
667,854,3,857,1131,0,0,75.77,431,423,大明里,NULL
340,851,6,857,1214,0,0,70.59,381,470,漢光里,NULL
350,847,10,857,1115,0,0,76.86,374,473,維仁里,NULL
0,847,10,857,1115,0,0,76.86,374,473,維仁里,NULL
563,848,9,857,1076,0,0,79.65,352,496,義和村,NULL
15,848,8,856,1107,0,0,77.33,693,155,民政里,NULL
172,848,8,856,1155,0,0,74.11,687,161,鳳智里,NULL
0,848,8,856,1155,0,0,74.11,687,161,鳳智里,NULL
661,844,12,856,1083,0,0,79.04,626,218,泰昌里,NULL
751,849,7,856,1023,0,0,83.68,604,245,北安里,NULL
173,847,9,856,1102,0,0,77.68,602,245,東安里,NULL
87,851,5,856,1262,0,0,67.83,535,316,枇杷里,NULL
212,848,8,856,1104,0,0,77.54,518,330,康樂里,NULL
604,848,8,856,1074,0,0,79.7,517,331,山頂村,NULL
747,853,3,856,1200,0,0,71.33,486,367,勝利里,NULL
71,852,4,856,1103,0,0,77.61,479,373,房裡里,NULL
231,844,12,856,1054,0,0,81.21,447,397,民族里,NULL
957,849,7,856,1085,0,0,78.89,442,407,化成里,NULL
488,851,5,856,1093,0,0,78.32,427,424,國民里,NULL
0,851,5,856,1093,0,0,78.32,427,424,國民里,NULL
396,846,10,856,1120,0,0,76.43,423,423,廣安村,NULL
657,848,8,856,1159,0,0,73.86,418,430,安康里,NULL
6,844,12,856,1147,0,0,74.63,396,448,州南里,NULL
1354,848,8,856,1131,0,0,75.69,388,460,貨饒里,NULL
210,847,9,856,1201,0,0,71.27,379,468,東中村,NULL
973,850,6,856,1134,0,0,75.49,354,496,大堀村,NULL
0,850,6,856,1134,0,0,75.49,354,496,大堀村,NULL
98,845,10,855,1015,0,0,84.24,773,72,永清里,NULL
580,849,6,855,1102,0,0,77.59,619,230,興隆里,NULL
0,853,2,855,1056,0,0,80.97,602,251,沙坑村,NULL
766,850,5,855,1043,0,0,81.98,509,341,忠孝里,NULL
850,845,10,855,1135,0,0,75.33,487,358,上田里,NULL
844,845,10,855,1139,0,0,75.07,481,364,員本里,NULL
61,845,10,855,1063,0,0,80.43,469,376,公館里,NULL
143,844,11,855,1067,0,0,80.13,467,377,客雅里,NULL
667,843,12,855,1067,0,0,80.13,462,381,竹東里,NULL
475,851,4,855,1113,0,0,76.82,430,421,興東里,NULL
846,851,4,855,1099,0,0,77.8,410,441,關廟村,NULL
65,847,8,855,1163,0,0,73.52,408,439,太平里,NULL
971,846,9,855,1129,0,0,75.73,401,445,大同村,NULL
35,847,8,855,1234,0,0,69.29,356,491,南華村,NULL
0,847,8,855,1234,0,0,69.29,356,491,南華村,NULL
221,843,12,855,1196,0,0,71.49,322,521,水南村,NULL
239,850,5,855,1208,0,0,70.78,259,591,美南村,NULL
0,850,5,855,1208,0,0,70.78,259,591,美南村,NULL
801,847,7,854,1095,0,0,77.99,621,226,網溪里,NULL
0,847,7,854,1095,0,0,77.99,621,226,網溪里,NULL
43,843,11,854,1079,0,0,79.15,615,228,主權里,NULL
62,844,10,854,1300,0,0,65.69,602,242,建和里,NULL
0,844,10,854,1300,0,0,65.69,602,242,建和里,NULL
817,846,8,854,1077,0,0,79.29,582,264,正興里,NULL
796,844,10,854,1112,0,0,76.8,566,278,仁美里,NULL
259,842,12,854,1090,0,0,78.35,522,320,漳和里,NULL
485,844,10,854,1151,0,0,74.2,492,352,南昌里,NULL
446,842,12,854,1106,0,0,77.22,462,380,介壽里,NULL
0,842,12,854,1106,0,0,77.22,462,380,介壽里,NULL
858,846,8,854,1148,0,0,74.39,451,395,中崙里,NULL
423,845,9,854,1215,0,0,70.29,445,400,重光里,NULL
489,842,12,854,1089,0,0,78.42,445,397,長春里,NULL
529,846,8,854,1103,0,0,77.43,439,407,慈福里,NULL
189,845,9,854,1137,0,0,75.11,431,414,鹿寮里,NULL
171,848,6,854,1112,0,0,76.8,401,447,西燕村,NULL
356,846,8,854,1125,0,0,75.91,376,470,麟趾村,NULL
584,847,7,854,1100,0,0,77.64,375,472,知義里,NULL
243,853,1,854,1098,0,0,77.78,373,480,港南里,NULL
915,845,9,854,1062,0,0,80.41,371,474,福興里,NULL
311,852,2,854,1121,0,0,76.18,353,499,安泰里,NULL
102,847,7,854,1115,0,0,76.59,159,688,平和里,NULL
0,847,7,854,1115,0,0,76.59,159,688,平和里,NULL
197,848,5,853,1062,0,0,80.32,704,144,上埔里,NULL
34,839,14,853,1052,0,0,81.08,624,215,綠水里,NULL
436,843,10,853,1113,0,0,76.64,584,259,崙峯里,NULL
241,838,15,853,1095,0,0,77.9,529,309,平昌里,NULL
706,845,8,853,1060,0,0,80.47,521,324,嘉穗里,NULL
33,844,9,853,1170,0,0,72.91,511,333,江南里,NULL
0,844,9,853,1170,0,0,72.91,511,333,江南里,NULL
2087,851,2,853,1072,0,0,79.57,506,345,萬順村,NULL
529,852,1,853,1210,0,0,70.5,499,353,枋寮村,NULL
0,852,1,853,1210,0,0,70.5,499,353,枋寮村,NULL
1144,845,8,853,1051,0,0,81.16,487,358,文明里,NULL
316,847,6,853,1092,0,0,78.11,448,399,文南村,NULL
560,847,6,853,1114,0,0,76.57,444,403,內定里,NULL
429,844,9,853,1030,0,0,82.82,437,407,漯底村,NULL
0,844,9,853,1030,0,0,82.82,437,407,漯底村,NULL
79,849,4,853,1182,0,0,72.17,428,421,仁德里,NULL
0,849,4,853,1182,0,0,72.17,428,421,仁德里,NULL
652,842,11,853,1074,0,0,79.42,422,420,衛武里,NULL
122,850,3,853,1198,0,0,71.2,393,457,隘丁里,NULL
726,842,11,853,1071,0,0,79.65,339,503,文山里,NULL
185,842,11,853,1192,0,0,71.56,339,503,泗溝村,NULL
0,842,11,853,1192,0,0,71.56,339,503,泗溝村,NULL
130,845,8,853,1138,0,0,74.96,315,530,東勢村,NULL
501,842,11,853,1125,0,0,75.82,300,542,安加村,NULL
0,842,11,853,1125,0,0,75.82,300,542,安加村,NULL
76,848,5,853,1126,0,0,75.75,297,551,城西里,NULL
0,848,5,853,1126,0,0,75.75,297,551,城西里,NULL
52,844,8,852,1074,0,0,79.33,624,220,東信里,NULL
884,843,9,852,1074,0,0,79.33,609,234,永樂里,NULL
201,849,3,852,1065,0,0,80,593,256,龍山里,NULL
60,847,5,852,1073,0,0,79.4,514,333,建昌里,NULL
428,848,4,852,1087,0,0,78.38,513,335,成功里,NULL
207,845,7,852,1164,0,0,73.2,504,341,南勢里,NULL
250,844,8,852,1145,0,0,74.41,483,361,豐田里,NULL
326,847,5,852,1112,0,0,76.62,450,397,東榮村,NULL
815,844,8,852,1132,0,0,75.27,427,417,國光里,NULL
531,842,10,852,1114,0,0,76.48,372,470,大明里,NULL
0,842,10,852,1114,0,0,76.48,372,470,大明里,NULL
410,847,5,852,1102,0,0,77.31,346,501,港西村,NULL
522,843,9,852,1093,0,0,77.95,330,513,昌隆村,NULL
0,843,9,852,1093,0,0,77.95,330,513,昌隆村,NULL
227,847,4,851,1047,0,0,81.28,703,144,蟠桃里,NULL
123,845,6,851,1184,0,0,71.88,646,199,明湖里,NULL
602,839,12,851,1140,0,0,74.65,574,265,普仁里,NULL
157,840,11,851,1097,0,0,77.58,569,271,山佳里,NULL
429,842,9,851,1084,0,0,78.51,539,303,鎮南里,NULL
469,846,5,851,1259,0,0,67.59,533,313,灣丘村,NULL
0,846,5,851,1259,0,0,67.59,533,313,灣丘村,NULL
700,840,11,851,1110,0,0,76.67,511,329,瑚璉村,NULL
663,845,6,851,1104,0,0,77.08,506,339,溝皂里,NULL
10,842,9,851,1086,0,0,78.36,428,414,西墩里,NULL
237,845,6,851,1228,0,0,69.3,374,471,同樂村,NULL
280,846,5,851,1156,0,0,73.62,349,497,鎮安村,NULL
232,844,7,851,1116,0,0,76.25,332,512,大樹村,NULL
721,837,13,850,1093,0,0,77.77,642,195,復興里,NULL
66,846,4,850,1157,0,0,73.47,621,225,國裕里,NULL
132,844,6,850,1036,0,0,82.05,591,253,新埔里,NULL
0,844,6,850,1036,0,0,82.05,591,253,新埔里,NULL
607,843,7,850,1030,0,0,82.52,535,308,山頂村,NULL
170,846,4,850,1130,0,0,75.22,526,320,法華里,NULL
425,839,11,850,1143,0,0,74.37,523,316,林頭里,NULL
109,842,8,850,1195,0,0,71.13,511,331,東崎里,NULL
308,839,11,850,1123,0,0,75.69,488,351,義德村,NULL
0,839,11,850,1123,0,0,75.69,488,351,義德村,NULL
500,842,8,850,1384,0,0,61.42,485,357,山腳村,NULL
0,842,8,850,1384,0,0,61.42,485,357,山腳村,NULL
621,843,7,850,1204,0,0,70.6,469,374,墾丁里,NULL
0,843,7,850,1204,0,0,70.6,469,374,墾丁里,NULL
276,837,13,850,1273,0,0,66.77,447,390,南港里,NULL
0,837,13,850,1273,0,0,66.77,447,390,南港里,NULL
533,840,10,850,1267,0,0,67.09,431,409,崁腳村,NULL
0,840,10,850,1267,0,0,67.09,431,409,崁腳村,NULL
156,847,3,850,1117,0,0,76.1,422,425,中營里,NULL
0,847,3,850,1117,0,0,76.1,422,425,中營里,NULL
271,838,12,850,1187,0,0,71.61,408,430,鳳山里,NULL
0,838,12,850,1187,0,0,71.61,408,430,鳳山里,NULL
367,838,12,850,1094,0,0,77.7,394,444,臺上里,NULL
214,838,12,850,1085,0,0,78.34,374,464,舊路村,NULL
449,846,4,850,1070,0,0,79.44,353,493,美華里,NULL
318,843,7,850,1203,0,0,70.66,276,567,潭大村,NULL
0,843,7,850,1203,0,0,70.66,276,567,潭大村,NULL
691,843,7,850,1181,0,0,71.97,240,603,中汕村,NULL
609,842,7,849,1075,0,0,78.98,652,190,水尾里,NULL
512,835,14,849,1137,0,0,74.67,575,260,新城里,NULL
146,840,9,849,1167,0,0,72.75,546,294,中正里,NULL
245,834,15,849,1123,0,0,75.6,531,303,龍泉村,NULL
132,845,4,849,1068,0,0,79.49,500,345,育英里,NULL
612,840,9,849,1057,0,0,80.32,494,346,信和里,NULL
624,844,5,849,1048,0,0,81.01,488,356,中山里,NULL
37,843,6,849,1108,0,0,76.62,480,363,東勢里,NULL
0,843,6,849,1108,0,0,76.62,480,363,東勢里,NULL
1641,837,12,849,1121,0,0,75.74,473,364,三福里,NULL
1061,834,15,849,1086,0,0,78.18,471,363,福營里,NULL
192,842,7,849,1104,0,0,76.9,438,404,保社村,NULL
209,844,5,849,1184,0,0,71.71,436,408,東中村,NULL
187,841,8,849,1307,0,0,64.96,349,492,鹿北村,NULL
0,841,8,849,1307,0,0,64.96,349,492,鹿北村,NULL
620,843,6,849,1124,0,0,75.53,342,501,大寮村,NULL
710,834,15,849,1104,0,0,76.9,334,500,崑山里,NULL
541,845,4,849,1098,0,0,77.32,316,529,港墘村,NULL
502,836,13,849,1028,0,0,82.59,250,586,竹後村,NULL
246,844,4,848,1043,0,0,81.3,644,200,員山村,NULL
251,838,10,848,1022,0,0,82.97,634,204,重興村,NULL
103,841,7,848,1210,0,0,70.08,569,272,太平村,NULL
657,840,8,848,1074,0,0,78.96,556,284,延平里,NULL
910,837,11,848,1084,0,0,78.23,550,287,佳安村,NULL
105,837,11,848,1093,0,0,77.58,528,309,安民里,NULL
0,837,11,848,1093,0,0,77.58,528,309,安民里,NULL
288,842,6,848,1111,0,0,76.33,472,370,僑中里,NULL
1728,841,7,848,1133,0,0,74.85,446,395,中山里,NULL
61,844,4,848,1135,0,0,74.71,442,402,安寮里,NULL
258,839,9,848,1168,0,0,72.6,439,400,宅內村,NULL
0,839,9,848,1168,0,0,72.6,439,400,宅內村,NULL
85,841,7,848,1249,0,0,67.89,430,411,福田里,NULL
0,841,7,848,1249,0,0,67.89,430,411,福田里,NULL
370,839,9,848,1209,0,0,70.14,318,521,王功村,NULL
286,841,7,848,1128,0,0,75.18,305,536,中賢村,NULL
473,839,9,848,1065,0,0,79.62,304,535,甲北村,NULL
5,842,5,847,1610,0,0,52.61,793,49,西門里,NULL
24,843,4,847,1571,0,0,53.91,790,53,新市里,NULL
108,842,5,847,1041,0,0,81.36,696,146,榮華里,NULL
190,838,9,847,1047,0,0,80.9,642,196,新華里,NULL
412,837,10,847,1002,0,0,84.53,624,213,三灣村,NULL
581,835,12,847,1083,0,0,78.21,621,214,內壢里,NULL
536,842,5,847,1094,0,0,77.42,539,303,樹德里,NULL
749,835,12,847,1121,0,0,75.56,518,317,饒平村,NULL
325,842,5,847,1200,0,0,70.58,473,369,中山里,NULL
342,842,5,847,1042,0,0,81.29,453,389,岡山里,NULL
112,838,9,847,1008,0,0,84.03,451,387,吉翠里,NULL
445,835,12,847,1144,0,0,74.04,413,422,振興里,NULL
249,844,3,847,1097,0,0,77.21,376,468,南興村,NULL
263,843,4,847,1097,0,0,77.21,361,482,營前村,NULL
655,840,7,847,1135,0,0,74.63,347,493,溪州村,NULL
536,841,6,847,1146,0,0,73.91,329,512,大社村,NULL
679,839,8,847,1140,0,0,74.3,322,517,龍潭里,NULL
267,836,11,847,1104,0,0,76.72,243,593,中營村,NULL
0,836,11,847,1104,0,0,76.72,243,593,中營村,NULL
17,841,5,846,1155,0,0,73.25,593,248,正濱里,NULL
0,841,5,846,1155,0,0,73.25,593,248,正濱里,NULL
14,844,2,846,1077,0,0,78.55,570,274,思源里,NULL
227,838,8,846,1121,0,0,75.47,569,269,松和里,NULL
320,835,11,846,1062,0,0,79.66,567,268,大宏里,NULL
173,833,13,846,1098,0,0,77.05,505,328,南燕村,NULL
2055,841,5,846,1042,0,0,81.19,501,340,林口村,NULL
460,834,12,846,1144,0,0,73.95,499,335,瑞興里,NULL
415,839,7,846,1077,0,0,78.55,468,371,國隆里,NULL
278,836,10,846,1103,0,0,76.7,466,370,老庄里,NULL
1428,840,6,846,1082,0,0,78.19,463,377,延壽里,NULL
190,840,6,846,1083,0,0,78.12,427,413,鹿寮里,NULL
368,841,5,846,1151,0,0,73.5,426,415,竹崎村,NULL
176,839,7,846,1100,0,0,76.91,419,420,沙鹿里,NULL
0,839,7,846,1100,0,0,76.91,419,420,沙鹿里,NULL
532,837,9,846,1096,0,0,77.19,414,423,大營村,NULL
855,838,8,846,1161,0,0,72.87,406,432,中民里,NULL
120,844,2,846,1172,0,0,72.18,365,479,岸內里,NULL
278,839,7,846,1155,0,0,73.25,310,529,甲東村,NULL
224,838,7,845,1040,0,0,81.25,677,161,成功里,NULL
19,840,5,845,1083,0,0,78.02,582,258,汴頭村,NULL
919,838,7,845,1043,0,0,81.02,579,259,仁愛里,NULL
724,830,15,845,1137,0,0,74.32,561,269,廣仁里,NULL
737,837,8,845,1079,0,0,78.31,553,284,清水村,NULL
0,837,8,845,1079,0,0,78.31,553,284,清水村,NULL
706,839,6,845,1120,0,0,75.45,525,314,正得里,NULL
39,841,4,845,1265,0,0,66.8,514,327,康樂里,NULL
0,841,4,845,1265,0,0,66.8,514,327,康樂里,NULL
717,840,5,845,1090,0,0,77.52,504,336,廣興里,NULL
590,831,14,845,1084,0,0,77.95,473,358,安祥里,NULL
618,839,6,845,1118,0,0,75.58,448,391,三合里,NULL
501,841,4,845,1084,0,0,77.95,446,395,積善里,NULL
507,841,4,845,1073,0,0,78.75,432,409,八卦村,NULL
359,839,6,845,1217,0,0,69.43,429,410,興南村,NULL
274,836,9,845,1146,0,0,73.73,408,428,梅東村,NULL
0,837,8,845,1198,0,0,70.53,389,448,港邊里,NULL
380,835,10,845,1053,0,0,80.25,369,466,內厝村,NULL
523,842,3,845,1150,0,0,73.48,366,476,新江里,NULL
0,842,3,845,1150,0,0,73.48,366,476,新江里,NULL
256,833,12,845,1112,0,0,75.99,362,471,新昌里,NULL
30,837,8,845,1162,0,0,72.72,356,481,白河里,NULL
114,828,16,844,1053,0,0,80.15,702,126,五豐里,NULL
400,837,7,844,1066,0,0,79.17,698,139,造橋村,NULL
11,839,5,844,1176,0,0,71.77,616,223,新豐里,NULL
1962,835,9,844,1193,0,0,70.75,608,227,深澳里,NULL
0,835,9,844,1193,0,0,70.75,608,227,深澳里,NULL
582,832,12,844,1053,0,0,80.15,600,232,福善里,NULL
812,838,6,844,1076,0,0,78.44,534,304,勵行里,NULL
0,838,6,844,1076,0,0,78.44,534,304,勵行里,NULL
68,839,5,844,1102,0,0,76.59,524,315,興安里,NULL
9,837,7,844,1094,0,0,77.15,486,351,庄美里,NULL
938,841,3,844,1120,0,0,75.36,477,364,埔頂村,NULL
1413,838,6,844,1086,0,0,77.72,466,372,廷寮里,NULL
537,830,14,844,1063,0,0,79.4,461,369,慈化里,NULL
722,832,12,844,1066,0,0,79.17,457,375,廣達里,NULL
239,835,9,844,1066,0,0,79.17,441,394,新豐村,NULL
565,841,3,844,1033,0,0,81.7,396,445,和煦里,NULL
2060,838,6,844,1094,0,0,77.15,394,444,菁湖村,NULL
341,842,2,844,1100,0,0,76.73,376,466,鎮山里,NULL
862,839,5,844,1053,0,0,80.15,371,468,松腳村,NULL
103,840,4,844,1117,0,0,75.56,360,480,德協村,NULL
0,840,4,844,1117,0,0,75.56,360,480,德協村,NULL
5,835,9,844,1247,0,0,67.68,340,495,灣南村,NULL
0,835,9,844,1247,0,0,67.68,340,495,灣南村,NULL
235,839,5,844,1134,0,0,74.43,317,522,檨腳村,NULL
135,838,6,844,1246,0,0,67.74,313,525,老埤村,NULL
307,837,7,844,1106,0,0,76.31,243,594,佛壇里,NULL
317,840,4,844,1192,0,0,70.81,208,632,港後村,NULL
792,832,11,843,1051,0,0,80.21,686,146,秀峰里,NULL
222,836,7,843,1027,0,0,82.08,638,198,建國里,NULL
296,830,13,843,1106,0,0,76.22,521,309,甲南村,NULL
109,831,12,843,1023,0,0,82.4,517,314,光鎮里,NULL
283,830,13,843,1071,0,0,78.71,511,319,和調里,NULL
133,836,7,843,1053,0,0,80.06,500,336,竹南里,NULL
325,836,7,843,1095,0,0,76.99,499,337,建興里,NULL
108,837,6,843,1029,0,0,81.92,460,377,朝陽里,NULL
106,837,6,843,1124,0,0,75,459,378,繁隆村,NULL
0,837,6,843,1124,0,0,75,459,378,繁隆村,NULL
476,835,8,843,1055,0,0,79.91,444,391,崇德里,NULL
132,837,6,843,1164,0,0,72.42,425,412,新西里,NULL
224,837,6,843,1095,0,0,76.99,315,522,水寮村,NULL
128,835,8,843,1123,0,0,75.07,267,568,富田村,NULL
171,835,7,842,1063,0,0,79.21,630,205,東安里,NULL
605,836,6,842,1045,0,0,80.57,569,267,過溝村,NULL
148,828,14,842,1047,0,0,80.42,562,266,聖福里,NULL
37,838,4,842,1017,0,0,82.79,546,292,國光里,NULL
176,835,7,842,1040,0,0,80.96,535,300,富貴里,NULL
82,835,7,842,1178,0,0,71.48,534,301,東門里,NULL
1404,833,9,842,1110,0,0,75.86,512,321,清水里,NULL
1086,834,8,842,1084,0,0,77.68,499,335,龍安里,NULL
1723,834,8,842,1142,0,0,73.73,464,370,山佳里,NULL
347,837,5,842,1257,0,0,66.98,454,383,延平里,NULL
170,838,4,842,1189,0,0,70.82,438,400,長南村,NULL
268,829,13,842,1091,0,0,77.18,399,430,日新里,NULL
568,833,9,842,1085,0,0,77.6,382,451,中庄村,NULL
261,834,8,842,1165,0,0,72.27,377,457,華勝里,NULL
272,834,8,842,1161,0,0,72.52,371,463,廣興村,NULL
229,838,4,842,1268,0,0,66.4,362,476,寶樹里,NULL
0,838,4,842,1268,0,0,66.4,362,476,寶樹里,NULL
848,833,9,842,1089,0,0,77.32,352,481,山西村,NULL
193,836,6,842,1153,0,0,73.03,338,498,吳沙村,NULL
493,832,10,842,1099,0,0,76.62,330,502,永煇里,NULL
491,832,9,841,1159,0,0,72.56,668,164,澤仁村,NULL
0,832,9,841,1159,0,0,72.56,668,164,澤仁村,NULL
223,831,10,841,1077,0,0,78.09,650,181,鳳凰村,NULL
51,838,3,841,1018,0,0,82.61,602,236,大昌里,NULL
674,829,12,841,1033,0,0,81.41,597,232,和興里,NULL
0,828,13,841,1287,0,0,65.35,578,250,大榮里,NULL
113,834,7,841,1126,0,0,74.69,554,280,立仁里,NULL
1334,834,7,841,1090,0,0,77.16,534,300,員信里,NULL
650,828,13,841,1067,0,0,78.82,525,303,三條里,NULL
200,837,4,841,1192,0,0,70.55,487,350,光華里,NULL
2043,831,10,841,1078,0,0,78.01,459,372,貴子村,NULL
179,829,12,841,1077,0,0,78.09,452,377,福安村,NULL
592,834,7,841,1389,0,0,60.55,451,383,永靖村,NULL
0,834,7,841,1389,0,0,60.55,451,383,永靖村,NULL
0,829,12,841,1134,0,0,74.16,446,383,梅埔里,NULL
35,835,6,841,1112,0,0,75.63,440,395,頂店里,NULL
147,833,8,841,1231,0,0,68.32,437,396,隘寮村,NULL
0,833,8,841,1231,0,0,68.32,437,396,隘寮村,NULL
117,827,14,841,1095,0,0,76.8,380,447,美和村,NULL
1173,837,3,840,1023,0,0,82.11,679,158,中華里,NULL
1201,835,5,840,1054,0,0,79.7,670,165,國豐里,NULL
11,831,9,840,1058,0,0,79.4,647,184,玉華里,NULL
247,835,5,840,1089,0,0,77.13,645,190,濫坑里,NULL
216,825,15,840,1121,0,0,74.93,578,247,清泉里,NULL
2037,838,2,840,1038,0,0,80.92,551,287,明志村,NULL
326,836,4,840,1153,0,0,72.85,527,309,中山里,NULL
264,832,8,840,1073,0,0,78.29,520,312,福山村,NULL
180,832,8,840,1050,0,0,80,518,314,鼓峰里,NULL
45,830,10,840,1092,0,0,76.92,518,312,千甲里,NULL
95,834,6,840,1088,0,0,77.21,518,316,新興里,NULL
2053,835,5,840,1139,0,0,73.75,516,319,林口村,NULL
303,833,7,840,1062,0,0,79.1,447,386,隆本村,NULL
110,831,9,840,1061,0,0,79.17,445,386,朝陽里,NULL
41,830,10,840,1111,0,0,75.61,439,391,四張里,NULL
526,829,11,840,1140,0,0,73.68,392,437,燄溫村,NULL
0,829,11,840,1140,0,0,73.68,392,437,燄溫村,NULL
134,834,6,840,1120,0,0,75,374,460,阿蓮村,NULL
275,831,9,840,1107,0,0,75.88,372,459,明亮里,NULL
254,833,7,840,1154,0,0,72.79,357,476,嘉泰村,NULL
0,833,7,840,1154,0,0,72.79,357,476,嘉泰村,NULL
0,832,8,840,1176,0,0,71.43,350,482,關嶺里,NULL
512,828,12,840,1119,0,0,75.07,346,482,棋盤村,NULL
649,832,8,840,1065,0,0,78.87,299,533,芝芭里,NULL
297,832,8,840,1106,0,0,75.95,292,540,喜北里,NULL
0,831,8,839,1150,0,0,72.96,676,155,南豐村,NULL
230,832,7,839,1074,0,0,78.12,664,168,東庄里,NULL
169,834,5,839,1218,0,0,68.88,633,201,鳳仁里,NULL
0,834,5,839,1218,0,0,68.88,633,201,鳳仁里,NULL
140,829,10,839,1021,0,0,82.17,565,264,新南里,NULL
692,830,9,839,1098,0,0,76.41,543,287,平安里,NULL
70,837,2,839,1020,0,0,82.25,535,302,秀昌里,NULL
524,830,9,839,1105,0,0,75.93,527,303,仁義里,NULL
352,832,7,839,1054,0,0,79.6,515,317,舊正村,NULL
462,832,7,839,1128,0,0,74.38,493,339,中山里,NULL
722,834,5,839,1069,0,0,78.48,487,347,仁雅村,NULL
1088,831,8,839,1090,0,0,76.97,442,389,富國里,NULL
404,827,12,839,1056,0,0,79.45,440,387,光榮里,NULL
0,827,12,839,1056,0,0,79.45,440,387,光榮里,NULL
139,827,12,839,1198,0,0,70.03,412,415,東屯里,NULL
0,827,12,839,1198,0,0,70.03,412,415,東屯里,NULL
563,834,5,839,1108,0,0,75.72,392,442,太平里,NULL
251,835,4,839,1053,0,0,79.68,377,458,再興里,NULL
328,831,8,839,1048,0,0,80.06,375,456,達勇里,NULL
0,831,8,839,1048,0,0,80.06,375,456,達勇里,NULL
674,835,4,839,1161,0,0,72.27,304,531,小港里,NULL
695,833,6,839,1100,0,0,76.27,300,533,大灣里,NULL
272,832,7,839,1157,0,0,72.52,243,589,甲中村,NULL
0,832,7,839,1157,0,0,72.52,243,589,甲中村,NULL
76,830,8,838,1512,0,0,55.42,705,125,三民里,NULL
676,835,3,838,1003,0,0,83.55,638,197,和興里,NULL
312,829,9,838,1035,0,0,80.97,625,204,館東村,NULL
1741,833,5,838,1256,0,0,66.72,535,298,北鶯里,NULL
701,828,10,838,1090,0,0,76.88,483,345,瑚璉村,NULL
95,831,7,838,1148,0,0,73,469,362,書院里,NULL
0,831,7,838,1148,0,0,73,469,362,書院里,NULL
998,835,3,838,1053,0,0,79.58,460,375,中華里,NULL
751,833,5,838,1044,0,0,80.27,456,377,三民里,NULL
0,833,5,838,1044,0,0,80.27,456,377,三民里,NULL
312,824,14,838,1136,0,0,73.77,447,377,石牌里,NULL
0,824,14,838,1136,0,0,73.77,447,377,石牌里,NULL
150,833,5,838,1045,0,0,80.19,427,406,湖內里,NULL
731,827,11,838,1076,0,0,77.88,422,405,廈莊里,NULL
921,833,5,838,1063,0,0,78.83,421,412,福誠里,NULL
991,831,7,838,1146,0,0,73.12,419,412,自強里,NULL
377,835,3,838,1069,0,0,78.39,408,427,寶厝村,NULL
85,826,12,838,1095,0,0,76.53,397,429,開元里,NULL
4,827,10,837,1052,0,0,79.56,655,172,維祥里,NULL
178,830,7,837,1070,0,0,78.22,559,271,金華里,NULL
729,829,8,837,1115,0,0,75.07,531,298,復國里,NULL
1309,829,8,837,1083,0,0,77.29,467,362,頂福里,NULL
146,833,4,837,1096,0,0,76.37,392,441,嵐翠里,NULL
302,830,7,837,1145,0,0,73.1,386,444,松柏村,NULL
0,830,7,837,1145,0,0,73.1,386,444,松柏村,NULL
425,833,4,837,1134,0,0,73.81,367,466,崁頂村,NULL
273,830,7,837,1161,0,0,72.09,366,464,廣興村,NULL
903,831,6,837,1060,0,0,78.96,356,475,南成里,NULL
49,828,8,836,1100,0,0,76,570,258,新社里,NULL
697,823,13,836,1070,0,0,78.13,553,270,積穗里,NULL
319,827,9,836,1141,0,0,73.27,535,292,永城里,NULL
602,827,9,836,1265,0,0,66.09,509,318,山脚里,NULL
721,825,11,836,1046,0,0,79.92,498,327,廣達里,NULL
83,829,7,836,1129,0,0,74.05,489,340,杷城里,NULL
192,835,1,836,1061,0,0,78.79,471,364,吳沙村,NULL
202,829,7,836,1100,0,0,76,391,438,新生里,NULL
0,829,7,836,1100,0,0,76,391,438,新生里,NULL
826,828,8,836,1082,0,0,77.26,390,438,武漢里,NULL
238,832,4,836,1106,0,0,75.59,352,480,新民里,NULL
0,832,4,836,1106,0,0,75.59,352,480,新民里,NULL
319,829,7,836,1039,0,0,80.46,348,481,立業里,NULL
0,829,7,836,1039,0,0,80.46,348,481,立業里,NULL
544,828,8,836,1161,0,0,72.01,310,518,新庄村,NULL
0,828,8,836,1161,0,0,72.01,310,518,新庄村,NULL
96,829,6,835,1034,0,0,80.75,670,159,鷄林里,NULL
354,828,7,835,1068,0,0,78.18,565,263,坑口村,NULL
587,829,6,835,1025,0,0,81.46,525,304,同慶里,NULL
740,828,7,835,1043,0,0,80.06,522,306,錦中里,NULL
784,823,12,835,1102,0,0,75.77,518,305,中路里,NULL
748,827,8,835,1087,0,0,76.82,502,325,新勢里,NULL
51,831,4,835,1214,0,0,68.78,458,373,東北村,NULL
0,831,4,835,1214,0,0,68.78,458,373,東北村,NULL
579,825,10,835,1115,0,0,74.89,455,370,豐榮里,NULL
277,831,4,835,1038,0,0,80.44,450,381,老庄里,NULL
339,831,4,835,1091,0,0,76.54,440,391,保寧村,NULL
781,825,10,835,1048,0,0,79.68,438,387,東路里,NULL
0,825,10,835,1048,0,0,79.68,438,387,東路里,NULL
986,824,11,835,1083,0,0,77.1,426,398,自信里,NULL
170,825,10,835,1069,0,0,78.11,421,404,安東村,NULL
423,829,6,835,1029,0,0,81.15,408,421,正德里,NULL
0,829,6,835,1029,0,0,81.15,408,421,正德里,NULL
836,828,7,835,1079,0,0,77.39,395,433,新樂里,NULL
523,828,7,835,1172,0,0,71.25,356,472,新廣村,NULL
0,828,7,835,1172,0,0,71.25,356,472,新廣村,NULL
879,827,8,835,1051,0,0,79.45,352,475,一甲里,NULL
476,827,8,835,1025,0,0,81.46,338,489,甲南村,NULL
690,828,7,835,1099,0,0,75.98,305,523,西勢里,NULL
582,825,9,834,1049,0,0,79.5,617,208,內壢里,NULL
216,816,18,834,1073,0,0,77.73,589,227,湖口村,NULL
105,828,6,834,1139,0,0,73.22,562,266,北梅里,NULL
889,828,6,834,1061,0,0,78.61,529,299,文盛里,NULL
28,824,10,834,1033,0,0,80.74,519,305,自強里,NULL
35,830,4,834,1096,0,0,76.09,514,316,和東里,NULL
1712,831,3,834,1123,0,0,74.27,508,323,中華里,NULL
581,826,8,834,1033,0,0,80.74,501,325,全興里,NULL
185,827,7,834,1049,0,0,79.5,474,353,新路村,NULL
366,826,8,834,1091,0,0,76.44,443,383,西湖里,NULL
704,825,9,834,1095,0,0,76.16,441,384,北門里,NULL
533,824,10,834,1100,0,0,75.82,415,409,永隆里,NULL
0,823,11,834,1360,0,0,61.32,387,436,水泉里,NULL
126,830,4,834,1143,0,0,72.97,337,493,埒內里,NULL
901,823,11,834,1074,0,0,77.65,334,489,南成里,NULL
126,824,9,833,1030,0,0,80.87,678,146,二重里,NULL
202,829,4,833,1118,0,0,74.51,542,287,北勢里,NULL
191,825,8,833,1071,0,0,77.78,511,314,華陽里,NULL
17,830,3,833,1043,0,0,79.87,501,329,文化里,NULL
335,823,10,833,1055,0,0,78.96,487,336,萊園村,NULL
0,823,10,833,1055,0,0,78.96,487,336,萊園村,NULL
102,826,7,833,1071,0,0,77.78,478,348,頂竹里,NULL
489,826,7,833,1123,0,0,74.18,474,352,仁里村,NULL
0,826,7,833,1123,0,0,74.18,474,352,仁里村,NULL
777,824,9,833,1109,0,0,75.11,441,383,鎮東里,NULL
15,823,10,833,1308,0,0,63.69,390,433,三盛村,NULL
325,826,7,833,1045,0,0,79.71,388,438,後鄉村,NULL
0,826,7,833,1045,0,0,79.71,388,438,後鄉村,NULL
671,825,8,833,1084,0,0,76.85,348,477,塩洲里,NULL
597,829,4,833,1076,0,0,77.42,314,515,永芳村,NULL
536,821,11,832,1187,0,0,70.09,485,336,崙子村,NULL
0,821,11,832,1187,0,0,70.09,485,336,崙子村,NULL
1429,822,10,832,1095,0,0,75.98,475,347,延壽里,NULL
566,823,9,832,1091,0,0,76.26,452,371,中和里,NULL
0,823,9,832,1091,0,0,76.26,452,371,中和里,NULL
487,832,0,832,1197,0,0,69.51,427,405,林投里,NULL
0,832,0,832,1197,0,0,69.51,427,405,林投里,NULL
475,827,5,832,1055,0,0,78.86,426,401,瑞德里,NULL
106,829,3,832,1160,0,0,71.72,425,404,瀰濃里,NULL
165,822,10,832,1052,0,0,79.09,422,400,福華里,NULL
0,828,4,832,1168,0,0,71.23,415,413,溪邊里,NULL
434,826,6,832,1106,0,0,75.23,410,416,江西村,NULL
0,826,6,832,1106,0,0,75.23,410,416,江西村,NULL
704,827,5,832,1040,0,0,80,395,432,西灣里,NULL
517,822,10,832,1141,0,0,72.92,385,437,荷苞村,NULL
71,826,6,832,1138,0,0,73.11,365,461,竹圍里,NULL
628,828,4,832,1089,0,0,76.4,358,470,內坑村,NULL
777,825,7,832,1102,0,0,75.5,345,480,後壁村,NULL
309,819,13,832,1059,0,0,78.56,287,532,同安里,NULL
367,828,4,832,1141,0,0,72.92,252,576,義和村,NULL
0,828,4,832,1141,0,0,72.92,252,576,義和村,NULL
680,825,6,831,990,0,0,83.94,712,113,龍安里,NULL
978,823,8,831,1155,0,0,71.95,471,352,富源村,NULL
262,822,9,831,1106,0,0,75.14,461,361,福山村,NULL
198,829,2,831,1090,0,0,76.24,448,381,水頭村,NULL
313,822,9,831,1068,0,0,77.81,444,378,竹西村,NULL
1520,816,15,831,1057,0,0,78.62,424,392,民和里,NULL
703,824,7,831,1042,0,0,79.75,418,406,北門里,NULL
159,827,4,831,1073,0,0,77.45,415,412,育英里,NULL
133,822,9,831,1102,0,0,75.41,376,446,阿蓮村,NULL
2113,819,12,831,1105,0,0,75.2,355,464,坪林村,NULL
0,819,12,831,1105,0,0,75.2,355,464,坪林村,NULL
314,825,6,831,1063,0,0,78.17,337,488,民享里,NULL
839,826,5,831,1090,0,0,76.24,307,519,媽廟村,NULL
181,823,8,831,1144,0,0,72.64,286,537,重寮村,NULL
0,823,8,831,1144,0,0,72.64,286,537,重寮村,NULL
269,821,10,831,1151,0,0,72.2,284,537,鹿埔村,NULL
280,822,8,830,1103,0,0,75.25,624,198,橫山村,NULL
642,820,10,830,1037,0,0,80.04,623,197,華南里,NULL
214,825,5,830,1058,0,0,78.45,600,225,永平里,NULL
121,822,8,830,1114,0,0,74.51,576,246,明湖里,NULL
681,822,8,830,1045,0,0,79.43,543,279,景勤里,NULL
1422,824,6,830,1067,0,0,77.79,496,328,峯廷里,NULL
690,821,9,830,1107,0,0,74.98,493,328,東北里,NULL
2154,821,9,830,1055,0,0,78.67,487,334,米倉村,NULL
1701,817,13,830,1052,0,0,78.9,460,357,和平里,NULL
365,820,10,830,1061,0,0,78.23,459,361,光田里,NULL
0,824,6,830,1133,0,0,73.26,448,376,下坪里,NULL
358,828,2,830,1064,0,0,78.01,442,386,碧紅里,NULL
135,821,9,830,1059,0,0,78.38,430,391,松柏里,NULL
145,820,10,830,1225,0,0,67.76,389,431,新民里,NULL
0,820,10,830,1225,0,0,67.76,389,431,新民里,NULL
668,827,3,830,1086,0,0,76.43,381,446,廣應村,NULL
339,823,7,830,1092,0,0,76.01,377,446,漢光里,NULL
640,823,7,830,1084,0,0,76.57,365,458,埔園里,NULL
1657,819,11,830,1446,0,0,57.4,348,471,潭底里,NULL
0,825,5,830,1185,0,0,70.04,299,526,三光村,NULL
497,826,4,830,1110,0,0,74.77,214,612,下廍里,NULL
0,807,22,829,1979,0,0,41.89,664,143,泰昌里,NULL
339,822,7,829,1032,0,0,80.33,648,174,銅鑼村,NULL
359,825,4,829,1041,0,0,79.63,639,186,南富村,NULL
0,825,4,829,1041,0,0,79.63,639,186,南富村,NULL
237,821,8,829,1079,0,0,76.83,612,209,民生里,NULL
484,822,7,829,1115,0,0,74.35,565,257,勤益里,NULL
195,819,10,829,1083,0,0,76.55,555,264,竹林里,NULL
392,823,6,829,1066,0,0,77.77,530,293,民龍里,NULL
276,821,8,829,1089,0,0,76.12,525,296,寶廍里,NULL
0,821,8,829,1089,0,0,76.12,525,296,寶廍里,NULL
1342,824,5,829,1051,0,0,78.88,517,307,員福里,NULL
222,820,9,829,1052,0,0,78.8,484,336,福安里,NULL
0,820,9,829,1052,0,0,78.8,484,336,福安里,NULL
2088,821,8,829,1043,0,0,79.48,454,367,萬福村,NULL
2020,825,4,829,1059,0,0,78.28,438,387,楓樹村,NULL
602,825,4,829,1007,0,0,82.32,405,420,永芳村,NULL
416,815,14,829,1122,0,0,73.89,357,458,和興村,NULL
519,822,7,829,1158,0,0,71.59,349,473,高林村,NULL
0,822,7,829,1158,0,0,71.59,349,473,高林村,NULL
19,825,4,829,1364,0,0,60.78,333,492,惠楠里,NULL
0,821,8,829,1352,0,0,61.32,321,500,保力村,NULL
179,821,7,828,1046,0,0,79.16,542,279,鼓峰里,NULL
40,823,5,828,1076,0,0,76.95,512,311,延平里,NULL
27,820,8,828,1091,0,0,75.89,489,331,文武里,NULL
161,824,4,828,1051,0,0,78.78,446,378,秀水村,NULL
2035,818,10,828,1103,0,0,75.07,436,382,明志村,NULL
1130,819,9,828,1058,0,0,78.26,414,405,光和里,NULL
804,822,6,828,1070,0,0,77.38,408,414,南保村,NULL
58,819,9,828,1057,0,0,78.33,407,412,頂寮里,NULL
113,818,10,828,1038,0,0,79.77,391,427,埤西里,NULL
0,818,10,828,1038,0,0,79.77,391,427,埤西里,NULL
697,825,3,828,1097,0,0,75.48,359,466,大灣里,NULL
0,819,9,828,1101,0,0,75.2,273,546,石湖村,NULL
31,826,1,827,1685,0,0,49.08,769,57,新湖里,NULL
127,817,10,827,1180,0,0,70.08,644,173,宜昌村,NULL
381,821,6,827,1076,0,0,76.86,604,217,勝興村,NULL
879,818,9,827,1029,0,0,80.37,574,244,大新里,NULL
1807,823,4,827,1040,0,0,79.52,547,276,龍埔里,NULL
157,821,6,827,1025,0,0,80.68,546,275,下寮里,NULL
30,812,15,827,1095,0,0,75.53,495,317,龍山里,NULL
21,822,5,827,1220,0,0,67.79,481,341,重光里,NULL
0,822,5,827,1220,0,0,67.79,481,341,重光里,NULL
268,817,10,827,1036,0,0,79.83,480,337,仁美里,NULL
287,813,14,827,1149,0,0,71.98,467,346,蔗廍村,NULL
558,822,5,827,1055,0,0,78.39,440,382,東榮里,NULL
125,818,9,827,1181,0,0,70.03,437,381,菁埔里,NULL
607,820,7,827,1033,0,0,80.06,406,414,英明里,NULL
304,819,8,827,1102,0,0,75.05,397,422,福安里,NULL
188,819,8,827,1107,0,0,74.71,381,438,林美村,NULL
0,819,8,827,1107,0,0,74.71,381,438,林美村,NULL
914,822,5,827,1038,0,0,79.67,361,461,福興里,NULL
440,822,5,827,1053,0,0,78.54,360,462,中崙村,NULL
0,822,5,827,1053,0,0,78.54,360,462,中崙村,NULL
191,819,8,827,1116,0,0,74.1,346,473,光武村,NULL
0,819,8,827,1116,0,0,74.1,346,473,光武村,NULL
83,819,8,827,1050,0,0,78.76,332,487,中興里,NULL
0,819,8,827,1050,0,0,78.76,332,487,中興里,NULL
38,818,9,827,1096,0,0,75.46,324,494,公親里,NULL
0,818,9,827,1096,0,0,75.46,324,494,公親里,NULL
380,821,6,827,1159,0,0,71.35,304,517,六合村,NULL
11,817,9,826,992,0,0,83.27,536,281,文華里,NULL
381,823,3,826,1060,0,0,77.92,529,294,東昇里,NULL
159,811,15,826,1018,0,0,81.14,521,290,南平里,NULL
0,811,15,826,1018,0,0,81.14,521,290,南平里,NULL
80,822,4,826,1026,0,0,80.51,520,302,水美村,NULL
177,818,8,826,1101,0,0,75.02,456,362,竹圍里,NULL
297,819,7,826,1156,0,0,71.45,435,384,大湖里,NULL
1343,813,13,826,1047,0,0,78.89,429,384,員福里,NULL
80,819,7,826,1105,0,0,74.75,416,403,仁和里,NULL
0,819,7,826,1105,0,0,74.75,416,403,仁和里,NULL
850,814,12,826,1085,0,0,76.13,408,406,香洋村,NULL
125,820,6,826,1018,0,0,81.14,388,432,中埔里,NULL
466,817,9,826,1200,0,0,68.83,383,434,聯美村,NULL
0,817,9,826,1200,0,0,68.83,383,434,聯美村,NULL
191,820,6,826,1068,0,0,77.34,380,440,鹿寮里,NULL
386,818,8,826,1055,0,0,78.29,234,584,新建里,NULL
0,818,8,826,1055,0,0,78.29,234,584,新建里,NULL
857,809,16,825,1036,0,0,79.63,558,251,高榮里,NULL
273,816,9,825,1020,0,0,80.88,553,263,大肚村,NULL
735,819,6,825,1023,0,0,80.65,526,293,復華里,NULL
244,818,7,825,1498,0,0,55.07,514,304,興仁里,NULL
730,814,11,825,1113,0,0,74.12,498,316,太平村,NULL
892,814,11,825,1029,0,0,80.17,490,324,龍潭村,NULL
1636,817,8,825,1060,0,0,77.83,481,336,東勢里,NULL
28,821,4,825,1071,0,0,77.03,472,349,東噴里,NULL
0,821,4,825,1071,0,0,77.03,472,349,東噴里,NULL
4,815,10,825,1016,0,0,81.2,452,363,黃石里,NULL
0,815,10,825,1016,0,0,81.2,452,363,黃石里,NULL
513,814,11,825,1090,0,0,75.69,451,363,福順里,NULL
123,813,12,825,1039,0,0,79.4,395,418,滿翠里,NULL
167,816,9,825,1138,0,0,72.5,378,438,重興里,NULL
87,816,9,825,1060,0,0,77.83,374,442,街尾里,NULL
707,816,9,825,1067,0,0,77.32,359,457,鎮北里,NULL
303,815,10,825,1099,0,0,75.07,292,523,永寧里,NULL
172,812,12,824,1039,0,0,79.31,622,190,東安里,NULL
65,818,6,824,1228,0,0,67.1,556,262,知本里,NULL
0,818,6,824,1228,0,0,67.1,556,262,知本里,NULL
374,819,5,824,1095,0,0,75.25,519,300,廣興村,NULL
422,817,7,824,1124,0,0,73.31,496,321,沙崙村,NULL
606,818,6,824,1053,0,0,78.25,492,326,山頂村,NULL
18,816,8,824,1083,0,0,76.08,478,338,香社里,NULL
97,819,5,824,999,0,0,82.48,463,356,東興里,NULL
800,822,2,824,1056,0,0,78.03,458,364,振興里,NULL
403,812,12,824,1031,0,0,79.92,452,360,仁義里,NULL
0,812,12,824,1031,0,0,79.92,452,360,仁義里,NULL
688,816,8,824,1104,0,0,74.64,431,385,烏竹里,NULL
22,817,7,824,1129,0,0,72.98,428,389,義寶村,NULL
0,817,7,824,1129,0,0,72.98,428,389,義寶村,NULL
235,817,7,824,1137,0,0,72.47,412,405,三德村,NULL
343,814,10,824,1164,0,0,70.79,367,447,岡山里,NULL
462,818,6,824,1135,0,0,72.6,365,453,十三里,NULL
0,818,6,824,1135,0,0,72.6,365,453,十三里,NULL
580,807,17,824,1142,0,0,72.15,361,446,西畔村,NULL
184,814,10,824,1047,0,0,78.7,348,466,鳳雄村,NULL
186,815,9,824,1127,0,0,73.11,334,481,五溝村,NULL
0,815,9,824,1127,0,0,73.11,334,481,五溝村,NULL
167,819,5,824,1093,0,0,75.39,332,487,東燕村,NULL
754,815,9,824,1030,0,0,80,297,518,太子村,NULL
618,820,4,824,1082,0,0,76.16,281,539,上寮村,NULL
22,814,9,823,1062,0,0,77.5,523,291,上林里,NULL
300,813,10,823,1043,0,0,78.91,522,291,學田村,NULL
0,816,7,823,1270,0,0,64.8,520,296,初鹿村,NULL
725,816,7,823,1089,0,0,75.57,490,326,美雅村,NULL
0,816,7,823,1089,0,0,75.57,490,326,美雅村,NULL
159,816,7,823,1099,0,0,74.89,479,337,大庄里,NULL
952,813,10,823,1071,0,0,76.84,478,335,榮和里,NULL
111,809,14,823,1080,0,0,76.2,433,376,小康里,NULL
532,813,10,823,1040,0,0,79.13,417,396,慈惠里,NULL
577,819,4,823,1059,0,0,77.71,406,413,後庄村,NULL
703,815,8,823,1017,0,0,80.92,357,458,西灣里,NULL
237,814,9,823,1071,0,0,76.84,354,460,麗興里,NULL
0,814,9,823,1071,0,0,76.84,354,460,麗興里,NULL
269,811,12,823,1126,0,0,73.09,334,477,永安里,NULL
0,811,12,823,1126,0,0,73.09,334,477,永安里,NULL
1199,817,5,822,1032,0,0,79.65,639,178,國豐里,NULL
89,815,7,822,1086,0,0,75.69,591,224,福瑞里,NULL
59,819,3,822,1189,0,0,69.13,588,231,國聯里,NULL
703,814,8,822,1102,0,0,74.59,494,320,浮圳村,NULL
0,814,8,822,1102,0,0,74.59,494,320,浮圳村,NULL
368,817,5,822,1059,0,0,77.62,475,342,成大里,NULL
1674,814,8,822,1094,0,0,75.14,474,340,圳民里,NULL
118,817,5,822,1082,0,0,75.97,472,345,新海里,NULL
1742,818,4,822,1022,0,0,80.43,456,362,西鶯里,NULL
20,816,6,822,1049,0,0,78.36,446,370,香雅里,NULL
293,817,5,822,1061,0,0,77.47,446,371,歡園里,NULL
0,817,5,822,1061,0,0,77.47,446,371,歡園里,NULL
862,812,10,822,1105,0,0,74.39,413,399,中榮里,NULL
113,820,2,822,1125,0,0,73.07,402,418,永榮里,NULL
739,812,10,822,1056,0,0,77.84,402,410,北庄村,NULL
443,816,6,822,1115,0,0,73.72,401,415,長泰里,NULL
385,810,12,822,1028,0,0,79.96,346,464,後村村,NULL
0,810,12,822,1028,0,0,79.96,346,464,後村村,NULL
351,817,5,822,1069,0,0,76.89,340,477,縣庄村,NULL
0,817,5,822,1069,0,0,76.89,340,477,縣庄村,NULL
41,814,8,822,1120,0,0,73.39,335,479,幸福里,NULL
278,815,7,822,1196,0,0,68.73,316,499,北汕里,NULL
485,815,7,822,1049,0,0,78.36,290,525,東林村,NULL
251,814,8,822,1241,0,0,66.24,215,599,平沙村,NULL
0,814,8,822,1241,0,0,66.24,215,599,平沙村,NULL
246,809,12,821,1087,0,0,75.53,563,246,平順里,NULL
924,811,10,821,1026,0,0,80.02,540,271,信義里,NULL
52,813,8,821,1080,0,0,76.02,518,295,福德里,NULL
0,813,8,821,1080,0,0,76.02,518,295,福德里,NULL
75,814,7,821,1080,0,0,76.02,510,304,忠勇里,NULL
0,814,7,821,1080,0,0,76.02,510,304,忠勇里,NULL
118,818,3,821,1090,0,0,75.32,475,343,公園里,NULL
977,810,11,821,1089,0,0,75.39,470,340,富源村,NULL
1515,814,7,821,1042,0,0,78.79,451,363,保和里,NULL
676,812,9,821,1136,0,0,72.27,449,363,林厝里,NULL
785,809,12,821,1053,0,0,77.97,428,381,興邦里,NULL
616,812,9,821,1078,0,0,76.16,425,387,民生里,NULL
351,813,8,821,1175,0,0,69.87,425,388,山崇里,NULL
250,818,3,821,1117,0,0,73.5,416,402,南興村,NULL
357,818,3,821,1092,0,0,75.18,387,431,六安里,NULL
139,814,7,821,1077,0,0,76.23,371,443,清蓮村,NULL
232,812,9,821,1067,0,0,76.94,371,441,樹下里,NULL
213,812,9,821,1108,0,0,74.1,358,454,溪洲村,NULL
0,812,9,821,1108,0,0,74.1,358,454,溪洲村,NULL
819,808,13,821,1052,0,0,78.04,348,460,辜厝村,NULL
191,815,6,821,1123,0,0,73.11,253,562,三角村,NULL
118,811,9,820,1008,0,0,81.35,641,170,三重里,NULL
228,810,10,820,1017,0,0,80.63,475,335,牛埔里,NULL
78,813,7,820,1319,0,0,62.17,465,348,赤崁村,NULL
0,813,7,820,1319,0,0,62.17,465,348,赤崁村,NULL
145,808,12,820,1083,0,0,75.72,459,349,中正里,NULL
298,811,9,820,1081,0,0,75.86,441,370,大湖里,NULL
580,805,15,820,1066,0,0,76.92,409,396,民生里,NULL
0,805,15,820,1066,0,0,76.92,409,396,民生里,NULL
0,812,8,820,1368,0,0,59.94,396,416,瓦磘村,NULL
342,815,5,820,1097,0,0,74.75,383,432,北勢里,NULL
856,811,9,820,1101,0,0,74.48,370,441,中民里,NULL
362,813,7,820,1034,0,0,79.3,333,480,新庄村,NULL
488,811,9,820,1126,0,0,72.82,319,492,興漁里,NULL
3,816,3,819,1442,0,0,56.8,775,41,南門里,NULL
376,815,4,819,1001,0,0,81.82,634,181,廣盛村,NULL
1187,815,4,819,1034,0,0,79.21,606,209,福德里,NULL
257,805,14,819,1067,0,0,76.76,597,208,松林村,NULL
601,812,7,819,1055,0,0,77.63,564,248,普仁里,NULL
615,814,5,819,1073,0,0,76.33,544,270,東和里,NULL
0,814,5,819,1073,0,0,76.33,544,270,東和里,NULL
730,814,5,819,1047,0,0,78.22,539,275,復國里,NULL
23,812,7,819,1046,0,0,78.3,538,274,東園里,NULL
737,803,16,819,1037,0,0,78.98,459,344,明德里,NULL
610,815,4,819,1029,0,0,79.59,459,356,會社村,NULL
224,811,8,819,1041,0,0,78.67,441,370,東安里,NULL
580,810,9,819,1109,0,0,73.85,418,392,全興里,NULL
177,814,5,819,1137,0,0,72.03,370,444,泗洲村,NULL
0,814,5,819,1137,0,0,72.03,370,444,泗洲村,NULL
569,816,3,819,1051,0,0,77.93,360,456,中庄村,NULL
526,812,7,819,998,0,0,82.06,338,474,南港里,NULL
406,806,12,818,1144,0,0,71.5,569,237,明德村,NULL
104,810,8,818,1102,0,0,74.23,546,264,北安里,NULL
252,804,14,818,1033,0,0,79.19,491,313,香山里,NULL
176,813,5,818,1081,0,0,75.67,489,324,大埔里,NULL
726,810,8,818,1095,0,0,74.7,475,335,里仁村,NULL
0,810,8,818,1095,0,0,74.7,475,335,里仁村,NULL
232,810,8,818,1090,0,0,75.05,463,347,龍津村,NULL
1671,809,9,818,1035,0,0,79.03,462,347,圳福里,NULL
37,813,5,818,1204,0,0,67.94,436,377,太白里,NULL
0,813,5,818,1204,0,0,67.94,436,377,太白里,NULL
62,812,6,818,1099,0,0,74.43,419,393,苑東里,NULL
664,809,9,818,1049,0,0,77.98,419,390,溝皂里,NULL
269,815,3,818,1061,0,0,77.1,418,397,田尾村,NULL
0,815,3,818,1061,0,0,77.1,418,397,田尾村,NULL
280,813,5,818,1102,0,0,74.23,401,412,永光里,NULL
0,813,5,818,1102,0,0,74.23,401,412,永光里,NULL
189,807,11,818,1119,0,0,73.1,390,417,深水村,NULL
392,815,3,818,1047,0,0,78.13,381,434,社皮村,NULL
261,808,10,818,1116,0,0,73.3,350,458,新興村,NULL
452,813,5,818,1074,0,0,76.16,346,467,智蚵村,NULL
633,806,12,818,1094,0,0,74.77,306,500,永康里,NULL
55,813,4,817,1020,0,0,80.1,665,148,軍功里,NULL
70,810,7,817,1078,0,0,75.79,651,159,國興里,NULL
164,812,5,817,1134,0,0,72.05,597,215,寶山里,NULL
112,811,6,817,1095,0,0,74.61,562,249,通化里,NULL
0,811,6,817,1095,0,0,74.61,562,249,通化里,NULL
143,807,10,817,1018,0,0,80.26,559,248,四座里,NULL
151,803,14,817,1141,0,0,71.6,533,270,草湳里,NULL
147,812,5,817,1114,0,0,73.34,457,355,鎮平村,NULL
0,812,5,817,1114,0,0,73.34,457,355,鎮平村,NULL
734,815,2,817,1014,0,0,80.57,449,366,文衡里,NULL
530,803,14,817,1044,0,0,78.26,432,371,慈生里,NULL
578,811,6,817,1073,0,0,76.14,391,420,後庄村,NULL
309,810,7,817,1139,0,0,71.73,378,432,集慶村,NULL
0,810,7,817,1139,0,0,71.73,378,432,集慶村,NULL
565,812,5,817,1110,0,0,73.6,362,450,太平里,NULL
320,809,8,817,1108,0,0,73.74,341,468,油車村,NULL
28,813,4,817,1175,0,0,69.53,340,473,福安村,NULL
0,813,4,817,1175,0,0,69.53,340,473,福安村,NULL
227,810,7,817,1215,0,0,67.24,331,479,蓁巷村,NULL
0,810,7,817,1215,0,0,67.24,331,479,蓁巷村,NULL
319,810,7,817,1098,0,0,74.41,280,530,南港村,NULL
0,810,7,817,1098,0,0,74.41,280,530,南港村,NULL
1825,809,7,816,1010,0,0,80.79,635,174,大埔里,NULL
22,809,7,816,1017,0,0,80.24,557,252,東園里,NULL
771,810,6,816,1008,0,0,80.95,552,258,中和里,NULL
117,814,2,816,1068,0,0,76.4,535,279,興南里,NULL
58,808,8,816,1031,0,0,79.15,515,293,溪州里,NULL
194,810,6,816,1077,0,0,75.77,509,301,竹林里,NULL
16,809,7,816,1129,0,0,72.28,509,300,七嘉村,NULL
427,807,9,816,1047,0,0,77.94,490,317,成功里,NULL
68,806,10,816,1087,0,0,75.07,477,329,大德里,NULL
92,809,7,816,1214,0,0,67.22,463,346,水頭里,NULL
1713,803,13,816,1070,0,0,76.26,460,343,太順里,NULL
608,805,11,816,1059,0,0,77.05,446,359,山頂村,NULL
338,814,2,816,1032,0,0,79.07,436,378,保寧村,NULL
409,812,4,816,1042,0,0,78.31,431,381,港西村,NULL
666,812,4,816,1073,0,0,76.05,427,385,竹東里,NULL
90,811,5,816,1040,0,0,78.46,407,404,華興里,NULL
381,808,8,816,1075,0,0,75.91,399,409,協和里,NULL
158,806,10,816,1032,0,0,79.07,393,413,育英里,NULL
247,807,9,816,1045,0,0,78.09,384,423,田寮里,NULL
917,811,5,816,1087,0,0,75.07,371,440,福興里,NULL
666,805,11,816,1071,0,0,76.19,369,436,王公村,NULL
26,803,12,815,1053,0,0,77.4,486,317,南門里,NULL
507,801,14,815,1030,0,0,79.13,443,358,德望里,NULL
258,810,5,815,1047,0,0,77.84,437,373,長春里,NULL
471,803,12,815,1041,0,0,78.29,435,368,順德里,NULL
413,806,9,815,1034,0,0,78.82,429,377,大園里,NULL
123,807,8,815,1122,0,0,72.64,414,393,新城里,NULL
0,807,8,815,1122,0,0,72.64,414,393,新城里,NULL
112,813,2,815,1135,0,0,71.81,383,430,福全里,NULL
303,810,5,815,1086,0,0,75.05,379,431,社西村,NULL
616,810,5,815,1001,0,0,81.42,368,442,福康里,NULL
556,810,5,815,1039,0,0,78.44,327,483,廣澤里,NULL
738,807,8,815,1046,0,0,77.92,325,482,山湖村,NULL
0,807,8,815,1046,0,0,77.92,325,482,山湖村,NULL
98,808,6,814,1105,0,0,73.67,570,238,西門里,NULL
175,808,6,814,997,0,0,81.64,570,238,光華里,NULL
1338,803,11,814,1048,0,0,77.67,524,279,員林里,NULL
53,807,7,814,999,0,0,81.48,520,287,民安里,NULL
885,802,12,814,1048,0,0,77.67,498,304,八德村,NULL
28,804,10,814,977,0,0,83.32,469,335,建華里,NULL
720,806,8,814,1034,0,0,78.72,457,349,文華里,NULL
45,805,9,814,1125,0,0,72.36,445,360,日南里,NULL
54,805,9,814,1024,0,0,79.49,435,370,建國里,NULL
2140,805,9,814,1155,0,0,70.48,435,370,興華村,NULL
0,805,9,814,1155,0,0,70.48,435,370,興華村,NULL
659,812,2,814,1106,0,0,73.6,420,392,潭頭村,NULL
255,808,6,814,1018,0,0,79.96,418,390,美山里,NULL
0,808,6,814,1018,0,0,79.96,418,390,美山里,NULL
270,808,6,814,1088,0,0,74.82,406,402,鹿埔村,NULL
125,804,10,814,1039,0,0,78.34,400,404,明翠里,NULL
61,798,16,814,1046,0,0,77.82,394,404,白地里,NULL
238,803,11,814,1039,0,0,78.34,388,415,新豐村,NULL
499,803,11,814,1251,0,0,65.07,366,437,潭墘村,NULL
774,807,7,814,1046,0,0,77.82,366,441,後壁村,NULL
0,803,11,814,1251,0,0,65.07,366,437,潭墘村,NULL
890,803,11,814,1040,0,0,78.27,361,442,富甲里,NULL
301,811,3,814,1053,0,0,77.3,359,452,德北里,NULL
50,803,11,814,1126,0,0,72.29,359,444,海西里,NULL
809,808,6,814,1039,0,0,78.34,319,489,六甲村,NULL
305,802,12,814,1126,0,0,72.29,273,529,南廍村,NULL
0,802,12,814,1126,0,0,72.29,273,529,南廍村,NULL
1,810,3,813,1478,0,0,55.01,748,62,東門里,NULL
240,807,6,813,1043,0,0,77.95,611,196,田寮里,NULL
688,808,5,813,970,0,0,83.81,552,256,景安里,NULL
780,807,6,813,974,0,0,83.47,551,256,瑞竹里,NULL
81,806,7,813,1052,0,0,77.28,542,264,福安里,NULL
71,804,9,813,1224,0,0,66.42,451,353,龍岩村,NULL
0,804,9,813,1224,0,0,66.42,451,353,龍岩村,NULL
95,803,10,813,1066,0,0,76.27,419,384,賢文里,NULL
200,806,7,813,1027,0,0,79.16,373,433,協進里,NULL
0,806,7,813,1027,0,0,79.16,373,433,協進里,NULL
468,802,11,813,1031,0,0,78.86,361,441,新勝里,NULL
866,801,12,813,1093,0,0,74.38,332,469,北花村,NULL
258,809,4,813,1052,0,0,77.28,331,478,沙地里,NULL
0,809,4,813,1052,0,0,77.28,331,478,沙地里,NULL
870,805,8,813,1054,0,0,77.13,306,499,正義里,NULL
423,805,8,813,1116,0,0,72.85,299,506,共和村,NULL
432,807,6,813,1028,0,0,79.09,297,510,梓信村,NULL
927,805,7,812,1036,0,0,78.38,574,231,上溪里,NULL
74,805,7,812,1190,0,0,68.24,541,264,柑林村,NULL
0,805,7,812,1190,0,0,68.24,541,264,柑林村,NULL
58,803,9,812,1141,0,0,71.17,525,278,國聯里,NULL
638,808,4,812,1035,0,0,78.45,513,295,南平里,NULL
736,800,12,812,1070,0,0,75.89,488,312,復華里,NULL
126,807,5,812,1055,0,0,76.97,470,337,明翠里,NULL
50,803,9,812,1006,0,0,80.72,467,336,大昌里,NULL
1426,800,12,812,1039,0,0,78.15,458,342,延吉里,NULL
959,801,11,812,1075,0,0,75.53,444,357,白玉村,NULL
0,801,11,812,1075,0,0,75.53,444,357,白玉村,NULL
176,801,11,812,1073,0,0,75.68,413,388,竹圍里,NULL
260,805,7,812,1115,0,0,72.83,396,409,新興村,NULL
780,809,3,812,1071,0,0,75.82,386,423,鎮海里,NULL
336,808,4,812,1080,0,0,75.19,334,474,仁義里,NULL
0,808,4,812,1080,0,0,75.19,334,474,仁義里,NULL
823,802,10,812,1036,0,0,78.38,333,469,武慶里,NULL
316,795,17,812,1095,0,0,74.16,317,478,三間村,NULL
0,795,17,812,1095,0,0,74.16,317,478,三間村,NULL
243,795,16,811,1690,0,0,47.99,643,152,松浦里,NULL
0,795,16,811,1690,0,0,47.99,643,152,松浦里,NULL
30,804,7,811,987,0,0,82.17,604,200,上苗里,NULL
1544,803,8,811,1064,0,0,76.22,562,241,大同里,NULL
2002,806,5,811,1045,0,0,77.61,498,308,福德村,NULL
136,800,11,811,1963,0,0,41.31,495,305,福德里,NULL
350,806,5,811,1059,0,0,76.58,478,328,仁愛里,NULL
286,800,11,811,1165,0,0,69.61,472,328,新街村,NULL
2029,806,5,811,1071,0,0,75.72,443,363,義學村,NULL
63,803,8,811,972,0,0,83.44,437,366,和昌里,NULL
93,794,17,811,1032,0,0,78.59,437,357,溪頭里,NULL
795,799,12,811,1081,0,0,75.02,421,378,二行村,NULL
39,801,10,811,1109,0,0,73.13,395,406,孟春里,NULL
297,800,11,811,1058,0,0,76.65,367,433,宮前村,NULL
293,807,4,811,1050,0,0,77.24,344,463,頂柳里,NULL
0,807,4,811,1050,0,0,77.24,344,463,頂柳里,NULL
654,801,10,811,1104,0,0,73.46,327,474,溪州村,NULL
94,807,3,810,1028,0,0,78.79,640,167,鷄林里,NULL
887,800,10,810,1073,0,0,75.49,500,300,八德村,NULL
88,803,7,810,1040,0,0,77.88,490,313,靈泉里,NULL
427,806,4,810,1053,0,0,76.92,490,316,崑崙村,NULL
0,803,7,810,1040,0,0,77.88,490,313,靈泉里,NULL
0,806,4,810,1053,0,0,76.92,490,316,崑崙村,NULL
320,808,2,810,1059,0,0,76.49,464,344,永城里,NULL
304,808,2,810,1023,0,0,79.18,450,358,隆本村,NULL
155,797,13,810,1035,0,0,78.26,439,358,民富里,NULL
96,806,4,810,1044,0,0,77.59,438,368,賢文里,NULL
179,804,6,810,1086,0,0,74.59,437,367,興仁里,NULL
258,796,14,810,1067,0,0,75.91,426,370,海山里,NULL
222,805,5,810,1058,0,0,76.56,387,418,內溪村,NULL
0,805,5,810,1058,0,0,76.56,387,418,內溪村,NULL
619,795,15,810,1043,0,0,77.66,359,436,朴子里,NULL
146,804,6,810,1146,0,0,70.68,344,460,黎明村,NULL
408,806,4,810,1101,0,0,73.57,331,475,新園村,NULL
194,795,15,810,1131,0,0,71.62,284,511,新厝村,NULL
0,795,15,810,1131,0,0,71.62,284,511,新厝村,NULL
27,798,12,810,1148,0,0,70.56,239,559,建興村,NULL
0,798,12,810,1148,0,0,70.56,239,559,建興村,NULL
25,807,2,809,1438,0,0,56.26,754,53,新市里,NULL
195,803,6,809,1079,0,0,74.98,624,179,碇內里,NULL
5,806,3,809,1051,0,0,76.97,603,203,中興里,NULL
875,804,5,809,1055,0,0,76.68,532,272,烏樹林村,NULL
138,798,11,809,1094,0,0,73.95,508,290,正南里,NULL
459,803,6,809,1070,0,0,75.61,506,297,湖西里,NULL
113,806,3,809,1062,0,0,76.18,495,311,內湖里,NULL
659,801,8,809,992,0,0,81.55,495,306,三信里,NULL
75,803,6,809,1111,0,0,72.82,488,315,鹽中村,NULL
24,800,9,809,1059,0,0,76.39,472,328,新店里,NULL
720,796,13,809,1029,0,0,78.62,470,326,廣達里,NULL
739,796,13,809,1042,0,0,77.64,451,345,朝興村,NULL
0,796,13,809,1042,0,0,77.64,451,345,朝興村,NULL
53,804,5,809,1130,0,0,71.59,419,385,南埔里,NULL
124,801,8,809,1037,0,0,78.01,398,403,中埔里,NULL
248,801,8,809,1101,0,0,73.48,334,467,香和村,NULL
399,806,3,809,1062,0,0,76.18,324,482,仙吉村,NULL
298,803,6,809,1066,0,0,75.89,227,576,喜北里,NULL
413,799,9,808,1190,0,0,67.9,705,94,羅娜村,NULL
0,799,9,808,1190,0,0,67.9,705,94,羅娜村,NULL
80,801,7,808,1006,0,0,80.32,703,98,東寧里,NULL
239,802,6,808,988,0,0,81.78,621,181,田寮里,NULL
82,798,10,808,1116,0,0,72.4,520,278,鐵山村,NULL
601,800,8,808,998,0,0,80.96,467,333,林德里,NULL
945,801,7,808,1063,0,0,76.01,465,336,後庄村,NULL
0,801,7,808,1063,0,0,76.01,465,336,後庄村,NULL
1673,803,5,808,1045,0,0,77.32,448,355,圳民里,NULL
169,803,5,808,1062,0,0,76.08,443,360,永寧里,NULL
589,804,4,808,1109,0,0,72.86,442,362,拔里,NULL
483,807,1,808,1106,0,0,73.06,416,391,長興里,NULL
46,802,6,808,1049,0,0,77.03,416,386,港德里,NULL
0,807,1,808,1106,0,0,73.06,416,391,長興里,NULL
142,800,8,808,1143,0,0,70.69,407,393,南寧里,NULL
0,800,8,808,1143,0,0,70.69,407,393,南寧里,NULL
0,800,8,808,1148,0,0,70.38,312,488,砂崙里,NULL
356,802,6,808,1054,0,0,76.66,307,495,六安里,NULL
434,802,6,808,1054,0,0,76.66,306,496,福仁里,NULL
0,802,6,808,1054,0,0,76.66,306,496,福仁里,NULL
227,799,9,808,1115,0,0,72.47,302,497,九塊里,NULL
424,803,5,808,1118,0,0,72.27,249,554,共和村,NULL
72,802,5,807,1063,0,0,75.92,627,175,國興里,NULL
317,794,13,807,1086,0,0,74.31,626,168,中義村,NULL
212,800,7,807,1068,0,0,75.56,616,184,下興里,NULL
257,798,9,807,1073,0,0,75.21,572,226,平和里,NULL
8,798,9,807,1027,0,0,78.58,568,230,錦華里,NULL
412,803,4,807,1152,0,0,70.05,560,243,華崙里,NULL
25,801,6,807,1044,0,0,77.3,557,244,正砂里,NULL
1269,798,9,807,1064,0,0,75.85,508,290,雙城里,NULL
2,802,5,807,1154,0,0,69.93,468,334,大甲里,NULL
0,802,5,807,1154,0,0,69.93,468,334,大甲里,NULL
1882,802,5,807,1043,0,0,77.37,451,351,新興里,NULL
463,800,7,807,1117,0,0,72.25,447,353,中山里,NULL
463,800,7,807,1100,0,0,73.36,436,364,灣成里,NULL
1536,801,6,807,1066,0,0,75.7,414,387,保新里,NULL
17,803,4,807,1039,0,0,77.67,410,393,長竹里,NULL
428,799,8,807,1000,0,0,80.7,403,396,文化里,NULL
1702,801,6,807,1047,0,0,77.08,399,402,和平里,NULL
71,799,8,807,1012,0,0,79.74,367,432,海南里,NULL
133,800,7,807,1071,0,0,75.35,305,495,上樹村,NULL
0,800,7,807,1071,0,0,75.35,305,495,上樹村,NULL
698,801,6,807,1039,0,0,77.67,287,514,東灣里,NULL
236,802,5,807,1092,0,0,73.9,218,584,興山村,NULL
0,802,5,807,1092,0,0,73.9,218,584,興山村,NULL
20,799,7,806,1506,0,0,53.52,770,29,榜林村,NULL
346,799,7,806,1133,0,0,71.14,655,144,竹森村,NULL
0,799,7,806,1133,0,0,71.14,655,144,竹森村,NULL
33,796,10,806,1002,0,0,80.44,627,169,北苗里,NULL
174,792,14,806,1410,0,0,57.16,616,176,大武村,NULL
0,792,14,806,1410,0,0,57.16,616,176,大武村,NULL
39,801,5,806,963,0,0,83.7,543,258,港尾里,NULL
271,802,4,806,1101,0,0,73.21,513,289,水尾里,NULL
0,802,4,806,1101,0,0,73.21,513,289,水尾里,NULL
327,801,5,806,1065,0,0,75.68,510,291,建興里,NULL
207,802,4,806,1126,0,0,71.58,503,299,正光里,NULL
194,800,6,806,1014,0,0,79.49,495,305,卦山里,NULL
433,794,12,806,1080,0,0,74.63,488,306,光復里,NULL
126,805,1,806,1138,0,0,70.83,479,326,通灣里,NULL
2044,799,7,806,1023,0,0,78.79,468,331,貴子村,NULL
559,799,7,806,998,0,0,80.76,456,343,舊明里,NULL
68,798,8,806,1050,0,0,76.76,450,348,幸福里,NULL
404,792,14,806,1074,0,0,75.05,433,359,健民里,NULL
342,798,8,806,1022,0,0,78.86,428,370,四德村,NULL
110,795,11,806,1063,0,0,75.82,426,369,海濱里,NULL
525,801,5,806,1150,0,0,70.09,414,387,東汴里,NULL
0,801,5,806,1150,0,0,70.09,414,387,東汴里,NULL
334,801,5,806,1148,0,0,70.21,408,393,建東里,NULL
0,801,5,806,1148,0,0,70.21,408,393,建東里,NULL
73,790,16,806,1025,0,0,78.63,401,389,廣福里,NULL
725,793,13,806,1023,0,0,78.79,376,417,中和村,NULL
116,799,7,806,1055,0,0,76.4,345,454,美和村,NULL
313,793,13,806,997,0,0,80.84,328,465,民享里,NULL
460,799,7,806,1013,0,0,79.57,322,477,橋頭村,NULL
61,800,6,806,1064,0,0,75.75,299,501,內厝里,NULL
0,800,6,806,1064,0,0,75.75,299,501,內厝里,NULL
450,804,2,806,1059,0,0,76.11,277,527,禮蚵村,NULL
2,802,3,805,1345,0,0,59.85,762,40,復興村、福沃村,NULL
0,802,3,805,1345,0,0,59.85,762,40,復興村、福沃村,NULL
10,803,2,805,1536,0,0,52.41,753,50,北門里,NULL
326,797,8,805,1069,0,0,75.3,747,50,新樂村,NULL
0,797,8,805,1069,0,0,75.3,747,50,新樂村,NULL
705,797,8,805,1050,0,0,76.67,641,156,廣福村,NULL
1586,801,4,805,1079,0,0,74.61,581,220,拱北里,NULL
791,799,6,805,971,0,0,82.9,560,239,誠德里,NULL
475,805,0,805,1089,0,0,73.92,559,246,東勢村,NULL
477,799,6,805,1024,0,0,78.61,535,264,合作里,NULL
450,798,7,805,1056,0,0,76.23,534,264,西寮里,NULL
23,800,5,805,1074,0,0,74.95,527,273,和睦里,NULL
412,800,5,805,1004,0,0,80.18,510,290,信義里,NULL
1638,793,12,805,1113,0,0,72.33,464,329,三興里,NULL
614,801,4,805,1022,0,0,78.77,455,346,福海里,NULL
0,801,4,805,1022,0,0,78.77,455,346,福海里,NULL
689,792,13,805,1032,0,0,78,439,353,東北里,NULL
380,795,10,805,1188,0,0,67.76,424,371,建平村,NULL
830,793,12,805,1029,0,0,78.23,399,394,瑞隆里,NULL
172,799,6,805,1044,0,0,77.11,399,400,南燕村,NULL
444,800,5,805,1055,0,0,76.3,345,455,大舍村,NULL
139,797,8,805,1060,0,0,75.94,344,453,楊厝里,NULL
0,797,8,805,1060,0,0,75.94,344,453,楊厝里,NULL
64,799,6,805,1084,0,0,74.26,329,470,大坵村,NULL
0,799,6,805,1084,0,0,74.26,329,470,大坵村,NULL
593,802,3,805,1223,0,0,65.82,326,476,港口村,NULL
0,802,3,805,1223,0,0,65.82,326,476,港口村,NULL
536,792,13,805,1180,0,0,68.22,288,504,桂林村,NULL
0,792,13,805,1180,0,0,68.22,288,504,桂林村,NULL
95,799,5,804,1205,0,0,66.72,735,64,崇德村,NULL
0,799,5,804,1205,0,0,66.72,735,64,崇德村,NULL
325,796,8,804,995,0,0,80.8,609,187,福星村,NULL
398,793,11,804,1135,0,0,70.84,598,195,湖東村,NULL
0,793,11,804,1135,0,0,70.84,598,195,湖東村,NULL
379,795,9,804,1098,0,0,73.22,428,367,祥興里,NULL
840,796,8,804,1020,0,0,78.82,371,425,新強里,NULL
697,798,6,804,1083,0,0,74.24,363,435,曹公里,NULL
539,801,3,804,1069,0,0,75.21,357,444,天時村,NULL
124,794,10,804,1079,0,0,74.51,343,451,正覺里,NULL
448,792,12,804,997,0,0,80.64,328,464,灣勝里,NULL
592,800,4,804,1025,0,0,78.44,268,532,翁園村,NULL
763,799,4,803,997,0,0,80.54,526,273,忠義里,NULL
596,795,8,803,992,0,0,80.95,515,280,福和里,NULL
712,795,8,803,1079,0,0,74.42,507,288,康樂里,NULL
409,799,4,803,1109,0,0,72.41,496,303,梅芳里,NULL
0,799,4,803,1109,0,0,72.41,496,303,梅芳里,NULL
270,795,8,803,1000,0,0,80.3,493,302,華福里,NULL
2,798,5,803,1044,0,0,76.92,491,307,負郭里,NULL
1327,796,7,803,1067,0,0,75.26,456,340,員仁里,NULL
309,792,11,803,1048,0,0,76.62,454,338,快官里,NULL
0,792,11,803,1048,0,0,76.62,454,338,快官里,NULL
435,793,10,803,995,0,0,80.7,446,347,長安里,NULL
173,795,8,803,1073,0,0,74.84,443,352,二城里,NULL
0,795,8,803,1073,0,0,74.84,443,352,二城里,NULL
396,800,3,803,1061,0,0,75.68,405,395,大同里,NULL
218,797,6,803,1082,0,0,74.21,403,394,八爺里,NULL
1044,791,12,803,1093,0,0,73.47,397,394,中隆里,NULL
665,799,4,803,1046,0,0,76.77,386,413,王公村,NULL
256,798,5,803,1102,0,0,72.87,342,456,明華里,NULL
0,798,5,803,1102,0,0,72.87,342,456,明華里,NULL
0,796,6,802,1723,0,0,46.55,631,165,北源村,NULL
236,792,10,802,1350,0,0,59.41,626,166,永昌里,NULL
0,792,10,802,1350,0,0,59.41,626,166,永昌里,NULL
241,798,4,802,996,0,0,80.52,605,193,員山村,NULL
1180,793,9,802,977,0,0,82.09,599,194,百忍里,NULL
133,793,9,802,1081,0,0,74.19,592,201,勝安村,NULL
152,799,3,802,1052,0,0,76.24,569,230,龍鳳里,NULL
13,797,5,802,1128,0,0,71.1,555,242,光榮里,NULL
103,796,6,802,1097,0,0,73.11,530,266,北安里,NULL
83,794,8,802,1064,0,0,75.38,511,283,中山村,NULL
0,794,8,802,1064,0,0,75.38,511,283,中山村,NULL
139,793,9,802,1105,0,0,72.58,499,294,定國里,NULL
0,793,9,802,1105,0,0,72.58,499,294,定國里,NULL
17,798,4,802,1179,0,0,68.02,494,304,朝陽里,NULL
138,792,10,802,1170,0,0,68.55,479,313,龍泉村,NULL
1647,792,10,802,970,0,0,82.68,470,322,三龍里,NULL
506,797,5,802,1038,0,0,77.26,432,365,德望里,NULL
967,794,8,802,1049,0,0,76.45,430,364,金湖村,NULL
720,793,9,802,991,0,0,80.93,407,386,墩西村,NULL
39,797,5,802,1072,0,0,74.81,396,401,神農里,NULL
0,797,5,802,1072,0,0,74.81,396,401,神農里,NULL
1628,797,5,802,1057,0,0,75.88,380,417,環河里,NULL
0,797,5,802,1057,0,0,75.88,380,417,環河里,NULL
368,797,5,802,1040,0,0,77.12,364,433,臺上里,NULL
449,797,5,802,1000,0,0,80.2,303,494,灣勝里,NULL
33,793,8,801,1388,0,0,57.71,747,46,正義里,NULL
0,793,8,801,1388,0,0,57.71,747,46,正義里,NULL
50,795,6,801,1049,0,0,76.36,617,178,國治里,NULL
0,795,6,801,1049,0,0,76.36,617,178,國治里,NULL
622,794,7,801,976,0,0,82.07,588,206,建和里,NULL
216,796,5,801,1033,0,0,77.54,537,259,永安里,NULL
260,794,7,801,1039,0,0,77.09,483,311,王田村,NULL
448,794,7,801,986,0,0,81.24,461,333,萬壽里,NULL
307,792,9,801,1027,0,0,77.99,458,334,聚安里,NULL
221,789,12,801,989,0,0,80.99,445,344,長安里,NULL
277,793,8,801,1040,0,0,77.02,437,356,古夷里,NULL
715,797,4,801,1004,0,0,79.78,363,434,文英里,NULL
262,798,3,801,1047,0,0,76.5,295,503,武淵村,NULL
0,798,3,801,1047,0,0,76.5,295,503,武淵村,NULL
185,799,2,801,1040,0,0,77.02,272,527,玉田村,NULL
184,793,8,801,1117,0,0,71.71,268,525,光潭村,NULL
0,793,8,801,1117,0,0,71.71,268,525,光潭村,NULL
268,794,7,801,1031,0,0,77.69,238,556,開化村,NULL
760,797,3,800,1021,0,0,78.35,610,187,新英里,NULL
719,794,6,800,985,0,0,81.22,585,209,瑞穗里,NULL
128,793,7,800,1114,0,0,71.81,575,218,宜昌村,NULL
2237,791,9,800,1210,0,0,66.12,554,237,北基村,NULL
170,792,8,800,1082,0,0,73.94,540,252,南山里,NULL
0,792,8,800,1082,0,0,73.94,540,252,南山里,NULL
120,797,3,800,1141,0,0,70.11,529,268,高北里,NULL
0,797,3,800,1141,0,0,70.11,529,268,高北里,NULL
9,791,9,800,1067,0,0,74.98,523,268,定興村,NULL
94,793,7,800,1082,0,0,73.94,512,281,獅球里,NULL
0,793,7,800,1082,0,0,73.94,512,281,獅球里,NULL
95,794,6,800,1011,0,0,79.13,487,307,重興里,NULL
796,794,6,800,1009,0,0,79.29,481,313,誠智里,NULL
394,792,8,800,1064,0,0,75.19,475,317,烏麻村,NULL
0,792,8,800,1064,0,0,75.19,475,317,烏麻村,NULL
96,796,4,800,1022,0,0,78.28,454,342,新興里,NULL
347,793,7,800,1033,0,0,77.44,403,390,茄荖村,NULL
1300,789,11,800,1003,0,0,79.76,383,406,屈尺里,NULL
182,797,3,800,1085,0,0,73.73,370,427,二龍村,NULL
0,797,3,800,1085,0,0,73.73,370,427,二龍村,NULL
290,795,5,800,1081,0,0,74.01,315,480,羅厝村,NULL
253,792,8,800,1113,0,0,71.88,266,526,鯤鯓村,NULL
285,790,9,799,1050,0,0,76.1,646,144,內灣村,NULL
0,790,9,799,1050,0,0,76.1,646,144,內灣村,NULL
64,793,6,799,1215,0,0,65.76,584,209,建業里,NULL
0,793,6,799,1215,0,0,65.76,584,209,建業里,NULL
132,790,9,799,1064,0,0,75.09,582,208,一新里,NULL
0,790,9,799,1064,0,0,75.09,582,208,一新里,NULL
658,791,8,799,977,0,0,81.78,564,227,上新里,NULL
0,791,8,799,977,0,0,81.78,564,227,上新里,NULL
56,796,3,799,1092,0,0,73.17,505,291,仁愛里,NULL
123,788,11,799,1104,0,0,72.37,414,374,龍山里,NULL
146,792,7,799,1164,0,0,68.64,389,403,復興里,NULL
665,794,5,799,1085,0,0,73.64,386,408,塩行里,NULL
370,788,11,799,1001,0,0,79.82,377,411,臺上里,NULL
420,790,9,799,1004,0,0,79.58,364,426,鹽埕村,NULL
836,794,5,799,1051,0,0,76.02,326,468,八甲村,NULL
768,791,8,799,1028,0,0,77.72,227,564,信德里,NULL
706,791,7,798,1050,0,0,76,643,148,莊敬里,NULL
276,790,8,798,1029,0,0,77.55,570,220,上山村,NULL
397,791,7,798,1104,0,0,72.28,529,262,興華里,NULL
0,791,7,798,1104,0,0,72.28,529,262,興華里,NULL
15,792,6,798,1067,0,0,74.79,490,302,埤墘村,NULL
0,792,6,798,1067,0,0,74.79,490,302,埤墘村,NULL
681,792,6,798,1048,0,0,76.15,475,317,鎮興里,NULL
767,796,2,798,1030,0,0,77.48,471,325,忠孝里,NULL
635,794,4,798,1044,0,0,76.44,457,337,新生里,NULL
97,791,7,798,1011,0,0,78.93,439,352,長興村,NULL
0,791,7,798,1011,0,0,78.93,439,352,長興村,NULL
632,789,9,798,1061,0,0,75.21,367,422,永康里,NULL
60,792,6,798,1079,0,0,73.96,363,429,安寮里,NULL
746,793,5,798,998,0,0,79.96,328,465,大佳里,NULL
0,793,5,798,998,0,0,79.96,328,465,大佳里,NULL
332,790,8,798,1064,0,0,75,288,502,義合村,NULL
0,790,8,798,1064,0,0,75,288,502,義合村,NULL
0,784,13,797,1098,0,0,72.59,682,102,和平村,NULL
758,794,3,797,1056,0,0,75.47,586,208,新富里,NULL
237,788,9,797,1282,0,0,62.17,573,215,源城里,NULL
0,788,9,797,1282,0,0,62.17,573,215,源城里,NULL
735,788,9,797,1021,0,0,78.06,501,287,文衡里,NULL
48,791,6,797,1049,0,0,75.98,468,323,久昌里,NULL
535,779,18,797,1033,0,0,77.15,467,312,樹德里,NULL
107,792,5,797,1031,0,0,77.3,456,336,中山里,NULL
0,792,5,797,1031,0,0,77.3,456,336,中山里,NULL
426,795,2,797,1036,0,0,76.93,428,367,崁頂村,NULL
375,789,8,797,982,0,0,81.16,424,365,壽峰里,NULL
90,793,4,797,1031,0,0,77.3,417,376,北成里,NULL
885,791,6,797,1017,0,0,78.37,364,427,鎮南里,NULL
849,787,10,797,1007,0,0,79.15,363,424,香洋村,NULL
444,792,5,797,1054,0,0,75.62,345,447,內江村,NULL
0,792,5,797,1054,0,0,75.62,345,447,內江村,NULL
676,794,3,797,1070,0,0,74.49,324,470,頂厝村,NULL
379,787,9,796,989,0,0,80.49,644,143,勝興村,NULL
1284,789,7,796,1027,0,0,77.51,641,148,吉祥里,NULL
36,790,6,796,1157,0,0,68.8,599,191,豐年里,NULL
141,788,8,796,1023,0,0,77.81,593,195,五埔里,NULL
154,788,8,796,987,0,0,80.65,593,195,龍鳳里,NULL
135,788,8,796,1094,0,0,72.76,590,198,勝安村,NULL
329,786,10,796,1035,0,0,76.91,584,202,五穀村,NULL
26,782,14,796,1050,0,0,75.81,523,259,溝內村,NULL
0,782,14,796,1050,0,0,75.81,523,259,溝內村,NULL
348,789,7,796,1065,0,0,74.74,515,274,中平村,NULL
260,785,11,796,1025,0,0,77.66,501,284,平陽里,NULL
2018,792,4,796,1076,0,0,73.98,480,312,楓樹村,NULL
18,789,7,796,1006,0,0,79.13,474,315,汴頭村,NULL
1391,784,12,796,1008,0,0,78.97,465,319,青雲里,NULL
232,791,5,796,985,0,0,80.81,459,332,民族里,NULL
120,788,8,796,1004,0,0,79.28,444,344,新海里,NULL
449,791,5,796,1079,0,0,73.77,435,356,錦江里,NULL
466,786,10,796,989,0,0,80.49,428,358,十甲里,NULL
769,791,5,796,1013,0,0,78.58,356,435,仁義村,NULL
608,788,8,796,1017,0,0,78.27,347,441,英明里,NULL
250,788,8,796,992,0,0,80.24,335,453,教仁里,NULL
447,789,7,796,1015,0,0,78.42,284,505,義和里,NULL
346,788,8,796,1080,0,0,73.7,227,561,東興里,NULL
0,788,8,796,1080,0,0,73.7,227,561,東興里,NULL
116,784,11,795,1105,0,0,71.95,574,210,福興村,NULL
180,789,6,795,1073,0,0,74.09,522,267,崎頂里,NULL
1811,787,8,795,1070,0,0,74.3,493,294,礁溪里,NULL
87,791,4,795,1035,0,0,76.81,457,334,元寶里,NULL
518,784,11,795,1051,0,0,75.64,342,442,大灣村,NULL
684,789,6,795,1067,0,0,74.51,273,516,西溪村,NULL
227,789,6,795,1181,0,0,67.32,222,567,大山村,NULL
444,790,5,795,1131,0,0,70.29,222,568,壽元村,NULL
0,789,6,795,1181,0,0,67.32,222,567,大山村,NULL
0,790,5,795,1131,0,0,70.29,222,568,壽元村,NULL
213,789,5,794,1052,0,0,75.48,632,157,下興里,NULL
223,791,3,794,965,0,0,82.28,626,165,建國里,NULL
1234,786,8,794,1009,0,0,78.69,610,176,學府里,NULL
319,787,7,794,973,0,0,81.6,583,204,玉泉村,NULL
328,789,5,794,1032,0,0,76.94,511,278,建興里,NULL
382,785,9,794,1070,0,0,74.21,505,280,林南村,NULL
0,785,9,794,1070,0,0,74.21,505,280,林南村,NULL
131,784,10,794,1081,0,0,73.45,472,312,育英里,NULL
143,788,6,794,998,0,0,79.56,432,356,西勢村,NULL
560,789,5,794,969,0,0,81.94,425,364,華美村,NULL
525,789,5,794,1076,0,0,73.79,424,365,朝陽村,NULL
264,785,9,794,1078,0,0,73.65,410,375,中坑里,NULL
497,787,7,794,1109,0,0,71.6,381,406,舊社里,NULL
725,790,4,794,1060,0,0,74.91,333,457,文山里,NULL
1175,785,8,793,1003,0,0,79.06,589,196,中華里,NULL
268,787,6,793,1103,0,0,71.89,555,232,外埔里,NULL
0,787,6,793,1103,0,0,71.89,555,232,外埔里,NULL
717,789,4,793,976,0,0,81.25,485,304,文英里,NULL
706,782,11,793,1098,0,0,72.22,483,299,仁里村,NULL
0,782,11,793,1098,0,0,72.22,483,299,仁里村,NULL
576,784,9,793,1024,0,0,77.44,463,321,德義里,NULL
283,782,11,793,1030,0,0,76.99,421,361,豐田里,NULL
0,782,11,793,1030,0,0,76.99,421,361,豐田里,NULL
1715,781,12,793,994,0,0,79.78,412,369,東昇里,NULL
253,786,7,793,1023,0,0,77.52,393,393,嘉樂村,NULL
336,783,10,793,1057,0,0,75.02,387,396,中興里,NULL
948,785,8,793,1051,0,0,75.45,383,402,糠榔村,NULL
0,785,8,793,1051,0,0,75.45,383,402,糠榔村,NULL
262,786,7,793,1050,0,0,75.52,377,409,營前村,NULL
457,790,3,793,1086,0,0,73.02,355,435,茄苳村,NULL
119,784,9,793,1029,0,0,77.07,352,432,山崙里,NULL
354,786,7,793,1054,0,0,75.24,347,439,後紅里,NULL
556,789,4,793,1043,0,0,76.03,345,444,仁美村,NULL
30,783,10,793,1362,0,0,58.22,300,483,新發村,NULL
0,783,10,793,1362,0,0,58.22,300,483,新發村,NULL
69,783,10,793,1088,0,0,72.89,298,485,港尾里,NULL
594,780,13,793,1040,0,0,76.25,261,519,琉球村,NULL
0,787,6,793,1088,0,0,72.89,204,583,新嘉村,NULL
0,789,3,792,1426,1816,78.52,55.54,752,37,北竿鄉,Beijiao Township
15,787,5,792,1137,0,0,69.66,639,148,和憲里,NULL
0,787,5,792,1137,0,0,69.66,639,148,和憲里,NULL
396,784,8,792,1036,0,0,76.45,528,256,鉅工村,NULL
0,784,8,792,1036,0,0,76.45,528,256,鉅工村,NULL
218,780,12,792,1066,0,0,74.3,515,265,西勢里,NULL
56,787,5,792,969,0,0,81.73,447,340,建國里,NULL
284,785,7,792,1266,0,0,62.56,425,360,浮洲里,NULL
91,783,9,792,1022,0,0,77.5,420,363,華興里,NULL
429,787,5,792,1003,0,0,78.96,398,389,綠川里,NULL
332,786,6,792,1116,0,0,70.97,386,400,寮頂村,NULL
119,789,3,792,1096,0,0,72.26,361,428,岸內里,NULL
468,789,3,792,991,0,0,79.92,340,449,安寧里,NULL
820,783,9,792,1023,0,0,77.42,340,443,新厝村,NULL
152,787,5,792,1045,0,0,75.79,293,494,美源里,NULL
0,785,6,791,1195,0,0,66.19,691,94,民生村,NULL
32,784,7,791,1076,0,0,73.51,527,257,主和里,NULL
549,781,10,791,1012,0,0,78.16,507,274,中央里,NULL
159,785,6,791,1016,0,0,77.85,345,440,大豐里,NULL
807,782,9,791,1123,0,0,70.44,325,457,六甲村,NULL
614,785,6,791,1004,0,0,78.78,284,501,三隆村,NULL
144,785,6,791,1023,0,0,77.32,239,546,中路村,NULL
316,783,7,790,991,0,0,79.72,615,168,館南村,NULL
371,783,7,790,1004,0,0,78.69,613,170,象山村,NULL
626,784,6,790,1523,0,0,51.87,606,178,大福村,NULL
0,784,6,790,1523,0,0,51.87,606,178,大福村,NULL
672,783,7,790,1047,0,0,75.45,580,203,崙雅里,NULL
18,779,11,790,990,0,0,79.8,558,221,玉苗里,NULL
0,779,11,790,990,0,0,79.8,558,221,玉苗里,NULL
178,779,11,790,1000,0,0,79,538,241,頂埔里,NULL
167,777,13,790,1037,0,0,76.18,533,244,中美里,NULL
949,782,8,790,1045,0,0,75.6,456,326,笨港村,NULL
0,782,8,790,1045,0,0,75.6,456,326,笨港村,NULL
436,784,6,790,1103,0,0,71.62,439,345,柳川里,NULL
968,781,9,790,1057,0,0,74.74,420,361,金湖村,NULL
96,777,13,790,1088,0,0,72.61,383,394,社苓里,NULL
395,785,5,790,995,0,0,79.4,381,404,福興里,NULL
0,785,5,790,995,0,0,79.4,381,404,福興里,NULL
552,784,6,790,1025,0,0,77.07,336,448,坔埔村,NULL
525,782,8,790,1066,0,0,74.11,263,519,羌園村,NULL
0,782,8,790,1066,0,0,74.11,263,519,羌園村,NULL
200,784,5,789,981,0,0,80.43,626,158,頭份里,NULL
1359,785,4,789,999,0,0,78.98,514,271,博嘉里,NULL
435,779,10,789,1055,0,0,74.79,497,282,永平村,NULL
0,779,10,789,1055,0,0,74.79,497,282,永平村,NULL
1652,780,9,789,1049,0,0,75.21,469,311,光興里,NULL
77,780,9,789,947,0,0,83.32,449,331,百壽里,NULL
597,783,6,789,992,0,0,79.54,428,355,五權里,NULL
129,785,4,789,1033,0,0,76.38,395,390,磚磘里,NULL
799,783,6,789,1021,0,0,77.28,354,429,振興里,NULL
193,780,9,789,978,0,0,80.67,337,443,大社村,NULL
808,783,6,789,1101,0,0,71.66,295,488,六甲村,NULL
542,787,2,789,994,0,0,79.38,295,492,夢裡村,NULL
91,785,4,789,959,0,0,82.27,217,568,廟北里,NULL
0,785,4,789,959,0,0,82.27,217,568,廟北里,NULL
1164,784,4,788,978,0,0,80.57,619,165,長春里,NULL
31,786,2,788,1100,0,0,71.64,516,270,石泉里,NULL
402,782,6,788,1160,0,0,67.93,510,272,上安村,NULL
0,782,6,788,1160,0,0,67.93,510,272,上安村,NULL
621,780,8,788,1030,0,0,76.5,400,380,朴子里,NULL
536,777,11,788,1034,0,0,76.21,398,379,慈化里,NULL
69,782,6,788,1088,0,0,72.43,379,403,中寮里,NULL
0,782,6,788,1088,0,0,72.43,379,403,中寮里,NULL
55,778,10,788,1050,0,0,75.05,374,404,南庄村,NULL
0,778,10,788,1050,0,0,75.05,374,404,南庄村,NULL
247,784,4,788,1077,0,0,73.17,373,411,香和村,NULL
983,783,5,788,1032,0,0,76.36,352,431,廣福村,NULL
94,786,2,788,1003,0,0,78.56,330,456,南勝里,NULL
166,779,9,788,1114,0,0,70.74,266,513,尖山村,NULL
0,779,9,788,1114,0,0,70.74,266,513,尖山村,NULL
0,779,9,788,1067,0,0,73.85,263,516,苓和村,NULL
76,783,5,788,1051,0,0,74.98,230,553,德興里,NULL
0,783,5,788,1051,0,0,74.98,230,553,德興里,NULL
7,787,0,787,1342,0,0,58.64,757,30,西門里,NULL
21,780,7,787,1048,0,0,75.1,575,205,線西村,NULL
13,767,20,787,1058,0,0,74.39,564,203,民運里,NULL
114,780,7,787,1097,0,0,71.74,495,285,同聲里,NULL
12,783,4,787,987,0,0,79.74,481,302,太平里,NULL
417,780,7,787,1060,0,0,74.25,479,301,西斗里,NULL
0,780,7,787,1060,0,0,74.25,479,301,西斗里,NULL
15,772,15,787,1074,0,0,73.28,467,305,中山里,NULL
135,775,12,787,1179,0,0,66.75,455,320,廣成里,NULL
0,775,12,787,1179,0,0,66.75,455,320,廣成里,NULL
12,781,6,787,1038,0,0,75.82,452,329,新美里,NULL
2226,781,6,787,1114,0,0,70.65,425,356,重和村,NULL
0,781,6,787,1114,0,0,70.65,425,356,重和村,NULL
1772,781,6,787,1090,0,0,72.2,424,357,鳳祥里,NULL
506,779,8,787,1033,0,0,76.19,364,415,港口村,NULL
132,779,8,787,1047,0,0,75.17,344,435,阿蓮村,NULL
285,778,9,787,1047,0,0,75.17,314,464,水林村,NULL
402,781,6,787,1048,0,0,75.1,307,474,田洋村,NULL
0,781,5,786,1043,0,0,75.36,713,68,錦屏村,NULL
214,774,12,786,1038,0,0,75.72,532,242,長安村,NULL
0,774,12,786,1038,0,0,75.72,532,242,長安村,NULL
1353,782,4,786,1036,0,0,75.87,507,275,裕生里,NULL
1543,780,6,786,1006,0,0,78.13,505,275,大同里,NULL
414,774,12,786,1026,0,0,76.61,494,280,公誠里,NULL
573,782,4,786,1072,0,0,73.32,451,331,協興里,NULL
1904,777,9,786,1023,0,0,76.83,438,339,清文里,NULL
0,777,9,786,1023,0,0,76.83,438,339,清文里,NULL
0,777,9,786,1109,0,0,70.87,412,365,義和村,NULL
750,779,7,786,1010,0,0,77.82,390,389,南興里,NULL
0,779,7,786,1010,0,0,77.82,390,389,南興里,NULL
646,777,9,786,1008,0,0,77.98,363,414,林園村,NULL
310,781,5,786,1014,0,0,77.51,340,441,同安里,NULL
176,776,10,786,962,0,0,81.7,310,466,瓊林村,NULL
208,779,7,786,965,0,0,81.45,284,495,龍壽村,NULL
13,778,8,786,1014,0,0,77.51,238,540,載興村,NULL
692,780,6,786,1102,0,0,71.32,229,551,中汕村,NULL
0,777,8,785,1562,0,0,50.26,635,142,三仙里,NULL
146,777,8,785,1217,0,0,64.5,634,143,仁和村,NULL
180,775,10,785,1075,0,0,73.02,555,220,錦山里,NULL
0,775,10,785,1075,0,0,73.02,555,220,錦山里,NULL
157,783,2,785,1218,0,0,64.45,455,328,美和村,NULL
0,783,2,785,1218,0,0,64.45,455,328,美和村,NULL
107,781,4,785,1055,0,0,74.41,454,327,瀰濃里,NULL
1850,778,7,785,1077,0,0,72.89,442,336,義山里,NULL
39,781,4,785,1014,0,0,77.42,441,340,延平里,NULL
144,781,4,785,1131,0,0,69.41,410,371,三合里,NULL
0,781,4,785,1131,0,0,69.41,410,371,三合里,NULL
359,779,6,785,967,0,0,81.18,392,387,六股村,NULL
280,775,10,785,1049,0,0,74.83,386,389,NA,NULL
1854,779,6,785,1004,0,0,78.19,378,401,忠寮里,NULL
0,779,6,785,1004,0,0,78.19,378,401,忠寮里,NULL
446,779,6,785,1018,0,0,77.11,331,448,振興里,NULL
70,782,3,785,1022,0,0,76.81,304,478,海南里,NULL
95,778,7,785,1069,0,0,73.43,281,497,大灣里,NULL
0,778,7,785,1069,0,0,73.43,281,497,大灣里,NULL
88,778,7,785,1121,0,0,70.03,218,560,梅華里,NULL
0,778,7,785,1121,0,0,70.03,218,560,梅華里,NULL
27,781,4,785,1001,0,0,78.42,194,587,玉屏里,NULL
467,778,6,784,1138,0,0,68.89,758,20,南和村,NULL
0,778,6,784,1138,0,0,68.89,758,20,南和村,NULL
36,775,9,784,1072,0,0,73.13,590,185,主農里,NULL
921,779,5,784,955,0,0,82.09,573,206,文化里,NULL
707,780,4,784,981,0,0,79.92,540,240,莊敬里,NULL
479,768,16,784,1050,0,0,74.67,532,236,建興里,NULL
127,774,10,784,1073,0,0,73.07,500,274,通灣里,NULL
595,775,9,784,972,0,0,80.66,499,276,福和里,NULL
399,770,14,784,1242,0,0,63.12,484,286,頂崁村,NULL
0,770,14,784,1242,0,0,63.12,484,286,頂崁村,NULL
232,779,5,784,1031,0,0,76.04,475,304,實踐里,NULL
1678,777,7,784,996,0,0,78.71,440,337,樹德里,NULL
307,776,8,784,1031,0,0,76.04,426,350,社南村,NULL
52,777,7,784,1043,0,0,75.17,400,377,觀亭村,NULL
523,768,16,784,1127,0,0,69.57,390,378,古坑村,NULL
385,772,12,784,987,0,0,79.43,374,398,山腳村,NULL
330,777,6,783,1042,0,0,75.14,734,43,南澳村,NULL
0,777,6,783,1042,0,0,75.14,734,43,南澳村,NULL
322,781,2,783,1060,0,0,73.87,622,159,福基村,NULL
0,781,2,783,1060,0,0,73.87,622,159,福基村,NULL
16,775,8,783,1079,0,0,72.57,612,163,民政里,NULL
165,777,6,783,1056,0,0,74.15,525,252,新建里,NULL
205,773,10,783,1008,0,0,77.68,444,329,廣新里,NULL
124,775,8,783,1049,0,0,74.64,424,351,菁埔里,NULL
138,776,7,783,1114,0,0,70.29,403,373,牛眠里,NULL
39,772,11,783,988,0,0,79.25,389,383,光復里,NULL
411,775,8,783,974,0,0,80.39,386,389,中山里,NULL
450,776,7,783,1020,0,0,76.76,386,390,錦江里,NULL
150,772,11,783,1147,0,0,68.27,352,420,麥厝村,NULL
888,780,3,783,1004,0,0,77.99,326,454,鎮南里,NULL
403,776,7,783,1052,0,0,74.43,201,575,麻口里,NULL
0,776,7,783,1052,0,0,74.43,201,575,麻口里,NULL
279,777,6,783,1167,0,0,67.1,157,620,樹腳里,NULL
341,775,7,782,1026,0,0,76.22,631,144,銅鑼村,NULL
1273,775,7,782,928,0,0,84.27,618,157,香坡里,NULL
162,774,8,782,996,0,0,78.51,542,232,中港里,NULL
0,774,8,782,996,0,0,78.51,542,232,中港里,NULL
28,772,10,782,1084,0,0,72.14,500,272,主義里、主睦里,NULL
0,772,10,782,1084,0,0,72.14,500,272,主義里、主睦里,NULL
477,775,7,782,993,0,0,78.75,420,355,崇德里,NULL
347,773,9,782,994,0,0,78.67,415,358,成功里,NULL
90,776,6,782,1011,0,0,77.35,399,377,頂庄里,NULL
135,772,10,782,1156,0,0,67.65,390,382,永安里,NULL
0,772,10,782,1156,0,0,67.65,390,382,永安里,NULL
137,772,10,782,1043,0,0,74.98,372,400,橋頭村,NULL
194,776,6,782,1115,0,0,70.13,367,409,口湖村,NULL
0,776,6,782,1115,0,0,70.13,367,409,口湖村,NULL
328,774,8,782,982,0,0,79.63,365,409,鴨寮村,NULL
359,780,2,782,1047,0,0,74.69,343,437,佳化里,NULL
777,775,7,782,1018,0,0,76.82,330,445,鎮榮里,NULL
115,775,7,782,1042,0,0,75.05,302,473,北新里,NULL
562,777,5,782,980,0,0,79.8,258,519,義和村,NULL
724,769,12,781,1020,0,0,76.57,600,169,建國里,NULL
107,774,7,781,1042,0,0,74.95,540,234,泰安里,NULL
255,777,4,781,1092,0,0,71.52,514,263,溪洲里,NULL
584,770,11,781,941,0,0,83,487,283,福善里,NULL
173,775,6,781,1593,0,0,49.03,455,320,尚武村,NULL
0,775,6,781,1593,0,0,49.03,455,320,尚武村,NULL
378,775,6,781,1007,0,0,77.56,433,342,祥興里,NULL
515,774,7,781,1037,0,0,75.31,425,349,新明里,NULL
844,778,3,781,983,0,0,79.45,417,361,海洋里,NULL
537,775,6,781,1061,0,0,73.61,408,367,鳥松村,NULL
294,768,13,781,1042,0,0,74.95,408,360,光大里,NULL
357,775,6,781,1063,0,0,73.47,397,378,峰谷村,NULL
0,775,6,781,1063,0,0,73.47,397,378,峰谷村,NULL
1062,769,12,781,983,0,0,79.45,396,373,福營里,NULL
511,772,9,781,1033,0,0,75.61,385,387,玉衡里,NULL
816,773,8,781,1035,0,0,75.46,385,388,文化村,NULL
0,772,9,781,1033,0,0,75.61,385,387,玉衡里,NULL
541,773,8,781,1087,0,0,71.85,370,403,人和村,NULL
832,771,10,781,962,0,0,81.19,341,430,新武里,NULL
86,767,14,781,967,0,0,80.77,306,461,菜園里,NULL
0,767,14,781,967,0,0,80.77,306,461,菜園里,NULL
335,775,6,781,1088,0,0,71.78,276,499,中和里,NULL
0,775,6,781,1088,0,0,71.78,276,499,中和里,NULL
704,769,11,780,1074,0,0,72.63,446,323,正義里,NULL
348,777,3,780,971,0,0,80.33,403,374,壽天里,NULL
601,776,4,780,1067,0,0,73.1,386,390,新興村,NULL
0,776,4,780,1067,0,0,73.1,386,390,新興村,NULL
300,775,5,780,1220,0,0,63.93,361,414,舊庄村,NULL
0,775,5,780,1220,0,0,63.93,361,414,舊庄村,NULL
121,771,9,780,1075,0,0,72.56,360,411,隘丁里,NULL
435,772,8,780,1027,0,0,75.95,354,418,梓義村,NULL
499,773,7,780,1013,0,0,77,317,456,文武村,NULL
284,771,9,780,1041,0,0,74.93,303,468,二甲村,NULL
247,771,9,780,1049,0,0,74.36,275,496,疊溪村,NULL
0,771,9,780,1049,0,0,74.36,275,496,疊溪村,NULL
500,772,8,780,1008,0,0,77.38,257,515,後安村,NULL
415,775,5,780,996,0,0,78.31,212,563,興龍村,NULL
704,772,7,779,959,0,0,81.23,614,158,莊敬里,NULL
2,773,6,779,1018,0,0,76.52,579,194,青苗里,NULL
0,773,6,779,1018,0,0,76.52,579,194,青苗里,NULL
941,774,5,779,1027,0,0,75.85,535,239,建國里,NULL
0,774,5,779,1027,0,0,75.85,535,239,建國里,NULL
144,771,8,779,1016,0,0,76.67,495,276,四座里,NULL
221,770,9,779,1053,0,0,73.98,489,281,竹坑村,NULL
1685,773,6,779,996,0,0,78.21,477,296,樹興里,NULL
556,772,7,779,993,0,0,78.45,431,341,武安里,NULL
756,773,6,779,967,0,0,80.56,414,359,興仁里,NULL
215,775,4,779,1024,0,0,76.07,392,383,蓬萊里,NULL
719,771,8,779,1012,0,0,76.98,386,385,文華里,NULL
620,773,6,779,1016,0,0,76.67,327,446,朴子里,NULL
674,771,8,779,966,0,0,80.64,310,461,甲頂里,NULL
1314,767,11,778,1237,0,0,62.89,518,249,明義里,NULL
46,767,11,778,987,0,0,78.82,516,251,新社里,NULL
177,772,6,778,964,0,0,80.71,508,264,金華里,NULL
732,775,3,778,1065,0,0,73.05,437,338,復華里,NULL
148,777,1,778,1043,0,0,74.59,432,345,湖內里,NULL
302,770,8,778,1029,0,0,75.61,374,396,社西村,NULL
1087,765,13,778,1007,0,0,77.26,371,394,富國里,NULL
717,771,7,778,1017,0,0,76.5,348,423,北灣里,NULL
261,768,10,778,1052,0,0,73.95,344,424,光定村,NULL
0,768,10,778,1052,0,0,73.95,344,424,光定村,NULL
181,775,2,777,974,0,0,79.77,623,152,雄峰里,NULL
403,772,5,777,984,0,0,78.96,608,164,豐湖村,NULL
0,772,5,777,984,0,0,78.96,608,164,豐湖村,NULL
8,773,4,777,991,0,0,78.41,574,199,復興里,NULL
584,773,4,777,972,0,0,79.94,521,252,中興村,NULL
231,776,1,777,1033,0,0,75.22,475,301,龍津村,NULL
778,774,3,777,992,0,0,78.33,404,370,鎮東里,NULL
1874,767,10,777,1030,0,0,75.44,404,363,埤島里,NULL
0,767,10,777,1030,0,0,75.44,404,363,埤島里,NULL
716,768,9,777,983,0,0,79.04,401,367,廣興里,NULL
562,769,8,777,1014,0,0,76.63,400,369,日中里,NULL
123,769,8,777,1057,0,0,73.51,348,421,光復里,NULL
713,773,4,777,1015,0,0,76.55,345,428,崑山里,NULL
70,771,6,777,1074,0,0,72.35,335,436,海岸里,NULL
0,771,6,777,1074,0,0,72.35,335,436,海岸里,NULL
410,770,6,776,868,0,0,89.4,751,19,仁義里,NULL
294,767,9,776,970,0,0,80,556,211,大愛里,NULL
930,763,13,776,958,0,0,81,547,216,河堤里,NULL
466,768,8,776,1004,0,0,77.29,433,335,平安里,NULL
758,774,2,776,1055,0,0,73.55,412,362,新興村,NULL
0,774,2,776,1055,0,0,73.55,412,362,新興村,NULL
443,771,5,776,1022,0,0,75.93,399,372,新庄里,NULL
82,771,5,776,1036,0,0,74.9,390,381,漢民里,NULL
406,772,4,776,1025,0,0,75.71,385,387,新東村,NULL
230,768,8,776,960,0,0,80.83,377,391,萬壽里,NULL
0,768,8,776,960,0,0,80.83,377,391,萬壽里,NULL
72,768,8,776,1084,0,0,71.59,367,401,房裡里,NULL
760,770,6,776,1026,0,0,75.63,367,403,仁德村,NULL
918,770,6,776,1035,0,0,74.98,344,426,福興里,NULL
796,772,4,776,1012,0,0,76.68,338,434,復興村,NULL
0,772,4,776,1012,0,0,76.68,338,434,復興村,NULL
463,771,5,776,971,0,0,79.92,288,483,仕隆村,NULL
0,769,6,775,988,0,0,78.44,590,179,達觀村,NULL
1605,766,9,775,1049,0,0,73.88,556,210,山光里,NULL
648,770,5,775,1005,0,0,77.11,482,288,永興里,NULL
0,770,5,775,1005,0,0,77.11,482,288,永興里,NULL
54,762,13,775,1032,0,0,75.1,470,292,南埔里,NULL
803,768,7,775,1014,0,0,76.43,467,301,文化村,NULL
0,768,7,775,1014,0,0,76.43,467,301,文化村,NULL
750,766,9,775,1070,0,0,72.43,440,326,饒平村,NULL
347,768,7,775,996,0,0,77.81,412,356,壽天里,NULL
125,766,9,775,1033,0,0,75.02,410,356,獅山里,NULL
617,771,4,775,999,0,0,77.58,405,366,三合里,NULL
256,771,4,775,997,0,0,77.73,378,393,河濱里,NULL
264,769,6,775,1020,0,0,75.98,375,394,群英村,NULL
895,771,4,775,1009,0,0,76.81,356,415,富榮里,NULL
0,765,10,775,1111,0,0,69.76,348,417,沄水村,NULL
824,762,13,775,1061,0,0,73.04,337,425,許厝村,NULL
77,767,8,775,1082,0,0,71.63,328,439,三協里,NULL
667,768,7,775,1038,0,0,74.66,304,464,廣應村,NULL
433,769,6,775,981,0,0,79,290,479,梓信村,NULL
498,768,7,775,1030,0,0,75.24,286,482,蘇厝村,NULL
305,773,2,775,1018,0,0,76.13,246,527,松安里,NULL
297,768,7,775,998,0,0,77.66,189,579,湖山村,NULL
0,768,7,775,998,0,0,77.66,189,579,湖山村,NULL
85,764,10,774,971,0,0,79.71,547,217,仙宮里,NULL
0,764,10,774,971,0,0,79.71,547,217,仙宮里,NULL
741,765,9,774,1027,0,0,75.37,542,223,成功里,NULL
250,765,9,774,1003,0,0,77.17,532,233,鳳坑村,NULL
0,765,9,774,1003,0,0,77.17,532,233,鳳坑村,NULL
26,771,3,774,1057,0,0,73.23,517,254,民權里,NULL
16,769,5,774,1003,0,0,77.17,500,269,文化里,NULL
1684,765,9,774,993,0,0,77.95,492,273,樹興里,NULL
616,764,10,774,1009,0,0,76.71,458,306,仁和里,NULL
295,766,8,774,1008,0,0,76.79,439,327,甲南村,NULL
299,769,5,774,1053,0,0,73.5,403,366,三崙村,NULL
367,768,6,774,1006,0,0,76.94,394,374,錦中村,NULL
382,763,11,774,945,0,0,81.9,393,370,祥興里,NULL
298,769,5,774,1030,0,0,75.15,366,403,甲北村,NULL
234,772,2,774,1022,0,0,75.73,332,440,檨腳村,NULL
148,765,9,774,1020,0,0,75.88,280,485,三和村,NULL
0,765,9,774,1020,0,0,75.88,280,485,三和村,NULL
1200,769,4,773,975,0,0,79.28,609,160,國豐里,NULL
314,764,9,773,1024,0,0,75.49,572,192,館南村,NULL
110,761,12,773,1140,0,0,67.81,560,201,蜈蚣里,NULL
78,764,9,773,1061,0,0,72.86,498,266,水美村,NULL
24,766,7,773,1061,0,0,72.86,484,282,寓埔村,NULL
108,763,10,773,1020,0,0,75.78,470,293,中山里,NULL
0,763,10,773,1020,0,0,75.78,470,293,中山里,NULL
10,767,6,773,1015,0,0,76.16,460,307,復興里,NULL
77,767,6,773,981,0,0,78.8,444,323,仁德里,NULL
0,767,6,773,981,0,0,78.8,444,323,仁德里,NULL
802,765,8,773,981,0,0,78.8,441,324,光化村,NULL
0,765,8,773,981,0,0,78.8,441,324,光化村,NULL
550,759,14,773,1003,0,0,77.07,437,322,中央里,NULL
618,764,9,773,989,0,0,78.16,415,349,福人里,NULL
377,770,3,773,961,0,0,80.44,409,361,仁壽里,NULL
144,767,6,773,1003,0,0,77.07,378,389,南勢里,NULL
169,771,2,773,984,0,0,78.56,359,412,西燕村,NULL
395,767,6,773,1153,0,0,67.04,357,410,香田里,NULL
0,767,6,773,1153,0,0,67.04,357,410,香田里,NULL
210,764,9,773,1004,0,0,76.99,347,417,中里村,NULL
715,757,16,773,1025,0,0,75.41,346,411,北灣里,NULL
209,767,6,773,977,0,0,79.12,332,435,中里村,NULL
603,765,8,773,971,0,0,79.61,310,455,山頂村,NULL
853,768,5,773,1021,0,0,75.71,305,463,老爺里,NULL
315,769,4,773,1127,0,0,68.59,271,498,大義村,NULL
0,769,4,773,1127,0,0,68.59,271,498,大義村,NULL
39,759,14,773,1127,0,0,68.59,270,489,副瀨村,NULL
0,759,14,773,1127,0,0,68.59,270,489,副瀨村,NULL
161,766,6,772,918,0,0,84.1,727,39,翠岱里,NULL
0,766,6,772,918,0,0,84.1,727,39,翠岱里,NULL
431,768,4,772,1030,0,0,74.95,513,255,鎮南里,NULL
204,764,8,772,1040,0,0,74.23,502,262,三和村,NULL
10,769,3,772,969,0,0,79.67,473,296,東平里,NULL
0,769,3,772,969,0,0,79.67,473,296,東平里,NULL
105,770,2,772,1055,0,0,73.18,454,316,平安里,NULL
619,768,4,772,1058,0,0,72.97,438,330,六合里,NULL
355,770,2,772,981,0,0,78.7,425,345,後紅里,NULL
379,766,6,772,1005,0,0,76.82,410,356,協和里,NULL
357,766,6,772,1005,0,0,76.82,390,376,碧紅里,NULL
458,763,9,772,1069,0,0,72.22,379,384,長安里,NULL
922,764,8,772,986,0,0,78.3,370,394,福誠里,NULL
246,761,11,772,997,0,0,77.43,369,392,田寮里,NULL
347,766,6,772,1024,0,0,75.39,351,415,丁臺村,NULL
112,765,7,772,1046,0,0,73.8,348,417,內田村,NULL
347,765,6,771,1027,0,0,75.07,672,93,福興村,NULL
0,765,6,771,1027,0,0,75.07,672,93,福興村,NULL
189,763,8,771,1012,0,0,76.19,598,165,斗煥里,NULL
194,765,6,771,1027,0,0,75.07,585,180,興隆里,NULL
315,765,6,771,1012,0,0,76.19,581,184,館南村,NULL
360,765,6,771,1012,0,0,76.19,547,218,員林村,NULL
0,765,6,771,1012,0,0,76.19,547,218,員林村,NULL
730,767,4,771,1007,0,0,76.56,474,293,復興里,NULL
681,762,9,771,1051,0,0,73.36,469,293,平鎮里,NULL
10,765,6,771,1034,0,0,74.56,450,315,新美里,NULL
69,766,5,771,1014,0,0,76.04,440,326,秀昌里,NULL
20,762,9,771,1177,0,0,65.51,438,324,陽明里,NULL
1356,766,5,771,987,0,0,78.12,425,341,貨饒里,NULL
199,762,9,771,989,0,0,77.96,394,368,吉祥村,NULL
122,759,12,771,1096,0,0,70.35,355,404,國姓里,NULL
342,760,11,771,991,0,0,77.8,324,436,三興村,NULL
0,760,11,771,991,0,0,77.8,324,436,三興村,NULL
169,767,4,771,976,0,0,79,307,460,二崙村,NULL
0,767,4,771,976,0,0,79,307,460,二崙村,NULL
19,768,2,770,1426,0,0,54,718,50,湖埔村,NULL
45,756,14,770,1021,0,0,75.42,641,115,福安里,NULL
279,768,2,770,1010,0,0,76.24,626,142,橫山村,NULL
546,762,8,770,1008,0,0,76.39,526,236,龍興里,NULL
60,761,9,770,1139,0,0,67.6,503,258,雙冬里,NULL
108,765,5,770,1005,0,0,76.62,490,275,光鎮里,NULL
115,764,6,770,1005,0,0,76.62,479,285,通明里,NULL
753,763,7,770,1019,0,0,75.56,464,299,睦宜村,NULL
0,763,7,770,1019,0,0,75.56,464,299,睦宜村,NULL
274,764,6,770,1070,0,0,71.96,434,330,湖東村,NULL
47,760,10,770,1003,0,0,76.77,428,332,港德里,NULL
568,762,8,770,955,0,0,80.63,428,334,西勢里,NULL
1532,765,5,770,989,0,0,77.86,417,348,忠孝里,NULL
530,766,4,770,1034,0,0,74.47,417,349,烏林村,NULL
728,764,6,770,1014,0,0,75.94,389,375,松竹村,NULL
716,769,1,770,991,0,0,77.7,389,380,文英里,NULL
0,764,6,770,1014,0,0,75.94,389,375,松竹村,NULL
443,770,0,770,1022,0,0,75.34,383,387,米崙村,NULL
0,770,0,770,1022,0,0,75.34,383,387,米崙村,NULL
799,764,6,770,1015,0,0,75.86,376,388,上豊村,NULL
0,764,6,770,1015,0,0,75.86,376,388,上豊村,NULL
216,765,5,770,1074,0,0,71.69,352,413,新社村,NULL
0,765,5,770,1074,0,0,71.69,352,413,新社村,NULL
192,767,3,770,1160,0,0,66.38,336,431,協和里,NULL
581,764,6,770,948,0,0,81.22,305,459,前庄村,NULL
283,759,11,770,966,0,0,79.71,290,469,葉厝村,NULL
331,760,10,770,1024,0,0,75.2,268,492,寮頂村,NULL
329,764,6,770,1074,0,0,71.69,259,505,樹林村,NULL
0,764,6,770,1074,0,0,71.69,259,505,樹林村,NULL
237,763,7,770,1201,0,0,64.11,254,509,松北村,NULL
0,763,7,770,1201,0,0,64.11,254,509,松北村,NULL
250,762,7,769,988,0,0,77.83,661,101,光榮里,NULL
63,761,8,769,963,0,0,79.85,550,211,龍山里,NULL
1804,758,11,769,1067,0,0,72.07,463,295,龍埔里,NULL
322,763,6,769,977,0,0,78.71,442,321,北口村,NULL
1651,762,7,769,1002,0,0,76.75,428,334,光興里,NULL
252,764,5,769,1027,0,0,74.88,415,349,吉林里,NULL
0,764,5,769,1027,0,0,74.88,415,349,吉林里,NULL
765,760,9,769,958,0,0,80.27,403,357,北興里,NULL
389,754,15,769,995,0,0,77.29,385,369,和龍里,NULL
102,762,7,769,1045,0,0,73.59,365,397,東勢里,NULL
0,762,7,769,1045,0,0,73.59,365,397,東勢里,NULL
179,759,10,769,1020,0,0,75.39,364,395,竹圍里,NULL
183,764,5,769,1018,0,0,75.54,355,409,開山里,NULL
644,763,6,769,1000,0,0,76.9,299,464,正強里,NULL
397,761,8,769,972,0,0,79.12,291,470,嘉興里,NULL
278,762,7,769,1029,0,0,74.73,277,485,劉家村,NULL
0,762,7,769,1029,0,0,74.73,277,485,劉家村,NULL
17,761,7,768,1009,0,0,76.11,586,175,民政里,NULL
203,764,4,768,962,0,0,79.83,582,182,自強里,NULL
2234,760,8,768,1009,0,0,76.11,490,270,萬里村,NULL
1926,762,6,768,1015,0,0,75.67,452,310,爪峯里,NULL
1316,757,11,768,1106,0,0,69.44,445,312,永寧里,NULL
146,760,8,768,977,0,0,78.61,417,343,永生里,NULL
0,760,8,768,977,0,0,78.61,417,343,永生里,NULL
516,759,9,768,1110,0,0,69.19,415,344,竹元村,NULL
0,759,9,768,1110,0,0,69.19,415,344,竹元村,NULL
149,760,8,768,1047,0,0,73.35,356,404,麥厝村,NULL
47,752,16,768,1064,0,0,72.18,350,402,淵西里,NULL
522,760,8,768,1041,0,0,73.78,346,414,新和村,NULL
374,762,6,768,1064,0,0,72.18,325,437,義仁村,NULL
0,762,6,768,1064,0,0,72.18,325,437,義仁村,NULL
126,759,9,768,1012,0,0,75.89,297,462,正覺里,NULL
774,760,8,768,938,0,0,81.88,275,485,鎮東里,NULL
44,759,8,767,981,0,0,78.19,584,175,福安里,NULL
84,761,6,767,951,0,0,80.65,574,187,中正里,NULL
512,757,10,767,1271,0,0,60.35,548,209,東港村,NULL
0,757,10,767,1271,0,0,60.35,548,209,東港村,NULL
14,761,6,767,1024,0,0,74.9,521,240,西安村,NULL
0,761,6,767,1024,0,0,74.9,521,240,西安村,NULL
275,760,7,767,1185,0,0,64.73,499,261,中和里,NULL
0,760,7,767,1185,0,0,64.73,499,261,中和里,NULL
683,758,9,767,977,0,0,78.51,489,269,平鎮里,NULL
76,761,6,767,1116,0,0,68.73,486,275,北山村,NULL
761,758,9,767,963,0,0,79.65,420,338,忠義里,NULL
141,762,5,767,1006,0,0,76.24,397,365,慈仁里,NULL
0,762,5,767,1006,0,0,76.24,397,365,慈仁里,NULL
474,761,6,767,958,0,0,80.06,376,385,瑞德里,NULL
110,762,5,767,1022,0,0,75.05,366,396,小康里,NULL
803,762,5,767,954,0,0,80.4,355,407,西甲里,NULL
148,759,8,767,1113,0,0,68.91,342,417,好美里,NULL
0,759,8,767,1113,0,0,68.91,342,417,好美里,NULL
599,759,8,767,990,0,0,77.47,284,475,永芳村,NULL
203,758,9,767,1083,0,0,70.82,246,512,果毅村,NULL
243,759,8,767,1069,0,0,71.75,210,549,游東村,NULL
0,759,8,767,1069,0,0,71.75,210,549,游東村,NULL
110,759,7,766,1027,0,0,74.59,631,128,五豐里,NULL
235,759,7,766,1016,0,0,75.39,520,239,文明里、泰安里,NULL
0,759,7,766,1016,0,0,75.39,520,239,文明里、泰安里,NULL
144,758,8,766,1017,0,0,75.32,452,306,下寮里,NULL
83,761,5,766,992,0,0,77.22,430,331,舊社里,NULL
43,760,6,766,1057,0,0,72.47,423,337,日南里,NULL
95,759,7,766,1036,0,0,73.94,419,340,社苓里,NULL
596,760,6,766,970,0,0,78.97,406,354,五權里,NULL
317,757,9,766,1017,0,0,75.32,394,363,文北村,NULL
137,761,5,766,1043,0,0,73.44,392,369,南安里,NULL
0,761,5,766,1043,0,0,73.44,392,369,南安里,NULL
166,757,9,766,942,0,0,81.32,381,376,振興里,NULL
647,765,1,766,992,0,0,77.22,342,423,林園村,NULL
193,751,15,766,954,0,0,80.29,340,411,協和里,NULL
321,754,12,766,1008,0,0,75.99,330,424,竹滬村,NULL
289,752,14,766,1095,0,0,69.95,312,440,龜港村,NULL
858,761,5,766,1046,0,0,73.23,312,449,東勢村,NULL
0,752,14,766,1095,0,0,69.95,312,440,龜港村,NULL
152,754,12,766,985,0,0,77.77,228,526,玉庫村,NULL
0,754,12,766,985,0,0,77.77,228,526,玉庫村,NULL
1,759,6,765,1287,0,0,59.44,490,269,育賢里、三民里,NULL
0,759,6,765,1287,0,0,59.44,490,269,育賢里、三民里,NULL
237,760,5,765,999,0,0,76.58,393,367,虎林里,NULL
54,763,2,765,1032,0,0,74.13,387,376,新生里,NULL
376,761,4,765,1004,0,0,76.2,382,379,寶厝村,NULL
496,754,11,765,1023,0,0,74.78,373,381,舊社里,NULL
369,757,8,765,1002,0,0,76.35,373,384,臺上里,NULL
441,756,9,765,1053,0,0,72.65,363,393,七塊村,NULL
0,756,9,765,1053,0,0,72.65,363,393,七塊村,NULL
179,760,4,764,947,0,0,80.68,556,204,金華里,NULL
2238,752,12,764,1153,0,0,66.26,507,245,北基村,NULL
564,755,9,764,1010,0,0,75.64,455,300,文昌里,NULL
380,758,6,764,961,0,0,79.5,444,314,協和里,NULL
255,753,11,764,1035,0,0,73.82,432,321,漳興里,NULL
63,757,7,764,993,0,0,76.94,424,333,苑南里,NULL
180,754,10,764,974,0,0,78.44,413,341,萬壽里,NULL
0,754,10,764,974,0,0,78.44,413,341,萬壽里,NULL
672,760,4,764,982,0,0,77.8,405,355,上城里,NULL
0,760,4,764,982,0,0,77.8,405,355,上城里,NULL
66,756,8,764,1132,0,0,67.49,402,354,太平里,NULL
486,760,4,764,1008,0,0,75.79,400,360,復元里,NULL
0,760,4,764,1008,0,0,75.79,400,360,復元里,NULL
36,760,4,764,1257,0,0,60.78,399,361,五港村,NULL
567,756,8,764,1011,0,0,75.57,394,362,中建里,NULL
0,756,8,764,1011,0,0,75.57,394,362,中建里,NULL
669,760,4,764,988,0,0,77.33,374,386,塩洲里,NULL
236,755,9,764,1007,0,0,75.87,321,434,峰南里,NULL
0,755,9,764,1007,0,0,75.87,321,434,峰南里,NULL
177,754,10,764,974,0,0,78.44,276,478,安招村,NULL
401,761,3,764,1014,0,0,75.35,272,489,田洋村,NULL
23,757,6,763,1041,0,0,73.29,483,274,寓埔村,NULL
34,756,7,763,993,0,0,76.84,479,277,信義里,NULL
0,756,7,763,993,0,0,76.84,479,277,信義里,NULL
210,756,7,763,940,0,0,81.17,477,279,深丘里,NULL
1272,758,5,763,971,0,0,78.58,443,315,雙城里,NULL
372,758,5,763,1019,0,0,74.88,416,342,圍下里,NULL
231,755,8,763,951,0,0,80.23,385,370,西興里,NULL
60,753,10,763,1250,0,0,61.04,376,377,新坤村,NULL
0,753,10,763,1250,0,0,61.04,376,377,新坤村,NULL
469,753,10,763,1101,0,0,69.3,355,398,大德村,NULL
0,753,10,763,1101,0,0,69.3,355,398,大德村,NULL
624,759,4,763,969,0,0,78.74,322,437,大寮村,NULL
464,757,6,763,988,0,0,77.23,313,444,灣成里,NULL
283,757,6,763,1053,0,0,72.46,291,466,二甲村,NULL
246,754,9,763,987,0,0,77.3,249,505,福德村,NULL
0,754,9,763,987,0,0,77.3,249,505,福德村,NULL
468,753,9,762,956,0,0,79.71,655,98,仁義里,NULL
25,753,9,762,1015,0,0,75.07,552,201,主勤里,NULL
0,753,9,762,1015,0,0,75.07,552,201,主勤里,NULL
485,757,5,762,992,0,0,76.81,542,215,勤益里,NULL
260,758,4,762,975,0,0,78.15,469,289,新華里,NULL
36,757,5,762,1015,0,0,75.07,441,316,新豐里,NULL
157,757,5,762,1006,0,0,75.75,421,336,民富里,NULL
62,756,6,762,952,0,0,80.04,396,360,公館里,NULL
1131,755,7,762,1055,0,0,72.23,393,362,光和里,NULL
773,758,4,762,984,0,0,77.44,386,372,新田村,NULL
498,758,4,762,961,0,0,79.29,383,375,文武村,NULL
322,757,5,762,1010,0,0,75.45,379,378,廣興里,NULL
401,753,9,762,1003,0,0,75.97,369,384,仁德里,NULL
418,755,7,762,954,0,0,79.87,356,399,過港村,NULL
0,755,7,762,954,0,0,79.87,356,399,過港村,NULL
188,752,10,762,1030,0,0,73.98,355,397,鹿寮里,NULL
46,754,8,762,1286,0,0,59.25,317,437,月眉村,NULL
0,754,8,762,1286,0,0,59.25,317,437,月眉村,NULL
179,754,8,762,979,0,0,77.83,279,475,安招村,NULL
119,750,11,761,1151,0,0,66.12,655,95,干城村,NULL
0,750,11,761,1151,0,0,66.12,655,95,干城村,NULL
738,756,5,761,931,0,0,81.74,643,113,神洲里,NULL
176,753,8,761,996,0,0,76.41,528,225,南新里,NULL
0,753,8,761,996,0,0,76.41,528,225,南新里,NULL
476,749,12,761,964,0,0,78.94,519,230,仁文里,NULL
14,751,10,761,985,0,0,77.26,493,258,岷山里,NULL
184,752,9,761,973,0,0,78.21,460,292,東平里,NULL
0,752,9,761,973,0,0,78.21,460,292,東平里,NULL
601,759,2,761,1074,0,0,70.86,441,318,城西里,NULL
0,759,2,761,1074,0,0,70.86,441,318,城西里,NULL
106,757,4,761,1050,0,0,72.48,438,319,德興里,NULL
329,754,7,761,1005,0,0,75.72,435,319,建興里,NULL
250,758,3,761,1034,0,0,73.6,426,332,香山里,NULL
1932,753,8,761,1028,0,0,74.03,426,327,柑坪里,NULL
0,753,8,761,1028,0,0,74.03,426,327,柑坪里,NULL
896,754,7,761,1029,0,0,73.96,425,329,富榮里,NULL
103,756,5,761,960,0,0,79.27,416,340,平元里,NULL
781,755,6,761,986,0,0,77.18,403,352,瑞竹里,NULL
305,754,7,761,1012,0,0,75.2,392,362,三村里,NULL
0,754,7,761,1012,0,0,75.2,392,362,三村里,NULL
902,757,4,761,962,0,0,79.11,376,381,南成里,NULL
335,752,9,761,1023,0,0,74.39,370,382,光華里,NULL
0,752,9,761,1023,0,0,74.39,370,382,光華里,NULL
630,758,3,761,963,0,0,79.02,368,390,正文里,NULL
417,754,7,761,1000,0,0,76.1,353,401,文昌里,NULL
508,757,4,761,998,0,0,76.25,343,414,華聲里,NULL
0,757,4,761,998,0,0,76.25,343,414,華聲里,NULL
134,754,7,761,1073,0,0,70.92,330,424,惠來里,NULL
551,755,6,761,935,0,0,81.39,330,425,坔埔村,NULL
865,753,8,761,1025,0,0,74.24,325,428,北花村,NULL
39,750,11,761,1094,0,0,69.56,294,456,田子村,NULL
0,750,11,761,1094,0,0,69.56,294,456,田子村,NULL
395,748,13,761,986,0,0,77.18,280,468,廣安村,NULL
700,754,6,760,947,0,0,80.25,634,120,黎安里,NULL
229,754,6,760,998,0,0,76.15,612,142,蟠桃里,NULL
793,753,7,760,962,0,0,79,600,153,秀士里,NULL
22,756,4,760,944,0,0,80.51,600,156,水源里,NULL
0,756,4,760,1317,0,0,57.71,520,236,福文村,NULL
0,750,10,760,1131,0,0,67.2,445,305,建興村,NULL
1686,750,10,760,997,0,0,76.23,441,309,樹興里,NULL
348,752,8,760,978,0,0,77.71,392,360,成功里,NULL
616,751,9,760,996,0,0,76.31,378,373,三合里,NULL
763,753,7,760,1014,0,0,74.95,370,383,仁德村,NULL
546,749,11,760,1009,0,0,75.32,369,380,富福里,NULL
334,753,6,759,959,0,0,79.14,488,265,錦榮村,NULL
0,753,6,759,959,0,0,79.14,488,265,錦榮村,NULL
140,747,12,759,1069,0,0,71,486,261,龍潭村,NULL
364,754,5,759,982,0,0,77.29,467,287,新鐘村,NULL
58,753,6,759,1039,0,0,73.05,437,316,安福里,NULL
686,747,12,759,994,0,0,76.36,423,324,南東里,NULL
182,752,7,759,982,0,0,77.29,412,340,公義里,NULL
0,752,7,759,982,0,0,77.29,412,340,公義里,NULL
70,752,7,759,1014,0,0,74.85,353,399,中圍里,NULL
484,754,5,759,1039,0,0,73.05,326,428,港東村,NULL
696,752,7,759,1011,0,0,75.07,316,436,大灣里,NULL
181,747,12,759,967,0,0,78.49,315,432,萬昌里,NULL
650,751,8,759,977,0,0,77.69,287,464,芝芭里,NULL
371,753,6,759,1006,0,0,75.45,256,497,龍安里,NULL
0,753,6,759,1006,0,0,75.45,256,497,龍安里,NULL
237,748,11,759,954,0,0,79.56,229,519,和山村,NULL
0,748,11,759,954,0,0,79.56,229,519,和山村,NULL
206,751,7,758,925,0,0,81.95,618,133,忠孝里,NULL
123,747,11,758,997,0,0,76.03,519,228,春社里,NULL
1930,755,3,758,1042,0,0,72.74,458,297,東和里,NULL
755,752,6,758,1059,0,0,71.58,434,318,北鎮村,NULL
0,752,6,758,1059,0,0,71.58,434,318,北鎮村,NULL
23,751,7,758,1100,0,0,68.91,428,323,文曲里,NULL
0,751,7,758,1100,0,0,68.91,428,323,文曲里,NULL
82,752,6,758,1069,0,0,70.91,371,381,中正里,NULL
811,748,10,758,994,0,0,76.26,331,417,歸南村,NULL
626,749,9,758,956,0,0,79.29,323,426,福西里,NULL
168,743,15,758,1040,0,0,72.88,314,429,民榮里,NULL
308,750,8,758,966,0,0,78.47,257,493,佛壇里,NULL
213,749,8,757,956,0,0,79.18,515,234,永平里,NULL
605,755,2,757,1047,0,0,72.3,500,255,山頂村,NULL
9,755,2,757,920,0,0,82.28,475,280,中山里,NULL
81,753,4,757,1019,0,0,74.29,458,295,誠仁里,NULL
0,753,4,757,1019,0,0,74.29,458,295,誠仁里,NULL
218,752,5,757,981,0,0,77.17,439,313,崇文里,NULL
0,752,5,757,981,0,0,77.17,439,313,崇文里,NULL
600,747,10,757,1135,0,0,66.7,434,313,城北里,NULL
323,749,8,757,1060,0,0,71.42,432,317,中山里,NULL
289,744,13,757,1019,0,0,74.29,427,317,僑中里,NULL
557,749,8,757,933,0,0,81.14,360,389,廣澤里,NULL
860,750,7,757,984,0,0,76.93,323,427,東勢村,NULL
315,745,12,757,1000,0,0,75.7,318,427,中洋村,NULL
0,745,12,757,1000,0,0,75.7,318,427,中洋村,NULL
642,750,7,757,1005,0,0,75.32,298,452,義仁村,NULL
688,752,5,757,998,0,0,75.85,294,458,鳳芸村,NULL
426,751,6,757,1020,0,0,74.22,260,491,什乃里,NULL
0,751,6,757,1020,0,0,74.22,260,491,什乃里,NULL
685,751,6,757,983,0,0,77.01,224,527,中芸村,NULL
915,748,8,756,904,0,0,83.63,628,120,大同里,NULL
0,748,8,756,904,0,0,83.63,628,120,大同里,NULL
72,751,5,756,1184,0,0,63.85,552,199,忠仁里,NULL
200,747,9,756,940,0,0,80.43,514,233,福林里,NULL
144,744,12,756,935,0,0,80.86,490,254,大厝里,NULL
259,751,5,756,983,0,0,76.91,462,289,海山里,NULL
734,752,4,756,1023,0,0,73.9,460,292,復華里,NULL
104,752,4,756,974,0,0,77.62,411,341,樹林里,NULL
324,748,8,756,1105,0,0,68.42,383,365,中山里,NULL
339,744,12,756,966,0,0,78.26,346,398,頂崁里,NULL
2085,749,7,756,994,0,0,76.06,338,411,太平村,NULL
0,749,7,756,994,0,0,76.06,338,411,太平村,NULL
89,751,5,756,1023,0,0,73.9,287,464,仁得里,NULL
63,750,5,755,930,0,0,81.18,677,73,大石里,NULL
0,750,5,755,930,0,0,81.18,677,73,大石里,NULL
21,752,3,755,987,0,0,76.49,591,161,建國里,NULL
89,747,8,755,1058,0,0,71.36,585,162,嘉里村,NULL
90,750,5,755,962,0,0,78.48,572,178,福瑞里,NULL
36,749,6,755,970,0,0,77.84,571,178,嘉盛里,NULL
1604,749,6,755,1023,0,0,73.8,555,194,山光里,NULL
17,740,15,755,936,0,0,80.66,510,230,新苗里,NULL
0,740,15,755,936,0,0,80.66,510,230,新苗里,NULL
57,747,8,755,953,0,0,79.22,476,271,溪州里,NULL
57,744,11,755,1066,0,0,70.83,470,274,仁愛里,NULL
273,750,5,755,987,0,0,76.49,466,284,湖東村,NULL
112,750,5,755,1038,0,0,72.74,447,303,中壇里,NULL
135,749,6,755,970,0,0,77.84,446,303,西華里,NULL
0,749,6,755,970,0,0,77.84,446,303,西華里,NULL
59,747,8,755,1154,0,0,65.42,441,306,雙冬里,NULL
1624,749,6,755,936,0,0,80.66,426,323,北山里,NULL
453,745,10,755,1051,0,0,71.84,408,337,玉田村,NULL
193,748,7,755,1217,0,0,62.04,382,366,東光村,NULL
265,750,5,755,931,0,0,81.1,382,368,仁美里,NULL
0,748,7,755,1217,0,0,62.04,382,366,東光村,NULL
462,741,14,755,977,0,0,77.28,371,370,安慶里,NULL
300,750,5,755,963,0,0,78.4,352,398,德北里,NULL
380,748,7,755,902,0,0,83.7,333,415,本文里,NULL
274,747,8,755,1175,0,0,64.26,295,452,溝皂里,NULL
0,747,8,755,1175,0,0,64.26,295,452,溝皂里,NULL
308,745,10,755,1125,0,0,67.11,274,471,三和村,NULL
14,753,1,754,1503,0,0,50.17,703,50,珠沙里,NULL
0,753,1,754,1503,0,0,50.17,703,50,珠沙里,NULL
35,745,9,754,902,0,0,83.59,525,220,福德里,NULL
573,747,7,754,955,0,0,78.95,468,279,福成里,NULL
718,749,5,754,914,0,0,82.49,458,291,瑞穗里,NULL
413,748,6,754,1032,0,0,73.06,427,321,五房村,NULL
1845,746,8,754,977,0,0,77.18,407,339,屯山里,NULL
0,746,8,754,977,0,0,77.18,407,339,屯山里,NULL
428,747,7,754,1017,0,0,74.14,346,401,園寮村,NULL
272,748,6,754,1049,0,0,71.88,317,431,慈愛里,NULL
383,747,7,754,975,0,0,77.33,296,451,中興里,NULL
619,748,6,754,1000,0,0,75.4,252,496,上寮村,NULL
36,752,1,753,1339,0,0,56.24,723,29,汶沙里,NULL
215,748,5,753,991,0,0,75.98,523,225,永安里,NULL
15,747,6,753,1174,0,0,64.14,444,303,朝陽里,NULL
440,747,6,753,1089,0,0,69.15,443,304,江厝里,NULL
295,744,9,753,1021,0,0,73.75,433,311,中山里,NULL
997,744,9,753,972,0,0,77.47,387,357,中華里,NULL
74,751,2,753,1011,0,0,74.48,363,388,瑞吉里,NULL
138,748,5,753,1014,0,0,74.26,354,394,垂楊里,NULL
859,747,6,753,998,0,0,75.45,343,404,中榮里,NULL
213,745,8,753,1013,0,0,74.33,316,429,功勞村,NULL
0,745,8,753,1013,0,0,74.33,316,429,功勞村,NULL
53,747,6,753,1144,0,0,65.82,306,441,西崙村,NULL
0,747,6,753,1144,0,0,65.82,306,441,西崙村,NULL
194,746,7,753,1005,0,0,74.93,287,459,大社村,NULL
400,745,8,753,990,0,0,76.06,221,524,海埔里,NULL
0,745,8,753,990,0,0,76.06,221,524,海埔里,NULL
187,749,3,752,977,0,0,76.97,553,196,斗煥里,NULL
1218,741,11,752,952,0,0,78.99,505,236,寶福里,NULL
230,745,7,752,959,0,0,78.42,494,251,福興村,NULL
0,745,7,752,959,0,0,78.42,494,251,福興村,NULL
670,744,8,752,1005,0,0,74.83,480,264,萬年里,NULL
84,747,5,752,939,0,0,80.09,412,335,塩田里,NULL
0,747,5,752,939,0,0,80.09,412,335,塩田里,NULL
661,747,5,752,929,0,0,80.95,404,343,三多里,NULL
639,744,8,752,1008,0,0,74.6,402,342,永源村,NULL
352,745,7,752,1017,0,0,73.94,344,401,大崎村,NULL
129,741,11,752,956,0,0,78.66,343,398,長美里,NULL
0,741,11,752,956,0,0,78.66,343,398,長美里,NULL
45,745,7,752,979,0,0,76.81,317,428,光復里,NULL
0,745,7,752,979,0,0,76.81,317,428,光復里,NULL
232,745,7,752,1030,0,0,73.01,256,489,西和村,NULL
0,745,7,752,1030,0,0,73.01,256,489,西和村,NULL
397,747,5,752,955,0,0,78.74,196,551,小埤里,NULL
0,747,5,752,955,0,0,78.74,196,551,小埤里,NULL
793,744,7,751,952,0,0,78.89,692,52,仁愛村,NULL
200,743,8,751,1024,0,0,73.34,515,228,福興里,NULL
236,743,8,751,964,0,0,77.9,464,279,虎林里,NULL
0,743,8,751,1167,0,0,64.35,457,286,公館村,NULL
101,744,7,751,965,0,0,77.82,450,294,頂竹里,NULL
2082,745,6,751,977,0,0,76.87,426,319,下福村,NULL
0,745,6,751,977,0,0,76.87,426,319,下福村,NULL
2030,747,4,751,996,0,0,75.4,422,325,義學村,NULL
262,743,8,751,944,0,0,79.56,406,337,信義里,NULL
0,743,8,751,944,0,0,79.56,406,337,信義里,NULL
451,745,6,751,984,0,0,76.32,392,353,打鐵村,NULL
0,745,6,751,984,0,0,76.32,392,353,打鐵村,NULL
301,746,5,751,988,0,0,76.01,375,371,隆田村,NULL
673,747,4,751,931,0,0,80.67,365,382,小港里,NULL
407,740,11,751,1049,0,0,71.59,338,402,富收村,NULL
171,745,6,751,1185,0,0,63.38,298,447,長南村,NULL
448,746,5,751,952,0,0,78.89,290,456,赤東村,NULL
293,744,7,751,1045,0,0,71.87,282,462,大庄村,NULL
843,746,5,751,919,0,0,81.72,272,474,海洋里,NULL
290,746,5,751,1004,0,0,74.8,269,477,竹園村,NULL
95,741,10,751,932,0,0,80.58,266,475,新宮里,NULL
0,741,10,751,932,0,0,80.58,266,475,新宮里,NULL
0,743,8,751,1029,0,0,72.98,251,492,保源村,NULL
14,748,2,750,1100,0,0,68.18,539,209,光榮里,NULL
222,745,5,750,1002,0,0,74.85,497,248,泰安里,NULL
1,747,3,750,1104,0,0,67.93,453,294,麥豐村,NULL
396,743,7,750,1065,0,0,70.42,447,296,外竹里,NULL
0,743,7,750,1065,0,0,70.42,447,296,外竹里,NULL
0,747,3,750,1227,0,0,61.12,439,308,明峰村,NULL
257,745,5,750,943,0,0,79.53,434,311,朝山里,NULL
1824,744,6,750,1002,0,0,74.85,424,320,大埔里,NULL
94,742,8,750,968,0,0,77.48,410,332,重興里,NULL
984,746,4,750,989,0,0,75.83,380,366,塔腳村,NULL
0,746,4,750,989,0,0,75.83,380,366,塔腳村,NULL
174,745,5,750,971,0,0,77.24,362,383,南燕村,NULL
318,748,2,750,984,0,0,76.22,334,414,劉厝村,NULL
0,748,2,750,984,0,0,76.22,334,414,劉厝村,NULL
823,746,4,750,1003,0,0,74.78,310,436,許厝村,NULL
26,748,2,750,1015,0,0,73.89,308,440,源泉村,NULL
0,748,2,750,1015,0,0,73.89,308,440,源泉村,NULL
369,742,8,750,1038,0,0,72.25,254,488,通興里,NULL
0,742,8,750,1038,0,0,72.25,254,488,通興里,NULL
708,746,4,750,986,0,0,76.06,227,519,南灣里,NULL
266,746,3,749,953,0,0,78.59,598,148,石潭村,NULL
88,743,6,749,916,0,0,81.77,582,161,中山里,NULL
615,743,6,749,981,0,0,76.35,579,164,興南里,NULL
50,744,5,749,934,0,0,80.19,542,202,東信里,NULL
121,746,3,749,1119,0,0,66.93,518,228,文化里,NULL
0,746,3,749,1119,0,0,66.93,518,228,文化里,NULL
390,742,7,749,999,0,0,74.97,497,245,城中村,NULL
0,742,7,749,999,0,0,74.97,497,245,城中村,NULL
2086,736,13,749,973,0,0,76.98,422,314,萬順村,NULL
509,742,7,749,988,0,0,75.81,351,391,港南村,NULL
26,746,2,748,948,0,0,78.9,578,168,清華里,NULL
735,744,4,748,907,0,0,82.47,553,191,壽德里,NULL
37,740,8,748,1013,0,0,73.84,506,234,福德里,NULL
632,736,12,748,1002,0,0,74.65,458,278,松隆里,NULL
192,744,4,748,982,0,0,76.17,390,354,大同里,NULL
0,744,4,748,982,0,0,76.17,390,354,大同里,NULL
319,745,3,748,930,0,0,80.43,362,383,文北村,NULL
285,742,6,748,1035,0,0,72.27,359,383,南陽村,NULL
419,741,7,748,944,0,0,79.24,355,386,鹽埕村,NULL
533,734,14,748,935,0,0,80,343,391,慈惠里,NULL
230,740,8,748,998,0,0,74.95,293,447,長榮村,NULL
0,740,8,748,998,0,0,74.95,293,447,長榮村,NULL
74,744,3,747,1114,0,0,67.06,550,194,忠智里,NULL
0,744,3,747,1114,0,0,67.06,550,194,忠智里,NULL
308,743,4,747,994,0,0,75.15,489,254,集集里,NULL
0,743,4,747,994,0,0,75.15,489,254,集集里,NULL
295,739,8,747,1026,0,0,72.81,432,307,湖日村,NULL
876,736,11,747,963,0,0,77.57,424,312,烏樹林村,NULL
457,739,8,747,972,0,0,76.85,417,322,旱溪里,NULL
0,740,7,747,1028,0,0,72.67,393,347,東昌里,NULL
425,739,8,747,946,0,0,78.96,382,357,打廉村,NULL
0,739,8,747,946,0,0,78.96,382,357,打廉村,NULL
119,742,5,747,983,0,0,75.99,367,375,新海里,NULL
84,741,6,747,966,0,0,77.33,345,396,洛津里,NULL
334,739,8,747,959,0,0,77.89,345,394,新港村,NULL
0,741,6,747,966,0,0,77.33,345,396,洛津里,NULL
279,742,5,747,983,0,0,75.99,323,419,安鎮里,NULL
467,741,6,747,989,0,0,75.53,291,450,安寧里,NULL
269,739,8,747,975,0,0,76.62,274,465,溝背里,NULL
0,739,8,747,975,0,0,76.62,274,465,溝背里,NULL
437,737,10,747,1022,0,0,73.09,240,497,嘉南里,NULL
0,737,10,747,1022,0,0,73.09,240,497,嘉南里,NULL
60,739,7,746,1020,0,0,73.14,529,210,南勢里,NULL
544,740,6,746,991,0,0,75.28,503,237,崇倫里,NULL
188,737,9,746,969,0,0,76.99,481,256,暖同里,NULL
733,739,7,746,1004,0,0,74.3,463,276,復華里,NULL
316,743,3,746,962,0,0,77.55,437,306,中庄村,NULL
694,738,8,746,1015,0,0,73.5,431,307,永北村,NULL
835,743,3,746,961,0,0,77.63,411,332,新泰里,NULL
105,734,12,746,1047,0,0,71.25,385,349,舊埤里,NULL
54,738,8,746,1030,0,0,72.43,383,355,南埔村,NULL
0,738,8,746,1030,0,0,72.43,383,355,南埔村,NULL
281,743,3,746,999,0,0,74.67,371,372,新民村,NULL
0,743,3,746,999,0,0,74.67,371,372,新民村,NULL
392,737,9,746,932,0,0,80.04,366,371,大元里,NULL
121,737,9,746,963,0,0,77.47,344,393,岸內里,NULL
183,735,11,746,1222,0,0,61.05,313,422,頂寮村,NULL
0,735,11,746,1222,0,0,61.05,313,422,頂寮村,NULL
267,739,7,746,953,0,0,78.28,309,430,日新里,NULL
243,737,9,746,1016,0,0,73.43,301,436,補城村,NULL
0,737,9,746,1016,0,0,73.43,301,436,補城村,NULL
31,732,14,746,1249,0,0,59.73,270,462,牛厝村,NULL
0,742,3,745,988,0,0,75.4,706,36,互助村,NULL
382,740,5,745,950,0,0,78.42,580,160,双湖村,NULL
58,739,6,745,1099,0,0,67.79,564,175,南王里,NULL
13,736,9,745,1145,0,0,65.07,535,201,後安村,NULL
203,739,6,745,944,0,0,78.92,531,208,碇安里,NULL
3,733,12,745,1053,0,0,70.75,512,221,砂子里,NULL
115,741,4,745,1040,0,0,71.63,506,235,清新里,NULL
0,735,10,745,1167,0,0,63.84,444,291,上山村,NULL
2013,735,10,745,961,0,0,77.52,440,295,山腳村,NULL
345,736,9,745,943,0,0,79,429,307,太平里,NULL
0,736,9,745,943,0,0,79,429,307,太平里,NULL
16,737,8,745,1201,0,0,62.03,428,309,朝陽里,NULL
701,735,10,745,927,0,0,80.37,411,324,正守里,NULL
585,736,9,745,1029,0,0,72.4,410,326,知義里,NULL
587,739,6,745,1141,0,0,65.29,405,334,柑園村,NULL
0,739,6,745,1141,0,0,65.29,405,334,柑園村,NULL
141,740,5,745,997,0,0,74.72,390,350,同安村,NULL
82,744,1,745,976,0,0,76.33,390,354,仁義里,NULL
181,742,3,745,924,0,0,80.63,381,361,角宿村,NULL
539,739,6,745,980,0,0,76.02,362,377,豐榮里,NULL
0,739,6,745,980,0,0,76.02,362,377,豐榮里,NULL
814,740,5,745,979,0,0,76.1,345,395,後市村,NULL
165,733,12,745,998,0,0,74.65,335,398,北榮里,NULL
215,741,4,745,994,0,0,74.95,326,415,美城村,NULL
911,742,3,745,940,0,0,79.26,317,425,五福里,NULL
349,740,5,745,980,0,0,76.02,285,455,頂湳里,NULL
0,740,5,745,980,0,0,76.02,285,455,頂湳里,NULL
447,740,5,745,1044,0,0,71.36,282,458,頭社村,NULL
0,740,5,745,1044,0,0,71.36,282,458,頭社村,NULL
125,737,8,745,1011,0,0,73.69,280,457,大屯里,NULL
0,737,8,745,1011,0,0,73.69,280,457,大屯里,NULL
432,741,4,745,997,0,0,74.72,263,478,田寮里,NULL
690,740,4,744,1003,0,0,74.18,603,137,博愛村,NULL
621,744,0,744,931,0,0,79.91,513,231,六合里,NULL
259,739,5,744,940,0,0,79.15,485,254,平陽里,NULL
254,735,9,744,1023,0,0,72.73,459,276,大庄里,NULL
74,738,6,744,984,0,0,75.61,412,326,泰安里,NULL
0,738,6,744,984,0,0,75.61,412,326,泰安里,NULL
228,743,1,744,1138,0,0,65.38,373,370,青山村,NULL
0,743,1,744,1138,0,0,65.38,373,370,青山村,NULL
698,733,11,744,962,0,0,77.34,370,363,湳港村,NULL
0,733,11,744,962,0,0,77.34,370,363,湳港村,NULL
553,737,7,744,978,0,0,76.07,368,369,人和里,NULL
287,738,6,744,1076,0,0,69.14,301,437,崙前村,NULL
718,743,1,744,959,0,0,77.58,281,462,北灣里,NULL
683,742,2,744,974,0,0,76.39,280,462,西溪村,NULL
570,739,4,743,1105,0,0,67.24,675,64,石門村,NULL
226,739,4,743,976,0,0,76.13,634,105,成功里,NULL
106,740,3,743,920,0,0,80.76,605,135,榮華里,NULL
257,732,11,743,864,0,0,86,602,130,仁愛里,NULL
38,741,2,743,949,0,0,78.29,482,259,光復里,NULL
40,738,5,743,1071,0,0,69.37,410,328,孟春里,NULL
164,736,7,743,968,0,0,76.76,395,341,莊雅村,NULL
827,738,5,743,965,0,0,76.99,394,344,武漢里,NULL
0,737,6,743,1055,0,0,70.43,382,355,太和村,NULL
198,736,7,743,1006,0,0,73.86,373,363,吉祥村,NULL
252,735,8,743,930,0,0,79.89,354,381,新樂里,NULL
0,735,8,743,930,0,0,79.89,354,381,新樂里,NULL
615,732,11,743,986,0,0,75.35,346,386,三隆村,NULL
675,737,6,743,1020,0,0,72.84,302,435,頂厝村,NULL
312,737,6,743,935,0,0,79.47,292,445,興農里,NULL
144,734,9,743,1035,0,0,71.79,286,448,新岑里,NULL
0,734,9,743,1035,0,0,71.79,286,448,新岑里,NULL
877,736,7,743,982,0,0,75.66,284,452,一甲里,NULL
1959,736,6,742,1040,0,0,71.35,507,229,海濱里,NULL
0,736,6,742,1040,0,0,71.35,507,229,海濱里,NULL
477,730,12,742,932,0,0,79.61,448,282,仁文里,NULL
1095,738,4,742,997,0,0,74.42,422,316,建福里,NULL
282,739,3,742,1006,0,0,73.76,389,350,炭寮村,NULL
0,739,3,742,1006,0,0,73.76,389,350,炭寮村,NULL
295,735,7,742,999,0,0,74.27,322,413,鯤鯓里,NULL
494,733,9,742,1027,0,0,72.25,320,413,船頭里,NULL
14,733,9,742,936,0,0,79.27,271,462,龍潭里,NULL
0,733,9,742,936,0,0,79.27,271,462,龍潭里,NULL
709,730,11,741,960,0,0,77.19,514,216,湧安里,NULL
0,736,5,741,1061,0,0,69.84,413,323,枋山村,NULL
215,734,7,741,972,0,0,76.23,408,326,中寮里,NULL
435,733,8,741,1001,0,0,74.03,392,341,大墩里,NULL
147,732,9,741,1033,0,0,71.73,383,349,大宏里,NULL
353,735,6,741,1044,0,0,70.98,367,368,社寮里,NULL
0,735,6,741,1044,0,0,70.98,367,368,社寮里,NULL
187,734,7,741,1054,0,0,70.3,348,386,橫山村,NULL
216,737,4,741,991,0,0,74.77,304,433,蓬萊里,NULL
37,735,6,741,1078,0,0,68.74,276,459,廣興村,NULL
0,735,6,741,1078,0,0,68.74,276,459,廣興村,NULL
434,735,6,741,1014,0,0,73.08,230,505,東昌里,NULL
0,735,6,741,1014,0,0,73.08,230,505,東昌里,NULL
405,738,2,740,911,0,0,81.23,623,115,大西村,NULL
295,731,9,740,928,0,0,79.74,502,229,大愛里,NULL
5,734,6,740,936,0,0,79.06,470,264,炎峰里,NULL
348,734,6,740,976,0,0,75.82,436,298,東聖里,NULL
2036,733,7,740,972,0,0,76.13,427,306,明志村,NULL
67,732,8,740,983,0,0,75.28,377,355,文化里,NULL
779,730,10,740,993,0,0,74.52,375,355,東勢里,NULL
44,731,9,740,916,0,0,80.79,373,358,水源里,NULL
294,729,11,740,975,0,0,75.9,347,382,甲南村,NULL
59,732,8,740,974,0,0,75.98,347,385,頂寮里,NULL
318,733,7,740,956,0,0,77.41,344,389,文北村,NULL
1792,733,7,740,973,0,0,76.05,341,392,弘道里,NULL
0,733,7,740,973,0,0,76.05,341,392,弘道里,NULL
189,737,3,740,1001,0,0,73.93,315,422,後堀村,NULL
19,733,7,740,1029,0,0,71.91,258,475,崙陽村,NULL
0,733,7,740,1029,0,0,71.91,258,475,崙陽村,NULL
464,731,8,739,1046,0,0,70.65,661,70,古樓村,NULL
0,731,8,739,1046,0,0,70.65,661,70,古樓村,NULL
463,733,6,739,979,0,0,75.49,533,200,仁善里,NULL
24,728,11,739,958,0,0,77.14,465,263,和睦里,NULL
167,733,6,739,1040,0,0,71.06,445,288,興農里,NULL
141,734,5,739,1009,0,0,73.24,443,291,頂寮里,NULL
82,734,5,739,913,0,0,80.94,417,317,藍田里,NULL
7,728,11,739,961,0,0,76.9,413,315,湳興里,NULL
1696,735,4,739,899,0,0,82.2,412,323,樹北里,NULL
0,735,4,739,899,0,0,82.2,412,323,樹北里,NULL
74,734,5,739,967,0,0,76.42,408,326,順天里,NULL
0,734,5,739,967,0,0,76.42,408,326,順天里,NULL
136,733,6,739,954,0,0,77.46,328,405,培元里,NULL
0,733,6,739,954,0,0,77.46,328,405,培元里,NULL
382,735,4,739,1060,0,0,69.72,306,429,昇平村,NULL
311,733,6,739,1090,0,0,67.8,279,454,拱照村,NULL
0,733,6,739,1090,0,0,67.8,279,454,拱照村,NULL
441,732,7,739,928,0,0,79.63,269,463,同安村,NULL
0,732,7,739,928,0,0,79.63,269,463,同安村,NULL
238,734,5,739,957,0,0,77.22,253,481,姑山村,NULL
0,734,5,739,957,0,0,77.22,253,481,姑山村,NULL
381,736,3,739,928,0,0,79.63,250,486,田厝村,NULL
0,736,3,739,928,0,0,79.63,250,486,田厝村,NULL
0,733,5,738,1000,0,0,73.8,636,97,霧臺村,NULL
647,733,5,738,923,0,0,79.96,542,191,仁美里,NULL
172,734,4,738,982,0,0,75.15,457,277,中崙里,NULL
0,734,4,738,982,0,0,75.15,457,277,中崙里,NULL
268,732,6,738,974,0,0,75.77,445,287,陽明里,NULL
0,731,7,738,1001,0,0,73.73,441,290,內湖村,NULL
392,732,6,738,892,0,0,82.74,439,293,菜寮里,NULL
113,731,7,738,1012,0,0,72.92,434,297,中壇里,NULL
1653,730,8,738,962,0,0,76.72,423,307,光興里,NULL
628,731,7,738,930,0,0,79.35,422,309,黎明里,NULL
785,735,3,738,988,0,0,74.7,419,316,新庄里,NULL
1744,731,7,738,916,0,0,80.57,412,319,中鶯里,NULL
0,731,7,738,916,0,0,80.57,412,319,中鶯里,NULL
227,729,9,738,916,0,0,80.57,410,319,牛埔里,NULL
88,730,8,738,955,0,0,77.28,372,358,街尾里,NULL
616,734,4,738,972,0,0,75.93,275,459,三隆村,NULL
278,733,5,738,952,0,0,77.52,249,484,安鎮里,NULL
591,737,1,738,1032,0,0,71.51,197,540,礁坑里,NULL
0,737,1,738,1032,0,0,71.51,197,540,礁坑里,NULL
21,730,8,738,981,0,0,75.23,175,555,竹新村,NULL
202,731,6,737,934,0,0,78.91,567,164,自強里,NULL
244,736,1,737,924,0,0,79.76,524,212,興田村,NULL
258,731,6,737,933,0,0,78.99,494,237,仁愛里,NULL
1250,733,4,737,918,0,0,80.28,484,249,景仁里,NULL
653,726,11,737,923,0,0,79.85,457,269,景本里,NULL
383,729,8,737,951,0,0,77.5,444,285,民生里,NULL
304,731,6,737,1061,0,0,69.46,430,301,新興里,NULL
1540,729,8,737,972,0,0,75.82,406,323,禮門里,NULL
0,729,8,737,972,0,0,75.82,406,323,禮門里,NULL
438,731,6,737,995,0,0,74.07,354,377,溪南村,NULL
0,731,6,737,995,0,0,74.07,354,377,溪南村,NULL
76,734,3,737,960,0,0,76.77,343,391,中正里,NULL
557,726,11,737,999,0,0,73.77,336,390,東榮里,NULL
906,731,6,737,923,0,0,79.85,336,395,天興里,NULL
134,731,6,737,1125,0,0,65.51,313,418,老埤村,NULL
143,733,4,737,1012,0,0,72.83,272,461,大新村,NULL
435,728,9,737,953,0,0,77.33,247,481,港東村,NULL
17,734,3,737,1088,0,0,67.74,246,488,豐美村,NULL
0,734,3,737,1088,0,0,67.74,246,488,豐美村,NULL
294,726,11,737,987,0,0,74.67,217,509,官田村,NULL
8,732,4,736,1251,0,0,58.83,689,43,西門里,NULL
350,727,9,736,1027,0,0,71.67,554,173,中平村,NULL
1941,729,7,736,980,0,0,75.1,489,240,吉安里,NULL
2012,733,3,736,966,0,0,76.19,466,267,山腳村,NULL
240,723,13,736,968,0,0,76.03,435,288,虎山里,NULL
315,728,8,736,952,0,0,77.31,430,298,大忠里,NULL
275,733,3,736,1005,0,0,73.23,427,306,南雅村,NULL
0,733,3,736,1005,0,0,73.23,427,306,南雅村,NULL
158,730,6,736,999,0,0,73.67,406,324,民富里,NULL
361,729,7,736,926,0,0,79.48,389,340,錦田里,NULL
1828,729,7,736,1009,0,0,72.94,369,360,添福里,NULL
0,729,7,736,1009,0,0,72.94,369,360,添福里,NULL
570,733,3,736,982,0,0,74.95,351,382,清水里,NULL
87,725,11,736,975,0,0,75.49,351,374,彭厝村,NULL
0,733,3,736,982,0,0,74.95,351,382,清水里,NULL
0,725,11,736,975,0,0,75.49,351,374,彭厝村,NULL
266,727,9,736,960,0,0,76.67,344,383,群英村,NULL
248,729,7,736,967,0,0,76.11,265,464,南安里,NULL
0,729,7,736,967,0,0,76.11,265,464,南安里,NULL
311,733,3,736,974,0,0,75.56,237,496,興農里,NULL
668,727,8,735,981,0,0,74.92,441,286,大明里,NULL
742,728,7,735,962,0,0,76.4,430,298,平和村,NULL
0,728,7,735,962,0,0,76.4,430,298,平和村,NULL
250,725,10,735,913,0,0,80.5,409,316,中龍里,NULL
0,725,10,735,913,0,0,80.5,409,316,中龍里,NULL
483,731,4,735,962,0,0,76.4,368,363,大興里,NULL
588,728,7,735,1030,0,0,71.36,355,373,拔里,NULL
217,726,9,735,998,0,0,73.65,352,374,八爺里,NULL
479,728,7,735,965,0,0,76.17,333,395,東金里,NULL
0,728,7,735,965,0,0,76.17,333,395,東金里,NULL
303,730,5,735,944,0,0,77.86,322,408,十美里,NULL
458,720,15,735,970,0,0,75.77,319,401,樂成里,NULL
650,729,6,735,946,0,0,77.7,312,417,文賢村,NULL
40,728,6,734,1123,0,0,65.36,498,230,新庄村,NULL
58,732,2,734,1016,0,0,72.24,494,238,平林里,NULL
0,732,2,734,1016,0,0,72.24,494,238,平林里,NULL
568,726,8,734,945,0,0,77.67,477,249,正行里,NULL
632,724,10,734,986,0,0,74.44,419,305,三義里,NULL
212,729,5,734,907,0,0,80.93,399,330,香丘里,NULL
347,727,7,734,1033,0,0,71.06,361,366,北斗村,NULL
0,724,10,734,1045,0,0,70.24,294,430,桃源村,NULL
81,728,5,733,880,0,0,83.3,598,130,東寧里,NULL
771,727,6,733,894,0,0,81.99,523,204,泰安里,NULL
1590,720,13,733,974,0,0,75.26,503,217,長青里,NULL
0,720,13,733,974,0,0,75.26,503,217,長青里,NULL
622,725,8,733,987,0,0,74.27,495,230,六合里,NULL
172,729,4,733,951,0,0,77.08,467,262,光田里,NULL
124,720,13,733,983,0,0,74.57,433,287,湖山里,NULL
421,726,7,733,1078,0,0,68,379,347,灣潭村,NULL
0,726,7,733,1078,0,0,68,379,347,灣潭村,NULL
648,725,8,733,1007,0,0,72.79,366,359,林園村,NULL
395,721,12,733,927,0,0,79.07,350,371,夏田里,NULL
0,721,12,733,927,0,0,79.07,350,371,夏田里,NULL
73,726,7,733,1034,0,0,70.89,349,377,羅莊里,NULL
625,725,8,733,943,0,0,77.73,330,395,福西里,NULL
442,728,5,733,1027,0,0,71.37,302,426,萬華村,NULL
0,728,5,733,1027,0,0,71.37,302,426,萬華村,NULL
434,728,5,733,924,0,0,79.33,255,473,梓義村,NULL
280,729,4,733,1029,0,0,71.23,253,476,龍湖村,NULL
0,729,4,733,1029,0,0,71.23,253,476,龍湖村,NULL
629,724,8,732,1483,0,0,49.36,506,218,上福村,NULL
0,724,8,732,1483,0,0,49.36,506,218,上福村,NULL
301,725,7,732,952,0,0,76.89,461,264,學田村,NULL
204,725,7,732,937,0,0,78.12,383,342,民政里,NULL
0,725,7,732,937,0,0,78.12,383,342,民政里,NULL
460,728,4,732,1000,0,0,73.2,378,350,溪洲里,NULL
197,722,10,732,921,0,0,79.48,375,347,永福里,NULL
0,722,10,732,921,0,0,79.48,375,347,永福里,NULL
185,729,3,732,1056,0,0,69.32,371,358,碧潭村,NULL
0,729,3,732,1056,0,0,69.32,371,358,碧潭村,NULL
674,722,10,732,1005,0,0,72.84,365,357,慶東里,NULL
371,727,5,732,946,0,0,77.38,357,370,東門里,NULL
629,722,10,732,910,0,0,80.44,350,372,正文里,NULL
37,724,8,732,960,0,0,76.25,329,395,府路里,NULL
0,724,8,732,960,0,0,76.25,329,395,府路里,NULL
5,727,5,732,1018,0,0,71.91,294,433,嘉苳村,NULL
306,724,8,732,1037,0,0,70.59,219,505,來惠村,NULL
344,726,5,731,1025,0,0,71.32,548,178,賴明里,NULL
102,727,4,731,983,0,0,74.36,515,212,北安里,NULL
78,723,8,731,1181,0,0,61.9,509,214,南港村,NULL
78,725,6,731,929,0,0,78.69,504,221,仕絨村,NULL
0,725,6,731,929,0,0,78.69,504,221,仕絨村,NULL
219,721,10,731,959,0,0,76.23,494,227,西勢里,NULL
597,725,6,731,977,0,0,74.82,426,299,田洋村,NULL
455,726,5,731,1052,0,0,69.49,426,300,玉田村,NULL
0,725,6,731,977,0,0,74.82,426,299,田洋村,NULL
623,728,3,731,981,0,0,74.52,423,305,和平里,NULL
260,723,8,731,938,0,0,77.93,407,316,廣德里,NULL
729,724,7,731,981,0,0,74.52,394,330,孔宅里,NULL
811,723,8,731,938,0,0,77.93,391,332,國泰里,NULL
355,723,8,731,964,0,0,75.83,388,335,坑口村,NULL
115,726,5,731,992,0,0,73.69,386,340,清水里,NULL
541,726,5,731,903,0,0,80.95,385,341,中山里,NULL
159,720,11,731,1021,0,0,71.6,385,335,福南村,NULL
0,726,5,731,903,0,0,80.95,385,341,中山里,NULL
77,726,5,731,927,0,0,78.86,369,357,中正里,NULL
175,727,4,731,941,0,0,77.68,363,364,湖邊里,NULL
70,727,4,731,989,0,0,73.91,358,369,湄洲里,NULL
407,728,3,731,988,0,0,73.99,354,374,新園村,NULL
422,728,3,731,931,0,0,78.52,352,376,彌靖村,NULL
224,725,6,731,1105,0,0,66.15,345,380,東原村,NULL
271,724,7,731,1040,0,0,70.29,337,387,得安村,NULL
0,724,7,731,1040,0,0,70.29,337,387,得安村,NULL
293,726,5,731,944,0,0,77.44,328,398,彰南里,NULL
32,723,8,731,995,0,0,73.47,323,400,永安里,NULL
34,727,4,731,952,0,0,76.79,323,404,永安里,NULL
641,726,5,731,1025,0,0,71.32,313,413,昭明村,NULL
325,724,7,731,1073,0,0,68.13,307,417,復興村,NULL
0,724,7,731,1073,0,0,68.13,307,417,復興村,NULL
243,723,8,731,992,0,0,73.69,265,458,興田村,NULL
175,726,5,731,948,0,0,77.11,264,462,瓊林村,NULL
264,723,8,731,983,0,0,74.36,237,486,湖南里,NULL
0,723,8,731,983,0,0,74.36,237,486,湖南里,NULL
204,722,8,730,1287,0,0,56.72,603,119,豐濱村,NULL
139,728,2,730,908,0,0,80.4,480,248,新南里,NULL
769,724,6,730,926,0,0,78.83,445,279,忠孝里,NULL
93,718,12,730,956,0,0,76.36,411,307,南寧里,NULL
913,727,3,730,938,0,0,77.83,348,379,五福里,NULL
824,722,8,730,908,0,0,80.4,331,391,瑞和里,NULL
214,723,7,730,943,0,0,77.41,321,402,美城村,NULL
725,723,7,730,1003,0,0,72.78,236,487,坪頂里,NULL
297,722,7,729,909,0,0,80.2,550,172,埔尾村,NULL
423,724,5,729,947,0,0,76.98,545,179,新店村,NULL
0,724,5,729,947,0,0,76.98,545,179,新店村,NULL
629,717,12,729,922,0,0,79.07,522,195,正南里,NULL
173,723,6,729,975,0,0,74.77,474,249,永平村,NULL
631,716,13,729,989,0,0,73.71,469,247,松隆里,NULL
90,723,6,729,927,0,0,78.64,412,311,曲水里,NULL
0,723,6,729,927,0,0,78.64,412,311,曲水里,NULL
99,726,3,729,1069,0,0,68.19,378,348,集祥里,NULL
0,726,3,729,1069,0,0,68.19,378,348,集祥里,NULL
343,721,8,729,957,0,0,76.18,363,358,四德村,NULL
279,724,5,729,1000,0,0,72.9,332,392,鎮安村,NULL
669,716,13,729,914,0,0,79.76,330,386,廣應村,NULL
899,722,7,729,910,0,0,80.11,326,396,南成里,NULL
205,720,9,729,960,0,0,75.94,325,395,民主里,NULL
0,720,9,729,960,0,0,75.94,325,395,民主里,NULL
200,724,5,729,914,0,0,79.76,286,438,三奶村,NULL
281,726,3,729,1015,0,0,71.82,254,472,長安里,NULL
103,721,7,728,1014,0,0,71.79,682,39,銅門村,NULL
0,721,7,728,1014,0,0,71.79,682,39,銅門村,NULL
0,726,2,728,1076,0,0,67.66,625,101,人和村,NULL
489,722,6,728,901,0,0,80.8,598,124,三元里,NULL
28,721,7,728,913,0,0,79.74,548,173,清華里,NULL
69,721,7,728,957,0,0,76.07,530,191,國慶里,NULL
0,721,7,728,957,0,0,76.07,530,191,國慶里,NULL
818,714,14,728,949,0,0,76.71,525,189,正興里,NULL
411,721,7,728,1004,0,0,72.51,456,265,龍昇村,NULL
0,721,7,728,1004,0,0,72.51,456,265,龍昇村,NULL
413,722,6,728,943,0,0,77.2,448,274,公誠里,NULL
456,719,9,728,993,0,0,73.31,393,326,梅林里,NULL
736,721,7,728,994,0,0,73.24,384,337,埤斗村,NULL
0,721,7,728,994,0,0,73.24,384,337,埤斗村,NULL
138,722,6,728,1018,0,0,71.51,338,384,南正里,NULL
0,722,6,728,1018,0,0,71.51,338,384,南正里,NULL
1490,719,9,728,956,0,0,76.15,337,382,玉清里,NULL
796,720,8,728,952,0,0,76.47,305,415,二行村,NULL
190,714,14,728,970,0,0,75.05,301,413,嘉誠村,NULL
0,714,14,728,970,0,0,75.05,301,413,嘉誠村,NULL
174,719,9,728,954,0,0,76.31,288,431,湖邊里,NULL
640,719,9,728,969,0,0,75.13,235,484,昭明村,NULL
320,717,10,727,940,0,0,77.34,517,200,玉泉村,NULL
503,720,7,727,1024,0,0,71,482,238,大城村,NULL
0,720,7,727,1024,0,0,71,482,238,大城村,NULL
160,719,8,727,1076,0,0,67.57,473,246,志學村,NULL
227,721,6,727,998,0,0,72.85,469,252,福田村,NULL
0,721,6,727,998,0,0,72.85,469,252,福田村,NULL
1918,724,3,727,929,0,0,78.26,430,294,龍興里,NULL
276,723,4,727,983,0,0,73.96,403,320,梅南村,NULL
0,723,4,727,983,0,0,73.96,403,320,梅南村,NULL
192,722,5,727,952,0,0,76.37,393,329,竹村里,NULL
0,722,5,727,952,0,0,76.37,393,329,竹村里,NULL
184,722,5,727,935,0,0,77.75,361,361,開山里,NULL
390,719,8,727,951,0,0,76.45,337,382,磚寮村,NULL
0,719,8,727,951,0,0,76.45,337,382,磚寮村,NULL
572,720,7,727,959,0,0,75.81,306,414,中庄村,NULL
177,722,5,727,1180,0,0,61.61,269,453,合和村,NULL
0,722,5,727,1180,0,0,61.61,269,453,合和村,NULL
407,723,4,727,932,0,0,78,177,546,謝安里,NULL
0,723,4,727,932,0,0,78,177,546,謝安里,NULL
409,723,3,726,846,0,0,85.82,702,21,仁義里,NULL
406,719,7,726,931,0,0,77.98,594,125,大西村,NULL
321,710,16,726,995,0,0,72.96,504,206,大坑村,NULL
0,710,16,726,995,0,0,72.96,504,206,大坑村,NULL
629,717,9,726,946,0,0,76.74,488,229,土牛村,NULL
0,717,9,726,946,0,0,76.74,488,229,土牛村,NULL
259,715,11,726,904,0,0,80.31,471,244,仁愛里,NULL
783,718,8,726,916,0,0,79.26,426,292,瑞竹里,NULL
228,721,5,726,942,0,0,77.07,397,324,富貴里,NULL
0,721,5,726,942,0,0,77.07,397,324,富貴里,NULL
227,725,1,726,1181,0,0,61.47,354,371,南勢村,NULL
0,725,1,726,1181,0,0,61.47,354,371,南勢村,NULL
593,724,2,726,920,0,0,78.91,217,507,翁園村,NULL
49,723,2,725,1489,0,0,48.69,707,16,上岐村,NULL
0,723,2,725,1489,0,0,48.69,707,16,上岐村,NULL
917,720,5,725,904,0,0,80.2,650,70,永成里,NULL
0,720,5,725,904,0,0,80.2,650,70,永成里,NULL
243,720,5,725,890,0,0,81.46,583,137,廣興里,NULL
0,720,5,725,890,0,0,81.46,583,137,廣興里,NULL
135,720,5,725,894,0,0,81.1,560,160,田新里,NULL
1141,722,3,725,935,0,0,77.54,514,208,國校里,NULL
678,714,11,725,957,0,0,75.76,487,227,東新里,NULL
208,717,8,725,998,0,0,72.65,423,294,南勢里,NULL
0,721,4,725,1083,0,0,66.94,389,332,箕湖村,NULL
225,722,3,725,1043,0,0,69.51,385,337,七賢村,NULL
0,722,3,725,1043,0,0,69.51,385,337,七賢村,NULL
353,716,9,725,944,0,0,76.8,363,353,舊正村,NULL
750,715,10,725,931,0,0,77.87,347,368,山皮村,NULL
0,715,10,725,931,0,0,77.87,347,368,山皮村,NULL
304,717,8,725,913,0,0,79.41,341,376,社南村,NULL
771,715,10,725,917,0,0,79.06,309,406,新田村,NULL
140,721,4,725,955,0,0,75.92,281,440,和蓮村,NULL
2081,716,9,725,978,0,0,74.13,280,436,頂福村,NULL
0,716,9,725,978,0,0,74.13,280,436,頂福村,NULL
185,722,2,724,915,0,0,79.13,592,130,珊湖里,NULL
39,719,5,724,912,0,0,79.39,521,198,竹義里,NULL
158,719,5,724,952,0,0,76.05,521,198,下寮里,NULL
28,718,6,724,1003,0,0,72.18,507,211,頂犁村,NULL
244,720,4,724,958,0,0,75.57,433,287,港南里,NULL
857,719,5,724,930,0,0,77.85,400,319,中崙里,NULL
432,720,4,724,936,0,0,77.35,380,340,錦安里,NULL
985,721,3,724,957,0,0,75.65,364,357,自信里,NULL
659,720,4,724,912,0,0,79.39,360,360,竹北里,NULL
767,718,6,724,949,0,0,76.29,338,380,仁義村,NULL
114,718,6,724,993,0,0,72.91,335,383,永榮里,NULL
825,716,8,724,923,0,0,78.44,335,381,武漢里,NULL
92,720,4,724,966,0,0,74.95,335,385,書院里,NULL
0,720,4,724,966,0,0,74.95,335,385,書院里,NULL
453,721,3,724,1016,0,0,71.26,328,393,榴北里,NULL
0,721,3,724,1016,0,0,71.26,328,393,榴北里,NULL
416,718,6,724,924,0,0,78.35,322,396,文安村,NULL
476,720,4,724,938,0,0,77.19,320,400,西港村,NULL
213,714,10,724,1142,0,0,63.4,316,398,大客村,NULL
0,714,10,724,1142,0,0,63.4,316,398,大客村,NULL
356,716,8,724,1025,0,0,70.63,314,402,大竹村,NULL
0,716,8,724,1025,0,0,70.63,314,402,大竹村,NULL
804,720,4,724,928,0,0,78.02,301,419,西甲里,NULL
296,714,10,724,951,0,0,76.13,299,415,龍華里,NULL
923,720,4,724,898,0,0,80.62,286,434,福誠里,NULL
19,716,8,724,1008,0,0,71.83,282,434,平安村,NULL
0,716,8,724,1008,0,0,71.83,282,434,平安村,NULL
205,716,7,723,900,0,0,80.33,591,125,忠孝里,NULL
150,716,7,723,1309,0,0,55.23,519,197,長濱村,NULL
932,720,3,723,926,0,0,78.08,503,217,新廍里,NULL
69,713,10,723,988,0,0,73.18,464,249,永豐村,NULL
0,713,10,723,988,0,0,73.18,464,249,永豐村,NULL
134,715,8,723,985,0,0,73.4,458,257,西定里,NULL
0,715,8,723,985,0,0,73.4,458,257,西定里,NULL
1337,719,4,723,926,0,0,78.08,456,263,員林里,NULL
365,718,5,723,959,0,0,75.39,366,352,新鐘村,NULL
206,716,7,723,876,0,0,82.53,362,354,士林里,NULL
757,717,6,723,927,0,0,77.99,311,406,一甲村,NULL
567,721,2,723,887,0,0,81.51,309,412,江山村,NULL
480,711,12,723,927,0,0,77.99,281,430,慶安村,NULL
831,713,10,723,950,0,0,76.11,229,484,大潭村,NULL
467,713,9,722,938,0,0,76.97,631,82,仁義里,NULL
466,711,11,722,936,0,0,77.14,579,132,仁義里,NULL
236,713,9,722,963,0,0,74.97,574,139,民生里,NULL
926,719,3,722,890,0,0,81.12,545,174,三和村,NULL
163,717,5,722,1001,0,0,72.13,526,191,竹安里,NULL
259,716,6,722,934,0,0,77.3,442,274,長春里,NULL
500,714,8,722,970,0,0,74.43,416,298,石頭里,NULL
1960,717,5,722,1002,0,0,72.06,415,302,瑞濱里,NULL
130,717,5,722,981,0,0,73.6,392,325,磚磘里,NULL
709,714,8,722,950,0,0,76,385,329,鎮北里,NULL
102,717,5,722,901,0,0,80.13,380,337,振興里,NULL
391,712,10,722,939,0,0,76.89,363,349,蘆洲里,NULL
0,712,10,722,939,0,0,76.89,363,349,蘆洲里,NULL
400,713,9,722,866,0,0,83.37,353,360,中和里,NULL
32,715,7,722,1065,0,0,67.79,353,362,寶來村,NULL
0,713,9,722,866,0,0,83.37,353,360,中和里,NULL
0,715,7,722,1065,0,0,67.79,353,362,寶來村,NULL
190,713,9,722,999,0,0,72.27,265,448,萬金村,NULL
108,714,8,722,1037,0,0,69.62,237,477,繁華村,NULL
500,719,3,722,973,0,0,74.2,234,485,興和里,NULL
0,719,3,722,973,0,0,74.2,234,485,興和里,NULL
162,714,7,721,902,0,0,79.93,593,121,西安里,NULL
308,709,12,721,984,0,0,73.27,476,233,樂英里、金華里,NULL
0,709,12,721,984,0,0,73.27,476,233,樂英里、金華里,NULL
25,715,6,721,1102,0,0,65.43,473,242,新興里,NULL
0,715,6,721,1102,0,0,65.43,473,242,新興里,NULL
57,714,7,721,1006,0,0,71.67,456,258,土城里,NULL
454,714,7,721,1001,0,0,72.03,453,261,玉田村,NULL
60,717,4,721,980,0,0,73.57,437,280,內門村,NULL
0,717,4,721,980,0,0,73.57,437,280,內門村,NULL
68,717,4,721,922,0,0,78.2,401,316,崇義里,NULL
94,717,4,721,894,0,0,80.65,399,318,新興里,NULL
118,713,8,721,983,0,0,73.35,396,317,吉洋里,NULL
122,712,9,721,1061,0,0,67.95,381,331,龍山里,NULL
225,716,5,721,1164,0,0,61.94,352,364,東原村,NULL
45,714,7,721,1090,0,0,66.15,291,423,鰲鼓村,NULL
2115,716,5,721,1046,0,0,68.93,258,458,大林村,NULL
0,716,5,721,1046,0,0,68.93,258,458,大林村,NULL
108,716,4,720,1102,0,0,65.34,667,49,東興村,NULL
0,716,4,720,1102,0,0,65.34,667,49,東興村,NULL
163,711,9,720,922,0,0,78.09,580,131,西安里,NULL
802,715,5,720,894,0,0,80.54,530,185,復興里,NULL
207,712,8,720,955,0,0,75.39,520,192,深丘里,NULL
0,715,5,720,1124,0,0,64.06,483,232,光明里,NULL
116,709,11,720,1031,0,0,69.84,453,256,清新里,NULL
0,716,4,720,1233,0,0,58.39,410,306,四美村,NULL
76,718,2,720,953,0,0,75.55,401,317,越港里,NULL
0,718,2,720,953,0,0,75.55,401,317,越港里,NULL
744,716,4,720,890,0,0,80.9,398,318,和德里,NULL
123,713,7,720,971,0,0,74.15,391,322,延平里,NULL
0,713,7,720,971,0,0,74.15,391,322,延平里,NULL
49,707,13,720,1073,0,0,67.1,380,327,豐原里,NULL
0,707,13,720,1073,0,0,67.1,380,327,豐原里,NULL
606,713,7,720,1168,0,0,61.64,362,351,網紗里,NULL
775,714,6,720,928,0,0,77.59,250,464,鎮東里,NULL
0,713,6,719,1053,0,0,68.28,678,35,親愛村,NULL
89,715,4,719,873,0,0,82.36,543,172,中山里,NULL
93,711,8,719,1119,0,0,64.25,497,214,賓朗村,NULL
239,716,3,719,909,0,0,79.1,476,240,營南里,NULL
278,713,6,719,919,0,0,78.24,463,250,高城里,NULL
473,715,4,719,970,0,0,74.12,438,277,東南里,NULL
893,713,6,719,881,0,0,81.61,434,279,龍潭村,NULL
59,711,8,719,947,0,0,75.92,427,284,新庄里,NULL
0,711,8,719,947,0,0,75.92,427,284,新庄里,NULL
174,710,9,719,935,0,0,76.9,409,301,洛泉里,NULL
56,716,3,719,1009,0,0,71.26,406,310,卑南里,NULL
327,715,4,719,976,0,0,73.67,379,336,東榮村,NULL
423,709,10,719,882,0,0,81.52,340,369,彌靖村,NULL
118,704,15,719,922,0,0,77.98,317,387,鎮平里,NULL
245,715,4,719,933,0,0,77.06,272,443,大興村,NULL
0,715,4,719,933,0,0,77.06,272,443,大興村,NULL
90,712,7,719,873,0,0,82.36,177,535,廟東里,NULL
0,712,7,719,873,0,0,82.36,177,535,廟東里,NULL
201,713,5,718,941,0,0,76.3,600,113,頭份里,NULL
344,713,5,718,945,0,0,75.98,575,138,朝陽村,NULL
20,715,3,718,958,0,0,74.95,496,219,線西村,NULL
595,713,5,718,1313,0,0,54.68,463,250,長樂村,NULL
0,713,5,718,1313,0,0,54.68,463,250,長樂村,NULL
1927,711,7,718,911,0,0,78.81,443,268,爪峯里,NULL
13,711,7,718,952,0,0,75.42,437,274,岷山里,NULL
281,710,8,718,928,0,0,77.37,430,280,白鷺里,NULL
48,708,10,718,1095,0,0,65.57,393,315,豐里里,NULL
504,709,9,718,923,0,0,77.79,383,326,江川里,NULL
506,713,5,718,963,0,0,74.56,359,354,東明里,NULL
0,713,5,718,963,0,0,74.56,359,354,東明里,NULL
77,702,16,718,990,0,0,72.53,355,347,仁和里,NULL
0,702,16,718,990,0,0,72.53,355,347,仁和里,NULL
166,707,11,718,1237,0,0,58.04,305,402,林厝村,NULL
0,707,11,718,1237,0,0,58.04,305,402,林厝村,NULL
2207,709,9,718,1054,0,0,68.12,287,422,真理村,NULL
246,708,9,717,920,0,0,77.93,588,120,濫坑里,NULL
318,710,7,717,990,0,0,72.42,466,244,中義村,NULL
207,711,6,717,1263,0,0,56.77,451,260,介壽里,NULL
236,708,9,717,889,0,0,80.65,446,262,後埔里,NULL
472,714,3,717,987,0,0,72.64,440,274,鹿田村,NULL
0,714,3,717,987,0,0,72.64,440,274,鹿田村,NULL
1852,713,4,717,1032,0,0,69.48,396,317,水源里,NULL
986,711,6,717,969,0,0,73.99,359,352,保障村,NULL
384,712,5,717,940,0,0,76.28,260,452,中興里,NULL
38,707,10,717,1001,0,0,71.63,260,447,舊庄村,NULL
0,707,10,717,1001,0,0,71.63,260,447,舊庄村,NULL
411,712,5,717,928,0,0,77.26,254,458,五房村,NULL
368,707,10,717,967,0,0,74.15,232,475,嘉福里,NULL
0,707,10,717,967,0,0,74.15,232,475,嘉福里,NULL
108,714,2,716,988,0,0,72.47,469,245,泰安里,NULL
124,707,9,716,994,0,0,72.03,461,246,桃米里,NULL
0,707,9,716,994,0,0,72.03,461,246,桃米里,NULL
45,712,4,716,963,0,0,74.35,456,256,智誠里,NULL
68,712,4,716,984,0,0,72.76,410,302,西勢里,NULL
101,709,7,716,899,0,0,79.64,393,316,通西里,NULL
80,705,11,716,1032,0,0,69.38,385,320,圓富里,NULL
154,707,9,716,1237,0,0,57.88,379,328,施湖村,NULL
0,707,9,716,1237,0,0,57.88,379,328,施湖村,NULL
381,703,13,716,1123,0,0,63.76,371,332,內厝村,NULL
859,710,6,716,972,0,0,73.66,363,347,東勢村,NULL
806,707,9,716,1002,0,0,71.46,361,346,裕民村,NULL
0,707,9,716,1002,0,0,71.46,361,346,裕民村,NULL
137,706,10,716,1002,0,0,71.46,357,349,福興里,NULL
0,706,10,716,1002,0,0,71.46,357,349,福興里,NULL
363,712,4,716,921,0,0,77.74,345,367,新庄村,NULL
200,708,8,716,940,0,0,76.17,303,405,古結村,NULL
0,708,8,716,940,0,0,76.17,303,405,古結村,NULL
86,708,8,716,962,0,0,74.43,253,455,上洲里,NULL
0,708,8,716,962,0,0,74.43,253,455,上洲里,NULL
430,708,8,716,1050,0,0,68.19,237,471,六德里,NULL
0,708,8,716,1050,0,0,68.19,237,471,六德里,NULL
637,711,5,716,900,0,0,79.56,228,483,潮寮村,NULL
264,711,4,715,879,0,0,81.34,590,121,秀湖村,NULL
0,711,4,715,879,0,0,81.34,590,121,秀湖村,NULL
117,704,11,715,1052,0,0,67.97,497,207,永安村,NULL
108,707,8,715,999,0,0,71.57,466,241,稻香里,NULL
2038,712,3,715,918,0,0,77.89,446,266,泰友村,NULL
154,704,11,715,944,0,0,75.74,349,355,北門里,NULL
0,704,11,715,944,0,0,75.74,349,355,北門里,NULL
267,712,3,715,928,0,0,77.05,313,399,陽明里,NULL
293,706,9,715,924,0,0,77.38,304,402,官田村,NULL
912,713,2,715,884,0,0,80.88,295,418,五福里,NULL
379,709,6,715,940,0,0,76.06,273,436,東角里,NULL
635,709,6,715,887,0,0,80.61,254,455,潮寮村,NULL
89,710,5,715,918,0,0,77.89,229,481,中洲里,NULL
0,710,5,715,918,0,0,77.89,229,481,中洲里,NULL
560,709,5,714,912,0,0,78.29,482,227,連和里,NULL
484,708,6,714,881,0,0,81.04,471,237,瑞源里,NULL
23,708,6,714,921,0,0,77.52,424,284,新店里,NULL
336,708,6,714,984,0,0,72.56,416,292,灣東村,NULL
0,708,6,714,984,0,0,72.56,416,292,灣東村,NULL
38,710,4,714,1117,0,0,63.92,413,297,富琦村,NULL
145,710,4,714,939,0,0,76.04,376,334,秀厝村,NULL
518,712,2,714,880,0,0,81.14,375,337,興昌里,NULL
900,707,7,714,911,0,0,78.38,303,404,南成里,NULL
320,711,3,714,922,0,0,77.44,300,411,竹滬村,NULL
538,711,2,713,920,0,0,77.5,417,294,鳥松村,NULL
961,708,5,713,929,0,0,76.75,409,299,福基里,NULL
666,705,8,713,990,0,0,72.02,396,309,塩行里,NULL
950,709,4,713,906,0,0,78.7,382,327,永安村,NULL
239,700,13,713,922,0,0,77.33,381,319,虎山里,NULL
72,701,12,713,996,0,0,71.59,318,383,新群里,NULL
431,710,3,713,946,0,0,75.37,290,420,洲子村,NULL
0,710,3,713,946,0,0,75.37,290,420,洲子村,NULL
132,707,6,713,914,0,0,78.01,254,453,東片村,NULL
0,707,6,713,914,0,0,78.01,254,453,東片村,NULL
395,706,6,712,916,0,0,77.73,525,181,三湖村,NULL
0,706,6,712,916,0,0,77.73,525,181,三湖村,NULL
139,704,8,712,927,0,0,76.81,474,230,旱坑里,NULL
44,700,12,712,1022,0,0,69.67,438,262,日南里,NULL
299,706,6,712,909,0,0,78.33,421,285,國聖里,NULL
54,707,5,712,946,0,0,75.26,409,298,芳草里,NULL
212,707,5,712,938,0,0,75.91,399,308,龍泉里,NULL
0,707,5,712,938,0,0,75.91,399,308,龍泉里,NULL
425,705,7,712,919,0,0,77.48,398,307,圳頭村,NULL
636,702,10,712,949,0,0,75.03,369,333,月湖村,NULL
0,702,10,712,949,0,0,75.03,369,333,月湖村,NULL
213,706,6,712,933,0,0,76.31,349,357,三和里,NULL
598,705,7,712,926,0,0,76.89,332,373,永芳村,NULL
119,709,3,712,1001,0,0,71.13,319,390,吉洋里,NULL
215,705,7,712,964,0,0,73.86,317,388,舊路村,NULL
570,702,10,712,1037,0,0,68.66,313,389,溪厝村,NULL
182,710,2,712,942,0,0,75.58,297,413,萬昌里,NULL
82,707,5,712,1001,0,0,71.13,286,421,竹村里,NULL
0,707,5,712,1001,0,0,71.13,286,421,竹村里,NULL
317,697,15,712,1100,0,0,64.73,255,442,安和村,NULL
0,697,15,712,1100,0,0,64.73,255,442,安和村,NULL
58,707,4,711,849,0,0,83.75,554,153,建功里,NULL
188,704,7,711,1044,0,0,68.1,543,161,大同村,NULL
0,704,7,711,1044,0,0,68.1,543,161,大同村,NULL
46,701,10,711,862,0,0,82.48,527,174,建功里,NULL
368,698,13,711,885,0,0,80.34,476,222,曲洞村,NULL
0,698,13,711,885,0,0,80.34,476,222,曲洞村,NULL
481,705,6,711,928,0,0,76.62,429,276,富仁里,NULL
100,704,7,711,933,0,0,76.21,422,282,頂竹里,NULL
283,699,12,711,1010,0,0,70.4,421,278,浮洲里,NULL
125,709,2,711,970,0,0,73.3,419,290,聖湖里,NULL
57,702,9,711,1165,0,0,61.03,386,316,同安村,NULL
137,706,5,711,991,0,0,71.75,373,333,東港里,NULL
1842,706,5,711,939,0,0,75.72,364,342,竹崙里,NULL
244,707,4,711,935,0,0,76.04,352,355,橋北里,NULL
0,707,4,711,935,0,0,76.04,352,355,橋北里,NULL
155,708,3,711,947,0,0,75.08,330,378,崇德村,NULL
0,708,3,711,947,0,0,75.08,330,378,崇德村,NULL
169,704,7,711,933,0,0,76.21,300,404,振義里,NULL
572,706,5,711,952,0,0,74.68,284,422,瓦厝村,NULL
0,706,5,711,952,0,0,74.68,284,422,瓦厝村,NULL
106,703,8,711,998,0,0,71.24,250,453,水秀里,NULL
87,703,7,710,1075,0,0,66.05,546,157,豐泉里,NULL
0,703,7,710,1075,0,0,66.05,546,157,豐泉里,NULL
38,707,3,710,918,0,0,77.34,538,169,義昭里,NULL
0,707,3,710,918,0,0,77.34,538,169,義昭里,NULL
35,707,3,710,1184,0,0,59.97,516,191,豐年里,NULL
69,701,9,710,1057,0,0,67.17,477,224,北港村,NULL
167,704,6,710,1015,0,0,69.95,424,280,福成里,NULL
0,704,6,710,1015,0,0,69.95,424,280,福成里,NULL
64,706,4,710,881,0,0,80.59,377,329,大義里,NULL
89,705,5,710,904,0,0,78.54,371,334,清水里,NULL
834,701,9,710,966,0,0,73.5,361,340,歸仁村,NULL
52,703,7,710,984,0,0,72.15,360,343,孝廉里,NULL
0,703,7,710,984,0,0,72.15,360,343,孝廉里,NULL
459,703,7,710,949,0,0,74.82,357,346,樂成里,NULL
6,700,10,710,995,0,0,71.36,348,352,重慶里,NULL
0,700,10,710,995,0,0,71.36,348,352,重慶里,NULL
530,701,9,710,1008,0,0,70.44,329,372,和豊村,NULL
153,702,8,710,914,0,0,77.68,329,373,仁里村,NULL
0,702,8,710,914,0,0,77.68,329,373,仁里村,NULL
682,707,3,710,952,0,0,74.58,325,382,西溪村,NULL
255,696,14,710,939,0,0,75.61,318,378,下營村,NULL
0,696,14,710,939,0,0,75.61,318,378,下營村,NULL
840,705,5,710,919,0,0,77.26,298,407,媽廟村,NULL
234,707,3,710,1007,0,0,70.51,295,412,忠興村,NULL
239,704,6,710,890,0,0,79.78,271,433,延平里,NULL
0,704,6,710,890,0,0,79.78,271,433,延平里,NULL
445,706,4,710,959,0,0,74.04,253,453,永福里,NULL
0,706,4,710,959,0,0,74.04,253,453,永福里,NULL
453,702,8,710,914,0,0,77.68,221,481,福安里,NULL
39,703,6,709,1244,0,0,56.99,672,31,浦山里,NULL
0,703,6,709,1244,0,0,56.99,672,31,浦山里,NULL
115,704,5,709,954,0,0,74.32,509,195,烏眉里,NULL
0,704,5,709,954,0,0,74.32,509,195,烏眉里,NULL
158,701,8,709,903,0,0,78.52,497,204,山佳里,NULL
388,702,7,709,1105,0,0,64.16,425,277,新城村,NULL
65,696,13,709,1000,0,0,70.9,424,272,福住村,NULL
0,696,13,709,1000,0,0,70.9,424,272,福住村,NULL
418,701,8,709,994,0,0,71.33,361,340,東華里,NULL
0,701,8,709,994,0,0,71.33,361,340,東華里,NULL
528,701,8,709,975,0,0,72.72,359,342,永光村,NULL
92,699,10,709,1021,0,0,69.44,358,341,賓朗村,NULL
103,701,8,709,929,0,0,76.32,357,344,振興里,NULL
266,696,13,709,880,0,0,80.57,336,360,新安里,NULL
813,708,1,709,912,0,0,77.74,311,397,國泰里,NULL
90,702,7,709,964,0,0,73.55,286,416,進興村,NULL
338,703,5,708,882,0,0,80.27,549,154,銅鑼村,NULL
95,702,6,708,1005,0,0,70.45,483,219,溪南里,NULL
0,702,6,708,1005,0,0,70.45,483,219,溪南里,NULL
737,701,7,708,936,0,0,75.64,446,255,復華里,NULL
2141,702,6,708,978,0,0,72.39,432,270,德茂村,NULL
0,702,6,708,978,0,0,72.39,432,270,德茂村,NULL
386,700,8,708,924,0,0,76.62,398,302,東和里,NULL
1063,703,5,708,923,0,0,76.71,376,327,營盤里,NULL
227,702,6,708,876,0,0,80.82,358,344,中央里,NULL
0,702,6,708,876,0,0,80.82,358,344,中央里,NULL
265,703,5,708,940,0,0,75.32,335,368,新安里,NULL
0,705,3,708,1011,0,0,70.03,241,464,本厝村,NULL
308,703,4,707,901,0,0,78.47,491,212,三峰村,NULL
0,703,4,707,901,0,0,78.47,491,212,三峰村,NULL
251,702,5,707,878,0,0,80.52,467,235,瑞興里,NULL
153,700,7,707,909,0,0,77.78,450,250,龍鳳里,NULL
24,699,8,707,1056,0,0,66.95,440,259,西文里,NULL
220,703,4,707,875,0,0,80.8,388,315,民生里,NULL
78,705,2,707,929,0,0,76.1,383,322,城中里,NULL
0,705,2,707,929,0,0,76.1,383,322,城中里,NULL
103,702,5,707,902,0,0,78.38,367,335,樹林里,NULL
532,699,8,707,938,0,0,75.37,318,381,秋山里,NULL
0,699,8,707,938,0,0,75.37,318,381,秋山里,NULL
395,698,9,707,952,0,0,74.26,314,384,重興村,NULL
361,700,7,707,906,0,0,78.04,262,438,禮化里,NULL
0,700,7,707,906,0,0,78.04,262,438,禮化里,NULL
190,698,9,707,925,0,0,76.43,259,439,玉光村,NULL
0,698,9,707,925,0,0,76.43,259,439,玉光村,NULL
773,703,3,706,896,0,0,78.79,680,23,誠正里,NULL
0,703,3,706,896,0,0,78.79,680,23,誠正里,NULL
705,696,10,706,845,0,0,83.55,606,90,莊敬里,NULL
0,703,3,706,929,0,0,76,583,120,自由村,NULL
482,701,5,706,932,0,0,75.75,553,148,富台里,NULL
29,702,4,706,892,0,0,79.15,529,173,東山里,NULL
458,702,4,706,977,0,0,72.26,455,247,湖西里,NULL
43,698,8,706,1215,0,0,58.11,442,256,和豐村,NULL
1057,699,7,706,896,0,0,78.79,439,260,泰豐里,NULL
382,698,8,706,1057,0,0,66.79,412,286,文津村,NULL
0,698,8,706,1057,0,0,66.79,412,286,文津村,NULL
2039,697,9,706,908,0,0,77.75,393,304,泰友村,NULL
939,702,4,706,902,0,0,78.27,386,316,全安里,NULL
391,696,10,706,900,0,0,78.44,382,314,菜寮里,NULL
434,695,11,706,949,0,0,74.39,380,315,長安里,NULL
492,699,7,706,931,0,0,75.83,349,350,博孝里,NULL
0,699,7,706,931,0,0,75.83,349,350,博孝里,NULL
293,699,7,706,991,0,0,71.24,291,408,阿勸村,NULL
254,704,2,706,1045,0,0,67.56,199,505,鯤溟村,NULL
0,704,2,706,1045,0,0,67.56,199,505,鯤溟村,NULL
204,701,4,705,851,0,0,82.84,562,139,忠孝里,NULL
372,703,2,705,898,0,0,78.51,551,152,明德村,NULL
281,696,9,705,871,0,0,80.94,506,190,田寮村,NULL
0,696,9,705,871,0,0,80.94,506,190,田寮村,NULL
503,702,3,705,936,0,0,75.32,396,306,西伯里,NULL
0,702,3,705,936,0,0,75.32,396,306,西伯里,NULL
116,696,9,705,1093,0,0,64.5,359,337,龍田村,NULL
0,696,9,705,1093,0,0,64.5,359,337,龍田村,NULL
178,701,4,705,931,0,0,75.73,355,346,安招村,NULL
85,700,5,705,879,0,0,80.2,351,349,順興里,NULL
0,700,5,705,879,0,0,80.2,351,349,順興里,NULL
212,702,3,705,963,0,0,73.21,335,367,三和里,NULL
170,697,8,705,953,0,0,73.98,320,377,西燕村,NULL
535,699,6,705,933,0,0,75.56,306,393,建華里,NULL
0,699,6,705,933,0,0,75.56,306,393,建華里,NULL
538,701,4,705,970,0,0,72.68,293,408,天時村,NULL
982,697,8,705,902,0,0,78.16,250,447,廣福村,NULL
489,702,3,705,894,0,0,78.86,240,462,筆秀村,NULL
0,701,3,704,842,0,0,83.61,577,124,力行村,NULL
238,700,4,704,912,0,0,77.19,553,147,田寮里,NULL
235,690,14,704,895,0,0,78.66,528,162,民權里,NULL
140,697,7,704,887,0,0,79.37,492,205,五埔里,NULL
1944,699,5,704,989,0,0,71.18,432,267,傑魚里,NULL
92,701,3,704,968,0,0,72.73,428,273,文安里,NULL
0,701,3,704,968,0,0,72.73,428,273,文安里,NULL
1656,701,3,704,939,0,0,74.97,424,277,金寮里,NULL
6,697,7,704,881,0,0,79.91,406,291,平安里,NULL
625,697,7,704,908,0,0,77.53,389,308,光明里,NULL
0,697,7,704,908,0,0,77.53,389,308,光明里,NULL
444,699,5,704,932,0,0,75.54,385,314,長泰里,NULL
1743,698,6,704,905,0,0,77.79,380,318,西鶯里,NULL
533,697,7,704,962,0,0,73.18,360,337,長驛里,NULL
0,697,7,704,962,0,0,73.18,360,337,長驛里,NULL
310,697,7,704,1006,0,0,69.98,313,384,田尾村,NULL
111,697,7,704,944,0,0,74.58,286,411,福全里,NULL
287,701,3,704,999,0,0,70.47,275,426,逸賢村,NULL
0,701,3,704,999,0,0,70.47,275,426,逸賢村,NULL
527,696,8,704,920,0,0,76.52,266,430,社內村,NULL
267,697,7,704,908,0,0,77.53,236,461,江南里,NULL
0,697,7,704,908,0,0,77.53,236,461,江南里,NULL
360,701,3,704,995,0,0,70.75,224,477,佳化里,NULL
417,698,6,704,936,0,0,75.21,180,518,中洲村,NULL
242,700,4,704,1056,0,0,66.67,160,540,海埔村,NULL
0,700,4,704,1056,0,0,66.67,160,540,海埔村,NULL
142,697,6,703,1401,0,0,50.18,575,122,泰源村,NULL
0,697,6,703,1401,0,0,50.18,575,122,泰源村,NULL
75,697,6,703,1012,0,0,69.47,501,196,新城村,NULL
92,695,8,703,867,0,0,81.08,409,286,南寧里,NULL
466,696,7,703,1000,0,0,70.3,403,293,豐里村,NULL
0,696,7,703,1000,0,0,70.3,403,293,豐里村,NULL
577,699,4,703,923,0,0,76.16,383,316,豐榮里,NULL
640,695,8,703,948,0,0,74.16,346,349,永源村,NULL
524,694,9,703,930,0,0,75.59,324,370,黎明里,NULL
245,698,5,703,884,0,0,79.52,324,374,大成里,NULL
0,694,9,703,930,0,0,75.59,324,370,黎明里,NULL
0,698,5,703,884,0,0,79.52,324,374,大成里,NULL
521,693,10,703,968,0,0,72.62,314,379,田心村,NULL
0,693,10,703,968,0,0,72.62,314,379,田心村,NULL
491,696,7,703,938,0,0,74.95,301,395,石溪里,NULL
0,696,7,703,938,0,0,74.95,301,395,石溪里,NULL
318,701,2,703,867,0,0,81.08,288,413,立誠里,NULL
0,701,2,703,867,0,0,81.08,288,413,立誠里,NULL
436,692,11,703,965,0,0,72.85,286,406,溪洲村,NULL
98,700,3,703,1012,0,0,69.47,214,486,北平里,NULL
0,700,3,703,1012,0,0,69.47,214,486,北平里,NULL
232,697,6,703,1133,0,0,62.05,204,493,蘇秦村,NULL
0,697,6,703,1133,0,0,62.05,204,493,蘇秦村,NULL
429,702,0,702,964,0,0,72.82,630,72,錦水村,NULL
0,702,0,702,964,0,0,72.82,630,72,錦水村,NULL
251,696,6,702,849,0,0,82.69,629,67,光明里,NULL
56,697,5,702,877,0,0,80.05,610,87,立功里,NULL
0,697,5,702,877,0,0,80.05,610,87,立功里,NULL
193,697,5,702,879,0,0,79.86,554,143,興隆里,NULL
244,692,10,702,889,0,0,78.97,538,154,員山村,NULL
182,695,7,702,883,0,0,79.5,520,175,石光里,NULL
744,697,5,702,907,0,0,77.4,496,201,圳前村,NULL
511,692,10,702,1146,0,0,61.26,486,206,菜寮村,NULL
0,692,10,702,1146,0,0,61.26,486,206,菜寮村,NULL
658,695,7,702,910,0,0,77.14,449,246,三信里,NULL
1,698,4,702,913,0,0,76.89,433,265,玉峰里,NULL
175,697,5,702,916,0,0,76.64,367,330,富貴里,NULL
613,700,2,702,903,0,0,77.74,328,372,會社村,NULL
294,694,8,702,900,0,0,78,319,375,彰南里,NULL
351,695,7,702,892,0,0,78.7,304,391,灣裡里,NULL
582,689,13,702,927,0,0,75.73,288,401,崙頂里,NULL
82,696,6,702,934,0,0,75.16,264,432,秀昌里,NULL
232,694,7,701,912,0,0,76.86,576,118,民族里,NULL
211,694,7,701,916,0,0,76.53,536,158,波羅村,NULL
43,697,4,701,879,0,0,79.75,529,168,福安里,NULL
199,698,3,701,846,0,0,82.86,505,193,仁勢村,NULL
0,698,3,701,846,0,0,82.86,505,193,仁勢村,NULL
155,694,7,701,882,0,0,79.48,459,235,上寮里,NULL
233,695,6,701,915,0,0,76.61,427,268,後湖村,NULL
19,700,1,701,1115,0,0,62.87,422,278,陽明里,NULL
452,695,6,701,986,0,0,71.1,392,303,玉田村,NULL
0,692,9,701,1078,0,0,65.03,344,348,大林村,NULL
337,692,9,701,907,0,0,77.29,335,357,二重里,NULL
952,700,1,701,965,0,0,72.64,308,392,永興村,NULL
0,700,1,701,965,0,0,72.64,308,392,永興村,NULL
186,697,4,701,939,0,0,74.65,307,390,光福村,NULL
32,694,7,701,1035,0,0,67.73,303,391,猿樹村,NULL
0,694,7,701,1035,0,0,67.73,303,391,猿樹村,NULL
215,694,7,701,1042,0,0,67.27,302,392,水井村,NULL
0,694,7,701,1042,0,0,67.27,302,392,水井村,NULL
470,695,6,701,993,0,0,70.59,256,439,松竹村,NULL
0,695,6,701,993,0,0,70.59,256,439,松竹村,NULL
106,691,10,701,861,0,0,81.42,204,487,聖后里,NULL
0,691,10,701,861,0,0,81.42,204,487,聖后里,NULL
199,697,3,700,865,0,0,80.92,565,132,頭份里,NULL
148,689,11,700,1063,0,0,65.85,523,166,溪口村,NULL
0,689,11,700,1063,0,0,65.85,523,166,溪口村,NULL
34,695,5,700,948,0,0,73.84,508,187,主學里,NULL
92,694,6,700,967,0,0,72.39,445,249,福聯里,NULL
277,690,10,700,895,0,0,78.21,425,265,成功村,NULL
0,690,10,700,895,0,0,78.21,425,265,成功村,NULL
96,693,7,700,901,0,0,77.69,415,278,東興里,NULL
99,691,9,700,933,0,0,75.03,392,299,南門里,NULL
0,691,9,700,933,0,0,75.03,392,299,南門里,NULL
0,694,6,700,1015,0,0,68.97,387,307,共和村,NULL
818,696,4,700,928,0,0,75.43,356,340,辜厝村,NULL
600,694,6,700,915,0,0,76.5,356,338,永芳村,NULL
348,696,4,700,944,0,0,74.15,345,351,延平里,NULL
0,688,12,700,925,0,0,75.68,339,349,慶西村,NULL
860,694,6,700,957,0,0,73.15,338,356,中榮里,NULL
0,693,7,700,1076,0,0,65.06,335,358,溫泉村,NULL
298,689,11,700,948,0,0,73.84,254,435,竹圍村,NULL
0,689,11,700,948,0,0,73.84,254,435,竹圍村,NULL
415,692,7,699,901,0,0,77.58,539,153,銅鏡村,NULL
0,692,7,699,901,0,0,77.58,539,153,銅鏡村,NULL
86,694,5,699,1039,0,0,67.28,512,182,北埔村,NULL
183,688,11,699,935,0,0,74.76,486,202,石光里,NULL
903,692,7,699,962,0,0,72.66,427,265,武漢村,NULL
289,695,4,699,910,0,0,76.81,399,296,中庄里,NULL
614,685,14,699,932,0,0,75,398,287,平和村,NULL
1085,691,8,699,919,0,0,76.06,389,302,龍安里,NULL
482,691,8,699,905,0,0,77.24,358,333,後金里,NULL
0,691,8,699,905,0,0,77.24,358,333,後金里,NULL
1730,693,6,699,908,0,0,76.98,336,357,柑園里,NULL
64,691,8,699,867,0,0,80.62,310,381,竹園里,NULL
0,691,8,699,867,0,0,80.62,310,381,竹園里,NULL
694,689,10,699,971,0,0,71.99,269,420,北汕村,NULL
300,695,3,698,924,0,0,75.54,466,229,大和里,NULL
1667,690,8,698,919,0,0,75.95,342,348,圳安里,NULL
306,695,3,698,941,0,0,74.18,342,353,社南村,NULL
207,684,14,698,899,0,0,77.64,324,360,古賢里,NULL
0,684,14,698,899,0,0,77.64,324,360,古賢里,NULL
277,694,4,698,1064,0,0,65.6,320,374,好收里,NULL
311,693,5,698,959,0,0,72.78,313,380,田尾村,NULL
231,689,9,698,968,0,0,72.11,284,405,三界村,NULL
0,689,9,698,968,0,0,72.11,284,405,三界村,NULL
615,692,6,698,880,0,0,79.32,276,416,福康里,NULL
33,691,7,698,917,0,0,76.12,266,425,永安里,NULL
36,692,6,698,963,0,0,72.48,207,485,廣福村,NULL
0,692,6,698,963,0,0,72.48,207,485,廣福村,NULL
185,685,13,698,1072,0,0,65.11,203,482,龍岩村,NULL
0,685,13,698,1072,0,0,65.11,203,482,龍岩村,NULL
55,691,6,697,928,0,0,75.11,507,184,國華里,NULL
315,693,4,697,851,0,0,81.9,506,187,峨眉村,NULL
0,693,4,697,851,0,0,81.9,506,187,峨眉村,NULL
37,690,7,697,894,0,0,77.96,505,185,主農里,NULL
0,690,7,697,1100,0,0,63.36,499,191,鹿野村,NULL
310,693,4,697,835,0,0,83.47,484,209,館中村,NULL
330,687,10,697,902,0,0,77.27,462,225,五穀村,NULL
741,692,5,697,928,0,0,75.11,427,265,泰安村,NULL
0,692,5,697,928,0,0,75.11,427,265,泰安村,NULL
146,694,3,697,890,0,0,78.31,416,278,安和里,NULL
0,694,3,697,890,0,0,78.31,416,278,安和里,NULL
80,694,3,697,1000,0,0,69.7,408,286,石廟里,NULL
1658,691,6,697,903,0,0,77.19,395,296,潭底里,NULL
355,689,8,697,957,0,0,72.83,357,332,中崙村,NULL
0,689,8,697,957,0,0,72.83,357,332,中崙村,NULL
95,692,5,697,955,0,0,72.98,321,371,東平里,NULL
309,688,9,697,949,0,0,73.45,305,383,西庄村,NULL
0,688,9,697,949,0,0,73.45,305,383,西庄村,NULL
85,694,3,697,948,0,0,73.52,280,414,荖藤里,NULL
191,689,8,697,936,0,0,74.47,269,420,萬金村,NULL
295,689,8,697,968,0,0,72,267,422,利澤村,NULL
14,687,9,696,873,0,0,79.73,521,166,綠苗里,NULL
0,687,9,696,873,0,0,79.73,521,166,綠苗里,NULL
149,684,12,696,946,0,0,73.57,473,211,竹興里,NULL
150,686,10,696,980,0,0,71.02,442,244,竹興里,NULL
91,687,9,696,923,0,0,75.41,418,269,崇文里,NULL
0,687,9,696,923,0,0,75.41,418,269,崇文里,NULL
296,689,7,696,908,0,0,76.65,400,289,中山里,NULL
283,688,8,696,925,0,0,75.24,390,298,四結村,NULL
596,691,5,696,907,0,0,76.74,387,304,中榮里,NULL
0,691,5,696,907,0,0,76.74,387,304,中榮里,NULL
312,693,3,696,912,0,0,76.32,347,346,竹南村,NULL
33,691,5,696,940,0,0,74.04,338,353,南津里,NULL
0,691,5,696,940,0,0,74.04,338,353,南津里,NULL
204,695,1,696,985,0,0,70.66,322,373,東港村,NULL
0,695,1,696,985,0,0,70.66,322,373,東港村,NULL
290,689,7,696,988,0,0,70.45,309,380,萬丹村,NULL
0,689,7,696,988,0,0,70.45,309,380,萬丹村,NULL
0,693,3,696,955,0,0,72.88,293,400,存仁里,NULL
191,688,7,695,884,0,0,78.62,493,195,東興村,NULL
25,689,6,695,1091,0,0,63.7,442,247,西文里,NULL
167,683,12,695,890,0,0,78.09,406,277,金興村,NULL
8,687,8,695,919,0,0,75.63,403,284,庄美里,NULL
527,687,8,695,1032,0,0,67.34,402,285,塭豐村,NULL
97,689,6,695,1001,0,0,69.43,393,296,西門里,NULL
524,690,5,695,924,0,0,75.22,355,335,朝陽村,NULL
513,684,11,695,896,0,0,77.57,352,332,順昌里,NULL
772,686,9,695,879,0,0,79.07,319,367,新田村,NULL
424,691,4,695,975,0,0,71.28,301,390,頂埔村,NULL
0,691,4,695,975,0,0,71.28,301,390,頂埔村,NULL
531,691,4,695,981,0,0,70.85,295,396,保生村,NULL
0,691,4,695,981,0,0,70.85,295,396,保生村,NULL
276,688,7,695,966,0,0,71.95,290,398,海埔村,NULL
298,689,6,695,972,0,0,71.5,273,416,擇仁里,NULL
0,689,6,695,972,0,0,71.5,273,416,擇仁里,NULL
0,692,3,695,970,0,0,71.65,245,447,後溝里,NULL
6,675,19,694,992,0,0,69.96,599,76,民意里,NULL
0,688,6,694,1073,0,0,64.68,562,126,秀巒村,NULL
794,687,7,694,879,0,0,78.95,545,142,誠信里,NULL
151,689,5,694,981,0,0,70.74,495,194,豐山村,NULL
88,691,3,694,997,0,0,69.61,447,244,元寶里,NULL
300,692,2,694,909,0,0,76.35,432,260,錦平里,NULL
55,687,7,694,939,0,0,73.91,420,267,坪頂里,NULL
0,687,7,694,939,0,0,73.91,420,267,坪頂里,NULL
106,690,4,694,902,0,0,76.94,415,275,安平里,NULL
0,690,4,694,902,0,0,76.94,415,275,安平里,NULL
104,690,4,694,946,0,0,73.36,404,286,合和里,NULL
284,685,9,694,904,0,0,76.77,368,317,新街村,NULL
338,684,10,694,870,0,0,79.77,348,336,二重里,NULL
886,686,8,694,893,0,0,77.72,347,339,鎮南里,NULL
122,689,5,694,883,0,0,78.6,332,357,滿翠里,NULL
797,680,14,694,855,0,0,81.17,304,376,大甲村,NULL
515,686,8,694,887,0,0,78.24,229,457,高楠村,NULL
327,687,7,694,979,0,0,70.89,222,465,大寮村,NULL
0,687,7,694,979,0,0,70.89,222,465,大寮村,NULL
145,691,3,694,918,0,0,75.6,219,472,中路村,NULL
270,686,8,694,898,0,0,77.28,188,498,西連村,NULL
0,686,8,694,898,0,0,77.28,188,498,西連村,NULL
482,683,10,693,923,0,0,75.08,508,175,光明里,NULL
1430,687,6,693,887,0,0,78.13,461,226,延祿里,NULL
81,682,11,693,962,0,0,72.04,459,223,鐵山村,NULL
711,685,8,693,952,0,0,72.79,420,265,康樂里,NULL
153,687,6,693,924,0,0,75,396,291,頂粘村,NULL
50,685,8,693,1013,0,0,68.41,360,325,永富村,NULL
0,685,8,693,1013,0,0,68.41,360,325,永富村,NULL
461,685,8,693,892,0,0,77.69,352,333,安慶里,NULL
68,685,8,693,894,0,0,77.52,334,351,永和里,NULL
486,685,8,693,901,0,0,76.91,326,359,南昌里,NULL
1533,690,3,693,897,0,0,77.26,319,371,忠孝里,NULL
854,687,6,693,929,0,0,74.6,306,381,新埔村,NULL
0,687,6,693,929,0,0,74.6,306,381,新埔村,NULL
1737,682,11,693,919,0,0,75.41,298,384,北園里,NULL
222,686,7,693,991,0,0,69.93,286,400,尚德村,NULL
548,685,8,693,1018,0,0,68.07,252,433,庄內村,NULL
0,685,8,693,1018,0,0,68.07,252,433,庄內村,NULL
374,687,6,693,1001,0,0,69.23,245,442,興貴村,NULL
183,687,6,693,916,0,0,75.66,244,443,鹿寮村,NULL
0,687,6,693,916,0,0,75.66,244,443,鹿寮村,NULL
87,682,11,693,866,0,0,80.02,204,478,鯤洲里,NULL
0,682,11,693,866,0,0,80.02,204,478,鯤洲里,NULL
206,683,9,692,844,0,0,81.99,481,202,介壽里,NULL
699,682,10,692,929,0,0,74.49,475,207,新莊村,NULL
0,682,10,692,929,0,0,74.49,475,207,新莊村,NULL
664,682,10,692,937,0,0,73.85,466,216,中嵙里,NULL
471,687,5,692,1049,0,0,65.97,407,280,照興村,NULL
0,687,5,692,1049,0,0,65.97,407,280,照興村,NULL
9,690,2,692,1099,0,0,62.97,397,293,興華村,NULL
0,687,5,692,908,0,0,76.21,392,295,湖光村,NULL
294,688,4,692,907,0,0,76.3,352,336,牛埔里,NULL
394,685,7,692,984,0,0,70.33,339,346,復金村,NULL
300,683,9,692,908,0,0,76.21,338,345,隆田村,NULL
671,687,5,692,901,0,0,76.8,332,355,龔厝村,NULL
8,685,7,692,897,0,0,77.15,281,404,過江村,NULL
644,686,5,691,847,0,0,81.58,496,190,忠孝里,NULL
79,677,14,691,948,0,0,72.89,473,204,水美村,NULL
210,683,8,691,980,0,0,70.51,472,211,波羅村,NULL
25,686,5,691,1086,0,0,63.63,457,229,海南村,NULL
0,686,5,691,1086,0,0,63.63,457,229,海南村,NULL
414,684,7,691,1003,0,0,68.89,450,234,東勢里,NULL
41,686,5,691,1106,0,0,62.48,450,236,和豐村,NULL
0,684,7,691,1003,0,0,68.89,450,234,東勢里,NULL
0,688,3,691,958,0,0,72.13,395,293,平林村,NULL
222,688,3,691,875,0,0,78.97,387,301,頂福里,NULL
1773,682,9,691,906,0,0,76.27,382,300,鳳鳴里,NULL
242,690,1,691,898,0,0,76.95,354,336,溪埔村,NULL
88,686,5,691,896,0,0,77.12,347,339,南市里,NULL
0,686,5,691,896,0,0,77.12,347,339,南市里,NULL
314,684,7,691,863,0,0,80.07,334,350,光明村,NULL
388,685,6,691,885,0,0,78.08,327,358,坑口村,NULL
422,684,7,691,889,0,0,77.73,326,358,重光里,NULL
530,685,6,691,1040,0,0,66.44,308,377,永昌村,NULL
127,683,8,691,940,0,0,73.51,306,377,大溪里,NULL
78,685,6,691,972,0,0,71.09,300,385,苑坑里,NULL
0,685,6,691,972,0,0,71.09,300,385,苑坑里,NULL
355,685,6,691,979,0,0,70.58,290,395,詔安里,NULL
0,685,6,691,979,0,0,70.58,290,395,詔安里,NULL
454,689,2,691,923,0,0,74.86,277,412,復興里,NULL
0,689,2,691,923,0,0,74.86,277,412,復興里,NULL
282,683,8,691,963,0,0,71.75,244,439,二甲村,NULL
0,684,6,690,1427,0,0,48.35,609,75,寧埔村,NULL
488,680,10,690,856,0,0,80.61,563,117,三元里,NULL
138,677,13,690,874,0,0,78.95,507,170,旱坑里,NULL
151,682,8,690,960,0,0,71.88,434,248,竹興里,NULL
1939,682,8,690,935,0,0,73.8,430,252,吉安里,NULL
60,680,10,690,863,0,0,79.95,424,256,龜売村,NULL
19,683,7,690,917,0,0,75.25,409,274,薰風里,NULL
0,683,7,690,917,0,0,75.25,409,274,薰風里,NULL
123,682,8,690,861,0,0,80.14,389,293,頭崙里,NULL
490,683,7,690,869,0,0,79.4,375,308,社東里,NULL
574,684,6,690,888,0,0,77.7,366,318,唪口里,NULL
431,688,2,690,866,0,0,79.68,340,348,南寮村,NULL
209,684,6,690,971,0,0,71.06,313,371,嶺頂村,NULL
822,682,8,690,887,0,0,77.79,281,401,許厝村,NULL
327,683,7,690,892,0,0,77.35,261,422,三爺村,NULL
0,683,7,690,892,0,0,77.35,261,422,三爺村,NULL
369,685,5,690,932,0,0,74.03,230,455,埔子村,NULL
230,683,7,690,855,0,0,80.7,184,499,龍目村,NULL
97,686,3,689,893,0,0,77.16,652,34,永清里,NULL
296,685,4,689,925,0,0,74.49,548,137,大湖村,NULL
663,679,10,689,940,0,0,73.3,460,219,中嵙里,NULL
62,681,8,689,968,0,0,71.18,380,301,中民村,NULL
602,684,5,689,889,0,0,77.5,371,313,林德里,NULL
255,685,4,689,992,0,0,69.46,306,379,嘉福村,NULL
0,685,4,689,992,0,0,69.46,306,379,嘉福村,NULL
190,679,9,688,872,0,0,78.9,468,211,華陽里,NULL
27,684,4,688,1029,0,0,66.86,424,260,東文里,NULL
695,681,7,688,936,0,0,73.5,419,262,永北村,NULL
604,684,4,688,921,0,0,74.7,412,272,擺塘村,NULL
784,680,8,688,939,0,0,73.27,406,274,北富里,NULL
152,686,2,688,974,0,0,70.64,405,281,廈粘村,NULL
714,685,3,688,881,0,0,78.09,398,287,厚里村,NULL
171,676,12,688,960,0,0,71.67,387,289,下埔里,NULL
0,676,12,688,960,0,0,71.67,387,289,下埔里,NULL
305,680,8,688,906,0,0,75.94,373,307,聚安里,NULL
350,680,8,688,945,0,0,72.8,367,313,進芬村,NULL
0,680,8,688,945,0,0,72.8,367,313,進芬村,NULL
126,685,3,688,863,0,0,79.72,332,353,振豐村,NULL
73,686,2,688,929,0,0,74.06,330,356,瑞吉里,NULL
252,686,2,688,953,0,0,72.19,325,361,西勢里,NULL
0,686,2,688,953,0,0,72.19,325,361,西勢里,NULL
121,682,6,688,984,0,0,69.92,319,363,穎川里,NULL
55,674,14,688,937,0,0,73.43,297,377,竹門里,NULL
0,674,14,688,937,0,0,73.43,297,377,竹門里,NULL
94,682,6,688,920,0,0,74.78,256,426,新榮里,NULL
185,684,3,687,854,0,0,80.44,501,183,上林里,NULL
0,684,3,687,854,0,0,80.44,501,183,上林里,NULL
31,676,11,687,1029,0,0,66.76,481,195,主和里,NULL
151,685,2,687,886,0,0,77.54,398,287,廈粘村,NULL
755,684,3,687,812,0,0,84.61,372,312,興仁里,NULL
168,679,8,687,946,0,0,72.62,358,321,興農里,NULL
122,682,5,687,894,0,0,76.85,357,325,港坪里,NULL
66,685,2,687,914,0,0,75.16,353,332,文昌里,NULL
0,685,2,687,914,0,0,75.16,353,332,文昌里,NULL
338,684,3,687,893,0,0,76.93,321,363,東寧里,NULL
234,680,7,687,931,0,0,73.79,288,392,浸水里,NULL
337,676,11,687,863,0,0,79.61,286,390,東寧里,NULL
375,684,3,687,914,0,0,75.16,201,483,三協里,NULL
0,684,3,687,914,0,0,75.16,201,483,三協里,NULL
322,678,9,687,942,0,0,72.93,170,508,龍山村,NULL
44,684,2,686,1287,0,0,53.3,655,29,光前里,NULL
0,684,2,686,1287,0,0,53.3,655,29,光前里,NULL
90,678,8,686,963,0,0,71.24,600,78,嘉里村,NULL
216,684,2,686,1077,0,0,63.7,476,208,瑞穗村,NULL
394,676,10,686,998,0,0,68.74,472,204,北埔村,NULL
0,676,10,686,998,0,0,68.74,472,204,北埔村,NULL
219,681,5,686,910,0,0,75.38,433,248,自強里,NULL
0,681,5,686,910,0,0,75.38,433,248,自強里,NULL
228,680,6,686,974,0,0,70.43,432,248,內城村,NULL
804,677,9,686,889,0,0,77.17,401,276,二水村,NULL
0,677,9,686,889,0,0,77.17,401,276,二水村,NULL
155,681,5,686,1121,0,0,61.2,371,310,羊調村,NULL
0,681,5,686,1121,0,0,61.2,371,310,羊調村,NULL
759,683,3,686,885,0,0,77.51,332,351,三角村,NULL
367,670,16,686,1001,0,0,68.53,330,340,三成村,NULL
0,670,16,686,1001,0,0,68.53,330,340,三成村,NULL
577,676,10,686,897,0,0,76.48,319,357,東州村,NULL
510,678,8,686,956,0,0,71.76,314,364,田頭里,NULL
570,678,8,686,872,0,0,78.67,310,368,中庄村,NULL
196,678,8,686,950,0,0,72.21,287,391,匏崙村,NULL
0,678,8,686,950,0,0,72.21,287,391,匏崙村,NULL
235,679,7,686,1050,0,0,65.33,199,480,蕃薯村,NULL
0,679,7,686,1050,0,0,65.33,199,480,蕃薯村,NULL
22,679,6,685,930,0,0,73.66,512,167,民族里、民權里,NULL
0,679,6,685,930,0,0,73.66,512,167,民族里、民權里,NULL
358,681,4,685,938,0,0,73.03,498,183,獅山村,NULL
0,681,4,685,938,0,0,73.03,498,183,獅山村,NULL
266,679,6,685,901,0,0,76.03,405,274,陽明里,NULL
106,682,3,685,983,0,0,69.68,402,280,平安里,NULL
323,677,8,685,890,0,0,76.97,387,290,廣興里,NULL
557,682,3,685,924,0,0,74.13,367,315,加祿村,NULL
257,678,7,685,848,0,0,80.78,356,322,河濱里,NULL
1733,669,16,685,887,0,0,77.23,352,317,南園里,NULL
505,682,3,685,939,0,0,72.95,339,343,仁聲里,NULL
0,682,3,685,939,0,0,72.95,339,343,仁聲里,NULL
433,678,7,685,859,0,0,79.74,338,340,興和里,NULL
102,679,6,685,870,0,0,78.74,318,361,德成村,NULL
0,679,6,685,870,0,0,78.74,318,361,德成村,NULL
317,677,8,685,849,0,0,80.68,302,375,德東里,NULL
0,677,8,685,849,0,0,80.68,302,375,德東里,NULL
38,680,5,685,1052,0,0,65.11,292,388,集來村,NULL
519,680,5,685,898,0,0,76.28,283,397,新市村,NULL
348,678,7,685,959,0,0,71.43,257,421,和興里,NULL
0,678,7,685,959,0,0,71.43,257,421,和興里,NULL
234,681,3,684,862,0,0,79.35,518,163,民權里,NULL
64,678,6,684,856,0,0,79.91,508,170,龍山里,NULL
91,681,3,684,958,0,0,71.4,482,199,福聯里,NULL
26,679,5,684,1051,0,0,65.08,452,227,海北村,NULL
0,679,5,684,1051,0,0,65.08,452,227,海北村,NULL
101,679,5,684,954,0,0,71.7,402,277,中圳里,NULL
0,671,13,684,1024,0,0,66.8,372,299,中明村,NULL
91,681,3,684,873,0,0,78.35,292,389,新光里,NULL
0,681,3,684,873,0,0,78.35,292,389,新光里,NULL
820,681,3,684,892,0,0,76.68,262,419,國隆里,NULL
230,680,4,684,911,0,0,75.08,235,445,四春里,NULL
353,672,12,684,940,0,0,72.77,216,456,七座里,NULL
0,672,12,684,940,0,0,72.77,216,456,七座里,NULL
363,679,5,684,919,0,0,74.43,191,488,甘厝村,NULL
0,679,5,684,919,0,0,74.43,191,488,甘厝村,NULL
207,677,6,683,877,0,0,77.88,516,161,仁愛里,NULL
649,675,8,683,965,0,0,70.78,390,285,福興村,NULL
428,677,6,683,924,0,0,73.92,387,290,綠川里,NULL
271,679,4,683,881,0,0,77.53,342,337,菁山里,NULL
344,677,6,683,911,0,0,74.97,334,343,鎮北村,NULL
0,677,6,683,911,0,0,74.97,334,343,鎮北村,NULL
96,672,11,683,945,0,0,72.28,302,370,東平里,NULL
304,679,4,683,874,0,0,78.15,296,383,十美里,NULL
168,677,6,683,897,0,0,76.14,292,385,重興里,NULL
297,675,8,683,903,0,0,75.64,279,396,甲北村,NULL
457,681,2,683,810,0,0,84.32,277,404,中新里,NULL
79,678,4,682,861,0,0,79.21,556,122,金山里,NULL
106,670,12,682,1025,0,0,66.54,522,148,泰安村,NULL
0,670,12,682,1025,0,0,66.54,522,148,泰安村,NULL
643,678,4,682,881,0,0,77.41,513,165,忠孝里,NULL
828,668,14,682,884,0,0,77.15,425,243,紅梅里,NULL
80,673,9,682,895,0,0,76.2,394,279,新埔里,NULL
1551,678,4,682,1283,0,0,53.16,389,289,秀峰里,NULL
265,675,7,682,835,0,0,81.68,372,303,陽明里,NULL
522,675,7,682,945,0,0,72.17,363,312,古坑村,NULL
340,677,5,682,883,0,0,77.24,327,350,頂崁里,NULL
544,678,4,682,901,0,0,75.69,322,356,永就村,NULL
116,677,5,682,879,0,0,77.59,317,360,力行里,NULL
0,677,5,682,879,0,0,77.59,317,360,力行里,NULL
282,675,7,682,924,0,0,73.81,294,381,長安里,NULL
536,675,7,682,839,0,0,81.29,286,389,漢民里,NULL
0,675,7,682,839,0,0,81.29,286,389,漢民里,NULL
126,676,6,682,936,0,0,72.86,252,424,大溪里,NULL
181,678,4,682,999,0,0,68.27,226,452,五興里,NULL
0,678,4,682,999,0,0,68.27,226,452,五興里,NULL
16,679,2,681,1316,0,0,51.75,642,37,安美村,NULL
366,675,6,681,846,0,0,80.5,516,159,獅潭村,NULL
275,678,3,681,834,0,0,81.65,494,184,上山村,NULL
96,677,4,681,975,0,0,69.85,428,249,西門里,NULL
4,677,4,681,839,0,0,81.17,418,259,東川里,NULL
105,677,4,681,892,0,0,76.35,392,285,仁愛里,NULL
1739,676,5,681,882,0,0,77.21,354,322,東鶯里,NULL
0,676,5,681,882,0,0,77.21,354,322,東鶯里,NULL
119,669,12,681,949,0,0,71.76,345,324,城南里,NULL
0,669,12,681,949,0,0,71.76,345,324,城南里,NULL
356,675,6,681,945,0,0,72.06,276,399,河南里,NULL
0,675,6,681,945,0,0,72.06,276,399,河南里,NULL
803,674,7,681,901,0,0,75.58,275,399,南保村,NULL
107,676,4,680,994,0,0,68.41,562,114,利嘉村,NULL
0,676,4,680,994,0,0,68.41,562,114,利嘉村,NULL
252,673,7,680,1081,0,0,62.9,561,112,竹田村,NULL
0,673,7,680,1081,0,0,62.9,561,112,竹田村,NULL
253,669,11,680,877,0,0,77.54,492,177,重興村,NULL
361,667,13,680,949,0,0,71.65,449,218,後寮村,NULL
0,667,13,680,949,0,0,71.65,449,218,後寮村,NULL
389,678,2,680,817,0,0,83.23,442,236,協榮里,NULL
762,676,4,680,907,0,0,74.97,400,276,忠義里,NULL
426,672,8,680,809,0,0,84.05,382,290,彌陀村,NULL
798,675,5,680,889,0,0,76.49,366,309,建隆里,NULL
0,675,5,680,889,0,0,76.49,366,309,建隆里,NULL
357,673,7,680,1003,0,0,67.8,346,327,芳苑村,NULL
0,673,7,680,1003,0,0,67.8,346,327,芳苑村,NULL
223,672,8,680,929,0,0,73.2,343,329,尚德村,NULL
151,672,8,680,1075,0,0,63.26,326,346,鹿場村,NULL
0,672,8,680,1075,0,0,63.26,326,346,鹿場村,NULL
393,675,5,680,953,0,0,71.35,254,421,復金村,NULL
94,675,5,680,953,0,0,71.35,251,424,南平里,NULL
240,671,9,680,954,0,0,71.28,251,420,美北村,NULL
0,671,9,680,954,0,0,71.28,251,420,美北村,NULL
513,672,8,680,953,0,0,71.35,249,423,棋盤村,NULL
2208,675,5,680,1014,0,0,67.06,234,441,真理村,NULL
188,672,7,679,851,0,0,79.79,543,129,斗煥里,NULL
1759,672,7,679,852,0,0,79.69,363,309,南靖里,NULL
241,671,8,679,898,0,0,75.61,357,314,虎山里,NULL
98,672,7,679,878,0,0,77.33,323,349,新勝里,NULL
0,672,7,679,988,0,0,68.72,306,366,和美村,NULL
66,669,10,679,984,0,0,69,259,410,馬鳴村,NULL
74,676,3,679,1055,0,0,64.36,237,439,錦湖村,NULL
0,676,3,679,1055,0,0,64.36,237,439,錦湖村,NULL
677,673,5,678,844,0,0,80.33,467,206,東新里,NULL
206,670,8,678,860,0,0,78.84,467,203,長興里,NULL
91,674,4,678,1041,0,0,65.13,458,216,水頭里,NULL
1676,672,6,678,874,0,0,77.57,401,271,樹德里,NULL
560,674,4,678,982,0,0,69.04,387,287,東榮里,NULL
14,673,5,678,1026,0,0,66.08,382,291,三盛村,NULL
327,678,0,678,878,0,0,77.22,362,316,斯文里,NULL
61,670,8,678,948,0,0,71.52,353,317,中民村,NULL
342,667,11,678,862,0,0,78.65,346,321,五谷里,NULL
819,671,7,678,888,0,0,76.35,346,325,國隆里,NULL
441,671,7,678,1068,0,0,63.48,337,334,新庄里,NULL
343,676,2,678,846,0,0,80.14,326,350,五谷里,NULL
129,674,4,678,995,0,0,68.14,323,351,田寮里,NULL
770,671,7,678,924,0,0,73.38,300,371,仁義村,NULL
534,674,4,678,871,0,0,77.84,289,385,建興里,NULL
0,674,4,678,871,0,0,77.84,289,385,建興里,NULL
269,675,3,678,877,0,0,77.31,275,400,開化村,NULL
445,671,7,678,949,0,0,71.44,274,397,同安村,NULL
0,671,7,678,949,0,0,71.44,274,397,同安村,NULL
202,672,6,678,1159,0,0,58.5,271,401,下崙村,NULL
427,674,4,678,891,0,0,76.09,262,412,溪美里,NULL
199,670,8,678,838,0,0,80.91,255,415,三奶村,NULL
105,671,6,677,840,0,0,80.6,465,206,新光里,NULL
174,670,7,677,839,0,0,80.69,427,243,大埔里,NULL
52,671,6,677,830,0,0,81.57,405,266,民安里,NULL
94,672,5,677,1023,0,0,66.18,397,275,珠格里,NULL
0,672,5,677,1023,0,0,66.18,397,275,珠格里,NULL
20,675,2,677,1089,0,0,62.17,363,312,小林村,NULL
0,675,2,677,1089,0,0,62.17,363,312,小林村,NULL
519,670,7,677,856,0,0,79.09,347,323,興昌里,NULL
422,674,3,677,953,0,0,71.04,338,336,石硦村,NULL
985,673,4,677,948,0,0,71.41,304,369,保障村,NULL
0,672,5,677,941,0,0,71.94,275,397,竹山村,NULL
556,674,3,677,925,0,0,73.19,259,415,加祿村,NULL
21,673,4,677,938,0,0,72.17,258,415,高樹村,NULL
778,670,7,677,858,0,0,78.9,250,420,鎮昌里,NULL
229,670,7,677,1032,0,0,65.6,182,488,春埔村,NULL
0,670,7,677,1032,0,0,65.6,182,488,春埔村,NULL
2,669,7,676,871,0,0,77.61,550,119,民勤里,NULL
499,668,8,676,1028,0,0,65.76,533,135,華陵村,NULL
0,668,8,676,1028,0,0,65.76,533,135,華陵村,NULL
287,668,8,676,871,0,0,77.61,455,213,新興里,NULL
24,671,5,676,871,0,0,77.61,421,250,武曲里,NULL
1791,671,5,676,878,0,0,76.99,417,254,中埔里,NULL
729,666,10,676,912,0,0,74.12,392,274,太平村,NULL
455,668,8,676,903,0,0,74.86,391,277,干城里,NULL
675,664,12,676,873,0,0,77.43,373,291,慶東里,NULL
293,668,8,676,891,0,0,75.87,332,336,下坑村,NULL
529,668,8,676,920,0,0,73.48,311,357,永光村,NULL
317,671,5,676,910,0,0,74.29,210,461,頂山村,NULL
0,671,5,676,910,0,0,74.29,210,461,頂山村,NULL
520,669,7,676,910,0,0,74.29,206,463,玉光村,NULL
118,667,9,676,991,0,0,68.21,149,518,汫水里,NULL
0,667,9,676,991,0,0,68.21,149,518,汫水里,NULL
323,671,5,676,937,0,0,72.15,99,572,南崙村,NULL
0,671,5,676,937,0,0,72.15,99,572,南崙村,NULL
722,669,6,675,890,0,0,75.84,599,70,光復里,NULL
0,669,6,675,890,0,0,75.84,599,70,光復里,NULL
134,669,6,675,838,0,0,80.55,470,199,竹南里,NULL
90,669,6,675,1019,0,0,66.24,441,228,水頭里,NULL
473,667,8,675,858,0,0,78.67,431,236,仁武里,NULL
267,673,2,675,973,0,0,69.37,394,279,海寶里,NULL
0,673,2,675,973,0,0,69.37,394,279,海寶里,NULL
561,663,12,675,894,0,0,75.5,385,278,護國里,NULL
0,668,7,675,974,0,0,69.3,338,330,公田村,NULL
405,670,5,675,893,0,0,75.59,319,351,大莊里,NULL
0,670,5,675,893,0,0,75.59,319,351,大莊里,NULL
1840,673,2,675,837,0,0,80.65,306,367,成福里,NULL
0,673,2,675,837,0,0,80.65,306,367,成福里,NULL
240,669,6,675,943,0,0,71.58,305,364,湖北村,NULL
0,669,6,675,943,0,0,71.58,305,364,湖北村,NULL
196,670,5,675,840,0,0,80.36,302,368,水上村,NULL
509,668,7,675,922,0,0,73.21,292,376,田厝村,NULL
0,668,7,675,922,0,0,73.21,292,376,田厝村,NULL
217,670,5,675,1064,0,0,63.44,216,454,湖口村,NULL
0,670,5,675,1064,0,0,63.44,216,454,湖口村,NULL
151,665,9,674,840,0,0,80.24,417,248,寶石里,NULL
0,665,9,674,840,0,0,80.24,417,248,寶石里,NULL
712,668,6,674,934,0,0,72.16,409,259,同仁村,NULL
0,668,6,674,934,0,0,72.16,409,259,同仁村,NULL
99,667,7,674,891,0,0,75.65,398,269,新勝里,NULL
537,663,11,674,882,0,0,76.42,382,281,豐原里,NULL
472,668,6,674,881,0,0,76.5,365,303,順德里,NULL
430,672,2,674,870,0,0,77.47,362,310,雙園里,NULL
0,672,2,674,870,0,0,77.47,362,310,雙園里,NULL
525,671,3,674,890,0,0,75.73,305,366,愛平里,NULL
0,671,3,674,890,0,0,75.73,305,366,愛平里,NULL
662,668,6,674,901,0,0,74.81,304,364,林內村,NULL
285,669,5,674,909,0,0,74.15,285,384,新街村,NULL
314,667,7,674,940,0,0,71.7,272,395,菜公村,NULL
0,667,7,674,940,0,0,71.7,272,395,菜公村,NULL
514,670,4,674,904,0,0,74.56,257,413,新吉村,NULL
147,671,2,673,817,0,0,82.37,641,30,大鵬里,NULL
335,665,8,673,872,0,0,77.18,456,209,灣雅村,NULL
0,665,8,673,872,0,0,77.18,456,209,灣雅村,NULL
648,666,7,673,870,0,0,77.36,431,235,忠孝里,NULL
727,668,5,673,838,0,0,80.31,425,243,文山里,NULL
176,666,7,673,1038,0,0,64.84,376,290,山內村,NULL
0,666,7,673,1038,0,0,64.84,376,290,山內村,NULL
458,668,5,673,919,0,0,73.23,361,307,竹圍村,NULL
291,667,6,673,867,0,0,77.62,334,333,下坑村,NULL
102,665,8,673,837,0,0,80.41,333,332,文昌里,NULL
0,665,8,673,837,0,0,80.41,333,332,文昌里,NULL
294,669,4,673,949,0,0,70.92,312,357,利澤村,NULL
818,667,6,673,881,0,0,76.39,281,386,國隆里,NULL
54,668,5,673,1007,0,0,66.83,272,396,塭仔村,NULL
0,668,5,673,1007,0,0,66.83,272,396,塭仔村,NULL
689,664,9,673,899,0,0,74.86,263,401,東汕村,NULL
0,664,9,673,899,0,0,74.86,263,401,東汕村,NULL
575,669,4,673,883,0,0,76.22,262,407,唪口里,NULL
8,664,9,673,885,0,0,76.05,230,434,土溝村,NULL
196,665,7,672,791,0,0,84.96,632,33,自強里,NULL
0,665,7,672,791,0,0,84.96,632,33,自強里,NULL
292,666,6,672,822,0,0,81.75,540,126,新興村,NULL
12,670,2,672,1011,0,0,66.47,452,218,後安村,NULL
449,666,6,672,895,0,0,75.08,418,248,西寮里,NULL
173,666,6,672,1163,0,0,57.78,405,261,光華里,NULL
321,668,4,672,867,0,0,77.51,378,290,竹山里,NULL
673,664,8,672,881,0,0,76.28,364,300,下城里,NULL
0,664,8,672,881,0,0,76.28,364,300,下城里,NULL
548,670,2,672,856,0,0,78.5,311,359,城東里,NULL
622,667,5,672,1036,0,0,64.86,311,356,鵝鑾里,NULL
0,667,5,672,1036,0,0,64.86,311,356,鵝鑾里,NULL
97,666,6,672,922,0,0,72.89,267,399,春珠里,NULL
397,669,3,672,895,0,0,75.08,267,402,瓦磘村,NULL
0,666,6,672,922,0,0,72.89,267,399,春珠里,NULL
138,667,4,671,1211,0,0,55.41,512,155,都蘭村,NULL
2127,667,4,671,901,0,0,74.47,437,230,古庄村,NULL
0,667,4,671,901,0,0,74.47,437,230,古庄村,NULL
394,668,3,671,801,0,0,83.77,343,325,石潭里,NULL
65,662,9,671,896,0,0,74.89,331,331,苑北里,NULL
0,662,9,671,896,0,0,74.89,331,331,苑北里,NULL
492,663,8,671,922,0,0,72.78,328,335,靖興里,NULL
0,663,8,671,922,0,0,72.78,328,335,靖興里,NULL
109,665,6,671,865,0,0,77.57,318,347,朝陽里,NULL
285,661,10,671,890,0,0,75.39,280,381,中賢村,NULL
667,669,2,671,904,0,0,74.23,276,393,塩行里,NULL
220,667,4,671,953,0,0,70.41,265,402,水北村,NULL
231,668,3,671,987,0,0,67.98,262,406,四春里,NULL
393,662,9,671,834,0,0,80.46,203,459,石潭里,NULL
116,665,5,670,873,0,0,76.75,481,184,中社里,NULL
498,667,3,670,840,0,0,79.76,363,304,浩然里,NULL
137,663,7,670,889,0,0,75.37,361,302,垂楊里,NULL
362,666,4,670,870,0,0,77.01,339,327,錦田里,NULL
255,663,7,670,831,0,0,80.63,317,346,育仁里,NULL
0,663,7,670,831,0,0,80.63,317,346,育仁里,NULL
370,663,7,670,851,0,0,78.73,312,351,萬惠村,NULL
0,663,7,670,851,0,0,78.73,312,351,萬惠村,NULL
203,664,6,670,906,0,0,73.95,301,363,新南村,NULL
0,664,6,670,906,0,0,73.95,301,363,新南村,NULL
335,669,1,670,841,0,0,79.67,249,420,海豐里,NULL
0,669,1,670,841,0,0,79.67,249,420,海豐里,NULL
401,661,8,669,885,0,0,75.59,527,134,造橋村,NULL
108,663,6,669,915,0,0,73.11,409,254,民治里,NULL
0,663,6,669,915,0,0,73.11,409,254,民治里,NULL
269,658,11,669,1006,0,0,66.5,385,273,海埔里,NULL
0,658,11,669,1006,0,0,66.5,385,273,海埔里,NULL
56,665,4,669,861,0,0,77.7,384,281,芳安里,NULL
794,661,8,669,893,0,0,74.92,358,303,三光里,NULL
0,661,8,669,893,0,0,74.92,358,303,三光里,NULL
678,662,7,669,891,0,0,75.08,294,368,頂厝村,NULL
657,659,10,669,971,0,0,68.9,282,377,五福村,NULL
411,662,7,669,879,0,0,76.11,277,385,東關里,NULL
0,662,7,669,879,0,0,76.11,277,385,東關里,NULL
281,664,5,669,910,0,0,73.52,195,469,七甲村,NULL
0,664,5,669,910,0,0,73.52,195,469,七甲村,NULL
5,660,8,668,824,0,0,81.07,466,194,挹秀里,NULL
292,662,6,668,1061,0,0,62.96,405,257,阿勸村,NULL
328,663,5,668,863,0,0,77.4,359,304,廣福里,NULL
84,666,2,668,895,0,0,74.64,354,312,漢民里,NULL
0,664,4,668,996,0,0,67.07,354,310,緞繻村,NULL
651,665,3,668,873,0,0,76.52,346,319,東橋里,NULL
0,665,3,668,902,0,0,74.06,299,366,北門村,NULL
905,662,6,668,879,0,0,76,298,364,天興里,NULL
115,664,4,668,894,0,0,74.72,279,385,永榮里,NULL
234,656,12,668,1052,0,0,63.5,274,382,灣西村,NULL
0,656,12,668,1052,0,0,63.5,274,382,灣西村,NULL
1275,663,4,667,855,0,0,78.01,507,156,香坡里,NULL
182,657,10,667,1056,0,0,63.16,483,174,長橋里,NULL
0,657,10,667,1056,0,0,63.16,483,174,長橋里,NULL
0,662,5,667,876,0,0,76.14,443,219,新基村,NULL
845,653,14,667,855,0,0,78.01,401,252,員本里,NULL
609,660,7,667,961,0,0,69.41,378,282,會社村,NULL
129,664,3,667,903,0,0,73.86,374,290,安溪里,NULL
562,664,3,667,789,0,0,84.54,373,291,富春里,NULL
0,664,3,667,789,0,0,84.54,373,291,富春里,NULL
783,665,2,667,863,0,0,77.29,372,293,中路里,NULL
1766,663,4,667,866,0,0,77.02,361,302,永昌里,NULL
545,657,10,667,863,0,0,77.29,353,304,富福里,NULL
310,664,3,667,859,0,0,77.65,343,321,竹南村,NULL
603,660,7,667,1036,0,0,64.38,340,320,山脚里,NULL
88,663,4,667,1003,0,0,66.5,317,346,後埔里,NULL
547,661,6,667,929,0,0,71.8,308,353,明和村,NULL
9,663,4,667,927,0,0,71.95,296,367,過江村,NULL
353,667,0,667,842,0,0,79.22,277,390,麟頂村,NULL
0,667,0,667,842,0,0,79.22,277,390,麟頂村,NULL
359,665,2,667,842,0,0,79.22,276,389,田心村,NULL
0,665,2,667,842,0,0,79.22,276,389,田心村,NULL
136,648,19,667,911,0,0,73.22,227,421,南港里,NULL
0,648,19,667,911,0,0,73.22,227,421,南港里,NULL
466,663,3,666,836,0,0,79.67,650,13,望嘉村,NULL
0,663,3,666,836,0,0,79.67,650,13,望嘉村,NULL
208,655,11,666,1016,0,0,65.55,609,46,西林村,NULL
0,655,11,666,1016,0,0,65.55,609,46,西林村,NULL
161,663,3,666,979,0,0,68.03,460,203,志學村,NULL
156,661,5,666,875,0,0,76.11,438,223,上寮里,NULL
1717,658,8,666,865,0,0,76.99,393,265,東昇里,NULL
87,662,4,666,901,0,0,73.92,378,284,蕉埔里,NULL
0,662,4,666,901,0,0,73.92,378,284,蕉埔里,NULL
18,660,6,666,1035,0,0,64.35,347,313,橋頭村,NULL
582,660,6,666,962,0,0,69.23,331,329,成功村,NULL
74,659,7,666,926,0,0,71.92,305,354,城南里,NULL
21,662,4,666,1102,0,0,60.44,301,361,六龜村,NULL
0,662,4,666,1102,0,0,60.44,301,361,六龜村,NULL
289,660,6,666,983,0,0,67.75,278,382,羅厝村,NULL
286,663,3,666,938,0,0,71,272,391,水林村,NULL
497,654,12,666,878,0,0,75.85,266,388,蘇林村,NULL
199,660,6,666,985,0,0,67.61,198,462,謝厝村,NULL
0,660,6,666,985,0,0,67.61,198,462,謝厝村,NULL
23,659,6,665,924,0,0,71.97,501,158,砂灣里,NULL
713,660,5,665,866,0,0,76.79,415,245,后里村,NULL
119,664,1,665,880,0,0,75.57,412,252,協和里,NULL
1669,661,4,665,900,0,0,73.89,384,277,圳安里,NULL
185,659,6,665,863,0,0,77.06,353,306,海山里,NULL
287,660,5,665,940,0,0,70.74,321,339,南都里,NULL
461,662,3,665,828,0,0,80.31,282,380,橋頭村,NULL
687,659,6,665,879,0,0,75.65,237,422,烏竹里,NULL
468,661,3,664,931,0,0,71.32,432,229,楠西村,NULL
673,658,6,664,813,0,0,81.67,396,262,甲頂里,NULL
2089,660,4,664,879,0,0,75.54,395,265,萬福村,NULL
373,655,9,664,932,0,0,71.24,335,320,興貴村,NULL
127,662,2,664,905,0,0,73.37,314,348,頂湳里,NULL
0,654,10,664,914,0,0,72.65,195,459,嘉昌村,NULL
679,660,3,663,802,0,0,82.67,531,129,景平里,NULL
1668,658,5,663,867,0,0,76.47,326,332,圳安里,NULL
754,660,3,663,879,0,0,75.43,320,340,興仁里,NULL
131,656,7,663,848,0,0,78.18,320,336,新西里,NULL
521,656,7,663,871,0,0,76.12,314,342,新市村,NULL
576,657,6,663,901,0,0,73.58,303,354,東州村,NULL
264,659,4,663,889,0,0,74.58,303,356,南港里,NULL
0,659,4,663,889,0,0,74.58,303,356,南港里,NULL
113,656,7,663,948,0,0,69.94,293,363,糠榔里,NULL
185,656,7,663,893,0,0,74.24,280,376,光福村,NULL
121,655,8,663,877,0,0,75.6,269,386,延平里,NULL
233,654,9,663,882,0,0,75.17,256,398,樹下里,NULL
409,658,5,663,865,0,0,76.65,167,491,安正里,NULL
0,658,5,663,865,0,0,76.65,167,491,安正里,NULL
281,655,8,663,968,0,0,68.49,118,537,扶朝里,NULL
0,655,8,663,968,0,0,68.49,118,537,扶朝里,NULL
247,652,10,662,1125,0,0,58.84,478,174,大禹里,NULL
0,652,10,662,1125,0,0,58.84,478,174,大禹里,NULL
187,653,9,662,811,0,0,81.63,470,183,南和里,NULL
0,653,9,662,811,0,0,81.63,470,183,南和里,NULL
15,651,11,662,867,0,0,76.36,369,282,文化里,NULL
545,656,6,662,903,0,0,73.31,314,342,永就村,NULL
546,653,9,662,961,0,0,68.89,312,341,竹圍村,NULL
0,653,9,662,961,0,0,68.89,312,341,竹圍村,NULL
0,662,0,662,855,0,0,77.43,292,370,觸口村,NULL
540,655,7,662,865,0,0,76.53,291,364,頂街里,NULL
0,655,7,662,865,0,0,76.53,291,364,頂街里,NULL
517,656,6,662,886,0,0,74.72,261,395,賴家村,NULL
0,656,6,662,886,0,0,74.72,261,395,賴家村,NULL
516,653,9,662,804,0,0,82.34,259,394,高楠村,NULL
531,660,2,662,879,0,0,75.31,255,405,烏林村,NULL
449,656,6,662,918,0,0,72.11,252,404,二溪村,NULL
0,656,6,662,918,0,0,72.11,252,404,二溪村,NULL
549,655,7,662,959,0,0,69.03,248,407,大湖村,NULL
0,655,7,662,959,0,0,69.03,248,407,大湖村,NULL
345,655,7,662,881,0,0,75.14,196,459,埤頭里,NULL
0,655,7,662,881,0,0,75.14,196,459,埤頭里,NULL
408,656,6,662,839,0,0,78.9,117,539,中民里,NULL
0,656,6,662,839,0,0,78.9,117,539,中民里,NULL
73,656,5,661,856,0,0,77.22,539,117,員崠里,NULL
314,656,5,661,872,0,0,75.8,409,247,吳厝里,NULL
0,656,5,661,872,0,0,75.8,409,247,吳厝里,NULL
115,654,7,661,896,0,0,73.77,400,254,洋厝里,NULL
415,659,2,661,830,0,0,79.64,394,265,忠孝里,NULL
43,653,8,661,1088,0,0,60.75,324,329,溪下村,NULL
0,653,8,661,1088,0,0,60.75,324,329,溪下村,NULL
474,654,7,661,830,0,0,79.64,314,340,甲北村,NULL
405,655,6,661,931,0,0,71,273,382,玉峰村,NULL
0,655,6,661,931,0,0,71,273,382,玉峰村,NULL
43,651,10,661,824,0,0,80.22,268,383,公塭里,NULL
0,651,10,661,824,0,0,80.22,268,383,公塭里,NULL
357,651,10,661,934,0,0,70.77,179,472,安定里,NULL
137,657,3,660,816,0,0,80.88,436,221,田新里,NULL
93,650,10,660,1025,0,0,64.39,395,255,麒麟里,NULL
0,650,10,660,1025,0,0,64.39,395,255,麒麟里,NULL
311,654,6,660,839,0,0,78.67,374,280,竹南村,NULL
280,654,6,660,817,0,0,80.78,373,281,中街里,NULL
0,654,6,660,817,0,0,80.78,373,281,中街里,NULL
1331,652,8,660,848,0,0,77.83,364,288,土城里,NULL
187,655,5,660,934,0,0,70.66,336,319,三民村,NULL
501,652,8,660,898,0,0,73.5,333,319,大東里,NULL
0,652,8,660,898,0,0,73.5,333,319,大東里,NULL
219,650,10,660,826,0,0,79.9,327,323,民生里,NULL
367,654,6,660,874,0,0,75.51,290,364,頂廍里,NULL
0,654,6,660,874,0,0,75.51,290,364,頂廍里,NULL
433,648,12,660,857,0,0,77.01,235,413,東隆里,NULL
546,655,5,660,882,0,0,74.83,235,420,明和村,NULL
0,648,12,660,857,0,0,77.01,235,413,東隆里,NULL
14,652,7,659,893,0,0,73.8,529,123,民運里,NULL
292,653,6,659,947,0,0,69.59,421,232,坪林里,NULL
0,653,6,659,947,0,0,69.59,421,232,坪林里,NULL
684,653,6,659,897,0,0,73.47,419,234,浮圳里,NULL
752,649,10,659,830,0,0,79.4,366,283,北安里,NULL
0,651,8,659,1003,0,0,65.7,316,335,桶頭里,NULL
946,652,7,659,865,0,0,76.18,300,352,蚵間村,NULL
0,652,7,659,865,0,0,76.18,300,352,蚵間村,NULL
522,651,8,659,1010,0,0,65.25,297,354,田頭村,NULL
0,651,8,659,1010,0,0,65.25,297,354,田頭村,NULL
96,656,3,659,930,0,0,70.86,276,380,西平里,NULL
150,652,7,659,847,0,0,77.8,243,409,復安村,NULL
412,652,7,659,874,0,0,75.4,226,426,五房村,NULL
294,654,4,658,928,0,0,70.91,487,167,五魁村,NULL
0,654,4,658,928,0,0,70.91,487,167,五魁村,NULL
30,648,10,658,912,0,0,72.15,475,173,主和里,NULL
423,649,9,658,869,0,0,75.72,428,221,出水村,NULL
0,649,9,658,869,0,0,75.72,428,221,出水村,NULL
9,654,4,658,920,0,0,71.52,427,227,民權里,NULL
0,654,4,658,920,0,0,71.52,427,227,民權里,NULL
81,652,6,658,882,0,0,74.6,421,231,東門里,NULL
745,656,2,658,813,0,0,80.93,365,291,圳堵村,NULL
198,648,10,658,876,0,0,75.11,345,303,犁分里,NULL
0,648,10,658,876,0,0,75.11,345,303,犁分里,NULL
813,656,2,658,847,0,0,77.69,334,322,後市村,NULL
148,653,5,658,909,0,0,72.39,324,329,大宏里,NULL
123,649,9,658,920,0,0,71.52,293,356,國姓里,NULL
845,655,3,658,864,0,0,76.16,286,369,關廟村,NULL
279,649,9,658,828,0,0,79.47,280,369,太爺村,NULL
0,649,9,658,828,0,0,79.47,280,369,太爺村,NULL
674,654,4,658,893,0,0,73.68,277,377,中門村,NULL
92,651,7,658,958,0,0,68.68,267,384,東平里,NULL
38,653,4,657,1190,0,0,55.21,630,23,何斗里,NULL
0,653,4,657,1190,0,0,55.21,630,23,何斗里,NULL
299,651,6,657,877,0,0,74.91,537,114,靜湖村,NULL
300,654,3,657,842,0,0,78.03,515,139,靜湖村,NULL
370,651,6,657,874,0,0,75.17,491,160,象山村,NULL
67,654,3,657,923,0,0,71.18,450,204,孝岡里,NULL
0,654,3,657,923,0,0,71.18,450,204,孝岡里,NULL
1330,647,10,657,827,0,0,79.44,392,255,土城里,NULL
213,646,11,657,856,0,0,76.75,368,278,康樂里,NULL
524,652,5,657,840,0,0,78.21,361,291,新和村,NULL
273,645,12,657,846,0,0,77.66,349,296,茄苳里,NULL
0,645,12,657,846,0,0,77.66,349,296,茄苳里,NULL
301,649,8,657,924,0,0,71.1,325,324,錦平里,NULL
406,652,5,657,801,0,0,82.02,322,330,福星里,NULL
0,652,5,657,801,0,0,82.02,322,330,福星里,NULL
528,656,1,657,874,0,0,75.17,309,347,慈福里,NULL
478,653,4,657,861,0,0,76.31,286,367,北金里,NULL
0,653,4,657,861,0,0,76.31,286,367,北金里,NULL
45,650,7,657,1219,0,0,53.9,279,371,風櫃里,NULL
0,650,7,657,1219,0,0,53.9,279,371,風櫃里,NULL
207,646,11,657,901,0,0,72.92,246,400,過嶺村,NULL
517,655,2,657,895,0,0,73.41,191,464,管寮村,NULL
0,655,2,657,895,0,0,73.41,191,464,管寮村,NULL
151,652,4,656,986,0,0,66.53,599,53,凉山村,NULL
0,652,4,656,986,0,0,66.53,599,53,凉山村,NULL
393,651,5,656,882,0,0,74.38,538,113,五湖村,NULL
0,651,5,656,882,0,0,74.38,538,113,五湖村,NULL
186,652,4,656,845,0,0,77.63,506,146,珊湖里,NULL
762,645,11,656,923,0,0,71.07,425,220,大社村,NULL
197,651,5,656,788,0,0,83.25,418,233,精忠村,NULL
432,649,7,656,854,0,0,76.81,395,254,社口里,NULL
274,652,4,656,819,0,0,80.1,380,272,永和村,NULL
0,652,4,656,819,0,0,80.1,380,272,永和村,NULL
60,650,6,656,971,0,0,67.56,378,272,豐田里,NULL
492,653,3,656,903,0,0,72.65,346,307,新舘村,NULL
0,653,3,656,903,0,0,72.65,346,307,新舘村,NULL
332,652,4,656,851,0,0,77.09,340,312,永華村,NULL
304,647,9,656,897,0,0,73.13,299,348,埔中村,NULL
0,647,9,656,897,0,0,73.13,299,348,埔中村,NULL
239,646,9,655,1120,0,0,58.48,574,72,樂合里,NULL
0,646,9,655,1120,0,0,58.48,574,72,樂合里,NULL
124,651,4,655,1021,0,0,64.15,462,189,福原村,NULL
115,651,4,655,902,0,0,72.62,410,241,平和里,NULL
308,645,10,655,826,0,0,79.3,341,304,田中里,NULL
0,645,10,655,826,0,0,79.3,341,304,田中里,NULL
611,649,6,655,859,0,0,76.25,323,326,會社村,NULL
92,650,5,655,781,0,0,83.87,202,448,尾南里,NULL
0,650,5,655,781,0,0,83.87,202,448,尾南里,NULL
247,654,1,655,914,0,0,71.66,133,521,玉山村,NULL
0,654,1,655,914,0,0,71.66,133,521,玉山村,NULL
9,649,5,654,1187,0,0,55.1,626,23,北門里,NULL
0,647,7,654,897,0,0,72.91,607,40,文蘭村,NULL
233,650,4,654,908,0,0,72.03,378,272,千秋里,NULL
0,650,4,654,908,0,0,72.03,378,272,千秋里,NULL
162,648,6,654,978,0,0,66.87,338,310,竹安里,NULL
583,647,7,654,892,0,0,73.32,332,315,成功村,NULL
18,651,3,654,891,0,0,73.4,275,376,三廍村,NULL
142,647,7,654,977,0,0,66.94,272,375,墾地里,NULL
0,647,7,654,977,0,0,66.94,272,375,墾地里,NULL
24,650,4,654,902,0,0,72.51,243,407,新東村,NULL
592,646,8,654,896,0,0,72.99,196,450,三條村,NULL
0,646,8,654,896,0,0,72.99,196,450,三條村,NULL
357,647,6,653,876,0,0,74.54,517,130,田美村,NULL
0,647,6,653,876,0,0,74.54,517,130,田美村,NULL
793,648,5,653,832,0,0,78.49,479,169,誠信里,NULL
117,646,7,653,781,0,0,83.61,456,190,湖濱里,NULL
114,646,7,653,901,0,0,72.48,447,199,通明里,NULL
534,647,6,653,950,0,0,68.74,416,231,豊崙村,NULL
379,651,2,653,905,0,0,72.15,409,242,竹豐村,NULL
0,651,2,653,905,0,0,72.15,409,242,竹豐村,NULL
687,643,10,653,925,0,0,70.59,386,257,南勢村,NULL
1968,648,5,653,867,0,0,75.32,385,263,集福村,NULL
47,648,5,653,1020,0,0,64.02,363,285,溝坪村,NULL
0,648,5,653,1020,0,0,64.02,363,285,溝坪村,NULL
261,649,4,653,826,0,0,79.06,344,305,中和村,NULL
0,649,4,653,826,0,0,79.06,344,305,中和村,NULL
333,650,3,653,897,0,0,72.8,317,333,永華村,NULL
398,648,5,653,1022,0,0,63.89,303,345,民和村,NULL
0,648,5,653,1022,0,0,63.89,303,345,民和村,NULL
52,643,10,653,888,0,0,73.54,192,451,詔安里,NULL
0,643,10,653,888,0,0,73.54,192,451,詔安里,NULL
362,650,2,652,974,0,0,66.94,595,55,東河村,NULL
0,650,2,652,974,0,0,66.94,595,55,東河村,NULL
682,644,8,652,851,0,0,76.62,393,251,鎮興里,NULL
861,647,5,652,845,0,0,77.16,374,273,中榮里,NULL
68,649,3,652,801,0,0,81.4,360,289,松雅村,NULL
0,649,3,652,801,0,0,81.4,360,289,松雅村,NULL
2174,645,7,652,950,0,0,68.63,360,285,十分村,NULL
0,645,7,652,950,0,0,68.63,360,285,十分村,NULL
104,647,5,652,853,0,0,76.44,358,289,平元里,NULL
491,641,11,652,890,0,0,73.26,340,301,南舘村,NULL
0,641,11,652,890,0,0,73.26,340,301,南舘村,NULL
48,648,4,652,843,0,0,77.34,330,318,港德里,NULL
349,646,6,652,888,0,0,73.42,321,325,芬園村,NULL
0,646,6,652,888,0,0,73.42,321,325,芬園村,NULL
39,644,8,652,1095,0,0,59.54,320,324,鎖港里,NULL
531,644,8,652,963,0,0,67.71,318,326,永昌村,NULL
301,643,9,652,880,0,0,74.09,308,335,社中村,NULL
0,643,9,652,880,0,0,74.09,308,335,社中村,NULL
581,644,8,652,960,0,0,67.92,281,363,西畔村,NULL
239,648,4,652,869,0,0,75.03,249,399,三和村,NULL
0,648,4,652,869,0,0,75.03,249,399,三和村,NULL
225,643,9,652,1029,0,0,63.36,238,405,大溝村,NULL
0,643,9,652,1029,0,0,63.36,238,405,大溝村,NULL
165,643,9,652,865,0,0,75.38,210,433,竹南村,NULL
0,643,9,652,865,0,0,75.38,210,433,竹南村,NULL
2249,646,5,651,894,0,0,72.82,427,219,中幅村,NULL
0,646,5,651,894,0,0,72.82,427,219,中幅村,NULL
495,640,11,651,891,0,0,73.06,344,296,梧鳳村,NULL
0,640,11,651,891,0,0,73.06,344,296,梧鳳村,NULL
183,647,4,651,861,0,0,75.61,321,326,角宿村,NULL
69,644,7,651,838,0,0,77.68,320,324,崇義里,NULL
38,646,5,651,877,0,0,74.23,283,363,秀祐里,NULL
0,646,5,651,877,0,0,74.23,283,363,秀祐里,NULL
150,649,2,651,1088,0,0,59.83,280,369,溪底村,NULL
0,649,2,651,1088,0,0,59.83,280,369,溪底村,NULL
433,645,6,651,896,0,0,72.66,274,371,越溪村,NULL
0,645,6,651,896,0,0,72.66,274,371,越溪村,NULL
334,649,2,651,926,0,0,70.3,262,387,永吉村,NULL
0,649,2,651,926,0,0,70.3,262,387,永吉村,NULL
757,649,2,651,843,0,0,77.22,259,390,明孝里,NULL
245,646,5,651,901,0,0,72.25,253,393,柳溝村,NULL
18,644,7,651,936,0,0,69.55,246,398,六斗村,NULL
0,644,7,651,936,0,0,69.55,246,398,六斗村,NULL
54,644,7,651,876,0,0,74.32,233,411,蓮潭里,NULL
0,644,7,651,876,0,0,74.32,233,411,蓮潭里,NULL
368,643,8,651,844,0,0,77.13,225,418,興安村,NULL
0,643,8,651,844,0,0,77.13,225,418,興安村,NULL
319,647,4,651,927,0,0,70.23,209,438,大義村,NULL
0,647,4,651,927,0,0,70.23,209,438,大義村,NULL
83,640,11,651,965,0,0,67.46,197,443,崁前里,NULL
0,640,11,651,965,0,0,67.46,197,443,崁前里,NULL
487,647,3,650,816,0,0,79.66,460,187,三元里,NULL
247,643,7,650,783,0,0,83.01,455,188,東香里,NULL
27,643,7,650,839,0,0,77.47,421,222,碧洲里,NULL
696,647,3,650,862,0,0,75.41,388,259,縣衙里,NULL
0,647,3,650,862,0,0,75.41,388,259,縣衙里,NULL
669,647,3,650,845,0,0,76.92,376,271,萬年里,NULL
415,623,27,650,899,0,0,72.3,368,255,大永里,NULL
0,623,27,650,899,0,0,72.3,368,255,大永里,NULL
1386,643,7,650,804,0,0,80.85,359,284,柑林里,NULL
293,638,12,650,879,0,0,73.95,346,292,光大里,NULL
186,647,3,650,913,0,0,71.19,340,307,松竹村,NULL
0,647,3,650,913,0,0,71.19,340,307,松竹村,NULL
312,650,0,650,951,0,0,68.35,201,449,定安村,NULL
0,650,0,650,951,0,0,68.35,201,449,定安村,NULL
146,648,1,649,872,0,0,74.43,581,67,春陽村,NULL
0,648,1,649,872,0,0,74.43,581,67,春陽村,NULL
174,638,11,649,838,0,0,77.45,412,226,東山里,NULL
0,638,11,649,838,0,0,77.45,412,226,東山里,NULL
80,641,8,649,908,0,0,71.48,370,271,好修里,NULL
401,648,1,649,862,0,0,75.29,349,299,光興里,NULL
0,648,1,649,862,0,0,75.29,349,299,光興里,NULL
55,647,2,649,885,0,0,73.33,341,306,茭白里,NULL
60,644,5,649,842,0,0,77.08,336,308,北門里,NULL
0,644,5,649,842,0,0,77.08,336,308,北門里,NULL
554,647,2,649,872,0,0,74.43,318,329,人和里,NULL
213,643,6,649,800,0,0,81.13,279,364,翠屏村,NULL
299,648,1,649,803,0,0,80.82,279,369,社東村,NULL
310,641,8,649,887,0,0,73.17,222,419,月眉村,NULL
1961,642,6,648,931,0,0,69.6,485,157,瑞濱里,NULL
2183,642,6,648,988,0,0,65.59,412,230,牡丹村,NULL
4,638,10,648,860,0,0,75.35,371,267,順天里,NULL
204,641,7,648,869,0,0,74.57,370,271,廣新里,NULL
1467,644,4,648,777,0,0,83.4,363,281,正義里,NULL
145,644,4,648,1017,0,0,63.72,306,338,四湖村,NULL
34,646,2,648,995,0,0,65.13,255,391,泰山村,NULL
298,639,8,647,961,0,0,67.33,620,19,復興里,NULL
909,642,5,647,826,0,0,78.33,539,103,北興村,NULL
375,639,8,647,818,0,0,79.1,492,147,廣盛村,NULL
75,641,6,647,893,0,0,72.45,423,218,地潭里,NULL
0,641,6,647,893,0,0,72.45,423,218,地潭里,NULL
400,637,10,647,862,0,0,75.06,347,290,仁德里,NULL
154,640,7,647,892,0,0,72.53,342,298,美源里,NULL
164,642,5,647,878,0,0,73.69,319,323,東過村,NULL
0,642,5,647,878,0,0,73.69,319,323,東過村,NULL
72,643,4,647,851,0,0,76.03,298,345,竹峰里,NULL
445,646,1,647,852,0,0,75.94,294,352,大內村,NULL
0,646,1,647,852,0,0,75.94,294,352,大內村,NULL
404,642,5,647,824,0,0,78.52,271,371,內庄村,NULL
0,642,5,647,824,0,0,78.52,271,371,內庄村,NULL
323,642,5,647,1011,0,0,64,252,390,庄西村,NULL
0,642,5,647,1011,0,0,64,252,390,庄西村,NULL
105,640,6,646,974,0,0,66.32,483,157,太平村,NULL
1940,644,2,646,870,0,0,74.25,430,214,吉安里,NULL
513,637,9,646,1011,0,0,63.9,422,215,西港村,NULL
0,637,9,646,1011,0,0,63.9,422,215,西港村,NULL
598,636,10,646,941,0,0,68.65,382,254,城南里,NULL
0,636,10,646,941,0,0,68.65,382,254,城南里,NULL
437,636,10,646,827,0,0,78.11,367,269,柳川里,NULL
73,645,1,646,871,0,0,74.17,359,286,忠正里,NULL
0,645,1,646,871,0,0,74.17,359,286,忠正里,NULL
307,642,4,646,893,0,0,72.34,346,296,新光村,NULL
120,638,8,646,832,0,0,77.64,339,299,南和里,NULL
0,638,8,646,832,0,0,77.64,339,299,南和里,NULL
98,645,1,646,804,0,0,80.35,321,324,竹蓮里,NULL
0,645,1,646,804,0,0,80.35,321,324,竹蓮里,NULL
193,645,1,646,812,0,0,79.56,274,371,太康村,NULL
376,638,8,646,881,0,0,73.33,245,393,四合村,NULL
97,638,8,646,870,0,0,74.25,219,419,中洲里,NULL
249,641,5,646,868,0,0,74.42,202,439,坪頂村,NULL
0,641,5,646,868,0,0,74.42,202,439,坪頂村,NULL
129,642,3,645,918,0,0,70.26,429,213,房里里,NULL
761,635,10,645,856,0,0,75.35,403,232,柳鳳村,NULL
0,635,10,645,856,0,0,75.35,403,232,柳鳳村,NULL
769,638,7,645,988,0,0,65.28,400,238,碧峰里,NULL
72,635,10,645,950,0,0,67.89,398,237,福龜村,NULL
498,638,7,645,872,0,0,73.97,383,255,埤脚村,NULL
0,638,7,645,872,0,0,73.97,383,255,埤脚村,NULL
782,639,6,645,809,0,0,79.73,376,263,瑞竹里,NULL
102,641,4,645,830,0,0,77.71,368,273,新興里,NULL
17,642,3,645,876,0,0,73.63,361,281,中正里,NULL
0,642,3,645,876,0,0,73.63,361,281,中正里,NULL
238,639,6,645,924,0,0,69.81,330,309,虎山里,NULL
344,644,1,645,912,0,0,70.72,312,332,岡山里,NULL
175,641,4,645,861,0,0,74.91,311,330,馬興村,NULL
786,639,6,645,853,0,0,75.62,241,398,鎮中里,NULL
0,639,6,645,853,0,0,75.62,241,398,鎮中里,NULL
93,641,4,645,867,0,0,74.39,205,436,新榮里,NULL
217,634,11,645,914,0,0,70.57,192,442,東河村,NULL
0,634,11,645,914,0,0,70.57,192,442,東河村,NULL
280,642,3,645,874,0,0,73.8,190,452,上竹里,NULL
183,637,8,645,903,0,0,71.43,187,450,下潭村,NULL
0,637,8,645,903,0,0,71.43,187,450,下潭村,NULL
0,634,10,644,1053,0,0,61.16,576,58,馬遠村,NULL
747,638,6,644,801,0,0,80.4,409,229,員富里,NULL
316,635,9,644,909,0,0,70.85,399,236,永昌里,NULL
0,635,9,644,909,0,0,70.85,399,236,永昌里,NULL
18,640,4,644,879,0,0,73.27,389,251,中山里,NULL
0,640,4,644,879,0,0,73.27,389,251,中山里,NULL
44,643,1,644,807,0,0,79.8,382,261,還社里,NULL
0,643,1,644,807,0,0,79.8,382,261,還社里,NULL
438,638,6,644,859,0,0,74.97,365,273,大誠里,NULL
435,638,6,644,848,0,0,75.94,341,297,嘉東里,NULL
0,638,6,644,848,0,0,75.94,341,297,嘉東里,NULL
452,636,8,644,821,0,0,78.44,306,330,泉源里,NULL
77,639,5,644,819,0,0,78.63,258,381,社口里,NULL
0,639,5,644,819,0,0,78.63,258,381,社口里,NULL
636,641,3,644,850,0,0,75.76,202,439,潮寮村,NULL
275,638,6,644,819,0,0,78.63,198,440,海埔村,NULL
1195,636,7,643,802,0,0,80.17,479,157,和平里,NULL
0,636,7,643,802,0,0,80.17,479,157,和平里,NULL
118,639,4,643,920,0,0,69.89,411,228,太白里,NULL
0,639,4,643,920,0,0,69.89,411,228,太白里,NULL
246,632,11,643,972,0,0,66.15,397,235,三民里,NULL
0,632,11,643,972,0,0,66.15,397,235,三民里,NULL
235,627,16,643,815,0,0,78.9,361,266,坡頭村,NULL
0,627,16,643,815,0,0,78.9,361,266,坡頭村,NULL
305,638,5,643,823,0,0,78.13,341,297,社南村,NULL
377,635,8,643,870,0,0,73.91,330,305,四合村,NULL
807,635,8,643,870,0,0,73.91,293,342,惠民村,NULL
0,635,8,643,870,0,0,73.91,293,342,惠民村,NULL
483,641,2,643,858,0,0,74.94,272,369,八德里,NULL
0,641,2,643,858,0,0,74.94,272,369,八德里,NULL
672,639,4,643,789,0,0,81.5,245,394,龔厝村,NULL
371,637,6,643,876,0,0,73.4,200,437,沙坑村,NULL
0,637,6,643,876,0,0,73.4,200,437,沙坑村,NULL
33,635,7,642,858,0,0,74.83,441,194,綠水里,NULL
128,637,5,642,790,0,0,81.27,426,211,溝墘里,NULL
130,637,5,642,903,0,0,71.1,348,289,番婆村,NULL
403,636,6,642,870,0,0,73.79,327,309,塩舘村,NULL
0,636,6,642,870,0,0,73.79,327,309,塩舘村,NULL
100,634,8,642,906,0,0,70.86,312,322,中圳里,NULL
396,637,5,642,861,0,0,74.56,310,327,重興村,NULL
50,636,6,642,928,0,0,69.18,280,356,洲仔村,NULL
505,637,5,642,829,0,0,77.44,280,357,中林村,NULL
0,636,6,642,928,0,0,69.18,280,356,洲仔村,NULL
0,637,5,642,829,0,0,77.44,280,357,中林村,NULL
368,641,1,642,816,0,0,78.68,259,382,埔子村,NULL
308,634,8,642,897,0,0,71.57,193,441,大潭村,NULL
47,635,6,641,986,0,0,65.01,407,228,豐里里,NULL
1907,634,7,641,802,0,0,79.93,392,242,永吉里,NULL
0,634,7,641,802,0,0,79.93,392,242,永吉里,NULL
489,638,3,641,833,0,0,76.95,349,289,社東里,NULL
329,631,10,641,858,0,0,74.71,337,294,廣福里,NULL
297,639,2,641,974,0,0,65.81,286,353,豐榮村,NULL
0,638,3,641,850,0,0,75.41,264,374,直潭里,NULL
157,638,3,641,885,0,0,72.43,260,378,西德村,NULL
0,638,3,641,885,0,0,72.43,260,378,西德村,NULL
252,633,8,641,871,0,0,73.59,250,383,嘉樂村,NULL
493,636,5,641,910,0,0,70.44,208,428,永樂村,NULL
0,636,5,641,910,0,0,70.44,208,428,永樂村,NULL
312,635,6,641,901,0,0,71.14,140,495,社子村,NULL
0,635,6,641,901,0,0,71.14,140,495,社子村,NULL
214,634,6,640,800,0,0,80,575,59,公明里,NULL
308,632,8,640,908,0,0,70.48,426,206,栗林村,NULL
0,632,8,640,908,0,0,70.48,426,206,栗林村,NULL
143,629,11,640,832,0,0,76.92,387,242,下寮里,NULL
229,635,5,640,872,0,0,73.39,382,253,麗水村,NULL
636,635,5,640,793,0,0,80.71,379,256,新生里,NULL
622,636,4,640,782,0,0,81.84,362,274,新興里,NULL
0,636,4,640,782,0,0,81.84,362,274,新興里,NULL
120,635,5,640,874,0,0,73.23,324,311,吉東里,NULL
548,633,7,640,946,0,0,67.65,319,314,太源村,NULL
0,633,7,640,946,0,0,67.65,319,314,太源村,NULL
1751,635,5,640,827,0,0,77.39,310,325,二甲里,NULL
0,635,5,640,827,0,0,77.39,310,325,二甲里,NULL
125,634,6,640,962,0,0,66.53,278,356,見龍里,NULL
0,634,6,640,962,0,0,66.53,278,356,見龍里,NULL
477,635,5,640,814,0,0,78.62,233,402,西港村,NULL
102,637,2,639,865,0,0,73.87,598,39,水源村,NULL
0,637,2,639,865,0,0,73.87,598,39,水源村,NULL
164,637,2,639,780,0,0,81.92,472,165,長樂里,NULL
71,636,3,639,900,0,0,71,469,167,福龜村,NULL
91,631,8,639,769,0,0,83.09,447,184,東華里,NULL
0,631,8,639,769,0,0,83.09,447,184,東華里,NULL
101,638,1,639,787,0,0,81.19,396,242,安仁里,NULL
467,636,3,639,936,0,0,68.27,396,240,楠西村,NULL
627,632,7,639,825,0,0,77.45,368,264,黎明里,NULL
22,631,8,639,1032,0,0,61.92,333,298,施厝村,NULL
652,635,4,639,782,0,0,81.71,327,308,東橋里,NULL
564,634,5,639,838,0,0,76.25,326,308,太平里,NULL
295,634,5,639,879,0,0,72.7,293,341,廍下村,NULL
0,634,5,639,879,0,0,72.7,293,341,廍下村,NULL
907,635,4,639,799,0,0,79.97,287,348,天興里,NULL
310,630,9,639,828,0,0,77.17,212,418,渡頭村,NULL
232,636,2,638,827,0,0,77.15,474,162,後湖村,NULL
685,632,6,638,781,0,0,81.69,436,196,景安里,NULL
637,630,8,638,846,0,0,75.41,407,223,新生里,NULL
214,633,5,638,819,0,0,77.9,400,233,三民里,NULL
0,633,5,638,819,0,0,77.9,400,233,三民里,NULL
309,635,3,638,909,0,0,70.19,365,270,和平里,NULL
0,635,3,638,909,0,0,70.19,365,270,和平里,NULL
0,634,4,638,863,0,0,73.93,363,271,德興里,NULL
42,631,7,638,1054,0,0,60.53,362,269,和豐村,NULL
0,629,9,638,896,0,0,71.21,355,274,塘興村,NULL
574,633,5,638,872,0,0,73.17,341,292,溪州村,NULL
207,636,2,638,851,0,0,74.97,313,323,民德里,NULL
0,636,2,638,851,0,0,74.97,313,323,民德里,NULL
550,631,7,638,917,0,0,69.57,301,330,山上村,NULL
0,631,7,638,917,0,0,69.57,301,330,山上村,NULL
267,634,4,638,837,0,0,76.22,282,352,大湖村,NULL
66,635,3,638,850,0,0,75.06,278,357,文化里,NULL
136,631,7,638,934,0,0,68.31,272,359,東港里,NULL
659,635,3,638,869,0,0,73.42,261,374,蔦松里,NULL
175,635,2,637,1097,0,0,58.07,614,21,大鳥村,NULL
0,635,2,637,1097,0,0,58.07,614,21,大鳥村,NULL
392,632,5,637,780,0,0,81.67,364,268,白米里,NULL
1849,631,6,637,796,0,0,80.03,357,274,忠山里,NULL
0,631,6,637,796,0,0,80.03,357,274,忠山里,NULL
1589,633,4,637,812,0,0,78.45,342,291,八連里,NULL
0,633,4,637,812,0,0,78.45,342,291,八連里,NULL
120,634,3,637,848,0,0,75.12,262,372,延平里,NULL
343,629,8,637,888,0,0,71.73,259,370,大新里,NULL
101,632,5,637,888,0,0,71.73,163,469,宅港里,NULL
0,632,5,637,888,0,0,71.73,163,469,宅港里,NULL
324,626,11,637,894,0,0,71.25,159,467,七股村,NULL
0,626,11,637,894,0,0,71.25,159,467,七股村,NULL
187,627,9,636,1050,0,0,60.57,543,84,大馬村,NULL
0,627,9,636,1050,0,0,60.57,543,84,大馬村,NULL
100,633,3,636,797,0,0,79.8,459,174,竹東里,NULL
38,630,6,636,811,0,0,78.42,447,183,竹義里,NULL
27,631,5,636,999,0,0,63.66,395,236,海口村,NULL
163,629,7,636,802,0,0,79.3,370,259,中華里,NULL
691,625,11,636,810,0,0,78.52,352,273,永東村,NULL
0,625,11,636,810,0,0,78.52,352,273,永東村,NULL
708,631,5,636,860,0,0,73.95,339,292,獨鰲村,NULL
0,631,5,636,860,0,0,73.95,339,292,獨鰲村,NULL
39,630,6,636,876,0,0,72.6,328,302,加老里,NULL
795,631,5,636,832,0,0,76.44,294,337,大社里,NULL
0,631,5,636,832,0,0,76.44,294,337,大社里,NULL
2,628,8,636,838,0,0,75.89,274,354,後壁村,NULL
48,630,6,636,931,0,0,68.31,260,370,蔦松村,NULL
0,630,6,636,931,0,0,68.31,260,370,蔦松村,NULL
585,629,7,636,981,0,0,64.83,244,385,大庄村,NULL
165,632,4,636,1108,0,0,57.4,154,478,箔東村,NULL
0,632,4,636,1108,0,0,57.4,154,478,箔東村,NULL
361,628,7,635,887,0,0,71.59,544,84,蓬萊村,NULL
0,628,7,635,887,0,0,71.59,544,84,蓬萊村,NULL
762,628,7,635,877,0,0,72.41,386,242,陸豐村,NULL
0,628,7,635,877,0,0,72.41,386,242,陸豐村,NULL
82,631,4,635,879,0,0,72.24,379,252,久愛村,NULL
0,631,4,635,879,0,0,72.24,379,252,久愛村,NULL
196,631,4,635,793,0,0,80.08,318,313,光復里,NULL
0,631,4,635,793,0,0,80.08,318,313,光復里,NULL
438,628,7,635,849,0,0,74.79,302,326,番路村,NULL
0,628,7,635,849,0,0,74.79,302,326,番路村,NULL
247,628,7,635,902,0,0,70.4,297,331,萬福村,NULL
0,628,7,635,902,0,0,70.4,297,331,萬福村,NULL
84,627,8,635,924,0,0,68.72,272,355,大林里,NULL
847,627,8,635,816,0,0,77.82,261,366,山西村,NULL
778,624,11,635,847,0,0,74.97,248,376,東勢里,NULL
188,628,7,635,984,0,0,64.53,242,386,鹿南村,NULL
0,628,7,635,984,0,0,64.53,242,386,鹿南村,NULL
0,629,5,634,813,0,0,77.98,472,157,忠義村,NULL
25,631,3,634,814,0,0,77.89,459,172,勝利里,NULL
28,629,5,634,1003,0,0,63.21,419,210,海口村,NULL
9,632,2,634,790,0,0,80.25,376,256,復興里,NULL
94,626,8,634,889,0,0,71.32,362,264,玉田里,NULL
428,631,3,634,851,0,0,74.5,357,274,海尾村,NULL
0,631,3,634,851,0,0,74.5,357,274,海尾村,NULL
123,630,4,634,904,0,0,70.13,331,299,籃城里,NULL
0,630,4,634,904,0,0,70.13,331,299,籃城里,NULL
69,631,3,634,839,0,0,75.57,323,308,興仁里,NULL
201,633,1,634,778,0,0,81.49,316,317,三奶村,NULL
217,629,5,634,907,0,0,69.9,295,334,大福村,NULL
100,627,7,634,838,0,0,75.66,262,365,協和里,NULL
84,620,13,633,949,0,0,66.7,504,116,北埔村,NULL
285,628,5,633,909,0,0,69.64,307,321,安靖村,NULL
0,628,5,633,909,0,0,69.64,307,321,安靖村,NULL
300,630,3,633,802,0,0,78.93,290,340,社東村,NULL
391,629,4,633,805,0,0,78.63,250,379,社皮村,NULL
86,629,4,633,852,0,0,74.3,245,384,慈福里,NULL
549,629,4,633,811,0,0,78.05,239,390,南洲村,NULL
869,626,7,633,874,0,0,72.43,231,395,布袋村,NULL
841,623,10,633,828,0,0,76.45,230,393,西埔村,NULL
434,628,5,633,850,0,0,74.47,225,403,港東村,NULL
7,626,7,633,916,0,0,69.1,214,412,雙涵村,NULL
0,626,7,633,916,0,0,69.1,214,412,雙涵村,NULL
60,622,10,632,796,0,0,79.4,394,228,白地里,NULL
49,627,5,632,831,0,0,76.05,384,243,西岐里,NULL
416,627,5,632,962,0,0,65.7,356,271,同富村,NULL
49,623,9,632,858,0,0,73.66,312,311,宣信里,NULL
225,628,4,632,877,0,0,72.06,264,364,興美里,NULL
0,628,4,632,877,0,0,72.06,264,364,興美里,NULL
211,627,5,632,842,0,0,75.06,261,366,塗溝村,NULL
0,627,5,632,842,0,0,75.06,261,366,塗溝村,NULL
271,628,4,632,803,0,0,78.7,239,389,湖內村,NULL
214,628,4,632,950,0,0,66.53,217,411,三榮村,NULL
0,628,4,632,950,0,0,66.53,217,411,三榮村,NULL
249,618,13,631,1189,0,0,53.07,457,161,東里村,NULL
0,618,13,631,1189,0,0,53.07,457,161,東里村,NULL
9,629,2,631,919,0,0,68.66,406,223,光復里,NULL
713,628,3,631,836,0,0,75.48,375,253,湳墘村,NULL
0,628,3,631,836,0,0,75.48,375,253,湳墘村,NULL
104,623,8,631,837,0,0,75.39,308,315,仁愛里,NULL
439,624,7,631,829,0,0,76.12,272,352,民和村,NULL
0,624,7,631,829,0,0,76.12,272,352,民和村,NULL
95,625,6,631,1169,0,0,53.98,265,360,內垵村,NULL
0,625,6,631,1169,0,0,53.98,265,360,內垵村,NULL
503,628,3,631,796,0,0,79.27,231,397,港尾村,NULL
311,623,8,631,836,0,0,75.48,223,400,月眉村,NULL
0,626,4,630,1012,0,0,62.25,522,104,西富村,NULL
269,624,6,630,795,0,0,79.25,418,206,陽明里,NULL
271,627,3,630,819,0,0,76.92,389,238,華福里,NULL
612,628,2,630,1001,0,0,62.94,337,291,龍水里,NULL
0,628,2,630,1001,0,0,62.94,337,291,龍水里,NULL
542,619,11,630,797,0,0,79.05,334,285,下街里,NULL
0,619,11,630,797,0,0,79.05,334,285,下街里,NULL
288,623,7,630,865,0,0,72.83,333,290,東湖村,NULL
51,629,1,630,845,0,0,74.56,307,322,中原里,NULL
533,626,4,630,871,0,0,72.33,302,324,安樂村,NULL
239,628,2,630,804,0,0,78.36,250,378,崇智里、崇禮里,NULL
0,628,2,630,804,0,0,78.36,250,378,崇智里、崇禮里,NULL
686,626,4,630,819,0,0,76.92,229,397,中芸村,NULL
1177,623,6,629,805,0,0,78.14,499,124,仁愛里,NULL
558,621,8,629,807,0,0,77.94,356,265,新政里,NULL
0,621,8,629,807,0,0,77.94,356,265,新政里,NULL
111,622,7,629,836,0,0,75.24,349,273,海濱里,NULL
214,622,7,629,844,0,0,74.53,345,277,中寮里,NULL
461,625,4,629,1102,0,0,57.08,334,291,大埔村,NULL
0,625,4,629,1102,0,0,57.08,334,291,大埔村,NULL
779,622,7,629,857,0,0,73.4,328,294,西路里,NULL
537,624,5,629,796,0,0,79.02,325,299,榮治里,NULL
0,624,5,629,796,0,0,79.02,325,299,榮治里,NULL
599,621,8,629,928,0,0,67.78,313,308,城北里,NULL
227,626,3,629,805,0,0,78.14,284,342,義興村,NULL
0,626,3,629,805,0,0,78.14,284,342,義興村,NULL
453,621,8,629,821,0,0,76.61,282,339,泉源里,NULL
211,625,4,629,1017,0,0,61.85,281,344,成龍村,NULL
0,625,4,629,1017,0,0,61.85,281,344,成龍村,NULL
17,624,5,629,828,0,0,75.97,262,362,三廍村,NULL
230,625,4,629,835,0,0,75.33,261,364,南鄉村,NULL
0,625,4,629,835,0,0,75.33,261,364,南鄉村,NULL
772,629,0,629,848,0,0,74.17,175,454,興仁里,NULL
0,629,0,629,848,0,0,74.17,175,454,興仁里,NULL
12,621,7,628,1153,0,0,54.47,602,19,金水里,NULL
0,621,7,628,1153,0,0,54.47,602,19,金水里,NULL
356,620,8,628,811,0,0,77.44,459,161,坑口村,NULL
83,624,4,628,909,0,0,69.09,458,166,里壠里,NULL
218,621,7,628,988,0,0,63.56,441,180,瑞美村,NULL
379,621,7,628,913,0,0,68.78,375,246,建平村,NULL
2023,617,11,628,813,0,0,77.24,343,274,同榮村,NULL
427,623,5,628,785,0,0,80,339,284,彌陀村,NULL
730,620,8,628,830,0,0,75.66,336,284,廣福村,NULL
0,620,8,628,830,0,0,75.66,336,284,廣福村,NULL
287,620,8,628,861,0,0,72.94,306,314,上新里,NULL
2246,621,7,628,849,0,0,73.97,301,320,雙興村,NULL
0,621,7,628,849,0,0,73.97,301,320,雙興村,NULL
391,623,5,628,779,0,0,80.62,289,334,白米里,NULL
383,626,2,628,810,0,0,77.53,272,354,本洲里,NULL
144,620,8,628,854,0,0,73.54,261,359,好平里,NULL
0,620,8,628,854,0,0,73.54,261,359,好平里,NULL
405,620,8,628,893,0,0,70.32,181,439,裕民村,NULL
0,620,8,628,893,0,0,70.32,181,439,裕民村,NULL
18,623,4,627,1148,0,0,54.62,590,33,湖埔村,NULL
0,623,4,627,1188,0,0,52.78,539,84,三間村,NULL
99,617,10,627,935,0,0,67.06,525,92,景美村,NULL
219,620,7,627,830,0,0,75.54,394,226,柳新村,NULL
433,620,7,627,810,0,0,77.41,350,270,錦安里,NULL
490,621,6,627,838,0,0,74.82,321,300,石龜里,NULL
0,621,6,627,838,0,0,74.82,321,300,石龜里,NULL
954,620,7,627,790,0,0,79.37,307,313,石牌村,NULL
0,620,7,627,790,0,0,79.37,307,313,石牌村,NULL
584,617,10,627,933,0,0,67.2,301,316,大庄村,NULL
24,618,9,627,932,0,0,67.27,234,384,潭墘村,NULL
0,618,9,627,932,0,0,67.27,234,384,潭墘村,NULL
499,620,7,627,818,0,0,76.65,231,389,蘇厝村,NULL
233,623,4,627,855,0,0,73.33,197,426,龍津村,NULL
2,622,4,626,788,0,0,79.44,502,120,親仁里,NULL
255,618,8,626,839,0,0,74.61,470,148,重興村,NULL
0,622,4,626,844,0,0,74.17,363,259,育仁里,NULL
98,626,0,626,838,0,0,74.7,360,266,崙頂里,NULL
0,626,0,626,838,0,0,74.7,360,266,崙頂里,NULL
638,620,6,626,828,0,0,75.6,359,261,永福里,NULL
348,623,3,626,827,0,0,75.7,354,269,廣興里,NULL
0,623,3,626,827,0,0,75.7,354,269,廣興里,NULL
732,621,5,626,826,0,0,75.79,353,268,橋頭村,NULL
168,621,5,626,818,0,0,76.53,339,282,金興村,NULL
148,619,7,626,842,0,0,74.35,336,283,水門村,NULL
0,619,7,626,842,0,0,74.35,336,283,水門村,NULL
298,623,3,626,1036,0,0,60.42,301,322,豐榮村,NULL
417,623,3,626,820,0,0,76.34,287,336,文安村,NULL
873,623,3,626,841,0,0,74.44,271,352,埤頭村,NULL
69,620,6,626,993,0,0,63.04,263,357,有才村,NULL
861,620,6,626,825,0,0,75.88,263,357,松腳村,NULL
0,620,6,626,993,0,0,63.04,263,357,有才村,NULL
3,619,7,626,894,0,0,70.02,251,368,蒜南村,NULL
0,619,7,626,894,0,0,70.02,251,368,蒜南村,NULL
355,620,6,626,810,0,0,77.28,233,387,麟蹄村,NULL
679,625,1,626,854,0,0,73.3,232,393,港埔村,NULL
314,622,4,626,914,0,0,68.49,169,453,大華村,NULL
0,622,4,626,914,0,0,68.49,169,453,大華村,NULL
140,620,5,625,846,0,0,73.88,542,78,南豐村,NULL
59,614,11,625,807,0,0,77.45,509,105,南勢里,NULL
220,615,10,625,1018,0,0,61.39,460,155,瑞祥村,NULL
0,615,10,625,1018,0,0,61.39,460,155,瑞祥村,NULL
785,621,4,625,778,0,0,80.33,427,194,秀景里,NULL
624,622,3,625,1087,0,0,57.5,415,207,中福村,NULL
0,622,3,625,1087,0,0,57.5,415,207,中福村,NULL
719,622,3,625,837,0,0,74.67,337,285,墩西村,NULL
144,616,9,625,795,0,0,78.62,337,279,西勢村,NULL
121,617,8,625,795,0,0,78.62,309,308,滿翠里,NULL
0,622,3,625,1042,0,0,59.98,299,323,美農村,NULL
534,618,7,625,876,0,0,71.35,298,320,安樂村,NULL
124,622,3,625,884,0,0,70.7,223,399,歡雅里,NULL
283,622,3,625,886,0,0,70.54,212,410,安順里,NULL
0,622,3,625,886,0,0,70.54,212,410,安順里,NULL
440,619,6,625,833,0,0,75.03,159,460,石湖村,NULL
99,624,1,625,889,0,0,70.3,157,467,光華里,NULL
916,615,9,624,775,0,0,80.52,483,132,新生里,NULL
0,615,9,624,775,0,0,80.52,483,132,新生里,NULL
451,616,8,624,842,0,0,74.11,400,216,玉井村,NULL
0,616,8,624,842,0,0,74.11,400,216,玉井村,NULL
59,619,5,624,900,0,0,69.33,376,243,豐田里,NULL
75,619,5,624,843,0,0,74.02,274,345,溪口里,NULL
0,619,5,624,843,0,0,74.02,274,345,溪口里,NULL
504,619,5,624,851,0,0,73.33,273,346,新崙里,NULL
402,618,6,624,760,0,0,82.11,143,475,華崗里,NULL
465,623,0,623,819,0,0,76.07,609,14,文樂村,NULL
0,623,0,623,819,0,0,76.07,609,14,文樂村,NULL
75,620,3,623,1215,0,0,51.28,525,95,三民里,NULL
124,615,8,623,1008,0,0,61.81,476,139,春社里,NULL
185,617,6,623,868,0,0,71.77,461,156,大安村,NULL
0,617,6,623,868,0,0,71.77,461,156,大安村,NULL
198,617,6,623,801,0,0,77.78,435,182,土牛里,NULL
0,617,6,623,801,0,0,77.78,435,182,土牛里,NULL
162,613,10,623,796,0,0,78.27,394,219,大庄里,NULL
660,615,8,623,794,0,0,78.46,388,227,壽南里,NULL
1736,615,8,623,838,0,0,74.34,334,281,北園里,NULL
69,621,2,623,840,0,0,74.17,314,307,湄洲里,NULL
165,614,9,623,911,0,0,68.39,235,379,西過村,NULL
0,614,9,623,911,0,0,68.39,235,379,西過村,NULL
401,620,3,623,771,0,0,80.8,219,401,潭底里,NULL
0,620,3,623,771,0,0,80.8,219,401,潭底里,NULL
404,614,9,623,832,0,0,74.88,191,423,三和里,NULL
0,614,9,623,832,0,0,74.88,191,423,三和里,NULL
150,614,8,622,949,0,0,65.54,429,185,豐山村,NULL
179,619,3,622,844,0,0,73.7,397,222,永福村,NULL
704,616,6,622,811,0,0,76.7,381,235,廣福村,NULL
62,620,2,622,864,0,0,71.99,320,300,頂安村,NULL
0,620,2,622,864,0,0,71.99,320,300,頂安村,NULL
2197,614,8,622,912,0,0,68.2,317,297,貢寮村,NULL
0,614,8,622,912,0,0,68.2,317,297,貢寮村,NULL
437,620,2,622,814,0,0,76.41,294,326,長生里,NULL
571,614,8,622,855,0,0,72.75,294,320,協興里,NULL
0,620,2,622,814,0,0,76.41,294,326,長生里,NULL
509,619,3,622,774,0,0,80.36,288,331,蕉園里,NULL
0,619,3,622,774,0,0,80.36,288,331,蕉園里,NULL
64,616,6,622,817,0,0,76.13,268,348,興村里,NULL
44,619,2,621,1101,0,0,56.4,435,184,嵵裡里,NULL
0,619,2,621,1101,0,0,56.4,435,184,嵵裡里,NULL
2149,619,2,621,801,0,0,77.53,422,197,草里村,NULL
0,619,2,621,801,0,0,77.53,422,197,草里村,NULL
104,618,3,621,802,0,0,77.43,370,248,南大里,NULL
817,619,2,621,861,0,0,72.13,309,310,辜厝村,NULL
548,619,2,621,755,0,0,82.25,305,314,南洲村,NULL
104,618,3,621,875,0,0,70.97,255,363,舊埤里,NULL
212,615,6,621,898,0,0,69.15,216,399,梧南村,NULL
316,612,9,621,829,0,0,74.91,186,426,篤加村,NULL
0,612,9,621,829,0,0,74.91,186,426,篤加村,NULL
299,605,15,620,803,0,0,77.21,346,259,復興里,NULL
198,613,7,620,792,0,0,78.28,332,281,光華里,NULL
0,613,7,620,792,0,0,78.28,332,281,光華里,NULL
322,618,2,620,819,0,0,75.7,317,301,竹滬村,NULL
389,617,3,620,901,0,0,68.81,296,321,林茂村,NULL
0,617,3,620,901,0,0,68.81,296,321,林茂村,NULL
743,614,6,620,850,0,0,72.94,291,323,龍井村,NULL
0,614,6,620,850,0,0,72.94,291,323,龍井村,NULL
515,612,8,620,962,0,0,64.45,288,324,台西村,NULL
0,612,8,620,962,0,0,64.45,288,324,台西村,NULL
574,610,10,620,758,0,0,81.79,268,342,光華里,NULL
0,610,10,620,758,0,0,81.79,268,342,光華里,NULL
588,614,6,620,927,0,0,66.88,254,360,潮洋村,NULL
0,614,6,620,927,0,0,66.88,254,360,潮洋村,NULL
244,615,5,620,846,0,0,73.29,235,380,三奇村,NULL
0,615,5,620,846,0,0,73.29,235,380,三奇村,NULL
426,612,7,619,845,0,0,73.25,506,106,林頭里,NULL
186,611,8,619,982,0,0,63.03,498,113,大平村,NULL
0,611,8,619,982,0,0,63.03,498,113,大平村,NULL
365,611,8,619,793,0,0,78.06,485,126,獅潭村,NULL
383,616,3,619,759,0,0,81.55,470,146,双湖村,NULL
1120,613,6,619,1853,0,0,33.41,410,203,龍安里,NULL
61,618,1,619,884,0,0,70.02,396,222,國姓村,NULL
35,617,2,619,780,0,0,79.36,384,233,德義里,NULL
0,617,2,619,780,0,0,79.36,384,233,德義里,NULL
88,609,10,619,824,0,0,75.12,356,253,龍門里,NULL
0,609,10,619,824,0,0,75.12,356,253,龍門里,NULL
563,609,10,619,766,0,0,80.81,351,258,葫蘆里,NULL
0,609,10,619,766,0,0,80.81,351,258,葫蘆里,NULL
38,613,6,619,917,0,0,67.5,347,266,龍港村,NULL
0,613,6,619,917,0,0,67.5,347,266,龍港村,NULL
742,612,7,619,826,0,0,74.94,304,308,庄後村,NULL
414,613,6,619,806,0,0,76.8,297,316,舊港村,NULL
355,609,10,619,817,0,0,75.76,285,324,秀林村,NULL
590,612,7,619,881,0,0,70.26,280,332,菜公村,NULL
0,612,7,619,881,0,0,70.26,280,332,菜公村,NULL
0,611,8,619,934,0,0,66.27,272,339,福連村,NULL
274,617,2,619,827,0,0,74.85,269,348,六甲村,NULL
344,612,7,619,836,0,0,74.04,226,386,大新里,NULL
345,614,4,618,784,0,0,78.83,486,128,朝陽村,NULL
530,613,5,618,859,0,0,71.94,404,209,新龍村,NULL
0,613,5,618,859,0,0,71.94,404,209,新龍村,NULL
158,607,11,618,923,0,0,66.96,400,207,平和村,NULL
14,614,4,618,793,0,0,77.93,386,228,太平里,NULL
610,615,3,618,889,0,0,69.52,358,257,玉山村,NULL
0,615,3,618,889,0,0,69.52,358,257,玉山村,NULL
606,607,11,618,771,0,0,80.16,327,280,中壢里,NULL
0,607,11,618,771,0,0,80.16,327,280,中壢里,NULL
302,616,2,618,853,0,0,72.45,278,338,枋南村,NULL
0,616,2,618,853,0,0,72.45,278,338,枋南村,NULL
490,617,1,618,797,0,0,77.54,208,409,金砂村,NULL
0,617,1,618,797,0,0,77.54,208,409,金砂村,NULL
805,606,11,617,760,0,0,81.18,589,17,海光里,NULL
838,609,8,617,837,0,0,73.72,391,218,東流里,NULL
447,607,10,617,799,0,0,77.22,342,265,萬壽里,NULL
211,612,5,617,879,0,0,70.19,342,270,南寮里,NULL
181,602,15,617,771,0,0,80.03,333,269,大同里,NULL
0,602,15,617,771,0,0,80.03,333,269,大同里,NULL
1830,612,5,617,834,0,0,73.98,323,289,五寮里,NULL
615,606,11,617,955,0,0,64.61,323,283,大光里,NULL
0,612,5,617,834,0,0,73.98,323,289,五寮里,NULL
213,607,10,617,920,0,0,67.07,297,310,梧南村,NULL
121,612,5,617,870,0,0,70.92,280,332,吉東里,NULL
554,611,5,616,852,0,0,72.3,584,27,七佳村,NULL
0,611,5,616,852,0,0,72.3,584,27,七佳村,NULL
9,608,8,616,780,0,0,78.97,375,233,湳興里,NULL
1945,614,2,616,862,0,0,71.46,365,249,傑魚里,NULL
595,608,8,616,858,0,0,71.79,352,256,中正村,NULL
0,608,8,616,858,0,0,71.79,352,256,中正村,NULL
299,611,5,616,821,0,0,75.03,327,284,建國里,NULL
0,611,5,616,821,0,0,75.03,327,284,建國里,NULL
757,606,10,616,839,0,0,73.42,324,282,福田村,NULL
0,606,10,616,839,0,0,73.42,324,282,福田村,NULL
1760,604,12,616,817,0,0,75.4,320,284,南靖里,NULL
113,611,5,616,777,0,0,79.28,288,323,水正里,NULL
0,611,5,616,777,0,0,79.28,288,323,水正里,NULL
296,613,3,616,806,0,0,76.43,276,337,宮前村,NULL
335,612,4,616,816,0,0,75.49,273,339,港西里,NULL
0,612,4,616,816,0,0,75.49,273,339,港西里,NULL
432,610,6,616,759,0,0,81.16,268,342,興和里,NULL
19,608,8,616,845,0,0,72.9,267,341,中和村,NULL
0,608,8,616,845,0,0,72.9,267,341,中和村,NULL
100,612,4,616,776,0,0,79.38,219,393,大業里,NULL
0,612,4,616,776,0,0,79.38,219,393,大業里,NULL
178,610,6,616,829,0,0,74.31,217,393,竹圍里,NULL
486,609,7,616,779,0,0,79.08,204,405,檨林村,NULL
1919,611,4,615,777,0,0,79.15,425,186,龍興里,NULL
201,610,5,615,794,0,0,77.46,380,230,福林里,NULL
154,606,9,615,918,0,0,66.99,361,245,外澳里,NULL
0,606,9,615,918,0,0,66.99,361,245,外澳里,NULL
310,610,5,615,803,0,0,76.59,312,298,竹巷里,NULL
0,610,5,615,803,0,0,76.59,312,298,竹巷里,NULL
617,608,7,615,821,0,0,74.91,310,298,翁社里,NULL
540,609,6,615,829,0,0,74.19,304,305,港墘村,NULL
558,611,4,615,780,0,0,78.85,301,310,中原里,NULL
288,613,2,615,843,0,0,72.95,291,322,中社村,NULL
0,607,8,615,832,0,0,73.92,276,331,新峰里,NULL
530,614,1,615,883,0,0,69.65,259,355,豐華村,NULL
0,614,1,615,883,0,0,69.65,259,355,豐華村,NULL
33,609,6,615,937,0,0,65.64,232,377,泰山村,NULL
159,612,2,614,818,0,0,75.06,575,37,武潭村,NULL
0,612,2,614,818,0,0,75.06,575,37,武潭村,NULL
0,611,3,614,842,0,0,72.92,519,92,清安村,NULL
233,608,6,614,750,0,0,81.87,469,139,民族里,NULL
739,611,3,614,802,0,0,76.56,458,153,神洲里,NULL
289,612,2,614,884,0,0,69.46,396,216,仁和村,NULL
0,612,2,614,884,0,0,69.46,396,216,仁和村,NULL
111,609,5,614,868,0,0,70.74,387,222,蜈蚣里,NULL
70,608,6,614,910,0,0,67.47,385,223,北港村,NULL
767,611,3,614,813,0,0,75.52,342,269,正義村,NULL
0,611,3,614,813,0,0,75.52,342,269,正義村,NULL
201,611,3,614,811,0,0,75.71,306,305,美福村,NULL
502,605,9,614,814,0,0,75.43,271,334,保西村,NULL
0,605,9,614,814,0,0,75.43,271,334,保西村,NULL
1853,611,3,614,870,0,0,70.57,268,343,水源里,NULL
1855,610,4,614,834,0,0,73.62,263,347,樹興里,NULL
0,610,4,614,834,0,0,73.62,263,347,樹興里,NULL
185,600,14,614,790,0,0,77.72,246,354,下崙村,NULL
288,613,1,614,963,0,0,63.76,222,391,崙前村,NULL
72,608,6,614,940,0,0,65.32,219,389,潮厝村,NULL
0,608,6,614,940,0,0,65.32,219,389,潮厝村,NULL
226,609,5,614,767,0,0,80.05,186,423,井腳村,NULL
46,608,5,613,764,0,0,80.24,458,150,千甲里,NULL
663,605,8,613,806,0,0,76.05,455,150,林內村,NULL
168,603,10,613,785,0,0,78.09,402,201,北山里,NULL
0,603,10,613,785,0,0,78.09,402,201,北山里,NULL
544,610,3,613,945,0,0,64.87,328,282,新開村,NULL
256,610,3,613,791,0,0,77.5,328,282,朝山里,NULL
0,610,3,613,945,0,0,64.87,328,282,新開村,NULL
425,606,7,613,731,0,0,83.86,325,281,彌壽村,NULL
0,606,7,613,731,0,0,83.86,325,281,彌壽村,NULL
95,606,7,613,727,0,0,84.32,320,286,北寧里,NULL
0,606,7,613,727,0,0,84.32,320,286,北寧里,NULL
1905,609,4,613,780,0,0,78.59,305,304,草東里,NULL
0,609,4,613,780,0,0,78.59,305,304,草東里,NULL
211,612,1,613,800,0,0,76.63,301,311,中里村,NULL
127,600,13,613,864,0,0,70.95,286,314,龍肚里,NULL
783,609,4,613,810,0,0,75.68,264,345,上崙村,NULL
349,603,9,612,793,0,0,77.18,585,18,大華村,NULL
0,603,9,612,793,0,0,77.18,585,18,大華村,NULL
215,602,10,612,859,0,0,71.25,465,137,瑞穗村,NULL
41,610,2,612,789,0,0,77.57,401,209,義民里,NULL
0,610,2,612,789,0,0,77.57,401,209,義民里,NULL
18,605,7,612,812,0,0,75.37,384,221,南陽里,NULL
0,605,7,612,812,0,0,75.37,384,221,南陽里,NULL
464,611,1,612,819,0,0,74.73,359,252,中竹里,NULL
0,611,1,612,819,0,0,74.73,359,252,中竹里,NULL
109,607,5,612,910,0,0,67.25,316,291,溫泉村,NULL
530,607,5,612,791,0,0,77.37,279,328,明莊里,NULL
0,607,5,612,791,0,0,77.37,279,328,明莊里,NULL
125,610,2,612,783,0,0,78.16,265,345,振豐村,NULL
186,607,5,612,919,0,0,66.59,233,374,西莊村,NULL
0,607,5,612,919,0,0,66.59,233,374,西莊村,NULL
118,610,2,612,828,0,0,73.91,217,393,和興村,NULL
370,602,10,612,821,0,0,74.54,173,429,蚶寮里,NULL
0,602,10,612,821,0,0,74.54,173,429,蚶寮里,NULL
193,610,1,611,945,0,0,64.66,590,20,嘉蘭村,NULL
0,610,1,611,945,0,0,64.66,590,20,嘉蘭村,NULL
431,606,5,611,843,0,0,72.48,342,264,西湖村,NULL
205,607,4,611,951,0,0,64.25,309,298,旭山村,NULL
169,607,4,611,881,0,0,69.35,300,307,長南村,NULL
0,602,9,611,816,0,0,74.88,294,308,大科村,NULL
266,605,6,611,839,0,0,72.82,275,330,上林里,NULL
0,605,6,611,839,0,0,72.82,275,330,上林里,NULL
438,607,4,611,758,0,0,80.61,252,355,梓和村,NULL
436,607,4,611,795,0,0,76.86,241,366,梓和村,NULL
374,606,5,611,797,0,0,76.66,185,421,子龍里,NULL
483,601,9,610,769,0,0,79.32,470,131,富台里,NULL
652,604,6,610,787,0,0,77.51,434,170,中寧里,NULL
0,604,6,610,787,0,0,77.51,434,170,中寧里,NULL
728,605,5,610,812,0,0,75.12,407,198,復國里,NULL
85,603,7,610,860,0,0,70.93,398,205,中福里,NULL
0,603,7,610,860,0,0,70.93,398,205,中福里,NULL
1922,607,3,610,816,0,0,74.75,396,211,龍川里,NULL
309,606,4,610,862,0,0,70.77,390,216,新開村,NULL
0,606,4,610,862,0,0,70.77,390,216,新開村,NULL
247,603,7,610,814,0,0,74.94,343,260,龍崗村,NULL
504,606,4,610,766,0,0,79.63,336,270,德政里,NULL
0,606,4,610,766,0,0,79.63,336,270,德政里,NULL
32,602,8,610,837,0,0,72.88,334,268,德化里,NULL
124,602,8,610,789,0,0,77.31,309,293,明翠里,NULL
91,607,3,610,874,0,0,69.79,297,310,大荖里,NULL
0,607,3,610,874,0,0,69.79,297,310,大荖里,NULL
325,608,2,610,817,0,0,74.66,235,373,玉成村,NULL
0,608,2,610,817,0,0,74.66,235,373,玉成村,NULL
27,608,1,609,1161,0,0,52.45,561,47,山外里,NULL
386,603,6,609,904,0,0,67.37,405,198,水里村,NULL
0,603,6,609,904,0,0,67.37,405,198,水里村,NULL
560,601,8,609,1056,0,0,57.67,264,337,楓港村,NULL
0,601,8,609,1056,0,0,57.67,264,337,楓港村,NULL
583,599,10,609,810,0,0,75.19,254,345,崙頂里,NULL
52,601,8,609,957,0,0,63.64,249,352,龍潭村,NULL
0,601,8,609,957,0,0,63.64,249,352,龍潭村,NULL
37,606,3,609,825,0,0,73.82,240,366,庄內里,NULL
93,604,5,609,921,0,0,66.12,202,402,東平里,NULL
295,605,3,608,783,0,0,77.65,471,134,大湖村,NULL
349,604,4,608,839,0,0,72.47,432,172,中平村,NULL
49,605,3,608,1057,0,0,57.52,427,178,國威里,NULL
80,602,6,608,841,0,0,72.29,345,257,福仁里,NULL
0,602,6,608,841,0,0,72.29,345,257,福仁里,NULL
688,599,8,607,829,0,0,73.22,479,120,南勢村,NULL
616,600,7,607,974,0,0,62.32,357,243,大光里,NULL
281,603,4,607,807,0,0,75.22,339,264,新厝里,NULL
151,603,4,607,784,0,0,77.42,319,284,復安村,NULL
385,604,3,607,791,0,0,76.74,256,348,內溝里,NULL
771,602,5,607,766,0,0,79.24,185,417,興化里,NULL
0,602,5,607,766,0,0,79.24,185,417,興化里,NULL
252,602,4,606,724,0,0,83.7,539,63,光明里,NULL
217,602,4,606,761,0,0,79.63,476,126,清泉里,NULL
80,595,11,606,886,0,0,68.4,468,127,康樂村,NULL
53,596,10,606,841,0,0,72.06,439,157,國防里,NULL
0,596,10,606,841,0,0,72.06,439,157,國防里,NULL
299,600,6,606,790,0,0,76.71,405,195,水磜村,NULL
0,600,6,606,790,0,0,76.71,405,195,水磜村,NULL
56,604,2,606,1017,0,0,59.59,357,247,同安村,NULL
0,601,5,606,955,0,0,63.46,354,247,頭社村,NULL
126,601,5,606,817,0,0,74.17,348,253,頂湳里,NULL
2230,600,6,606,811,0,0,74.72,346,254,清泉村,NULL
0,600,6,606,811,0,0,74.72,346,254,清泉村,NULL
134,601,5,606,812,0,0,74.63,336,265,下湳里,NULL
798,592,14,606,841,0,0,72.06,324,268,合和村,NULL
0,592,14,606,841,0,0,72.06,324,268,合和村,NULL
768,601,5,606,861,0,0,70.38,306,295,香山里,NULL
0,601,5,606,861,0,0,70.38,306,295,香山里,NULL
210,602,4,606,822,0,0,73.72,303,299,忠孝村,NULL
101,604,2,606,782,0,0,77.49,292,312,中庸里,NULL
0,604,2,606,782,0,0,77.49,292,312,中庸里,NULL
680,604,2,606,809,0,0,74.91,258,346,港埔村,NULL
110,605,1,606,742,0,0,81.67,245,360,路東里,NULL
0,605,1,606,742,0,0,81.67,245,360,路東里,NULL
276,601,5,606,840,0,0,72.14,206,395,大進村,NULL
0,601,5,606,840,0,0,72.14,206,395,大進村,NULL
358,598,8,606,862,0,0,70.3,162,436,安定里,NULL
459,601,4,605,839,0,0,72.11,569,32,來義村,NULL
0,601,4,605,839,0,0,72.11,569,32,來義村,NULL
1937,599,6,605,814,0,0,74.32,392,207,吉慶里,NULL
15,592,13,605,829,0,0,72.98,375,217,和安村,NULL
0,592,13,605,829,0,0,72.98,375,217,和安村,NULL
272,595,10,605,775,0,0,78.06,374,221,大肚村,NULL
17,594,11,605,882,0,0,68.59,374,220,大田村,NULL
56,601,4,605,764,0,0,79.19,364,237,文化里,NULL
0,601,4,605,764,0,0,79.19,364,237,文化里,NULL
809,600,5,605,800,0,0,75.63,343,257,修仁村,NULL
63,601,4,605,894,0,0,67.67,343,258,建興里,NULL
0,600,5,605,800,0,0,75.63,343,257,修仁村,NULL
0,601,4,605,894,0,0,67.67,343,258,建興里,NULL
502,602,3,605,831,0,0,72.8,339,263,埤麻里,NULL
0,602,3,605,831,0,0,72.8,339,263,埤麻里,NULL
509,600,5,605,914,0,0,66.19,322,278,豐美村,NULL
0,600,5,605,914,0,0,66.19,322,278,豐美村,NULL
285,599,6,605,806,0,0,75.06,317,282,苗豐里,NULL
0,599,6,605,806,0,0,75.06,317,282,苗豐里,NULL
54,602,3,605,944,0,0,64.09,281,321,昌南村,NULL
0,602,3,605,944,0,0,64.09,281,321,昌南村,NULL
867,601,4,605,793,0,0,76.29,251,350,深坑村,NULL
677,599,6,605,779,0,0,77.66,238,361,頂厝村,NULL
122,601,3,604,737,0,0,81.95,508,93,自助里,NULL
200,596,8,604,763,0,0,79.16,364,232,中山里,NULL
0,596,8,604,763,0,0,79.16,364,232,中山里,NULL
182,598,6,604,907,0,0,66.59,361,237,清水村,NULL
0,598,6,604,907,0,0,66.59,361,237,清水村,NULL
61,599,5,604,801,0,0,75.41,340,259,苑東里,NULL
126,597,7,604,825,0,0,73.21,327,270,湖田里,NULL
0,597,7,604,825,0,0,73.21,327,270,湖田里,NULL
460,598,6,604,790,0,0,76.46,320,278,田中里,NULL
0,598,6,604,790,0,0,76.46,320,278,田中里,NULL
590,596,8,604,855,0,0,70.64,279,317,羊林里,NULL
0,596,8,604,855,0,0,70.64,279,317,羊林里,NULL
583,594,10,604,932,0,0,64.81,266,328,溫泉村,NULL
0,594,10,604,932,0,0,64.81,266,328,溫泉村,NULL
382,599,5,604,778,0,0,77.63,240,359,本洲里,NULL
475,598,6,604,780,0,0,77.44,237,361,三川里,NULL
0,598,6,604,780,0,0,77.44,237,361,三川里,NULL
40,596,8,604,975,0,0,61.95,217,379,鎖港里,NULL
239,598,6,604,829,0,0,72.86,213,385,逸仙村,NULL
0,598,6,604,829,0,0,72.86,213,385,逸仙村,NULL
141,594,10,604,903,0,0,66.89,211,383,芳草里,NULL
0,594,10,604,903,0,0,66.89,211,383,芳草里,NULL
321,599,5,604,865,0,0,69.83,195,404,共和村,NULL
0,599,5,604,865,0,0,69.83,195,404,共和村,NULL
662,598,5,603,804,0,0,75,464,134,泰昌里,NULL
307,599,4,603,841,0,0,71.7,429,170,義和村,NULL
741,598,5,603,753,0,0,80.08,279,319,成功里,NULL
0,598,5,603,753,0,0,80.08,279,319,成功里,NULL
165,593,10,603,841,0,0,71.7,254,339,廣興村,NULL
0,593,10,603,841,0,0,71.7,254,339,廣興村,NULL
872,591,12,603,806,0,0,74.81,241,350,龜洞村,NULL
0,591,12,603,806,0,0,74.81,241,350,龜洞村,NULL
0,594,9,603,848,0,0,71.11,223,371,東光村,NULL
483,591,12,603,723,0,0,83.4,173,418,西林村,NULL
331,599,3,602,796,0,0,75.63,574,25,碧候村,NULL
0,599,3,602,796,0,0,75.63,574,25,碧候村,NULL
164,595,7,602,748,0,0,80.48,430,165,南雄里,NULL
0,595,7,602,748,0,0,80.48,430,165,南雄里,NULL
292,593,9,602,834,0,0,72.18,303,290,下坑村,NULL
48,598,4,602,774,0,0,77.78,281,317,龍泉里,NULL
371,594,8,602,896,0,0,67.19,259,335,王功村,NULL
184,597,5,602,778,0,0,77.38,259,338,士林村,NULL
186,589,13,602,827,0,0,72.79,255,334,橫山村,NULL
436,596,6,602,838,0,0,71.84,250,346,新福村,NULL
0,596,6,602,838,0,0,71.84,250,346,新福村,NULL
2,589,13,602,911,0,0,66.08,244,345,蒜東村,NULL
0,589,13,602,911,0,0,66.08,244,345,蒜東村,NULL
538,599,3,602,793,0,0,75.91,217,382,潭頂村,NULL
654,595,6,601,743,0,0,80.89,418,177,南平里,NULL
89,594,7,601,811,0,0,74.11,334,260,泰田里,NULL
661,595,6,601,789,0,0,76.17,310,285,三民里,NULL
151,598,3,601,898,0,0,66.93,303,295,大溪里,NULL
0,598,3,601,898,0,0,66.93,303,295,大溪里,NULL
287,596,5,601,814,0,0,73.83,281,315,東湖村,NULL
202,600,1,601,797,0,0,75.41,280,320,美福村,NULL
2210,597,4,601,862,0,0,69.72,266,331,仁里村,NULL
281,596,5,601,779,0,0,77.15,252,344,NA,NULL
305,593,7,600,756,0,0,79.37,444,149,新興里,NULL
200,599,1,600,759,0,0,79.05,436,163,碇祥里,NULL
220,590,10,600,793,0,0,75.66,410,180,泰安里,NULL
352,596,4,600,835,0,0,71.86,408,188,下湳里,NULL
0,596,4,600,835,0,0,71.86,408,188,下湳里,NULL
438,596,4,600,833,0,0,72.03,393,203,天盛村,NULL
0,596,4,600,833,0,0,72.03,393,203,天盛村,NULL
329,597,3,600,858,0,0,69.93,337,260,竹圍里,NULL
147,589,11,600,748,0,0,80.21,318,271,鹿鳴里,NULL
134,594,6,600,743,0,0,80.75,318,276,萬豐村,NULL
0,589,11,600,748,0,0,80.21,318,271,鹿鳴里,NULL
0,594,6,600,743,0,0,80.75,318,276,萬豐村,NULL
2209,590,10,600,802,0,0,74.81,305,285,仁里村,NULL
60,591,9,600,906,0,0,66.23,285,306,草店里,NULL
0,591,9,600,906,0,0,66.23,285,306,草店里,NULL
868,594,6,600,793,0,0,75.66,251,343,深坑村,NULL
523,594,6,600,820,0,0,73.17,238,356,豐隆村,NULL
0,594,6,600,820,0,0,73.17,238,356,豐隆村,NULL
204,597,3,600,805,0,0,74.53,194,403,彭城里,NULL
0,597,3,600,805,0,0,74.53,194,403,彭城里,NULL
316,587,12,599,771,0,0,77.69,490,97,大忠里,NULL
52,589,10,599,870,0,0,68.85,474,115,南榮里,NULL
33,596,3,599,833,0,0,71.91,438,158,主學里,NULL
29,595,4,599,845,0,0,70.89,437,158,主計里,NULL
0,595,4,599,845,0,0,70.89,437,158,主計里,NULL
1848,598,1,599,857,0,0,69.89,395,203,蕃薯里,NULL
0,598,1,599,857,0,0,69.89,395,203,蕃薯里,NULL
303,598,1,599,825,0,0,72.61,355,243,崁腳村,NULL
0,598,1,599,825,0,0,72.61,355,243,崁腳村,NULL
501,590,9,599,1681,0,0,35.63,354,236,石頭里,NULL
268,596,3,599,798,0,0,75.06,345,251,茄苳里,NULL
0,596,3,599,798,0,0,75.06,345,251,茄苳里,NULL
178,596,3,599,1021,0,0,58.67,335,261,五塊村,NULL
0,596,3,599,1021,0,0,58.67,335,261,五塊村,NULL
0,591,8,599,820,0,0,73.05,279,312,岸腳村,NULL
72,598,1,599,781,0,0,76.7,277,321,北城里,NULL
0,598,1,599,781,0,0,76.7,277,321,北城里,NULL
0,594,5,599,801,0,0,74.78,267,327,人和村,NULL
6,592,7,599,792,0,0,75.63,236,356,永春村,NULL
0,592,7,599,792,0,0,75.63,236,356,永春村,NULL
339,594,5,599,789,0,0,75.92,207,387,西昌村,NULL
0,594,5,599,789,0,0,75.92,207,387,西昌村,NULL
29,594,5,599,801,0,0,74.78,149,445,菜寮村,NULL
0,594,5,599,801,0,0,74.78,149,445,菜寮村,NULL
0,592,6,598,1054,0,0,56.74,560,32,東富村,NULL
135,591,7,598,821,0,0,72.84,464,127,曲溪里,NULL
205,591,7,598,813,0,0,73.55,265,326,復興村,NULL
808,592,6,598,796,0,0,75.13,258,334,大園村,NULL
0,592,6,598,796,0,0,75.13,258,334,大園村,NULL
566,594,4,598,801,0,0,74.66,249,345,太平里,NULL
184,589,9,598,845,0,0,70.77,223,366,玉田村,NULL
44,593,4,597,827,0,0,72.19,434,159,月眉村,NULL
454,589,8,597,834,0,0,71.58,314,275,信蚵村,NULL
125,594,3,597,762,0,0,78.35,301,293,潛園里,NULL
0,594,3,597,762,0,0,78.35,301,293,潛園里,NULL
216,592,5,597,776,0,0,76.93,291,301,南和村,NULL
0,593,4,597,788,0,0,75.76,260,333,粗窟村,NULL
403,594,3,597,774,0,0,77.13,242,352,港墘村,NULL
0,594,3,597,774,0,0,77.13,242,352,港墘村,NULL
188,591,5,596,913,0,0,65.28,491,100,桃源村,NULL
0,591,5,596,913,0,0,65.28,491,100,桃源村,NULL
414,590,6,596,846,0,0,70.45,444,146,望美村,NULL
373,590,6,596,788,0,0,75.63,415,175,廣興村,NULL
2019,593,3,596,796,0,0,74.87,353,240,楓樹村,NULL
964,589,7,596,780,0,0,76.41,304,285,三和村,NULL
0,589,7,596,780,0,0,76.41,304,285,三和村,NULL
302,586,10,596,814,0,0,73.22,280,306,隆本村,NULL
288,591,5,596,754,0,0,79.05,244,347,忠興村,NULL
0,591,5,596,754,0,0,79.05,244,347,忠興村,NULL
398,594,2,596,757,0,0,78.73,210,384,瓦磘村,NULL
309,592,4,596,795,0,0,74.97,198,394,渡頭村,NULL
42,592,3,595,1087,0,0,54.74,578,14,三山里,NULL
0,592,3,595,1087,0,0,54.74,578,14,三山里,NULL
720,590,5,595,810,0,0,73.46,490,100,復興里,NULL
87,588,7,595,809,0,0,73.55,459,129,佳林村,NULL
0,588,7,595,809,0,0,73.55,459,129,佳林村,NULL
2128,590,5,595,808,0,0,73.64,374,216,新庄村,NULL
0,590,5,595,808,0,0,73.64,374,216,新庄村,NULL
436,592,3,595,800,0,0,74.38,345,247,永樂村,NULL
0,592,3,595,800,0,0,74.38,345,247,永樂村,NULL
159,591,4,595,815,0,0,73.01,299,292,埤前村,NULL
0,591,4,595,815,0,0,73.01,299,292,埤前村,NULL
310,590,5,595,844,0,0,70.5,289,301,月眉村,NULL
0,590,5,595,844,0,0,70.5,289,301,月眉村,NULL
119,593,2,595,772,0,0,77.07,275,318,劉厝里,NULL
59,589,6,595,809,0,0,73.55,264,325,安福里,NULL
641,591,4,595,759,0,0,78.39,218,373,永源村,NULL
406,591,4,595,742,0,0,80.19,123,468,安西里,NULL
0,591,4,595,742,0,0,80.19,123,468,安西里,NULL
59,592,2,594,695,0,0,85.47,551,41,建功里,NULL
8,591,3,594,838,0,0,70.88,446,145,民心里,NULL
0,591,3,594,838,0,0,70.88,446,145,民心里,NULL
1147,588,6,594,1789,0,0,33.2,421,167,中興里,NULL
311,588,6,594,763,0,0,77.85,404,184,館中村,NULL
120,588,6,594,780,0,0,76.15,378,210,協和里,NULL
17,591,3,594,944,0,0,62.92,372,219,崙後村,NULL
289,593,1,594,794,0,0,74.81,328,265,竹園村,NULL
331,592,2,594,785,0,0,75.67,321,271,永安村,NULL
167,587,7,594,1080,0,0,55,302,285,林東村,NULL
0,587,7,594,1080,0,0,55,302,285,林東村,NULL
66,589,5,594,726,0,0,81.82,267,322,尚義里,NULL
1831,589,5,594,792,0,0,75,264,325,插角里,NULL
0,589,5,594,792,0,0,75,264,325,插角里,NULL
610,580,14,594,963,0,0,61.68,231,349,四溝里,NULL
0,580,14,594,963,0,0,61.68,231,349,四溝里,NULL
1841,588,6,594,819,0,0,72.53,216,372,竹崙里,NULL
871,590,4,594,785,0,0,75.67,197,393,田中村,NULL
0,590,4,594,785,0,0,75.67,197,393,田中村,NULL
487,588,6,594,787,0,0,75.48,183,405,檨林村,NULL
41,590,3,593,1176,0,0,50.43,571,19,官嶼里,NULL
0,590,3,593,1176,0,0,50.43,571,19,官嶼里,NULL
110,587,6,593,806,0,0,73.57,415,172,仁正里,NULL
0,587,6,593,806,0,0,73.57,415,172,仁正里,NULL
904,590,3,593,799,0,0,74.22,272,318,天興里,NULL
482,590,3,593,727,0,0,81.57,164,426,三德村,NULL
0,590,3,593,727,0,0,81.57,164,426,三德村,NULL
181,585,7,592,836,0,0,70.81,470,115,林榮里,NULL
0,585,7,592,836,0,0,70.81,470,115,林榮里,NULL
102,590,2,592,736,0,0,80.43,457,133,榮樂里,NULL
439,581,11,592,708,0,0,83.62,316,265,大德里,NULL
0,581,11,592,708,0,0,83.62,316,265,大德里,NULL
437,586,6,592,817,0,0,72.46,279,307,溪洲村,NULL
2205,586,6,592,856,0,0,69.16,278,308,福隆村,NULL
449,585,7,592,769,0,0,76.98,255,330,建功村,NULL
32,589,2,591,813,0,0,72.69,386,203,御史里,NULL
1917,587,4,591,776,0,0,76.16,372,215,龍潭里,NULL
0,587,4,591,776,0,0,76.16,372,215,龍潭里,NULL
135,585,6,591,824,0,0,71.72,312,273,下湳里,NULL
286,585,6,591,834,0,0,70.86,307,278,上新里,NULL
210,582,9,591,820,0,0,72.07,301,281,南寮里,NULL
130,590,1,591,846,0,0,69.86,291,299,廣林里,NULL
428,585,6,591,765,0,0,77.25,230,355,溪美里,NULL
275,582,9,591,956,0,0,61.82,165,417,番溝里,NULL
0,582,9,591,956,0,0,61.82,165,417,番溝里,NULL
117,584,7,591,789,0,0,74.9,114,470,舊營里,NULL
0,584,7,591,789,0,0,74.9,114,470,舊營里,NULL
795,587,3,590,723,0,0,81.6,539,48,中正里,NULL
0,587,3,590,723,0,0,81.6,539,48,中正里,NULL
125,579,11,590,794,0,0,74.31,452,127,春安里,NULL
0,579,11,590,794,0,0,74.31,452,127,春安里,NULL
812,590,0,590,797,0,0,74.03,339,251,國泰里,NULL
136,586,4,590,755,0,0,78.15,309,277,松柏里,NULL
1908,587,3,590,746,0,0,79.09,286,301,民安里,NULL
0,587,3,590,746,0,0,79.09,286,301,民安里,NULL
415,586,4,590,734,0,0,80.38,279,307,舊港村,NULL
95,582,8,590,847,0,0,69.66,237,345,南平里,NULL
241,588,2,590,750,0,0,78.67,162,426,溪埔村,NULL
161,587,2,589,873,0,0,67.47,472,115,大王村,NULL
98,582,7,589,830,0,0,70.96,352,230,田心里,NULL
103,583,6,589,844,0,0,69.79,324,259,新興里,NULL
497,586,3,589,767,0,0,76.79,309,277,埤霞村,NULL
0,586,3,589,767,0,0,76.79,309,277,埤霞村,NULL
116,585,4,589,760,0,0,77.5,304,281,清水里,NULL
25,582,7,589,880,0,0,66.93,264,318,六腳村,NULL
785,583,6,589,735,0,0,80.14,264,319,三甲村,NULL
0,582,7,589,880,0,0,66.93,264,318,六腳村,NULL
0,583,6,589,735,0,0,80.14,264,319,三甲村,NULL
643,581,8,589,780,0,0,75.51,217,364,義仁村,NULL
40,578,11,589,749,0,0,78.64,190,388,鹽樹村,NULL
227,582,7,589,769,0,0,76.59,177,405,井腳村,NULL
212,584,5,589,744,0,0,79.17,168,416,翠屏村,NULL
0,582,6,588,1009,0,0,58.28,536,46,立山村,NULL
2225,581,7,588,790,0,0,74.43,331,250,五湖村,NULL
140,586,2,588,824,0,0,71.36,328,258,南興里,NULL
448,585,3,588,871,0,0,67.51,306,279,環湖村,NULL
0,585,3,588,871,0,0,67.51,306,279,環湖村,NULL
305,577,11,588,802,0,0,73.32,275,302,新厝村,NULL
0,577,11,588,802,0,0,73.32,275,302,新厝村,NULL
539,585,3,588,792,0,0,74.24,267,318,潭頂村,NULL
273,581,7,588,784,0,0,75,265,316,三村里,NULL
0,581,7,588,784,0,0,75,265,316,三村里,NULL
470,585,3,588,752,0,0,78.19,192,393,新莊村,NULL
222,574,13,587,968,0,0,60.64,456,118,舞鶴村,NULL
0,574,13,587,968,0,0,60.64,456,118,舞鶴村,NULL
291,586,1,587,730,0,0,80.41,447,139,新興村,NULL
93,585,2,587,786,0,0,74.68,393,192,兆連里,NULL
0,585,2,587,786,0,0,74.68,393,192,兆連里,NULL
395,583,4,587,869,0,0,67.55,298,285,緞繻村,NULL
81,579,8,587,782,0,0,75.06,267,312,山脚里,NULL
253,584,3,587,709,0,0,82.79,258,326,中原里,NULL
0,584,3,587,709,0,0,82.79,258,326,中原里,NULL
206,579,8,587,791,0,0,74.21,257,322,復興村,NULL
2083,583,4,587,724,0,0,81.08,240,343,嘉寶村,NULL
0,583,4,587,724,0,0,81.08,240,343,嘉寶村,NULL
299,582,5,587,801,0,0,73.28,210,372,宮後村,NULL
136,580,6,586,723,0,0,81.05,452,128,田新里,NULL
119,579,7,586,954,0,0,61.43,431,148,瑞隆村,NULL
0,579,7,586,954,0,0,61.43,431,148,瑞隆村,NULL
25,582,4,586,797,0,0,73.53,338,244,武曲里,NULL
346,579,7,586,812,0,0,72.17,314,265,延正里,NULL
56,582,4,586,784,0,0,74.74,304,278,內東村,NULL
0,582,4,586,784,0,0,74.74,304,278,內東村,NULL
874,583,3,586,760,0,0,77.11,223,360,埤頭村,NULL
7,580,5,585,786,0,0,74.43,563,17,民意里,NULL
3,576,9,585,770,0,0,75.97,501,75,民勤里,NULL
437,577,8,585,748,0,0,78.21,369,208,崙峯里,NULL
2243,580,5,585,776,0,0,75.39,347,233,大鵬村,NULL
0,581,4,585,882,0,0,66.33,286,295,順安村,NULL
963,580,5,585,767,0,0,76.27,285,295,武威村,NULL
0,580,5,585,767,0,0,76.27,285,295,武威村,NULL
283,578,7,585,820,0,0,71.34,284,294,新街村,NULL
705,583,2,585,729,0,0,80.25,283,300,北門里,NULL
296,582,3,585,934,0,0,62.63,263,319,大有村,NULL
97,580,5,585,741,0,0,78.95,224,356,福松里,NULL
0,580,5,585,741,0,0,78.95,224,356,福松里,NULL
304,583,2,585,771,0,0,75.88,217,366,永寧里,NULL
24,581,4,585,815,0,0,71.78,166,415,東興村,NULL
0,581,4,585,815,0,0,71.78,166,415,東興村,NULL
1,581,3,584,871,0,0,67.05,420,161,文化里,NULL
0,581,3,584,871,0,0,67.05,420,161,文化里,NULL
322,575,9,584,832,0,0,70.19,322,253,溪尾村,NULL
0,575,9,584,832,0,0,70.19,322,253,溪尾村,NULL
164,577,7,584,780,0,0,74.87,319,258,新建里,NULL
103,578,6,584,787,0,0,74.21,317,261,北杏里,NULL
0,578,6,584,787,0,0,74.21,317,261,北杏里,NULL
530,579,5,584,752,0,0,77.66,295,284,黃竹里,NULL
0,579,5,584,752,0,0,77.66,295,284,黃竹里,NULL
0,580,4,584,848,0,0,68.87,291,289,中和村,NULL
578,577,7,584,848,0,0,68.87,285,292,福興村,NULL
745,575,9,584,782,0,0,74.68,276,299,協和村,NULL
25,571,13,584,918,0,0,63.62,251,320,興龍村,NULL
0,571,13,584,918,0,0,63.62,251,320,興龍村,NULL
48,578,6,584,983,0,0,59.41,224,354,嘉隆村,NULL
551,578,6,584,812,0,0,71.92,212,366,新莊村,NULL
0,578,6,584,812,0,0,71.92,212,366,新莊村,NULL
65,582,2,584,770,0,0,75.84,208,374,博厚里,NULL
0,582,2,584,770,0,0,75.84,208,374,博厚里,NULL
237,579,5,584,826,0,0,70.7,199,380,柴林村,NULL
0,579,5,584,826,0,0,70.7,199,380,柴林村,NULL
319,576,7,583,772,0,0,75.52,535,41,寒溪村,NULL
0,576,7,583,772,0,0,75.52,535,41,寒溪村,NULL
371,577,6,583,781,0,0,74.65,390,187,彰雅村,NULL
5,578,5,583,729,0,0,79.97,334,244,孔門里,NULL
0,578,5,583,729,0,0,79.97,334,244,孔門里,NULL
272,579,4,583,805,0,0,72.42,296,283,三角里,NULL
0,579,4,583,805,0,0,72.42,296,283,三角里,NULL
50,579,4,583,832,0,0,70.07,274,305,宣信里,NULL
300,576,7,583,756,0,0,77.12,259,317,萬年里,NULL
0,576,7,583,756,0,0,77.12,259,317,萬年里,NULL
291,578,5,583,822,0,0,70.92,208,370,王爺村,NULL
0,578,5,583,822,0,0,70.92,208,370,王爺村,NULL
238,582,1,583,865,0,0,67.4,149,433,林腳村,NULL
0,582,1,583,865,0,0,67.4,149,433,林腳村,NULL
214,577,5,582,1054,0,0,55.22,545,32,紅葉村,NULL
0,577,5,582,1054,0,0,55.22,545,32,紅葉村,NULL
301,572,10,582,705,0,0,82.55,457,115,大林村,NULL
0,572,10,582,705,0,0,82.55,457,115,大林村,NULL
125,576,6,582,910,0,0,63.96,357,219,福原村,NULL
462,579,3,582,765,0,0,76.08,306,273,三和村,NULL
0,579,3,582,765,0,0,76.08,306,273,三和村,NULL
477,576,6,582,802,0,0,72.57,304,272,怡然村,NULL
0,576,6,582,802,0,0,72.57,304,272,怡然村,NULL
162,580,2,582,758,0,0,76.78,281,299,小西里,NULL
0,580,2,582,758,0,0,76.78,281,299,小西里,NULL
0,576,6,582,961,0,0,60.56,245,331,瑞豐村,NULL
152,577,5,582,972,0,0,59.88,240,337,蔡厝村,NULL
0,577,5,582,972,0,0,59.88,240,337,蔡厝村,NULL
209,580,2,582,814,0,0,71.5,228,352,永鎮村,NULL
0,580,2,582,814,0,0,71.5,228,352,永鎮村,NULL
28,580,2,582,817,0,0,71.24,143,437,古林村,NULL
0,580,2,582,817,0,0,71.24,143,437,古林村,NULL
501,571,10,581,858,0,0,67.72,349,222,西城村,NULL
0,571,10,581,858,0,0,67.72,349,222,西城村,NULL
757,576,5,581,756,0,0,76.85,305,271,興中里,NULL
0,576,5,581,756,0,0,76.85,305,271,興中里,NULL
525,576,5,581,857,0,0,67.79,283,293,竹林村,NULL
0,576,5,581,857,0,0,67.79,283,293,竹林村,NULL
287,574,7,581,765,0,0,75.95,180,394,中社村,NULL
196,574,6,580,707,0,0,82.04,556,18,碇和里,NULL
0,571,9,580,824,0,0,70.39,472,99,玉峰村,NULL
267,573,7,580,736,0,0,78.8,330,243,大湖里,NULL
0,573,7,580,736,0,0,78.8,330,243,大湖里,NULL
480,570,10,580,778,0,0,74.55,307,263,中興里,NULL
0,570,10,580,778,0,0,74.55,307,263,中興里,NULL
11,572,8,580,813,0,0,71.34,224,348,菁豊村,NULL
0,572,8,580,813,0,0,71.34,224,348,菁豊村,NULL
418,579,1,580,771,0,0,75.23,164,415,中洲村,NULL
8,572,7,579,882,0,0,65.65,394,178,寶桑里,NULL
0,572,7,579,882,0,0,65.65,394,178,寶桑里,NULL
158,578,1,579,745,0,0,77.72,391,187,城東里,NULL
0,578,1,579,745,0,0,77.72,391,187,城東里,NULL
2204,570,9,579,855,0,0,67.72,311,259,福隆村,NULL
69,576,3,579,756,0,0,76.59,292,284,西勢里,NULL
306,577,2,579,786,0,0,73.66,205,372,松安里,NULL
40,571,8,579,865,0,0,66.94,195,376,下揖村,NULL
0,571,8,579,865,0,0,66.94,195,376,下揖村,NULL
136,572,6,578,781,0,0,74.01,369,203,西榮里,NULL
0,572,6,578,781,0,0,74.01,369,203,西榮里,NULL
100,572,6,578,729,0,0,79.29,353,219,明德里,NULL
0,572,6,578,729,0,0,79.29,353,219,明德里,NULL
2135,574,4,578,751,0,0,76.96,342,232,錫板村,NULL
0,574,4,578,751,0,0,76.96,342,232,錫板村,NULL
443,576,2,578,779,0,0,74.2,333,243,久安里,NULL
264,568,10,578,810,0,0,71.36,227,341,大屯村,NULL
0,568,10,578,810,0,0,71.36,227,341,大屯村,NULL
112,572,6,578,802,0,0,72.07,222,350,頂寮里,NULL
0,572,6,578,802,0,0,72.07,222,350,頂寮里,NULL
29,573,5,578,793,0,0,72.89,187,386,烏樹村,NULL
0,573,5,578,793,0,0,72.89,187,386,烏樹村,NULL
209,569,8,577,806,0,0,71.59,432,137,信義里,NULL
0,569,8,577,806,0,0,71.59,432,137,信義里,NULL
311,571,6,577,714,0,0,80.81,404,167,深井村,NULL
0,571,6,577,714,0,0,80.81,404,167,深井村,NULL
163,575,2,577,836,0,0,69.02,379,196,泰和村,NULL
464,568,9,577,846,0,0,68.2,287,281,望明村,NULL
70,576,1,577,805,0,0,71.68,259,317,東壁村,NULL
0,576,1,577,805,0,0,71.68,259,317,東壁村,NULL
236,574,3,577,886,0,0,65.12,131,443,山腳村,NULL
0,574,3,577,886,0,0,65.12,131,443,山腳村,NULL
194,574,2,576,882,0,0,65.31,523,51,北富村,NULL
0,574,2,576,882,0,0,65.31,523,51,北富村,NULL
29,571,5,576,716,0,0,80.45,417,154,上苗里,NULL
63,562,14,576,864,0,0,66.67,370,192,石門村,NULL
229,572,4,576,929,0,0,62,341,231,高原村,NULL
0,572,4,576,929,0,0,62,341,231,高原村,NULL
608,572,4,576,827,0,0,69.65,323,249,西埔村,NULL
0,572,4,576,827,0,0,69.65,323,249,西埔村,NULL
303,572,4,576,789,0,0,73,250,322,福德村,NULL
176,571,5,576,730,0,0,78.9,204,367,六巷村,NULL
0,571,5,576,730,0,0,78.9,204,367,六巷村,NULL
0,574,2,576,856,0,0,67.29,187,387,漁光村,NULL
142,570,5,575,844,0,0,68.13,441,129,大同村,NULL
75,570,5,575,747,0,0,76.97,330,240,檜村里,NULL
559,569,6,575,771,0,0,74.58,324,245,東榮里,NULL
5,573,2,575,742,0,0,77.49,317,256,成功里,NULL
0,573,2,575,742,0,0,77.49,317,256,成功里,NULL
359,572,3,575,822,0,0,69.95,304,268,仁愛村,NULL
0,572,3,575,822,0,0,69.95,304,268,仁愛村,NULL
118,569,6,575,821,0,0,70.04,279,290,興南里,NULL
337,571,4,575,775,0,0,74.19,266,305,中和村,NULL
0,571,4,575,775,0,0,74.19,266,305,中和村,NULL
545,569,6,575,812,0,0,70.81,261,308,陸嘉村,NULL
0,569,6,575,812,0,0,70.81,261,308,陸嘉村,NULL
128,566,9,575,819,0,0,70.21,252,314,安溪里,NULL
631,570,5,575,813,0,0,70.73,242,328,新厝村,NULL
863,572,3,575,744,0,0,77.28,228,344,南花村,NULL
297,569,6,575,785,0,0,73.25,215,354,成興村,NULL
498,570,5,575,750,0,0,76.67,204,366,下廍里,NULL
421,572,2,574,819,0,0,70.09,520,52,人和村,NULL
406,567,7,574,799,0,0,71.84,366,201,萬興里,NULL
0,567,7,574,799,0,0,71.84,366,201,萬興里,NULL
699,566,7,573,1008,0,0,56.85,460,106,梨山村,NULL
84,568,5,573,739,0,0,77.54,434,134,仙水里,NULL
282,567,6,573,766,0,0,74.8,315,252,新厝里,NULL
761,572,1,573,826,0,0,69.37,314,258,仁德村,NULL
345,567,6,573,841,0,0,68.13,289,278,延正里,NULL
39,573,0,573,832,0,0,68.87,235,338,河東里,NULL
183,567,6,573,811,0,0,70.65,232,335,士林村,NULL
164,567,6,573,1008,0,0,56.85,190,377,箔子村,NULL
0,567,6,573,1008,0,0,56.85,190,377,箔子村,NULL
625,566,7,573,769,0,0,74.51,179,387,拷潭村,NULL
423,568,4,572,770,0,0,74.29,523,45,地利村,NULL
0,568,4,572,770,0,0,74.29,523,45,地利村,NULL
152,569,3,572,815,0,0,70.18,479,90,佳義村,NULL
0,569,3,572,815,0,0,70.18,479,90,佳義村,NULL
241,563,9,572,982,0,0,58.25,418,145,觀音里,NULL
264,568,4,572,770,0,0,74.29,352,216,大山里,NULL
724,567,5,572,787,0,0,72.68,329,238,崙雅村,NULL
0,567,5,572,787,0,0,72.68,329,238,崙雅村,NULL
397,567,5,572,727,0,0,78.68,314,253,信義里,NULL
0,567,5,572,727,0,0,78.68,314,253,信義里,NULL
8,568,4,572,891,0,0,64.2,298,270,光復里,NULL
1287,567,5,572,761,0,0,75.16,176,391,塗潭里,NULL
0,567,5,572,761,0,0,75.16,176,391,塗潭里,NULL
130,570,2,572,773,0,0,74,144,426,竹埔里,NULL
0,570,2,572,773,0,0,74,144,426,竹埔里,NULL
183,566,5,571,721,0,0,79.2,451,115,流東里,NULL
153,565,6,571,825,0,0,69.21,415,150,豐坪村,NULL
0,565,6,571,825,0,0,69.21,415,150,豐坪村,NULL
117,568,3,571,810,0,0,70.49,362,206,福源里,NULL
0,568,3,571,810,0,0,70.49,362,206,福源里,NULL
129,567,4,571,795,0,0,71.82,326,241,內島里,NULL
0,567,4,571,795,0,0,71.82,326,241,內島里,NULL
265,562,9,571,797,0,0,71.64,315,247,大山里,NULL
0,565,6,571,873,0,0,65.41,308,257,鯉魚里,NULL
235,566,5,571,750,0,0,76.13,290,276,浸水里,NULL
2108,566,5,571,763,0,0,74.84,279,287,中民村,NULL
0,566,5,571,763,0,0,74.84,279,287,中民村,NULL
345,568,3,571,708,0,0,80.65,251,317,岡山里,NULL
79,567,4,571,838,0,0,68.14,246,321,石廟里,NULL
296,568,3,571,828,0,0,68.96,241,327,鯤鯓里,NULL
2112,568,3,571,756,0,0,75.53,235,333,格頭村,NULL
0,568,3,571,756,0,0,75.53,235,333,格頭村,NULL
3,566,5,571,776,0,0,73.58,194,372,侯伯村,NULL
0,561,9,570,977,0,0,58.34,537,24,卓清村,NULL
456,565,5,570,817,0,0,69.77,524,41,達邦村,NULL
0,565,5,570,817,0,0,69.77,524,41,達邦村,NULL
918,568,2,570,708,0,0,80.51,511,57,忠義里,NULL
0,568,2,570,708,0,0,80.51,511,57,忠義里,NULL
411,566,4,570,699,0,0,81.55,429,137,信義里,NULL
455,559,11,570,729,0,0,78.19,283,276,梅林里,NULL
265,563,7,570,747,0,0,76.31,243,320,大埤村,NULL
0,563,7,570,747,0,0,76.31,243,320,大埤村,NULL
354,568,2,570,735,0,0,77.55,240,328,麟蹄村,NULL
162,564,6,570,778,0,0,73.26,164,400,七星村,NULL
0,564,6,570,778,0,0,73.26,164,400,七星村,NULL
321,565,5,570,776,0,0,73.45,139,426,龍山村,NULL
289,568,1,569,714,0,0,79.69,424,144,沙坑村,NULL
157,564,5,569,802,0,0,70.95,380,184,池南村,NULL
0,564,5,569,802,0,0,70.95,380,184,池南村,NULL
126,569,0,569,774,0,0,73.51,344,225,龍肚里,NULL
444,566,3,569,714,0,0,79.69,329,237,平和里,NULL
0,566,3,569,714,0,0,79.69,329,237,平和里,NULL
104,562,7,569,757,0,0,75.17,305,257,新建里,NULL
0,562,7,569,757,0,0,75.17,305,257,新建里,NULL
97,567,2,569,780,0,0,72.95,298,269,寺前里,NULL
0,567,2,569,780,0,0,72.95,298,269,寺前里,NULL
0,565,4,569,751,0,0,75.77,280,285,上德村,NULL
26,563,6,569,777,0,0,73.23,271,292,新威村,NULL
0,563,6,569,777,0,0,73.23,271,292,新威村,NULL
127,559,10,569,770,0,0,73.9,254,305,堀頭里,NULL
0,559,10,569,770,0,0,73.9,254,305,堀頭里,NULL
171,564,5,569,766,0,0,74.28,232,332,竹文里,NULL
244,564,5,569,821,0,0,69.31,202,362,溪墘村,NULL
0,564,5,569,821,0,0,69.31,202,362,溪墘村,NULL
0,557,11,568,942,0,0,60.3,524,33,古風村,NULL
150,567,1,568,743,0,0,76.45,521,46,北葉村,NULL
0,567,1,568,743,0,0,76.45,521,46,北葉村,NULL
386,563,5,568,679,0,0,83.65,479,84,西湖村,NULL
64,561,7,568,830,0,0,68.43,439,122,石門村,NULL
420,562,6,568,856,0,0,66.36,431,131,東埔村,NULL
0,562,6,568,856,0,0,66.36,431,131,東埔村,NULL
227,561,7,568,706,0,0,80.45,375,186,福丘里,NULL
5,565,3,568,871,0,0,65.21,283,282,啟明里,NULL
0,565,3,568,871,0,0,65.21,283,282,啟明里,NULL
125,563,5,568,801,0,0,70.91,261,302,五北里,NULL
238,558,10,568,827,0,0,68.68,243,315,湖東村,NULL
0,558,10,568,827,0,0,68.68,243,315,湖東村,NULL
566,565,3,568,704,0,0,80.68,230,335,江山村,NULL
479,564,4,568,745,0,0,76.24,221,343,興農里,NULL
0,564,4,568,745,0,0,76.24,221,343,興農里,NULL
484,563,5,568,730,0,0,77.81,205,358,西林村,NULL
0,560,8,568,784,0,0,72.45,165,395,溪洲村,NULL
232,557,10,567,869,0,0,65.25,399,158,啟模里,NULL
249,567,0,567,776,0,0,73.07,365,202,南龍里,NULL
316,562,5,567,712,0,0,79.63,334,228,中盛村,NULL
0,562,5,567,712,0,0,79.63,334,228,中盛村,NULL
122,565,2,567,783,0,0,72.41,325,240,穎川里,NULL
3,563,4,567,739,0,0,76.73,305,258,順天里,NULL
127,563,4,567,766,0,0,74.02,231,332,富田村,NULL
254,562,5,567,791,0,0,71.68,221,341,八寶村,NULL
0,562,5,567,791,0,0,71.68,221,341,八寶村,NULL
181,561,6,567,787,0,0,72.05,213,348,萬全村,NULL
0,561,6,567,787,0,0,72.05,213,348,萬全村,NULL
316,565,2,567,773,0,0,73.35,210,355,尚武村,NULL
0,565,2,567,773,0,0,73.35,210,355,尚武村,NULL
694,561,6,567,731,0,0,77.56,203,358,新樹里,NULL
17,564,2,566,952,0,0,59.45,535,29,安美村,NULL
2224,560,6,566,718,0,0,78.83,363,197,五湖村,NULL
143,560,6,566,801,0,0,70.66,345,215,振寮里,NULL
0,560,6,566,801,0,0,70.66,345,215,振寮里,NULL
150,558,8,566,743,0,0,76.18,339,219,安仁里,NULL
0,558,8,566,743,0,0,76.18,339,219,安仁里,NULL
109,555,11,566,719,0,0,78.72,248,307,功科里,NULL
0,555,11,566,719,0,0,78.72,248,307,功科里,NULL
68,563,3,566,802,0,0,70.57,242,321,保吉村,NULL
0,557,9,566,799,0,0,70.84,221,336,美豐村,NULL
324,561,5,566,828,0,0,68.36,217,344,大同村,NULL
0,561,5,566,828,0,0,68.36,217,344,大同村,NULL
15,559,6,565,829,0,0,68.15,352,207,成功里,NULL
0,559,6,565,829,0,0,68.15,352,207,成功里,NULL
472,558,7,565,751,0,0,75.23,298,260,湳底里,NULL
0,558,7,565,751,0,0,75.23,298,260,湳底里,NULL
123,558,7,565,731,0,0,77.29,290,268,湖山里,NULL
143,559,6,565,787,0,0,71.79,269,290,北溪里,NULL
0,559,6,565,787,0,0,71.79,269,290,北溪里,NULL
504,556,9,565,732,0,0,77.19,265,291,港尾村,NULL
92,556,9,565,724,0,0,78.04,262,294,龍山里,NULL
0,556,9,565,724,0,0,78.04,262,294,龍山里,NULL
338,560,5,565,729,0,0,77.5,244,316,平和村,NULL
0,560,5,565,729,0,0,77.5,244,316,平和村,NULL
830,562,3,565,724,0,0,78.04,227,335,大潭村,NULL
564,559,6,565,719,0,0,78.58,222,337,溪寮村,NULL
97,559,6,565,890,0,0,63.48,218,341,西平里,NULL
229,560,5,565,699,0,0,80.83,140,420,龍目村,NULL
494,558,6,564,834,0,0,67.63,460,98,羅浮村,NULL
0,558,6,564,834,0,0,67.63,460,98,羅浮村,NULL
326,558,6,564,732,0,0,77.05,424,134,石墻村,NULL
206,558,6,564,807,0,0,69.89,390,168,水社村,NULL
0,558,6,564,807,0,0,69.89,390,168,水社村,NULL
80,557,7,564,805,0,0,70.06,333,224,東門里,NULL
112,563,1,564,751,0,0,75.1,325,238,內湖里,NULL
463,561,3,564,784,0,0,71.94,274,287,北和村,NULL
0,561,3,564,784,0,0,71.94,274,287,北和村,NULL
364,557,7,564,982,0,0,57.43,218,339,新街村,NULL
0,557,7,564,982,0,0,57.43,218,339,新街村,NULL
446,558,6,564,707,0,0,79.77,217,341,赤崁村,NULL
84,558,6,564,810,0,0,69.63,186,372,崁後里,NULL
0,558,6,564,810,0,0,69.63,186,372,崁後里,NULL
393,558,6,564,770,0,0,73.25,143,415,龍泉里,NULL
0,558,6,564,770,0,0,73.25,143,415,龍泉里,NULL
323,557,6,563,737,0,0,76.39,453,104,義興村、嘉樂村,NULL
0,557,6,563,737,0,0,76.39,453,104,義興村、嘉樂村,NULL
1235,555,8,563,724,0,0,77.76,401,154,學府里,NULL
179,558,5,563,778,0,0,72.37,336,222,大忠村,NULL
91,560,3,563,821,0,0,68.57,313,247,上舘里,NULL
149,554,9,563,722,0,0,77.98,256,298,崗山村,NULL
0,554,9,563,722,0,0,77.98,256,298,崗山村,NULL
275,557,6,563,761,0,0,73.98,253,304,六甲村,NULL
252,559,4,563,816,0,0,69,250,309,冬山村,NULL
0,559,4,563,816,0,0,69,250,309,冬山村,NULL
14,560,3,563,752,0,0,74.87,199,361,墨林村,NULL
0,560,3,563,752,0,0,74.87,199,361,墨林村,NULL
123,560,3,563,795,0,0,70.82,162,398,下中里,NULL
0,560,3,563,795,0,0,70.82,162,398,下中里,NULL
254,561,1,562,686,0,0,81.92,501,60,光華里,NULL
233,553,9,562,826,0,0,68.04,430,123,啟模里,NULL
1367,550,12,562,747,0,0,75.23,236,314,指南里,NULL
192,556,6,562,908,0,0,61.89,228,328,崙仔村,NULL
0,556,6,562,908,0,0,61.89,228,328,崙仔村,NULL
339,554,7,561,737,0,0,76.12,454,100,桃山村,NULL
10,558,3,561,858,0,0,65.38,405,153,海豐村,NULL
628,559,2,561,1028,0,0,54.57,384,175,天福村,NULL
0,559,2,561,1028,0,0,54.57,384,175,天福村,NULL
54,557,4,561,748,0,0,75,379,178,東光里,NULL
5,555,6,561,710,0,0,79.01,355,200,東川里,NULL
475,557,4,561,768,0,0,73.05,307,250,西勢里,NULL
710,553,8,561,732,0,0,76.64,295,258,崙美村,NULL
0,553,8,561,732,0,0,76.64,295,258,崙美村,NULL
172,557,4,561,710,0,0,79.01,266,291,竹文里,NULL
270,555,6,561,729,0,0,76.95,262,293,湖內村,NULL
306,554,7,561,767,0,0,73.14,251,303,新光村,NULL
80,557,4,561,777,0,0,72.2,213,344,秀昌里,NULL
166,557,3,560,735,0,0,76.19,371,186,中美里,NULL
1143,552,8,560,683,0,0,81.99,277,275,廣明里,NULL
0,552,8,560,683,0,0,81.99,277,275,廣明里,NULL
302,559,1,560,749,0,0,74.77,249,310,福德村,NULL
298,556,4,560,777,0,0,72.07,248,308,宮後村,NULL
179,554,6,560,898,0,0,62.36,182,372,潭西村,NULL
0,554,6,560,898,0,0,62.36,182,372,潭西村,NULL
244,558,2,560,797,0,0,70.26,161,397,游西村,NULL
0,558,2,560,797,0,0,70.26,161,397,游西村,NULL
442,556,4,560,750,0,0,74.67,143,413,石林村,NULL
0,556,4,560,750,0,0,74.67,143,413,石林村,NULL
139,551,8,559,950,0,0,58.84,382,169,興昌村,NULL
0,551,8,559,950,0,0,58.84,382,169,興昌村,NULL
410,552,7,559,722,0,0,77.42,370,182,談文村,NULL
0,552,7,559,722,0,0,77.42,370,182,談文村,NULL
294,551,8,559,713,0,0,78.4,314,237,中山里,NULL
555,554,5,559,721,0,0,77.53,307,247,武安里,NULL
43,553,6,559,876,0,0,63.81,232,321,月眉村,NULL
9,555,3,558,726,0,0,76.86,488,67,錦華里,NULL
324,556,2,558,751,0,0,74.3,405,151,福星村,NULL
81,554,4,558,815,0,0,68.47,315,239,圓富里,NULL
427,553,5,558,748,0,0,74.6,268,285,園寮村,NULL
351,546,12,558,737,0,0,75.71,215,331,新田村,NULL
351,557,1,558,775,0,0,72,204,353,九隆里,NULL
0,557,1,558,775,0,0,72,204,353,九隆里,NULL
387,553,4,557,717,0,0,77.68,429,124,西湖村,NULL
586,555,2,557,797,0,0,69.89,397,158,榮光村,NULL
0,555,2,557,797,0,0,69.89,397,158,榮光村,NULL
86,553,4,557,770,0,0,72.34,339,214,枇杷里,NULL
92,554,3,557,742,0,0,75.07,306,248,上舘里,NULL
48,555,2,557,898,0,0,62.03,301,254,湖西村,NULL
0,555,2,557,898,0,0,62.03,301,254,湖西村,NULL
290,545,12,557,758,0,0,73.48,293,252,內灣里,NULL
480,552,5,557,797,0,0,69.89,282,270,西鎮村,NULL
0,552,5,557,797,0,0,69.89,282,270,西鎮村,NULL
0,554,3,557,792,0,0,70.33,172,382,玉港村,NULL
34,555,1,556,992,0,0,56.05,541,14,瓊林里,NULL
103,553,3,556,694,0,0,80.12,435,118,榮樂里,NULL
16,552,4,556,913,0,0,60.9,395,157,崙後村,NULL
48,554,2,556,728,0,0,76.37,379,175,國威里,NULL
745,554,2,556,712,0,0,78.09,306,248,和德里,NULL
42,548,8,556,713,0,0,77.98,295,253,安平里,NULL
0,548,8,556,713,0,0,77.98,295,253,安平里,NULL
132,554,2,556,814,0,0,68.3,293,261,白西里,NULL
0,554,2,556,814,0,0,68.3,293,261,白西里,NULL
128,549,7,556,718,0,0,77.44,256,293,仁德里,NULL
0,549,7,556,718,0,0,77.44,256,293,仁德里,NULL
62,549,7,556,755,0,0,73.64,252,297,鄂王里,NULL
0,549,7,556,755,0,0,73.64,252,297,鄂王里,NULL
561,550,6,556,930,0,0,59.78,226,324,善餘村,NULL
0,550,6,556,930,0,0,59.78,226,324,善餘村,NULL
569,545,11,556,775,0,0,71.74,222,323,溪厝村,NULL
16,549,7,556,796,0,0,69.85,124,425,港美村,NULL
0,549,7,556,796,0,0,69.85,124,425,港美村,NULL
97,551,4,555,1001,0,0,55.44,431,120,外垵村,NULL
217,551,4,555,799,0,0,69.46,399,152,瑞美村,NULL
440,548,7,555,732,0,0,75.82,366,182,溪北村,NULL
0,548,7,555,732,0,0,75.82,366,182,溪北村,NULL
2144,547,8,555,780,0,0,71.15,358,189,山溪村,NULL
0,547,8,555,780,0,0,71.15,358,189,山溪村,NULL
303,549,6,555,773,0,0,71.8,340,209,新北里,NULL
346,548,7,555,740,0,0,75,269,279,北斗村,NULL
112,554,1,555,704,0,0,78.84,232,322,廍南里,NULL
0,554,1,555,704,0,0,78.84,232,322,廍南里,NULL
687,552,3,555,739,0,0,75.1,142,410,鳳芸村,NULL
26,553,1,554,983,0,0,56.36,518,35,山外里,NULL
156,548,6,554,763,0,0,72.61,465,83,光榮村,NULL
0,548,6,554,763,0,0,72.61,465,83,光榮村,NULL
83,551,3,554,694,0,0,79.83,408,143,中正里,NULL
57,549,5,554,735,0,0,75.37,402,147,國魂里,NULL
518,551,3,554,798,0,0,69.42,321,230,小西村,NULL
0,551,3,554,798,0,0,69.42,321,230,小西村,NULL
626,552,2,554,666,0,0,83.18,299,253,中山里,NULL
0,552,2,554,666,0,0,83.18,299,253,中山里,NULL
114,551,3,554,777,0,0,71.3,261,290,橋南里,NULL
653,546,8,554,697,0,0,79.48,251,295,東橋里,NULL
257,549,5,554,805,0,0,68.82,231,318,大同里,NULL
73,549,4,553,833,0,0,66.39,372,177,乾溝村,NULL
0,549,4,553,833,0,0,66.39,372,177,乾溝村,NULL
0,549,4,553,783,0,0,70.63,310,239,掌潭村,NULL
31,548,5,553,774,0,0,71.45,248,300,德化里,NULL
245,548,5,553,759,0,0,72.86,201,347,東陽里,NULL
0,548,5,553,759,0,0,72.86,201,347,東陽里,NULL
247,547,6,553,702,0,0,78.77,195,352,博愛里,NULL
0,547,6,553,702,0,0,78.77,195,352,博愛里,NULL
690,551,2,553,758,0,0,72.96,190,361,西汕村,NULL
0,551,2,553,758,0,0,72.96,190,361,西汕村,NULL
226,546,7,553,900,0,0,61.44,133,413,順興村,NULL
0,546,7,553,900,0,0,61.44,133,413,順興村,NULL
0,547,5,552,1109,0,0,49.77,430,117,忠孝里,NULL
86,546,6,552,915,0,0,60.33,401,145,新福里,NULL
0,546,6,552,915,0,0,60.33,401,145,新福里,NULL
149,549,3,552,720,0,0,76.67,342,207,大同里,NULL
0,549,3,552,720,0,0,76.67,342,207,大同里,NULL
174,549,3,552,772,0,0,71.5,332,217,永平村,NULL
98,547,5,552,776,0,0,71.13,320,227,西社里,NULL
573,546,6,552,716,0,0,77.09,280,266,溪州村,NULL
329,548,4,552,711,0,0,77.64,262,286,鴨寮村,NULL
66,546,6,552,729,0,0,75.72,247,299,開明里,NULL
188,546,6,552,844,0,0,65.4,240,306,赤山村,NULL
218,547,5,552,769,0,0,71.78,181,366,聖賢村,NULL
252,550,2,552,814,0,0,67.81,166,384,鯤鯓村,NULL
519,547,4,551,783,0,0,70.37,328,219,民靖村,NULL
0,547,4,551,783,0,0,70.37,328,219,民靖村,NULL
180,544,7,551,690,0,0,79.86,285,259,埔崙村,NULL
1297,547,4,551,778,0,0,70.82,264,283,雙坑里,NULL
0,547,4,551,778,0,0,70.82,264,283,雙坑里,NULL
485,547,4,551,746,0,0,73.86,263,284,民生里,NULL
0,547,4,551,746,0,0,73.86,263,284,民生里,NULL
458,547,4,551,719,0,0,76.63,259,288,中新里,NULL
1368,546,5,551,715,0,0,77.06,250,296,老泉里,NULL
0,546,5,551,715,0,0,77.06,250,296,老泉里,NULL
889,544,7,551,1044,0,0,52.78,237,307,富甲里,NULL
47,548,2,550,1168,0,0,47.09,537,11,西口村,NULL
0,548,2,550,1168,0,0,47.09,537,11,西口村,NULL
4,548,2,550,958,0,0,57.41,515,33,塘岐村、后沃村、橋仔村,NULL
0,548,2,550,958,0,0,57.41,515,33,塘岐村、后沃村、橋仔村,NULL
91,536,14,550,762,0,0,72.18,478,58,嘉新村,NULL
355,547,3,550,695,0,0,79.14,437,110,西村,NULL
0,547,3,550,695,0,0,79.14,437,110,西村,NULL
751,544,6,550,707,0,0,77.79,324,220,北安里,NULL
91,545,5,550,695,0,0,79.14,296,249,文昌里,NULL
0,545,5,550,695,0,0,79.14,296,249,文昌里,NULL
84,547,3,550,745,0,0,73.83,285,262,舊社里,NULL
320,544,6,550,776,0,0,70.88,222,322,中寮村,NULL
0,544,6,550,776,0,0,70.88,222,322,中寮村,NULL
505,547,3,550,745,0,0,73.83,215,332,新崙里,NULL
127,540,9,549,827,0,0,66.38,278,262,龍江里,NULL
4,542,7,549,705,0,0,77.87,278,264,東門里,NULL
0,540,9,549,827,0,0,66.38,278,262,龍江里,NULL
0,542,7,549,705,0,0,77.87,278,264,東門里,NULL
427,546,3,549,736,0,0,74.59,252,294,深坑村,NULL
0,546,3,549,736,0,0,74.59,252,294,深坑村,NULL
181,544,5,549,819,0,0,67.03,240,304,客厝村,NULL
0,544,5,549,819,0,0,67.03,240,304,客厝村,NULL
173,543,6,549,841,0,0,65.28,236,307,長北村,NULL
487,543,6,549,768,0,0,71.48,233,310,興漁里,NULL
67,545,4,549,765,0,0,71.76,229,316,開明里,NULL
387,547,2,549,674,0,0,81.45,214,333,上村村,NULL
0,547,2,549,674,0,0,81.45,214,333,上村村,NULL
533,546,3,549,709,0,0,77.43,202,344,仁福村,NULL
0,546,3,549,709,0,0,77.43,202,344,仁福村,NULL
88,546,3,549,681,0,0,80.62,173,373,中北里,NULL
0,546,3,549,681,0,0,80.62,173,373,中北里,NULL
101,543,5,548,775,0,0,70.71,510,33,佳民村,NULL
0,543,5,548,775,0,0,70.71,510,33,佳民村,NULL
121,541,7,548,822,0,0,66.67,452,89,永興村,NULL
428,544,4,548,682,0,0,80.35,353,191,角樹村,NULL
0,544,4,548,682,0,0,80.35,353,191,角樹村,NULL
274,544,4,548,792,0,0,69.19,327,217,福寧里,NULL
0,544,4,548,792,0,0,69.19,327,217,福寧里,NULL
404,543,5,548,758,0,0,72.3,312,231,龍門村,NULL
0,543,5,548,758,0,0,72.3,312,231,龍門村,NULL
107,545,3,548,745,0,0,73.56,311,234,圳頭里,NULL
0,545,3,548,745,0,0,73.56,311,234,圳頭里,NULL
534,548,0,548,706,0,0,77.62,254,294,大營村,NULL
0,544,4,548,792,0,0,69.19,183,361,鯤江村,NULL
59,545,3,548,761,0,0,72.01,167,378,內角里,NULL
0,545,3,548,761,0,0,72.01,167,378,內角里,NULL
249,546,2,548,825,0,0,66.42,156,390,長沙村,NULL
30,543,4,547,1049,0,0,52.14,520,23,料羅里,NULL
0,543,4,547,1049,0,0,52.14,520,23,料羅里,NULL
7,538,9,547,706,0,0,77.48,338,200,中正里,NULL
0,538,9,547,706,0,0,77.48,338,200,中正里,NULL
108,546,1,547,757,0,0,72.26,330,216,梅南里,NULL
266,540,7,547,683,0,0,80.09,275,265,大湖村,NULL
266,544,3,547,657,0,0,83.26,256,288,新化里,NULL
272,544,3,547,845,0,0,64.73,256,288,府番里,NULL
0,544,3,547,657,0,0,83.26,256,288,新化里,NULL
0,544,3,547,845,0,0,64.73,256,288,府番里,NULL
634,541,6,547,750,0,0,72.93,221,320,過溪村,NULL
36,543,4,547,748,0,0,73.13,195,348,庄內里,NULL
305,544,3,547,773,0,0,70.76,176,368,中庄村,NULL
384,537,9,546,683,0,0,79.94,413,124,双潭村,NULL
270,538,8,546,689,0,0,79.25,392,146,水坑村,NULL
0,538,8,546,689,0,0,79.25,392,146,水坑村,NULL
259,543,3,546,698,0,0,78.22,322,221,新華里,NULL
117,539,7,546,708,0,0,77.12,266,273,埤鄉里,NULL
0,539,7,546,708,0,0,77.12,266,273,埤鄉里,NULL
218,540,6,546,743,0,0,73.49,256,284,大福村,NULL
300,539,7,546,756,0,0,72.22,202,337,大興村,NULL
27,541,5,546,771,0,0,70.82,173,368,崩山村,NULL
0,541,5,546,771,0,0,70.82,173,368,崩山村,NULL
0,540,6,546,785,0,0,69.55,171,369,三義村,NULL
373,543,3,546,731,0,0,74.69,148,395,子龍里,NULL
225,536,9,545,856,0,0,63.67,417,119,富源村,NULL
0,536,9,545,856,0,0,63.67,417,119,富源村,NULL
926,538,7,545,721,0,0,75.59,398,140,上溪里,NULL
149,536,9,545,1046,0,0,52.1,393,143,竹湖村,NULL
0,536,9,545,1046,0,0,52.1,393,143,竹湖村,NULL
29,541,4,545,920,0,0,59.24,274,267,山寮村,NULL
0,541,4,545,920,0,0,59.24,274,267,山寮村,NULL
855,536,9,545,757,0,0,71.99,188,348,新光村,NULL
0,536,9,545,757,0,0,71.99,188,348,新光村,NULL
222,541,4,545,782,0,0,69.69,182,359,水南村,NULL
331,540,5,545,729,0,0,74.76,162,378,竹橋村,NULL
0,540,5,545,729,0,0,74.76,162,378,竹橋村,NULL
0,541,3,544,848,0,0,64.15,418,123,水璉村,NULL
1938,539,5,544,770,0,0,70.65,363,176,吉慶里,NULL
205,539,5,544,686,0,0,79.3,263,276,三和村,NULL
2206,542,2,544,723,0,0,75.24,212,330,龍門村,NULL
0,542,2,544,723,0,0,75.24,212,330,龍門村,NULL
451,537,7,544,717,0,0,75.87,206,331,美華里,NULL
122,543,1,544,786,0,0,69.21,194,349,義稠里,NULL
0,543,1,544,786,0,0,69.21,194,349,義稠里,NULL
125,534,10,544,792,0,0,68.69,166,368,歡雅里,NULL
0,542,1,543,729,0,0,74.49,491,51,佳平村,NULL
270,538,5,543,717,0,0,75.73,313,225,秀水里,NULL
0,538,5,543,717,0,0,75.73,313,225,秀水里,NULL
330,542,1,543,701,0,0,77.46,294,248,永安村,NULL
1832,535,8,543,778,0,0,69.79,239,296,有木里,NULL
0,535,8,543,778,0,0,69.79,239,296,有木里,NULL
660,538,5,543,682,0,0,79.62,231,307,蔦松里,NULL
190,538,5,543,872,0,0,62.27,223,315,瓦磘村,NULL
234,537,6,543,733,0,0,74.08,210,327,溪西村,NULL
0,537,6,543,733,0,0,74.08,210,327,溪西村,NULL
14,536,6,542,753,0,0,71.98,358,178,大同里,NULL
0,536,6,542,753,0,0,71.98,358,178,大同里,NULL
159,532,10,542,706,0,0,76.77,329,203,福翠里,NULL
271,539,3,542,723,0,0,74.97,273,266,內林里,NULL
0,539,3,542,723,0,0,74.97,273,266,內林里,NULL
292,537,5,542,770,0,0,70.39,259,278,瑞峰村,NULL
0,537,5,542,770,0,0,70.39,259,278,瑞峰村,NULL
70,537,5,542,802,0,0,67.58,230,307,田洋村,NULL
0,537,5,542,802,0,0,67.58,230,307,田洋村,NULL
265,536,6,542,687,0,0,78.89,217,319,瀨南里,NULL
0,536,6,542,687,0,0,78.89,217,319,瀨南里,NULL
175,537,5,542,783,0,0,69.22,207,330,後湖村,NULL
0,537,5,542,783,0,0,69.22,207,330,後湖村,NULL
307,536,6,542,696,0,0,77.87,40,496,西庄村,NULL
0,536,6,542,696,0,0,77.87,40,496,西庄村,NULL
99,536,5,541,648,0,0,83.49,397,139,竹東里,NULL
627,536,5,541,1138,0,0,47.54,353,183,南福村,NULL
0,536,5,541,1138,0,0,47.54,353,183,南福村,NULL
495,538,3,541,744,0,0,72.72,274,264,南海村、永樂村、新復村,NULL
0,538,3,541,744,0,0,72.72,274,264,南海村、永樂村、新復村,NULL
560,535,6,541,711,0,0,76.09,266,269,五權里,NULL
0,535,6,541,711,0,0,76.09,266,269,五權里,NULL
163,539,1,540,703,0,0,76.81,514,25,萬安村,NULL
0,539,1,540,703,0,0,76.81,514,25,萬安村,NULL
385,538,2,540,698,0,0,77.36,401,137,双潭村,NULL
120,538,2,540,884,0,0,61.09,398,140,瑞源村,NULL
0,538,2,540,884,0,0,61.09,398,140,瑞源村,NULL
109,539,1,540,737,0,0,73.27,283,256,梅南里,NULL
93,534,6,540,775,0,0,69.68,254,280,玉田里,NULL
304,535,5,540,749,0,0,72.1,246,289,光華里,NULL
0,535,5,540,749,0,0,72.1,246,289,光華里,NULL
0,532,8,540,812,0,0,66.5,218,314,東崙村,NULL
312,534,5,539,671,0,0,80.33,428,106,寶山村,NULL
0,534,5,539,671,0,0,80.33,428,106,寶山村,NULL
427,535,4,539,747,0,0,72.16,402,133,竹木村,NULL
0,535,4,539,747,0,0,72.16,402,133,竹木村,NULL
680,531,8,539,743,0,0,72.54,343,188,大峯里,NULL
0,531,8,539,743,0,0,72.54,343,188,大峯里,NULL
19,536,3,539,751,0,0,71.77,304,232,興國里,NULL
0,536,3,539,751,0,0,71.77,304,232,興國里,NULL
684,534,5,539,724,0,0,74.45,303,231,泰興里,NULL
323,536,3,539,683,0,0,78.92,303,233,北口村,NULL
0,534,5,539,724,0,0,74.45,303,231,泰興里,NULL
20,532,7,539,821,0,0,65.65,258,274,新吉村,NULL
0,532,7,539,821,0,0,65.65,258,274,新吉村,NULL
472,535,4,539,725,0,0,74.34,256,279,東和里,NULL
0,535,4,539,725,0,0,74.34,256,279,東和里,NULL
56,536,3,539,799,0,0,67.46,241,295,崎內里,NULL
0,536,3,539,799,0,0,67.46,241,295,崎內里,NULL
89,538,1,539,824,0,0,65.41,231,307,崙內里,NULL
479,535,4,539,774,0,0,69.64,227,308,興安村,NULL
0,535,4,539,774,0,0,69.64,227,308,興安村,NULL
561,535,4,539,676,0,0,79.73,226,309,大竹村,NULL
0,535,4,539,676,0,0,79.73,226,309,大竹村,NULL
864,535,4,539,698,0,0,77.22,217,318,南花村,NULL
201,534,5,539,685,0,0,78.69,211,323,同榮里,NULL
0,534,5,539,685,0,0,78.69,211,323,同榮里,NULL
86,532,7,539,780,0,0,69.1,177,355,德家里,NULL
0,532,7,539,780,0,0,69.1,177,355,德家里,NULL
6,534,4,538,718,0,0,74.93,369,165,挹秀里,NULL
2184,533,5,538,751,0,0,71.64,319,214,牡丹村,NULL
82,533,5,538,725,0,0,74.21,316,217,鹿耳里,NULL
0,533,5,538,725,0,0,74.21,316,217,鹿耳里,NULL
473,535,3,538,729,0,0,73.8,298,237,龜丹村,NULL
0,535,3,538,729,0,0,73.8,298,237,龜丹村,NULL
41,536,2,538,720,0,0,74.72,288,248,龍山里,NULL
0,536,2,538,720,0,0,74.72,288,248,龍山里,NULL
0,528,10,538,729,0,0,73.8,253,275,田尾里,NULL
373,533,5,538,787,0,0,68.36,231,302,和平村,NULL
0,533,5,538,787,0,0,68.36,231,302,和平村,NULL
372,530,8,538,765,0,0,70.33,219,311,博愛村,NULL
0,530,8,538,765,0,0,70.33,219,311,博愛村,NULL
695,531,6,537,692,0,0,77.6,378,153,達觀村,NULL
68,529,8,537,814,0,0,65.97,369,160,長豐村,NULL
0,529,8,537,814,0,0,65.97,369,160,長豐村,NULL
144,532,5,537,765,0,0,70.2,304,228,大新村,NULL
463,533,4,537,712,0,0,75.42,286,247,望明村,NULL
464,534,3,537,778,0,0,69.02,211,323,吉田村,NULL
0,534,3,537,778,0,0,69.02,211,323,吉田村,NULL
327,526,10,536,736,0,0,72.83,417,109,石墻村,NULL
501,531,5,536,694,0,0,77.23,415,116,共和里,NULL
0,531,5,536,694,0,0,77.23,415,116,共和里,NULL
24,532,4,536,706,0,0,75.92,354,178,主商里,NULL
0,532,4,536,706,0,0,75.92,354,178,主商里,NULL
470,535,1,536,779,0,0,68.81,353,182,密枝村,NULL
0,535,1,536,779,0,0,68.81,353,182,密枝村,NULL
61,528,8,536,735,0,0,72.93,309,219,龜売村,NULL
55,528,8,536,919,0,0,58.32,242,286,安南村,NULL
0,528,8,536,919,0,0,58.32,242,286,安南村,NULL
1192,533,3,536,695,0,0,77.12,230,303,中山里,NULL
161,527,8,535,735,0,0,72.79,508,19,中正村,NULL
0,527,8,535,735,0,0,72.79,508,19,中正村,NULL
81,529,6,535,725,0,0,73.79,337,192,好修里,NULL
291,527,8,535,728,0,0,73.49,309,218,內灣里,NULL
399,527,8,535,723,0,0,74,296,231,太平里,NULL
0,527,8,535,723,0,0,74,296,231,太平里,NULL
95,527,8,535,735,0,0,72.79,274,253,梅埔里,NULL
235,516,19,535,747,0,0,71.62,267,249,登山里,NULL
0,516,19,535,747,0,0,71.62,267,249,登山里,NULL
0,534,1,535,744,0,0,71.91,266,268,光華村,NULL
160,527,8,535,961,0,0,55.67,260,267,崙北村,NULL
118,530,5,535,762,0,0,70.21,239,291,港邊里,NULL
187,531,4,535,722,0,0,74.1,218,313,中埕村,NULL
0,531,4,535,722,0,0,74.1,218,313,中埕村,NULL
370,526,9,535,781,0,0,68.5,213,313,坑頭村,NULL
0,526,9,535,781,0,0,68.5,213,313,坑頭村,NULL
49,531,4,535,789,0,0,67.81,189,342,圍潭村,NULL
0,531,4,535,789,0,0,67.81,189,342,圍潭村,NULL
259,531,4,535,770,0,0,69.48,145,386,西結里,NULL
0,531,4,535,770,0,0,69.48,145,386,西結里,NULL
625,532,2,534,934,0,0,57.17,423,109,漁福村,NULL
0,532,2,534,934,0,0,57.17,423,109,漁福村,NULL
2101,532,2,534,666,0,0,80.18,302,230,潭邊村,NULL
0,532,2,534,666,0,0,80.18,302,230,潭邊村,NULL
603,527,7,534,716,0,0,74.58,276,251,南化村,NULL
7,530,4,534,843,0,0,63.35,253,277,瓦磘村,NULL
1,531,3,534,716,0,0,74.58,245,286,後壁村,NULL
189,526,8,534,819,0,0,65.2,244,282,赤山村,NULL
66,527,7,534,883,0,0,60.48,230,297,林投村,NULL
0,527,7,534,883,0,0,60.48,230,297,林投村,NULL
246,529,5,534,709,0,0,75.32,202,327,光民里,NULL
0,529,5,534,709,0,0,75.32,202,327,光民里,NULL
301,528,6,534,711,0,0,75.11,178,350,大興村,NULL
178,530,3,533,913,0,0,58.38,466,64,南寮村,NULL
0,530,3,533,913,0,0,58.38,466,64,南寮村,NULL
249,530,3,533,671,0,0,79.43,464,66,光榮里,NULL
278,529,4,533,763,0,0,69.86,311,218,中山村,NULL
1923,529,4,533,719,0,0,74.13,311,218,龍川里,NULL
272,527,6,533,747,0,0,71.35,303,224,永興里,NULL
0,527,6,533,747,0,0,71.35,303,224,永興里,NULL
419,527,6,533,731,0,0,72.91,286,241,復豐里,NULL
0,527,6,533,731,0,0,72.91,286,241,復豐里,NULL
118,527,6,533,691,0,0,77.13,282,245,城北里,NULL
0,527,6,533,691,0,0,77.13,282,245,城北里,NULL
520,529,4,533,725,0,0,73.52,247,282,新市村,NULL
512,527,6,533,664,0,0,80.27,205,322,中沙村,NULL
0,527,6,533,664,0,0,80.27,205,322,中沙村,NULL
9,523,9,532,793,0,0,67.09,386,137,新富里,NULL
366,528,4,532,745,0,0,71.41,332,196,路平村,NULL
0,528,4,532,745,0,0,71.41,332,196,路平村,NULL
160,527,5,532,675,0,0,78.81,317,210,北平里,NULL
0,527,5,532,675,0,0,78.81,317,210,北平里,NULL
810,531,1,532,712,0,0,74.72,227,304,合興村,NULL
0,531,1,532,712,0,0,74.72,227,304,合興村,NULL
195,529,3,532,722,0,0,73.68,190,339,重溪村,NULL
429,529,3,532,706,0,0,75.35,180,349,六分里,NULL
0,529,3,532,706,0,0,75.35,180,349,六分里,NULL
315,529,3,532,745,0,0,71.41,145,384,義庄村,NULL
0,529,3,532,745,0,0,71.41,145,384,義庄村,NULL
0,529,2,531,893,0,0,59.46,488,41,多良村,NULL
208,525,6,531,691,0,0,76.85,386,139,仁愛里,NULL
711,522,9,531,703,0,0,75.53,316,206,同安村,NULL
0,522,9,531,703,0,0,75.53,316,206,同安村,NULL
64,527,4,531,728,0,0,72.94,261,266,中山里,NULL
0,527,4,531,728,0,0,72.94,261,266,中山里,NULL
0,527,4,531,732,0,0,72.54,211,316,中華村,NULL
3,526,4,530,685,0,0,77.37,432,94,親仁里,NULL
51,522,8,530,870,0,0,60.92,387,135,富豐里,NULL
0,522,8,530,870,0,0,60.92,387,135,富豐里,NULL
604,524,6,530,788,0,0,67.26,322,202,小崙村,NULL
0,524,6,530,788,0,0,67.26,322,202,小崙村,NULL
166,529,1,530,677,0,0,78.29,236,293,糶糴村,NULL
0,529,1,530,677,0,0,78.29,236,293,糶糴村,NULL
292,526,4,530,724,0,0,73.2,205,321,大坑村,NULL
0,526,4,530,724,0,0,73.2,205,321,大坑村,NULL
58,521,9,530,719,0,0,73.71,163,358,汴頭里,NULL
0,521,9,530,719,0,0,73.71,163,358,汴頭里,NULL
112,526,3,529,693,0,0,76.33,404,122,五豐里,NULL
10,527,2,529,801,0,0,66.04,387,140,新豐里,NULL
158,526,3,529,950,0,0,55.68,324,202,飛沙村,NULL
0,526,3,529,950,0,0,55.68,324,202,飛沙村,NULL
949,524,5,529,699,0,0,75.68,240,284,興漢里,NULL
295,526,3,529,793,0,0,66.71,231,295,大有村,NULL
85,525,4,529,851,0,0,62.16,202,323,埤腳里,NULL
366,520,9,529,730,0,0,72.47,184,336,漳洲里,NULL
0,520,9,529,730,0,0,72.47,184,336,漳洲里,NULL
806,526,2,528,694,0,0,76.08,476,50,海光里,NULL
21,528,0,528,713,0,0,74.05,415,113,民主里、民治里,NULL
0,528,0,528,713,0,0,74.05,415,113,民主里、民治里,NULL
367,520,8,528,694,0,0,76.08,411,109,北坑村,NULL
0,520,8,528,694,0,0,76.08,411,109,北坑村,NULL
133,523,5,528,652,0,0,80.98,341,182,新生里,NULL
0,523,5,528,652,0,0,80.98,341,182,新生里,NULL
126,524,4,528,783,0,0,67.43,282,242,新厝里,NULL
0,524,4,528,783,0,0,67.43,282,242,新厝里,NULL
61,521,7,528,721,0,0,73.23,230,291,慶和里,NULL
0,521,7,528,721,0,0,73.23,230,291,慶和里,NULL
392,527,1,528,674,0,0,78.34,212,315,總榮里,NULL
0,527,1,528,674,0,0,78.34,212,315,總榮里,NULL
50,518,9,527,710,0,0,74.23,319,199,西岐里,NULL
740,519,8,527,709,0,0,74.33,304,215,仁和村,NULL
0,519,8,527,709,0,0,74.33,304,215,仁和村,NULL
20,525,2,527,670,0,0,78.66,256,269,昇平里,NULL
0,525,2,527,670,0,0,78.66,256,269,昇平里,NULL
442,524,3,527,803,0,0,65.63,236,288,大湖村,NULL
0,524,3,527,803,0,0,65.63,236,288,大湖村,NULL
877,525,2,527,704,0,0,74.86,214,311,土崎村,NULL
0,525,2,527,704,0,0,74.86,214,311,土崎村,NULL
360,517,10,527,679,0,0,77.61,206,311,田道村,NULL
0,517,10,527,679,0,0,77.61,206,311,田道村,NULL
164,518,9,527,652,0,0,80.83,167,351,新興村,NULL
254,519,7,526,877,0,0,59.98,398,121,石牌村,NULL
0,519,7,526,877,0,0,59.98,398,121,石牌村,NULL
558,520,6,526,661,0,0,79.58,338,182,舊明里,NULL
124,522,4,526,698,0,0,75.36,312,210,五北里,NULL
87,520,6,526,691,0,0,76.12,262,258,南門里,NULL
0,520,6,526,691,0,0,76.12,262,258,南門里,NULL
797,521,5,526,698,0,0,75.36,245,276,十五村,NULL
0,521,5,526,698,0,0,75.36,245,276,十五村,NULL
452,520,6,526,740,0,0,71.08,240,280,南豐村,NULL
0,520,6,526,740,0,0,71.08,240,280,南豐村,NULL
546,520,6,526,654,0,0,80.43,230,290,城西里,NULL
0,520,6,526,654,0,0,80.43,230,290,城西里,NULL
307,521,5,526,734,0,0,71.66,150,371,大潭村,NULL
131,517,8,525,668,0,0,78.59,344,173,柯湖里,NULL
0,517,8,525,668,0,0,78.59,344,173,柯湖里,NULL
562,521,4,525,858,0,0,61.19,311,210,護國里,NULL
429,524,1,525,749,0,0,70.09,279,245,瑞豐村,NULL
0,524,1,525,749,0,0,70.09,279,245,瑞豐村,NULL
193,522,3,525,747,0,0,70.28,224,298,新吉村,NULL
0,522,3,525,747,0,0,70.28,224,298,新吉村,NULL
296,517,8,525,662,0,0,79.31,219,298,赤水村,NULL
318,520,5,525,715,0,0,73.43,217,303,港後村,NULL
196,521,4,525,737,0,0,71.23,202,319,重溪村,NULL
0,520,5,525,750,0,0,70,199,321,貴舍里,NULL
483,521,4,525,661,0,0,79.43,110,411,南海村,NULL
306,520,4,524,756,0,0,69.31,511,9,大信里,NULL
0,522,2,524,764,0,0,68.59,272,250,八仙村,NULL
131,520,4,524,810,0,0,64.69,256,264,廣林里,NULL
124,521,3,524,687,0,0,76.27,228,293,頭港里,NULL
297,520,3,523,648,0,0,80.71,429,91,明湖村,NULL
0,520,3,523,648,0,0,80.71,429,91,明湖村,NULL
43,516,7,523,673,0,0,77.71,360,156,智慧里,NULL
0,516,7,523,673,0,0,77.71,360,156,智慧里,NULL
0,519,4,523,798,0,0,65.54,298,221,福盛村,NULL
71,517,6,523,708,0,0,73.87,241,276,竹峰里,NULL
158,518,5,523,738,0,0,70.87,222,296,南安村,NULL
172,519,4,523,822,0,0,63.63,212,307,長北村,NULL
970,520,3,523,721,0,0,72.54,200,320,藍埔村,NULL
680,518,4,522,688,0,0,75.87,343,175,粵寧里,NULL
1790,516,6,522,699,0,0,74.68,332,184,中埔里,NULL
1322,519,3,522,673,0,0,77.56,243,276,大安里,NULL
166,520,2,522,832,0,0,62.74,168,352,官和村,NULL
0,520,2,522,832,0,0,62.74,168,352,官和村,NULL
403,520,2,522,645,0,0,80.93,141,379,華崗里,NULL
141,518,3,521,1042,0,0,50,463,55,東河村,NULL
0,518,3,521,1042,0,0,50,463,55,東河村,NULL
304,517,4,521,733,0,0,71.08,377,140,東興村,NULL
0,517,4,521,733,0,0,71.08,377,140,東興村,NULL
62,521,0,521,763,0,0,68.28,344,177,國姓村,NULL
207,515,6,521,758,0,0,68.73,304,211,日月村,NULL
0,515,6,521,758,0,0,68.73,304,211,日月村,NULL
162,510,11,521,855,0,0,60.94,289,221,大王村,NULL
602,515,6,521,690,0,0,75.51,280,235,南化村,NULL
390,518,3,521,662,0,0,78.7,277,241,鯉魚潭村,NULL
124,515,6,521,708,0,0,73.59,276,239,光復里,NULL
385,513,8,521,745,0,0,69.93,275,238,白杞村,NULL
0,513,8,521,745,0,0,69.93,275,238,白杞村,NULL
953,514,7,521,679,0,0,76.73,248,266,下埔村,NULL
0,514,7,521,679,0,0,76.73,248,266,下埔村,NULL
145,517,4,521,780,0,0,66.79,234,283,南強里,NULL
0,517,4,521,780,0,0,66.79,234,283,南強里,NULL
439,518,3,521,726,0,0,71.76,233,285,江厝里,NULL
248,515,6,521,733,0,0,71.08,205,310,妙崙村,NULL
0,515,6,521,733,0,0,71.08,205,310,妙崙村,NULL
565,515,6,521,689,0,0,75.62,173,342,溪寮村,NULL
0,516,4,520,749,0,0,69.43,333,183,自強村,NULL
182,515,5,520,684,0,0,76.02,322,193,八堵里,NULL
0,515,5,520,684,0,0,76.02,322,193,八堵里,NULL
36,514,6,520,756,0,0,68.78,261,253,永屯村,NULL
0,514,6,520,756,0,0,68.78,261,253,永屯村,NULL
30,516,4,520,684,0,0,76.02,241,275,司馬村,NULL
0,516,4,520,684,0,0,76.02,241,275,司馬村,NULL
490,514,6,520,658,0,0,79.03,170,344,中崎村,NULL
0,514,6,520,658,0,0,79.03,170,344,中崎村,NULL
455,517,2,519,754,0,0,68.83,396,121,樂野村,NULL
0,517,2,519,754,0,0,68.83,396,121,樂野村,NULL
18,510,9,519,723,0,0,71.78,241,269,寶隆村,NULL
0,510,9,519,723,0,0,71.78,241,269,寶隆村,NULL
0,517,2,519,804,0,0,64.55,236,281,雙玉村,NULL
37,512,7,519,833,0,0,62.3,225,287,烏崁里,NULL
0,512,7,519,833,0,0,62.3,225,287,烏崁里,NULL
212,516,3,519,758,0,0,68.47,218,298,東正村,NULL
387,513,6,519,736,0,0,70.52,196,317,林北村,NULL
437,515,4,519,653,0,0,79.48,195,320,梓和村,NULL
306,515,4,519,748,0,0,69.39,181,334,中庄村,NULL
223,512,7,519,786,0,0,66.03,144,368,萬興村,NULL
0,512,7,519,786,0,0,66.03,144,368,萬興村,NULL
148,511,7,518,636,0,0,81.45,492,19,大鵬里,NULL
193,513,5,518,854,0,0,60.66,459,54,南富村,NULL
0,513,5,518,854,0,0,60.66,459,54,南富村,NULL
642,510,8,518,642,0,0,80.69,437,73,中興村,NULL
0,510,8,518,642,0,0,80.69,437,73,中興村,NULL
131,515,3,518,855,0,0,60.58,346,169,新興村,NULL
0,515,3,518,855,0,0,60.58,346,169,新興村,NULL
143,504,14,518,758,0,0,68.34,291,213,干城里,NULL
67,515,3,518,678,0,0,76.4,272,243,尚義里,NULL
449,513,5,518,710,0,0,72.96,261,252,赤西村,NULL
0,513,5,518,710,0,0,72.96,261,252,赤西村,NULL
180,512,6,518,683,0,0,75.84,256,256,大義村,NULL
0,512,6,518,683,0,0,75.84,256,256,大義村,NULL
103,514,4,518,668,0,0,77.54,253,261,南大里,NULL
990,515,3,518,732,0,0,70.77,238,277,樹林村,NULL
385,512,6,518,678,0,0,76.4,235,277,林中村,NULL
842,516,2,518,629,0,0,82.35,179,337,西埔村,NULL
184,514,3,517,928,0,0,55.71,484,30,海端村,NULL
0,514,3,517,928,0,0,55.71,484,30,海端村,NULL
49,513,4,517,636,0,0,81.29,390,123,豐功里,NULL
27,511,6,517,686,0,0,75.36,343,168,主信里,NULL
0,511,6,517,686,0,0,75.36,343,168,主信里,NULL
132,511,6,517,700,0,0,73.86,323,188,福林里,NULL
31,515,2,517,683,0,0,75.7,250,265,南橋里,NULL
0,515,2,517,683,0,0,75.7,250,265,南橋里,NULL
383,512,5,517,721,0,0,71.71,210,302,桃源村,NULL
450,513,4,517,639,0,0,80.91,169,344,曲溪村,NULL
0,513,4,517,639,0,0,80.91,169,344,曲溪村,NULL
173,512,4,516,793,0,0,65.07,434,78,鳳信里,NULL
169,512,4,516,715,0,0,72.17,304,208,金盈里,NULL
0,512,4,516,715,0,0,72.17,304,208,金盈里,NULL
133,510,6,516,670,0,0,77.01,294,216,華明里,NULL
0,510,6,516,670,0,0,77.01,294,216,華明里,NULL
65,509,7,516,756,0,0,68.25,293,216,大旗村,NULL
0,509,7,516,756,0,0,68.25,293,216,大旗村,NULL
141,506,10,516,766,0,0,67.36,265,241,南興里,NULL
162,515,1,516,902,0,0,57.21,265,250,崙南村,NULL
0,515,1,516,902,0,0,57.21,265,250,崙南村,NULL
2106,508,8,516,704,0,0,73.3,240,268,隆盛村,NULL
0,508,8,516,704,0,0,73.3,240,268,隆盛村,NULL
765,509,7,516,666,0,0,77.48,143,366,平昌里,NULL
0,509,7,516,666,0,0,77.48,143,366,平昌里,NULL
12,513,2,515,756,0,0,68.12,337,176,仁愛里,NULL
0,513,2,515,756,0,0,68.12,337,176,仁愛里,NULL
3,509,6,515,629,0,0,81.88,334,175,赤松里,NULL
0,509,6,515,629,0,0,81.88,334,175,赤松里,NULL
927,508,7,515,681,0,0,75.62,207,301,三水村,NULL
0,508,7,515,681,0,0,75.62,207,301,三水村,NULL
198,512,3,515,891,0,0,57.8,198,314,埔北村,NULL
0,512,3,515,891,0,0,57.8,198,314,埔北村,NULL
176,510,4,514,700,0,0,73.43,360,150,中寮村,NULL
0,510,4,514,700,0,0,73.43,360,150,中寮村,NULL
626,513,1,514,690,0,0,74.49,290,223,龍興村,NULL
0,513,1,514,690,0,0,74.49,290,223,龍興村,NULL
154,510,4,514,734,0,0,70.03,239,271,傳芳村,NULL
0,510,4,514,734,0,0,70.03,239,271,傳芳村,NULL
64,510,4,514,694,0,0,74.06,227,283,中正里,NULL
0,510,4,514,694,0,0,74.06,227,283,中正里,NULL
187,510,4,514,708,0,0,72.6,225,285,竹山村,NULL
533,513,1,514,678,0,0,75.81,218,295,大營村,NULL
335,513,1,514,717,0,0,71.69,190,323,新港村,NULL
165,507,6,513,799,0,0,64.21,439,68,月眉村,NULL
0,507,6,513,799,0,0,64.21,439,68,月眉村,NULL
161,510,3,513,674,0,0,76.11,349,161,城南里,NULL
0,510,3,513,674,0,0,76.11,349,161,城南里,NULL
87,505,8,513,664,0,0,77.26,311,194,英仁里,NULL
205,510,3,513,672,0,0,76.34,271,239,士林里,NULL
86,511,2,513,662,0,0,77.49,191,320,荖藤里,NULL
241,510,3,513,715,0,0,71.75,131,379,仁和村,NULL
0,510,3,513,715,0,0,71.75,131,379,仁和村,NULL
0,508,4,512,646,0,0,79.26,491,17,丹林村,NULL
81,509,3,512,749,0,0,68.36,449,60,大漢村,NULL
687,505,7,512,701,0,0,73.04,302,203,南東里,NULL
465,506,6,512,689,0,0,74.31,285,221,層林村,NULL
0,506,6,512,689,0,0,74.31,285,221,層林村,NULL
293,504,8,512,725,0,0,70.62,276,228,瑞里村,NULL
0,504,8,512,725,0,0,70.62,276,228,瑞里村,NULL
493,505,7,512,729,0,0,70.23,234,271,新南里,NULL
0,505,7,512,729,0,0,70.23,234,271,新南里,NULL
528,512,0,512,795,0,0,64.4,211,301,長安村,NULL
0,512,0,512,795,0,0,64.4,211,301,長安村,NULL
198,501,11,512,728,0,0,70.33,199,302,篤農村,NULL
180,503,9,512,718,0,0,71.31,174,329,鐵線里,NULL
0,503,9,512,718,0,0,71.31,174,329,鐵線里,NULL
303,507,4,511,706,0,0,72.38,350,157,南湖村,NULL
0,507,4,511,706,0,0,72.38,350,157,南湖村,NULL
86,507,4,511,693,0,0,73.74,278,229,英仁里,NULL
29,507,4,511,679,0,0,75.26,241,266,進士里,NULL
299,499,12,511,730,0,0,70,215,284,季新村,NULL
352,507,4,511,674,0,0,75.82,210,297,圳墘村,NULL
0,507,4,511,674,0,0,75.82,210,297,圳墘村,NULL
366,506,5,511,664,0,0,76.96,206,300,興桐村,NULL
302,508,3,511,786,0,0,65.01,203,305,天福村,NULL
0,508,3,511,786,0,0,65.01,203,305,天福村,NULL
527,504,7,511,694,0,0,73.63,202,302,湳仔村,NULL
0,504,7,511,694,0,0,73.63,202,302,湳仔村,NULL
363,507,4,511,691,0,0,73.95,195,312,營頂里,NULL
0,507,4,511,691,0,0,73.95,195,312,營頂里,NULL
100,505,6,511,772,0,0,66.19,182,323,德和村,NULL
0,505,6,511,772,0,0,66.19,182,323,德和村,NULL
391,504,7,511,719,0,0,71.07,174,330,文峯村,NULL
0,504,7,511,719,0,0,71.07,174,330,文峯村,NULL
216,505,6,511,772,0,0,66.19,132,373,後厝村,NULL
0,505,6,511,772,0,0,66.19,132,373,後厝村,NULL
244,499,11,510,938,0,0,54.37,381,118,春日里,NULL
0,499,11,510,938,0,0,54.37,381,118,春日里,NULL
117,507,3,510,699,0,0,72.96,296,211,仙洞里,NULL
0,507,3,510,699,0,0,72.96,296,211,仙洞里,NULL
216,506,4,510,660,0,0,77.27,287,219,南投里,NULL
0,506,4,510,660,0,0,77.27,287,219,南投里,NULL
184,505,5,510,721,0,0,70.74,258,247,龍安村,NULL
0,505,5,510,721,0,0,70.74,258,247,龍安村,NULL
535,501,9,510,803,0,0,63.51,203,298,華山村,NULL
0,501,9,510,803,0,0,63.51,203,298,華山村,NULL
446,504,6,510,684,0,0,74.56,170,334,內郭村,NULL
0,504,6,510,684,0,0,74.56,170,334,內郭村,NULL
333,500,10,510,691,0,0,73.81,165,335,糠榔村,NULL
0,500,10,510,691,0,0,73.81,165,335,糠榔村,NULL
405,508,2,510,676,0,0,75.44,132,376,安業里,NULL
0,508,2,510,676,0,0,75.44,132,376,安業里,NULL
240,508,2,510,810,0,0,62.96,119,389,欍埔村,NULL
0,508,2,510,810,0,0,62.96,119,389,欍埔村,NULL
550,508,1,509,803,0,0,63.39,474,34,春日村,NULL
0,508,1,509,803,0,0,63.39,474,34,春日村,NULL
77,507,2,509,722,0,0,70.5,251,256,溪邊里,NULL
90,503,6,509,713,0,0,71.39,248,255,泰田里,NULL
23,506,3,509,646,0,0,78.79,151,355,新東村,NULL
163,501,8,509,637,0,0,79.91,149,352,新興村,NULL
709,503,5,508,712,0,0,71.35,313,190,敦厚村,NULL
0,503,5,508,712,0,0,71.35,313,190,敦厚村,NULL
103,504,4,508,651,0,0,78.03,303,201,新店里,NULL
0,504,4,508,651,0,0,78.03,303,201,新店里,NULL
51,506,2,508,706,0,0,71.95,244,262,觀亭村,NULL
375,503,5,508,757,0,0,67.11,201,302,民生村,NULL
0,503,5,508,757,0,0,67.11,201,302,民生村,NULL
82,506,2,508,1241,0,0,40.93,169,337,吉貝村,NULL
0,506,2,508,1241,0,0,40.93,169,337,吉貝村,NULL
201,504,4,508,894,0,0,56.82,168,336,下崙村,NULL
632,505,3,508,662,0,0,76.74,167,338,新厝村,NULL
239,502,6,508,761,0,0,66.75,114,388,松西村,NULL
0,502,6,508,761,0,0,66.75,114,388,松西村,NULL
399,504,3,507,700,0,0,72.43,368,136,二湖村,NULL
0,504,3,507,700,0,0,72.43,368,136,二湖村,NULL
47,501,6,507,648,0,0,78.24,262,239,新民里,NULL
0,501,6,507,648,0,0,78.24,262,239,新民里,NULL
211,500,7,507,781,0,0,64.92,195,305,東正村,NULL
431,500,7,507,692,0,0,73.27,145,355,田寮里,NULL
89,498,8,506,918,0,0,55.12,399,99,德高里,NULL
155,502,4,506,634,0,0,79.81,348,154,龍鳳里,NULL
389,503,3,506,691,0,0,73.23,307,196,中央村,NULL
0,503,3,506,691,0,0,73.23,307,196,中央村,NULL
714,499,7,506,666,0,0,75.98,302,197,四芳村,NULL
0,499,7,506,666,0,0,75.98,302,197,四芳村,NULL
0,500,6,506,771,0,0,65.63,267,233,秀林里,NULL
289,503,3,506,682,0,0,74.19,249,254,內灣里,NULL
305,500,6,506,691,0,0,73.23,217,283,萬富村,NULL
0,500,6,506,691,0,0,73.23,217,283,萬富村,NULL
153,501,5,506,852,0,0,59.39,197,304,湖寮村,NULL
0,501,5,506,852,0,0,59.39,197,304,湖寮村,NULL
593,500,6,506,676,0,0,74.85,193,307,榮和村,NULL
0,500,6,506,676,0,0,74.85,193,307,榮和村,NULL
0,500,5,505,806,0,0,62.66,374,126,大全村,NULL
210,502,3,505,667,0,0,75.71,321,181,正明里,NULL
24,496,9,505,644,0,0,78.42,318,178,東園里,NULL
385,498,7,505,774,0,0,65.25,290,208,瑞田村,NULL
0,498,7,505,774,0,0,65.25,290,208,瑞田村,NULL
381,501,4,505,705,0,0,71.63,270,231,昇平村,NULL
485,503,2,505,670,0,0,75.37,196,307,豐漁里,NULL
0,503,2,505,670,0,0,75.37,196,307,豐漁里,NULL
83,499,6,505,825,0,0,61.21,195,304,奮起里,NULL
223,501,3,504,853,0,0,59.09,446,55,鶴岡村,NULL
0,501,3,504,853,0,0,59.09,446,55,鶴岡村,NULL
1958,498,6,504,765,0,0,65.88,320,178,鼻頭里,NULL
0,498,6,504,765,0,0,65.88,320,178,鼻頭里,NULL
748,497,7,504,682,0,0,73.9,305,192,豐田村,NULL
0,497,7,504,682,0,0,73.9,305,192,豐田村,NULL
398,498,6,504,658,0,0,76.6,302,196,四維里,NULL
0,498,6,504,658,0,0,76.6,302,196,四維里,NULL
123,500,4,504,661,0,0,76.25,244,256,頭港里,NULL
685,496,8,504,643,0,0,78.38,240,256,埤頭里,NULL
0,496,8,504,643,0,0,78.38,240,256,埤頭里,NULL
571,500,4,504,700,0,0,72,215,285,坑厝村,NULL
0,500,4,504,700,0,0,72,215,285,坑厝村,NULL
160,498,5,503,635,0,0,79.21,336,162,城西里,NULL
0,498,5,503,635,0,0,79.21,336,162,城西里,NULL
7,502,1,503,690,0,0,72.9,334,168,中興里,NULL
0,502,1,503,690,0,0,72.9,334,168,中興里,NULL
146,499,4,503,734,0,0,68.53,252,247,四湖村,NULL
333,502,1,503,658,0,0,76.44,251,251,中和里,NULL
0,502,1,503,658,0,0,76.44,251,251,中和里,NULL
1931,499,3,502,713,0,0,70.41,345,154,東和里,NULL
149,496,6,502,724,0,0,69.34,320,176,大里里,NULL
0,496,6,502,724,0,0,69.34,320,176,大里里,NULL
322,497,5,502,681,0,0,73.72,301,196,中正里,NULL
0,497,5,502,681,0,0,73.72,301,196,中正里,NULL
82,496,6,502,669,0,0,75.04,280,216,山脚里,NULL
208,498,4,502,815,0,0,61.6,256,242,港西村,NULL
0,498,4,502,815,0,0,61.6,256,242,港西村,NULL
189,500,2,502,735,0,0,68.3,235,265,白鵝村,NULL
0,500,2,502,735,0,0,68.3,235,265,白鵝村,NULL
394,497,5,502,639,0,0,78.56,183,314,南勢里,NULL
19,497,4,501,731,0,0,68.54,284,213,關山村,NULL
0,497,4,501,731,0,0,68.54,284,213,關山村,NULL
63,496,5,501,691,0,0,72.5,222,274,順天里,NULL
0,496,5,501,691,0,0,72.5,222,274,順天里,NULL
204,500,1,501,854,0,0,58.67,190,310,崙中村,NULL
21,493,8,501,725,0,0,69.1,151,342,竹本村,NULL
0,493,8,501,725,0,0,69.1,151,342,竹本村,NULL
68,493,8,501,775,0,0,64.65,148,345,新湖村,NULL
241,499,2,501,807,0,0,62.08,129,370,塭底村,NULL
0,499,2,501,807,0,0,62.08,129,370,塭底村,NULL
698,496,4,500,599,0,0,83.47,318,178,積穗里,NULL
2186,498,2,500,668,0,0,74.85,307,191,平林村,NULL
539,493,7,500,622,0,0,80.39,282,211,博仁里,NULL
0,493,7,500,622,0,0,80.39,282,211,博仁里,NULL
1646,494,6,500,657,0,0,76.1,276,218,三龍里,NULL
270,496,4,500,676,0,0,73.96,270,226,義和里,NULL
0,496,4,500,676,0,0,73.96,270,226,義和里,NULL
47,491,9,500,733,0,0,68.21,208,283,仙草里,NULL
260,493,7,500,689,0,0,72.57,205,288,湖北里,NULL
0,493,7,500,689,0,0,72.57,205,288,湖北里,NULL
8,498,1,499,761,0,0,65.57,476,22,中柳村、樂華村,NULL
0,498,1,499,761,0,0,65.57,476,22,中柳村、樂華村,NULL
0,498,1,499,761,986,77.18,65.57,476,22,東引鄉,Dongxiang Township
327,495,4,499,641,0,0,77.85,472,23,四季村,NULL
0,495,4,499,641,0,0,77.85,472,23,四季村,NULL
678,494,5,499,605,0,0,82.48,390,104,中堅里,NULL
214,492,7,499,644,0,0,77.48,304,188,三鎮村,NULL
0,492,7,499,644,0,0,77.48,304,188,三鎮村,NULL
64,495,4,499,693,0,0,72.01,241,254,苑南里,NULL
169,491,8,499,685,0,0,72.85,202,289,東光村,NULL
203,497,2,499,852,0,0,58.57,200,297,崙中村,NULL
53,491,8,499,687,0,0,72.63,180,311,廣安里,NULL
0,491,8,499,687,0,0,72.63,180,311,廣安里,NULL
306,495,3,498,694,0,0,71.76,348,147,義和村,NULL
310,494,4,498,639,0,0,77.93,338,156,寶斗村,NULL
0,494,4,498,639,0,0,77.93,338,156,寶斗村,NULL
131,492,6,498,711,0,0,70.04,314,178,白東里,NULL
801,494,4,498,645,0,0,77.21,262,232,五伯村,NULL
0,494,4,498,645,0,0,77.21,262,232,五伯村,NULL
62,495,3,498,685,0,0,72.7,234,261,三平村,NULL
0,495,3,498,685,0,0,72.7,234,261,三平村,NULL
0,486,12,498,733,0,0,67.94,167,319,朝陽里,NULL
8,493,5,498,708,0,0,70.34,127,366,塗師村,NULL
0,493,5,498,708,0,0,70.34,127,366,塗師村,NULL
21,497,0,497,963,0,0,51.61,479,18,榜林村,NULL
262,489,8,497,648,0,0,76.7,294,195,復興里,NULL
0,489,8,497,648,0,0,76.7,294,195,復興里,NULL
352,491,6,497,630,0,0,78.89,238,253,灣裡里,NULL
925,493,4,497,647,0,0,76.82,220,273,三和村,NULL
170,493,4,497,639,0,0,77.78,199,294,美崙村,NULL
0,493,4,497,639,0,0,77.78,199,294,美崙村,NULL
414,491,5,496,610,0,0,81.31,384,107,內灣村,NULL
0,491,5,496,610,0,0,81.31,384,107,內灣村,NULL
2137,490,6,496,671,0,0,73.92,321,169,福德村,NULL
0,490,6,496,671,0,0,73.92,321,169,福德村,NULL
317,493,3,496,647,0,0,76.66,310,183,石井村,NULL
0,493,3,496,647,0,0,76.66,310,183,石井村,NULL
607,493,3,496,802,0,0,61.85,250,243,仁壽里,NULL
0,493,3,496,802,0,0,61.85,250,243,仁壽里,NULL
541,490,6,496,716,0,0,69.27,235,255,崙腳村,NULL
0,490,6,496,716,0,0,69.27,235,255,崙腳村,NULL
150,494,2,496,658,0,0,75.38,228,266,中山里,NULL
0,494,2,496,658,0,0,75.38,228,266,中山里,NULL
965,494,2,496,658,0,0,75.38,226,268,新興村,NULL
0,494,2,496,658,0,0,75.38,226,268,新興村,NULL
613,493,3,496,777,0,0,63.84,212,281,山海里,NULL
294,492,4,496,709,0,0,69.96,207,285,大庄村,NULL
792,491,4,495,607,0,0,81.55,457,34,貿易里,NULL
0,491,4,495,607,0,0,81.55,457,34,貿易里,NULL
197,491,4,495,757,0,0,65.39,290,201,新城村,NULL
777,493,2,495,665,0,0,74.44,236,257,龍潭里,NULL
0,493,2,495,665,0,0,74.44,236,257,龍潭里,NULL
384,493,2,495,718,0,0,68.94,235,258,清水村,NULL
0,493,2,495,718,0,0,68.94,235,258,清水村,NULL
321,494,1,495,659,0,0,75.11,230,264,中口村,NULL
0,494,1,495,659,0,0,75.11,230,264,中口村,NULL
79,491,4,495,663,0,0,74.66,181,310,仁里村,NULL
0,491,4,495,663,0,0,74.66,181,310,仁里村,NULL
194,490,5,495,688,0,0,71.95,163,327,太康村,NULL
167,491,3,494,724,0,0,68.23,471,20,金崙村,NULL
47,492,2,494,651,0,0,75.88,315,177,龍泉里,NULL
44,492,2,494,677,0,0,72.97,273,219,智誠里,NULL
73,491,3,494,628,0,0,78.66,258,233,仁武里,NULL
0,491,3,494,628,0,0,78.66,258,233,仁武里,NULL
45,493,1,494,718,0,0,68.8,208,285,關嶺里,NULL
176,491,3,494,644,0,0,76.71,155,336,鹿東村,NULL
0,491,3,494,644,0,0,76.71,155,336,鹿東村,NULL
336,490,3,493,655,0,0,75.27,465,25,大隘村,NULL
90,490,3,493,789,0,0,62.48,312,178,德高里,NULL
350,493,0,493,726,0,0,67.91,261,232,延山里,NULL
0,493,0,493,726,0,0,67.91,261,232,延山里,NULL
109,491,2,493,674,0,0,73.15,222,269,龍德里,NULL
67,489,4,493,604,0,0,81.62,186,303,東寧村,NULL
253,486,6,492,626,0,0,78.59,423,63,光華里,NULL
248,489,3,492,638,0,0,77.12,317,172,南龍里,NULL
117,489,3,492,701,0,0,70.19,273,216,公園里,NULL
262,487,5,492,626,0,0,78.59,242,245,新豐里,NULL
0,487,5,492,626,0,0,78.59,242,245,新豐里,NULL
581,486,6,492,774,0,0,63.57,228,258,海口村,NULL
0,486,6,492,774,0,0,63.57,228,258,海口村,NULL
46,490,2,492,738,0,0,66.67,194,296,金竹村,NULL
0,490,2,492,738,0,0,66.67,194,296,金竹村,NULL
371,488,4,492,611,0,0,80.52,181,307,為隨里,NULL
0,488,4,492,611,0,0,80.52,181,307,為隨里,NULL
239,486,6,492,657,0,0,74.89,172,314,苓和村,NULL
529,487,5,492,663,0,0,74.21,167,320,大洲村,NULL
0,487,5,492,663,0,0,74.21,167,320,大洲村,NULL
563,488,2,490,736,0,0,66.58,450,38,丹路村,NULL
0,488,2,490,736,0,0,66.58,450,38,丹路村,NULL
0,485,5,490,628,0,0,78.03,286,199,七星村,NULL
177,485,5,490,632,0,0,77.53,285,200,新富里,NULL
0,485,5,490,632,0,0,77.53,285,200,新富里,NULL
416,489,1,490,619,0,0,79.16,276,213,忠孝里,NULL
97,483,7,490,672,0,0,72.92,238,245,東昌里,NULL
82,487,3,490,686,0,0,71.43,224,263,興新里,NULL
611,476,14,490,777,0,0,63.06,222,254,德和里,NULL
0,476,14,490,777,0,0,63.06,222,254,德和里,NULL
175,490,0,490,683,0,0,71.74,215,275,永豐村,NULL
0,490,0,490,683,0,0,71.74,215,275,永豐村,NULL
647,482,8,490,670,0,0,73.13,210,272,慶西村,NULL
532,485,5,490,670,0,0,73.13,210,275,中寮村,NULL
0,485,5,490,670,0,0,73.13,210,275,中寮村,NULL
538,489,1,490,658,0,0,74.47,204,285,草嶺村,NULL
0,489,1,490,658,0,0,74.47,204,285,草嶺村,NULL
226,480,9,489,947,0,0,51.64,427,53,富民村,NULL
0,480,9,489,947,0,0,51.64,427,53,富民村,NULL
84,486,3,489,840,0,0,58.21,392,94,里壠里,NULL
0,488,1,489,825,0,0,59.27,344,144,香蘭村,NULL
45,485,4,489,643,0,0,76.05,326,159,面前里,NULL
947,483,6,489,644,0,0,75.93,272,211,深圳村,NULL
0,483,6,489,644,0,0,75.93,272,211,深圳村,NULL
336,484,5,489,664,0,0,73.64,234,250,新港村,NULL
200,485,4,489,655,0,0,74.66,184,301,大農村,NULL
0,485,4,489,655,0,0,74.66,184,301,大農村,NULL
92,486,3,489,653,0,0,74.89,129,357,新達里,NULL
78,480,8,488,998,0,0,48.9,407,73,三仙里,NULL
365,480,8,488,723,0,0,67.5,292,188,路上村,NULL
0,480,8,488,723,0,0,67.5,292,188,路上村,NULL
355,483,5,488,701,0,0,69.61,285,198,富州里,NULL
0,483,5,488,701,0,0,69.61,285,198,富州里,NULL
0,480,8,488,695,0,0,70.22,250,230,大雁村,NULL
88,485,3,488,692,0,0,70.52,244,241,南勢里,NULL
0,485,3,488,692,0,0,70.52,244,241,南勢里,NULL
420,485,3,488,673,0,0,72.51,216,269,西關里,NULL
0,485,3,488,673,0,0,72.51,216,269,西關里,NULL
424,485,2,487,619,0,0,78.68,252,233,彌仁村,NULL
0,485,2,487,619,0,0,78.68,252,233,彌仁村,NULL
394,482,4,486,640,0,0,75.94,405,77,四湖村,NULL
0,482,4,486,640,0,0,75.94,405,77,四湖村,NULL
506,483,3,486,720,0,0,67.5,328,155,永和村,NULL
0,483,3,486,720,0,0,67.5,328,155,永和村,NULL
312,480,6,486,707,0,0,68.74,179,301,行健村,NULL
0,480,6,486,707,0,0,68.74,179,301,行健村,NULL
321,482,4,486,709,0,0,68.55,166,316,油車村,NULL
234,468,17,485,928,0,0,52.26,357,111,泰昌里,NULL
136,482,3,485,677,0,0,71.64,309,173,史港里,NULL
0,482,3,485,677,0,0,71.64,309,173,史港里,NULL
99,481,4,485,632,0,0,76.74,282,199,廣福里,NULL
0,481,4,485,632,0,0,76.74,282,199,廣福里,NULL
158,481,4,485,615,0,0,78.86,273,208,福翠里,NULL
68,482,3,485,792,0,0,61.24,230,252,龍門村,NULL
95,479,6,485,640,0,0,75.78,222,257,香楊村,NULL
273,478,7,485,682,0,0,71.11,205,273,鳳鳴里,NULL
0,478,7,485,682,0,0,71.11,205,273,鳳鳴里,NULL
156,480,5,485,916,0,0,52.95,200,280,內湖村,NULL
0,480,5,485,916,0,0,52.95,200,280,內湖村,NULL
199,482,3,485,656,0,0,73.93,151,331,篤農村,NULL
147,478,6,484,668,0,0,72.46,431,47,精英村,NULL
6,475,9,484,577,0,0,83.88,341,134,隘口里,NULL
0,475,9,484,577,0,0,83.88,341,134,隘口里,NULL
0,480,4,484,739,0,0,65.49,327,153,神木村,NULL
812,479,5,484,636,0,0,76.1,274,205,倡和村,NULL
0,479,5,484,636,0,0,76.1,274,205,倡和村,NULL
69,479,5,484,768,0,0,63.02,240,239,龍門村,NULL
155,478,5,483,644,0,0,75,437,41,三和村,NULL
99,477,6,483,616,0,0,78.41,328,149,下竹里,NULL
0,477,6,483,616,0,0,78.41,328,149,下竹里,NULL
811,481,2,483,651,0,0,74.19,284,197,源泉村,NULL
0,481,2,483,651,0,0,74.19,284,197,源泉村,NULL
620,478,5,483,765,0,0,63.14,281,197,南灣里,NULL
118,478,5,483,679,0,0,71.13,261,217,岱江里,NULL
0,478,5,483,679,0,0,71.13,261,217,岱江里,NULL
99,482,1,483,773,0,0,62.48,254,228,明峰村,NULL
26,480,3,483,651,0,0,74.19,215,265,長安村,NULL
81,478,5,483,665,0,0,72.63,193,285,佳禾里,NULL
0,478,5,483,665,0,0,72.63,193,285,佳禾里,NULL
0,480,3,483,673,0,0,71.77,179,301,溪北村,NULL
190,476,6,482,839,0,0,57.45,453,23,東富村,NULL
51,478,4,482,643,0,0,74.96,450,28,青山村,NULL
0,478,4,482,643,0,0,74.96,450,28,青山村,NULL
20,478,4,482,676,0,0,71.3,332,146,民有里,NULL
0,478,4,482,676,0,0,71.3,332,146,民有里,NULL
1942,477,5,482,632,0,0,76.27,303,174,上天里,NULL
49,481,1,482,777,0,0,62.03,269,212,嘉隆村,NULL
57,481,1,482,647,0,0,74.5,264,217,光興村,NULL
0,481,1,482,647,0,0,74.5,264,217,光興村,NULL
43,474,8,482,633,0,0,76.15,233,241,文昌里,NULL
0,474,8,482,633,0,0,76.15,233,241,文昌里,NULL
99,480,2,482,662,0,0,72.81,228,252,田心里,NULL
197,475,7,482,683,0,0,70.57,185,290,埔南村,NULL
0,475,7,482,683,0,0,70.57,185,290,埔南村,NULL
168,476,5,481,616,0,0,78.08,293,183,開元里,NULL
0,476,5,481,616,0,0,78.08,293,183,開元里,NULL
800,475,6,481,637,0,0,75.51,261,214,過圳村,NULL
0,475,6,481,637,0,0,75.51,261,214,過圳村,NULL
37,474,7,481,747,0,0,64.39,207,267,木梓村,NULL
0,474,7,481,747,0,0,64.39,207,267,木梓村,NULL
228,477,4,481,757,0,0,63.54,169,308,後寮村,NULL
0,477,4,481,757,0,0,63.54,169,308,後寮村,NULL
251,479,2,481,704,0,0,68.32,168,311,安平村,NULL
0,479,2,481,704,0,0,68.32,168,311,安平村,NULL
23,477,4,481,743,0,0,64.74,131,346,魚寮村,NULL
0,477,4,481,743,0,0,64.74,131,346,魚寮村,NULL
0,477,3,480,983,1183,83.09,48.83,453,24,莒光鄉,Shuguang Township
101,474,6,480,629,0,0,76.31,310,164,同風里,NULL
0,474,6,480,629,0,0,76.31,310,164,同風里,NULL
508,473,7,480,747,0,0,64.26,305,168,公館村,NULL
161,471,9,480,784,0,0,61.22,266,205,崙北村,NULL
559,475,5,480,632,0,0,75.95,229,246,重慶里,NULL
0,475,5,480,632,0,0,75.95,229,246,重慶里,NULL
248,471,9,480,697,0,0,68.87,174,297,廣山村,NULL
0,471,9,480,697,0,0,68.87,174,297,廣山村,NULL
78,473,7,480,707,0,0,67.89,129,344,中樞村,NULL
0,473,7,480,707,0,0,67.89,129,344,中樞村,NULL
0,470,9,479,814,0,0,58.85,444,26,大竹村,NULL
104,470,9,479,737,0,0,64.99,375,95,太平村,NULL
294,476,3,479,704,0,0,68.04,294,182,景山里,NULL
0,476,3,479,704,0,0,68.04,294,182,景山里,NULL
186,473,6,479,676,0,0,70.86,268,205,龍岩村,NULL
0,473,6,479,676,0,0,70.86,268,205,龍岩村,NULL
374,473,6,479,568,0,0,84.33,230,243,萬安村,NULL
0,473,6,479,568,0,0,84.33,230,243,萬安村,NULL
589,473,6,479,719,0,0,66.62,226,247,張厝村,NULL
0,473,6,479,719,0,0,66.62,226,247,張厝村,NULL
510,474,5,479,645,0,0,74.26,222,252,大同村,NULL
0,474,5,479,645,0,0,74.26,222,252,大同村,NULL
141,476,3,479,648,0,0,73.92,188,288,建興村,NULL
243,476,3,479,706,0,0,67.85,158,318,將富村,NULL
0,476,3,479,706,0,0,67.85,158,318,將富村,NULL
29,475,3,478,910,0,0,52.53,456,19,蓮庵里,NULL
0,475,3,478,910,0,0,52.53,456,19,蓮庵里,NULL
57,475,3,478,616,0,0,77.6,425,50,建功里,NULL
171,478,0,478,641,0,0,74.57,372,106,鳳禮里,NULL
0,478,0,478,641,0,0,74.57,372,106,鳳禮里,NULL
245,475,3,478,644,0,0,74.22,302,173,東香里,NULL
40,474,4,478,602,0,0,79.4,268,206,崇文里,NULL
0,474,4,478,602,0,0,79.4,268,206,崇文里,NULL
91,470,8,478,614,0,0,77.85,245,225,興化里,NULL
0,470,8,478,614,0,0,77.85,245,225,興化里,NULL
478,474,4,478,705,0,0,67.8,185,289,北鎮村,NULL
0,474,4,478,705,0,0,67.8,185,289,北鎮村,NULL
314,473,5,478,688,0,0,69.48,173,300,大潭村,NULL
0,473,5,478,688,0,0,69.48,173,300,大潭村,NULL
2102,469,9,478,630,0,0,75.87,173,296,烏塗村,NULL
0,469,9,478,630,0,0,75.87,173,296,烏塗村,NULL
392,476,1,477,585,0,0,81.54,386,90,下埔村,NULL
0,476,1,477,585,0,0,81.54,386,90,下埔村,NULL
425,470,7,477,644,0,0,74.07,384,86,豐林村,NULL
0,470,7,477,644,0,0,74.07,384,86,豐林村,NULL
119,473,4,477,591,0,0,80.71,369,104,三重里,NULL
1943,471,6,477,632,0,0,75.47,270,201,上天里,NULL
282,470,7,477,667,0,0,71.51,248,222,圳北村,NULL
0,470,7,477,667,0,0,71.51,248,222,圳北村,NULL
16,473,4,477,709,0,0,67.28,245,228,大田村,NULL
28,469,8,477,651,0,0,73.27,200,269,大埔村,NULL
0,469,8,477,651,0,0,73.27,200,269,大埔村,NULL
292,474,3,477,686,0,0,69.53,180,294,大丘村,NULL
0,474,3,477,686,0,0,69.53,180,294,大丘村,NULL
404,474,3,477,632,0,0,75.47,162,312,安東里,NULL
0,474,3,477,632,0,0,75.47,162,312,安東里,NULL
453,472,4,476,677,0,0,70.31,255,217,萬隆村,NULL
73,472,4,476,681,0,0,69.9,211,261,新寮里,NULL
0,472,4,476,681,0,0,69.9,211,261,新寮里,NULL
1,475,1,476,546,0,0,87.18,203,272,長潭里,NULL
0,475,1,476,546,0,0,87.18,203,272,長潭里,NULL
210,472,3,475,725,0,0,65.52,421,51,萬榮村,NULL
0,472,3,475,725,0,0,65.52,421,51,萬榮村,NULL
13,473,2,475,598,0,0,79.43,313,160,太平里,NULL
392,466,9,475,653,0,0,72.74,216,250,湖本村,NULL
0,466,9,475,653,0,0,72.74,216,250,湖本村,NULL
376,473,2,475,602,0,0,78.9,146,327,穀興里,NULL
0,473,2,475,602,0,0,78.9,146,327,穀興里,NULL
208,469,5,474,690,0,0,68.7,247,222,過嶺村,NULL
74,471,3,474,693,0,0,68.4,206,265,雙溪里,NULL
0,471,3,474,693,0,0,68.4,206,265,雙溪里,NULL
305,472,2,474,678,0,0,69.91,173,299,來惠村,NULL
179,473,0,473,883,0,0,53.57,429,44,中寮村,NULL
0,473,0,473,883,0,0,53.57,429,44,中寮村,NULL
0,472,1,473,743,0,0,63.66,301,171,武登村,NULL
130,465,8,473,663,0,0,71.34,273,192,白東里,NULL
626,467,6,473,637,0,0,74.25,167,300,拷潭村,NULL
532,468,5,473,679,0,0,69.66,137,331,麻園村,NULL
0,468,5,473,679,0,0,69.66,137,331,麻園村,NULL
204,467,5,472,793,0,0,59.52,458,9,土坂村,NULL
0,467,5,472,793,0,0,59.52,458,9,土坂村,NULL
2216,469,3,472,651,0,0,72.5,297,172,大同村,NULL
0,469,3,472,651,0,0,72.5,297,172,大同村,NULL
246,470,2,472,612,0,0,77.12,293,177,內興里,NULL
0,465,7,472,688,0,0,68.6,247,218,魚行村,NULL
335,470,1,471,626,0,0,75.24,441,29,澳花村,NULL
0,470,1,471,626,0,0,75.24,441,29,澳花村,NULL
177,467,4,471,584,0,0,80.65,304,163,美仁里,NULL
0,467,4,471,584,0,0,80.65,304,163,美仁里,NULL
110,465,6,471,595,0,0,79.16,214,251,康莊里,NULL
0,465,6,471,595,0,0,79.16,214,251,康莊里,NULL
526,463,8,471,689,0,0,68.36,208,255,土庫村,NULL
0,463,8,471,689,0,0,68.36,208,255,土庫村,NULL
258,462,9,471,661,0,0,71.26,118,344,排路里,NULL
0,462,9,471,661,0,0,71.26,118,344,排路里,NULL
4,469,1,470,739,0,0,63.6,434,35,桃源村,NULL
0,469,1,470,739,0,0,63.6,434,35,桃源村,NULL
19,459,11,470,601,0,0,78.2,358,101,大同里,NULL
0,459,11,470,601,0,0,78.2,358,101,大同里,NULL
1921,466,4,470,618,0,0,76.05,301,165,龍安里,NULL
0,466,4,470,618,0,0,76.05,301,165,龍安里,NULL
0,468,2,470,726,0,0,64.74,288,180,五城村,NULL
131,468,2,470,674,0,0,69.73,267,201,向善里,NULL
0,468,2,470,674,0,0,69.73,267,201,向善里,NULL
2139,459,11,470,631,0,0,74.48,210,249,店子村,NULL
0,459,11,470,631,0,0,74.48,210,249,店子村,NULL
103,465,5,470,663,0,0,70.89,172,293,三慶里,NULL
470,466,3,469,653,0,0,71.82,301,165,頂庄里,NULL
0,466,3,469,653,0,0,71.82,301,165,頂庄里,NULL
2172,466,3,469,701,0,0,66.9,263,203,嶺腳村,NULL
0,466,3,469,701,0,0,66.9,263,203,嶺腳村,NULL
2188,462,7,469,708,0,0,66.24,231,231,上林村,NULL
0,462,7,469,708,0,0,66.24,231,231,上林村,NULL
58,465,4,469,724,0,0,64.78,152,313,沙港村,NULL
0,465,4,469,724,0,0,64.78,152,313,沙港村,NULL
399,464,5,469,579,0,0,81,114,350,大山里,NULL
0,464,5,469,579,0,0,81,114,350,大山里,NULL
276,462,6,468,642,0,0,72.9,288,174,永順里、永昌里,NULL
0,462,6,468,642,0,0,72.9,288,174,永順里、永昌里,NULL
147,465,3,468,630,0,0,74.29,273,192,樂一里,NULL
0,465,3,468,630,0,0,74.29,273,192,樂一里,NULL
456,457,11,468,639,0,0,73.24,259,198,中正村,NULL
86,463,5,468,596,0,0,78.52,247,216,石鎮里,NULL
0,463,5,468,596,0,0,78.52,247,216,石鎮里,NULL
607,465,3,468,594,0,0,78.79,231,234,北平村,NULL
0,465,3,468,594,0,0,78.79,231,234,北平村,NULL
27,466,2,468,724,0,0,64.64,205,261,新興村,NULL
0,466,2,468,724,0,0,64.64,205,261,新興村,NULL
68,463,4,467,976,0,0,47.85,413,50,信義里,NULL
83,464,3,467,988,0,0,47.27,379,85,鳥嶼村,NULL
0,464,3,467,988,0,0,47.27,379,85,鳥嶼村,NULL
161,464,3,467,551,0,0,84.75,344,120,東興里,NULL
0,464,3,467,551,0,0,84.75,344,120,東興里,NULL
35,461,6,467,720,0,0,64.86,232,229,光華村,NULL
0,461,6,467,720,0,0,64.86,232,229,光華村,NULL
189,463,4,467,753,0,0,62.02,179,284,瓦磘村,NULL
578,458,8,466,624,0,0,74.68,259,199,豐榮里,NULL
771,464,2,466,652,0,0,71.47,256,208,東源里,NULL
0,464,2,466,652,0,0,71.47,256,208,東源里,NULL
401,456,10,466,720,0,0,64.72,237,219,豐田里,NULL
108,464,2,466,613,0,0,76.02,223,241,榮檜里,NULL
0,464,2,466,613,0,0,76.02,223,241,榮檜里,NULL
547,461,5,466,626,0,0,74.44,219,242,大庄村,NULL
0,461,5,466,626,0,0,74.44,219,242,大庄村,NULL
457,459,7,466,630,0,0,73.97,218,241,中正村,NULL
63,463,3,466,676,0,0,68.93,202,261,木柵村,NULL
0,463,3,466,676,0,0,68.93,202,261,木柵村,NULL
135,460,6,466,625,0,0,74.56,196,264,導民里,NULL
28,464,1,465,893,0,0,52.07,443,21,溪湖里,NULL
0,464,1,465,893,0,0,52.07,443,21,溪湖里,NULL
186,460,5,465,578,0,0,80.45,330,130,新力里,NULL
0,460,5,465,578,0,0,80.45,330,130,新力里,NULL
108,463,2,465,605,0,0,76.86,202,261,福得里,NULL
0,463,2,465,605,0,0,76.86,202,261,福得里,NULL
172,457,8,465,660,0,0,70.45,201,256,龍蛟村,NULL
0,457,8,465,660,0,0,70.45,201,256,龍蛟村,NULL
207,463,2,465,591,0,0,78.68,173,290,大堀村,NULL
216,461,4,465,606,0,0,76.73,169,292,科里村,NULL
52,461,3,464,587,0,0,79.05,426,35,青葉村,NULL
0,461,3,464,587,0,0,79.05,426,35,青葉村,NULL
93,458,6,464,626,0,0,74.12,398,60,和平村,NULL
286,461,3,464,571,0,0,81.26,382,79,力行村,NULL
266,458,6,464,631,0,0,73.53,277,181,南隘里,NULL
0,458,6,464,631,0,0,73.53,277,181,南隘里,NULL
244,459,4,463,616,0,0,75.16,273,186,桃源里,NULL
0,459,4,463,616,0,0,75.16,273,186,桃源里,NULL
75,460,3,463,694,0,0,66.71,226,234,慈安村,NULL
0,460,3,463,694,0,0,66.71,226,234,慈安村,NULL
117,457,6,463,578,0,0,80.1,212,245,鎮平里,NULL
521,461,2,463,647,0,0,71.56,200,261,樹腳村,NULL
0,461,2,463,647,0,0,71.56,200,261,樹腳村,NULL
1,457,6,463,608,0,0,76.15,197,260,東和里,NULL
0,457,6,463,608,0,0,76.15,197,260,東和里,NULL
87,457,6,463,575,0,0,80.52,194,263,頂北里,NULL
0,457,6,463,575,0,0,80.52,194,263,頂北里,NULL
328,458,5,463,629,0,0,73.61,138,320,看坪村,NULL
0,458,5,463,629,0,0,73.61,138,320,看坪村,NULL
381,455,7,462,730,0,0,63.29,310,145,崙腳村,NULL
0,455,7,462,730,0,0,63.29,310,145,崙腳村,NULL
65,458,4,462,594,0,0,77.78,240,218,大義里,NULL
233,456,6,462,716,0,0,64.53,240,216,灣東村,NULL
0,456,6,462,716,0,0,64.53,240,216,灣東村,NULL
330,456,6,462,597,0,0,77.39,157,299,竹港村,NULL
0,456,6,462,597,0,0,77.39,157,299,竹港村,NULL
202,458,3,461,809,0,0,56.98,382,76,港口村,NULL
0,458,3,461,809,0,0,56.98,382,76,港口村,NULL
148,452,9,461,598,0,0,77.09,245,207,新北里,NULL
0,452,9,461,598,0,0,77.09,245,207,新北里,NULL
44,457,4,461,577,0,0,79.9,244,213,蘭井里,NULL
0,457,4,461,577,0,0,79.9,244,213,蘭井里,NULL
614,458,3,461,765,0,0,60.26,196,262,山海里,NULL
2005,455,6,461,623,0,0,74,193,262,大科村,NULL
351,455,5,460,611,0,0,75.29,329,126,興隆村,NULL
0,455,5,460,611,0,0,75.29,329,126,興隆村,NULL
97,457,3,460,739,0,0,62.25,299,158,初鹿村,NULL
1,458,2,460,569,0,0,80.84,291,167,南門里,NULL
0,458,2,460,569,0,0,80.84,291,167,南門里,NULL
75,458,2,460,726,0,0,63.36,285,173,大石村,NULL
0,458,2,460,726,0,0,63.36,285,173,大石村,NULL
352,460,0,460,666,0,0,69.07,267,193,山崇里,NULL
465,459,1,460,682,0,0,67.45,240,219,豐岡村,NULL
0,459,1,460,682,0,0,67.45,240,219,豐岡村,NULL
766,454,6,460,645,0,0,71.32,218,236,溪頂村,NULL
0,454,6,460,645,0,0,71.32,218,236,溪頂村,NULL
179,453,6,459,661,0,0,69.44,309,144,金山里,NULL
0,453,6,459,661,0,0,69.44,309,144,金山里,NULL
177,455,4,459,710,0,0,64.65,296,159,大榮里,NULL
133,454,5,459,615,0,0,74.63,255,199,長安里,NULL
0,454,5,459,615,0,0,74.63,255,199,長安里,NULL
215,453,6,459,719,0,0,63.84,234,219,科里村,NULL
1836,454,5,459,617,0,0,74.39,227,227,溪北里,NULL
230,456,3,459,730,0,0,62.88,195,261,西井村,NULL
0,456,3,459,730,0,0,62.88,195,261,西井村,NULL
242,455,4,459,611,0,0,75.12,122,333,北埔村,NULL
0,455,4,459,611,0,0,75.12,122,333,北埔村,NULL
269,451,7,458,567,0,0,80.78,376,75,中坑村,NULL
0,451,7,458,567,0,0,80.78,376,75,中坑村,NULL
150,453,5,458,665,0,0,68.87,316,137,龜山里,NULL
0,453,5,458,665,0,0,68.87,316,137,龜山里,NULL
514,453,5,458,765,0,0,59.87,230,223,頂庄村,NULL
0,453,5,458,765,0,0,59.87,230,223,頂庄村,NULL
167,456,2,458,596,0,0,76.85,189,267,履豐村,NULL
0,456,2,458,596,0,0,76.85,189,267,履豐村,NULL
27,453,5,458,631,0,0,72.58,174,279,長安村,NULL
128,454,4,458,665,0,0,68.87,149,305,後宅里,NULL
0,454,4,458,665,0,0,68.87,149,305,後宅里,NULL
0,453,4,457,724,0,0,63.12,427,26,發祥村,NULL
162,455,2,457,592,0,0,77.2,240,215,秀水村,NULL
87,449,8,457,633,0,0,72.2,209,240,新庄里,NULL
0,449,8,457,633,0,0,72.2,209,240,新庄里,NULL
245,457,0,457,578,0,0,79.07,125,332,統嶺村,NULL
0,457,0,457,578,0,0,79.07,125,332,統嶺村,NULL
802,456,0,456,557,0,0,81.87,430,26,金龍里,NULL
0,456,0,456,557,0,0,81.87,430,26,金龍里,NULL
648,450,6,456,582,0,0,78.35,345,105,中和村,NULL
0,450,6,456,582,0,0,78.35,345,105,中和村,NULL
226,451,5,456,761,0,0,59.92,177,274,嶺南村,NULL
0,451,5,456,761,0,0,59.92,177,274,嶺南村,NULL
40,453,2,455,877,0,0,51.88,435,18,西園里,NULL
0,453,2,455,877,0,0,51.88,435,18,西園里,NULL
167,453,2,455,723,0,0,62.93,348,105,水璉村,NULL
26,449,6,455,638,0,0,71.32,307,142,主工里,NULL
0,449,6,455,638,0,0,71.32,307,142,主工里,NULL
272,448,7,455,622,0,0,73.15,272,176,龍津里,NULL
0,448,7,455,622,0,0,73.15,272,176,龍津里,NULL
180,450,4,454,698,0,0,65.04,444,6,安招村,NULL
195,451,3,454,628,0,0,72.29,266,185,新置村,NULL
366,452,2,454,678,0,0,66.96,243,209,瑞竹里,NULL
0,452,2,454,678,0,0,66.96,243,209,瑞竹里,NULL
334,452,2,454,604,0,0,75.17,223,229,福興里,NULL
0,452,2,454,604,0,0,75.17,223,229,福興里,NULL
283,454,0,454,594,0,0,76.43,206,248,雙溪村,NULL
0,454,0,454,594,0,0,76.43,206,248,雙溪村,NULL
98,451,3,454,645,0,0,70.39,167,284,中洲里,NULL
173,446,8,454,644,0,0,70.5,148,298,溪洲村,NULL
377,450,3,453,594,0,0,76.26,303,147,和雅村,NULL
0,450,3,453,594,0,0,76.26,303,147,和雅村,NULL
287,449,4,453,575,0,0,78.78,300,149,復興里,NULL
18,453,0,453,597,0,0,75.88,273,180,神農里,NULL
0,453,0,453,597,0,0,75.88,273,180,神農里,NULL
756,444,9,453,634,0,0,71.45,235,209,南鎮村,NULL
0,444,9,453,634,0,0,71.45,235,209,南鎮村,NULL
110,450,3,453,640,0,0,70.78,234,216,過溝里,NULL
36,448,5,453,590,0,0,76.78,204,244,建國里,NULL
0,448,5,453,590,0,0,76.78,204,244,建國里,NULL
109,450,2,452,600,0,0,75.33,375,75,榮華村,NULL
0,450,2,452,600,0,0,75.33,375,75,榮華村,NULL
691,445,7,452,586,0,0,77.13,333,112,博愛村,NULL
381,446,6,452,616,0,0,73.38,198,248,六合村,NULL
104,444,7,451,618,0,0,72.98,426,18,文蘭村,NULL
321,448,3,451,608,0,0,74.18,342,106,松羅村,NULL
0,448,3,451,608,0,0,74.18,342,106,松羅村,NULL
424,445,6,451,597,0,0,75.54,336,109,和興村,NULL
0,445,6,451,597,0,0,75.54,336,109,和興村,NULL
23,440,11,451,660,0,0,68.33,300,140,復國里,NULL
0,440,11,451,660,0,0,68.33,300,140,復國里,NULL
488,446,5,451,592,0,0,76.18,234,212,大華村,NULL
0,446,5,451,592,0,0,76.18,234,212,大華村,NULL
135,448,3,451,652,0,0,69.17,219,229,永春里,NULL
0,448,3,451,652,0,0,69.17,219,229,永春里,NULL
32,449,2,451,683,0,0,66.03,167,282,祐民里,NULL
0,449,2,451,683,0,0,66.03,167,282,祐民里,NULL
96,445,5,450,830,0,0,54.22,349,96,外垵村,NULL
422,444,6,450,623,0,0,72.23,313,131,永興村,NULL
0,444,6,450,623,0,0,72.23,313,131,永興村,NULL
334,446,4,450,627,0,0,71.77,264,182,下坪里,NULL
8,449,1,450,724,0,0,62.15,229,220,興華村,NULL
172,445,5,450,692,0,0,65.03,224,221,和興村,NULL
0,445,5,450,692,0,0,65.03,224,221,和興村,NULL
36,446,4,450,695,0,0,64.75,221,225,興仁里,NULL
0,446,4,450,695,0,0,64.75,221,225,興仁里,NULL
28,448,2,450,624,0,0,72.12,194,254,新寮村,NULL
0,448,2,450,624,0,0,72.12,194,254,新寮村,NULL
255,447,3,450,620,0,0,72.58,174,273,公舘里,NULL
0,447,3,450,620,0,0,72.58,174,273,公舘里,NULL
0,445,5,450,639,0,0,70.42,155,290,將貴村,NULL
313,445,4,449,579,0,0,77.55,328,117,油田村,NULL
0,445,4,449,579,0,0,77.55,328,117,油田村,NULL
53,445,4,449,618,0,0,72.65,252,193,中埔村,NULL
0,445,4,449,618,0,0,72.65,252,193,中埔村,NULL
39,445,4,449,760,0,0,59.08,175,270,集來村,NULL
130,444,4,448,806,0,0,55.58,331,113,大埔村,NULL
0,444,4,448,806,0,0,55.58,331,113,大埔村,NULL
121,444,4,448,643,0,0,69.67,226,218,福興里,NULL
0,444,4,448,643,0,0,69.67,226,218,福興里,NULL
79,443,5,448,617,0,0,72.61,195,248,水坡里,NULL
0,443,5,448,617,0,0,72.61,195,248,水坡里,NULL
553,445,2,447,642,0,0,69.63,424,21,歸崇村,NULL
0,445,2,447,642,0,0,69.63,424,21,歸崇村,NULL
551,443,4,447,638,0,0,70.06,411,32,古華村,NULL
0,443,4,447,638,0,0,70.06,411,32,古華村,NULL
391,442,5,447,579,0,0,77.2,367,75,高埔村,NULL
0,442,5,447,579,0,0,77.2,367,75,高埔村,NULL
170,444,3,447,632,0,0,70.73,361,83,鳳義里,NULL
0,444,3,447,632,0,0,70.73,361,83,鳳義里,NULL
58,444,3,447,788,0,0,56.73,322,122,四美村,NULL
183,441,6,447,620,0,0,72.1,272,169,八南里,NULL
0,441,6,447,620,0,0,72.1,272,169,八南里,NULL
290,444,3,447,602,0,0,74.25,172,272,菁埔村,NULL
0,444,3,447,602,0,0,74.25,172,272,菁埔村,NULL
686,443,3,446,608,0,0,73.36,169,274,王行里,NULL
224,440,6,446,711,0,0,62.73,144,296,尖山村,NULL
0,440,6,446,711,0,0,62.73,144,296,尖山村,NULL
182,442,4,446,585,0,0,76.24,135,307,角宿村,NULL
562,442,3,445,664,0,0,67.02,390,52,楓林村,NULL
0,442,3,445,664,0,0,67.02,390,52,楓林村,NULL
343,440,5,445,561,0,0,79.32,238,202,楓坑村,NULL
0,440,5,445,561,0,0,79.32,238,202,楓坑村,NULL
618,442,3,445,713,0,0,62.41,201,241,水泉里,NULL
373,443,2,445,554,0,0,80.32,190,253,萬後村,NULL
0,443,2,445,554,0,0,80.32,190,253,萬後村,NULL
36,444,1,445,739,0,0,60.22,177,267,杉林村,NULL
0,444,1,445,739,0,0,60.22,177,267,杉林村,NULL
25,442,3,445,610,0,0,72.95,169,273,東振村,NULL
0,442,3,445,610,0,0,72.95,169,273,東振村,NULL
695,443,1,444,562,0,0,79,258,185,灰磘里,NULL
0,443,1,444,562,0,0,79,258,185,灰磘里,NULL
95,438,6,444,594,0,0,74.75,232,206,菜園里,NULL
0,438,6,444,594,0,0,74.75,232,206,菜園里,NULL
580,440,4,444,692,0,0,64.16,201,239,田中村,NULL
0,440,4,444,692,0,0,64.16,201,239,田中村,NULL
518,442,2,444,536,0,0,82.84,197,245,南安村,NULL
0,442,2,444,536,0,0,82.84,197,245,南安村,NULL
15,442,2,444,638,0,0,69.59,167,275,溪厝村,NULL
0,442,2,444,638,0,0,69.59,167,275,溪厝村,NULL
564,437,6,443,620,0,0,71.45,407,30,草埔村,NULL
0,437,6,443,620,0,0,71.45,407,30,草埔村,NULL
154,441,2,443,583,0,0,75.99,390,51,三和村,NULL
41,437,6,443,585,0,0,75.73,241,196,鹽樹村,NULL
2229,440,3,443,604,0,0,73.34,234,206,三界村,NULL
0,440,3,443,604,0,0,73.34,234,206,三界村,NULL
151,438,5,443,589,0,0,75.21,210,228,中興里,NULL
0,438,5,443,589,0,0,75.21,210,228,中興里,NULL
373,440,3,443,562,0,0,78.83,183,257,義和村,NULL
0,440,3,443,562,0,0,78.83,183,257,義和村,NULL
14,441,2,443,586,0,0,75.6,178,263,正義村,NULL
438,440,2,442,579,0,0,76.34,292,148,溝埧里,NULL
0,440,2,442,579,0,0,76.34,292,148,溝埧里,NULL
67,439,3,442,683,0,0,64.71,281,158,長福村,NULL
0,439,3,442,683,0,0,64.71,281,158,長福村,NULL
13,441,1,442,640,0,0,69.06,243,198,東安村,NULL
0,441,1,442,640,0,0,69.06,243,198,東安村,NULL
455,439,3,442,666,0,0,66.37,224,215,萬隆村,NULL
280,439,3,442,578,0,0,76.47,211,228,過山村,NULL
0,439,3,442,578,0,0,76.47,211,228,過山村,NULL
154,438,4,442,635,0,0,69.61,173,265,古亭村,NULL
0,438,4,442,635,0,0,69.61,173,265,古亭村,NULL
191,438,4,442,652,0,0,67.79,157,281,內寮村,NULL
377,439,3,442,559,0,0,79.07,157,282,保安里,NULL
0,438,4,442,652,0,0,67.79,157,281,內寮村,NULL
0,439,3,442,559,0,0,79.07,157,282,保安里,NULL
55,440,1,441,590,0,0,74.75,409,31,霧臺村,NULL
159,438,3,441,661,0,0,66.72,203,235,華源村,NULL
0,438,3,441,661,0,0,66.72,203,235,華源村,NULL
215,437,3,440,543,0,0,81.03,214,223,仁和里,NULL
0,437,3,440,543,0,0,81.03,214,223,仁和里,NULL
116,438,2,440,596,0,0,73.83,201,237,存仁里,NULL
308,437,3,440,554,0,0,79.42,169,268,拔林村,NULL
0,437,3,440,554,0,0,79.42,169,268,拔林村,NULL
6,435,5,440,626,0,0,70.29,168,267,鹿寮里,NULL
0,435,5,440,626,0,0,70.29,168,267,鹿寮里,NULL
109,435,5,440,548,0,0,80.29,150,285,城南里,NULL
0,435,5,440,548,0,0,80.29,150,285,城南里,NULL
0,438,2,440,1203,0,0,36.58,110,328,將軍村,NULL
162,436,3,439,587,0,0,74.79,407,29,互助村,NULL
317,435,4,439,654,0,0,67.13,263,172,廣明里,NULL
0,435,4,439,654,0,0,67.13,263,172,廣明里,NULL
181,433,6,439,637,0,0,68.92,233,200,義和村,NULL
61,436,3,439,648,0,0,67.75,138,298,甘宅里,NULL
0,436,3,439,648,0,0,67.75,138,298,甘宅里,NULL
322,436,3,439,587,0,0,74.79,123,313,埤子村,NULL
0,436,3,439,587,0,0,74.79,123,313,埤子村,NULL
425,434,4,438,567,0,0,77.25,386,48,胡厝里,NULL
168,435,3,438,788,0,0,55.58,246,189,溪尾村,NULL
0,435,3,438,788,0,0,55.58,246,189,溪尾村,NULL
220,432,6,438,646,0,0,67.8,176,256,聖賢村,NULL
365,433,5,438,591,0,0,74.11,175,258,興桐村,NULL
89,435,3,438,554,0,0,79.06,109,326,中南里,NULL
0,435,3,438,554,0,0,79.06,109,326,中南里,NULL
337,431,6,437,590,0,0,74.07,395,36,大隘村,NULL
156,434,3,437,593,0,0,73.69,391,43,三和村,NULL
116,433,4,437,565,0,0,77.35,318,115,和平里,NULL
0,433,4,437,565,0,0,77.35,318,115,和平里,NULL
56,432,5,437,601,0,0,72.71,291,141,土城里,NULL
605,433,4,437,641,0,0,68.17,237,196,東和村,NULL
0,433,4,437,641,0,0,68.17,237,196,東和村,NULL
197,435,2,437,579,0,0,75.47,230,205,潮州里,NULL
0,435,2,437,579,0,0,75.47,230,205,潮州里,NULL
368,432,5,437,643,0,0,67.96,197,235,福榮村,NULL
0,432,5,437,643,0,0,67.96,197,235,福榮村,NULL
196,432,4,436,694,0,0,62.82,327,105,大全村,NULL
418,434,2,436,584,0,0,74.66,309,125,大河村,NULL
0,434,2,436,584,0,0,74.66,309,125,大河村,NULL
148,432,4,436,555,0,0,78.56,227,205,中和里,NULL
0,432,4,436,555,0,0,78.56,227,205,中和里,NULL
49,433,3,436,584,0,0,74.66,226,207,中正里,NULL
0,433,3,436,584,0,0,74.66,226,207,中正里,NULL
2248,431,5,436,601,0,0,72.55,225,206,崁腳村,NULL
0,431,5,436,601,0,0,72.55,225,206,崁腳村,NULL
87,433,3,436,577,0,0,75.56,208,225,慈福里,NULL
76,434,2,436,650,0,0,67.08,201,233,三光村,NULL
543,434,2,436,695,0,0,62.73,136,298,內寮村,NULL
0,434,2,436,695,0,0,62.73,136,298,內寮村,NULL
35,431,4,435,803,0,0,54.17,418,13,瓊林里,NULL
160,428,7,435,634,0,0,68.61,404,24,法治村,NULL
0,428,7,435,634,0,0,68.61,404,24,法治村,NULL
11,433,2,435,655,0,0,66.41,403,30,民生村,NULL
31,432,3,435,598,0,0,72.74,196,236,白河里,NULL
455,428,7,435,577,0,0,75.39,193,235,新峰里,NULL
0,430,5,435,573,0,0,75.92,189,241,港尾里,NULL
829,433,2,435,630,0,0,69.05,178,255,沙崙村,NULL
0,433,2,435,630,0,0,69.05,178,255,沙崙村,NULL
33,432,2,434,569,0,0,76.27,368,64,茂林村,NULL
0,432,2,434,569,0,0,76.27,368,64,茂林村,NULL
78,426,8,434,599,0,0,72.45,226,200,三協里,NULL
446,426,8,434,573,0,0,75.74,152,274,南安村,NULL
0,426,8,434,573,0,0,75.74,152,274,南安村,NULL
231,430,4,434,673,0,0,64.49,128,302,車港村,NULL
0,430,4,434,673,0,0,64.49,128,302,車港村,NULL
0,424,9,433,659,0,0,65.71,396,28,太平村,NULL
340,429,4,433,604,0,0,71.69,356,73,花園村,NULL
0,429,4,433,604,0,0,71.69,356,73,花園村,NULL
45,425,8,433,707,0,0,61.24,353,72,蚊港村,NULL
19,432,1,433,588,0,0,73.64,346,86,民樂里,NULL
0,432,1,433,588,0,0,73.64,346,86,民樂里,NULL
90,424,9,433,684,0,0,63.3,208,216,崙內里,NULL
2111,432,1,433,565,0,0,76.64,192,240,永安村,NULL
0,432,1,433,565,0,0,76.64,192,240,永安村,NULL
102,430,3,433,551,0,0,78.58,181,249,學圃里,NULL
0,430,3,433,551,0,0,78.58,181,249,學圃里,NULL
426,430,3,433,670,0,0,64.63,153,277,同仁村,NULL
572,430,2,432,640,0,0,67.5,412,18,牡丹村,NULL
0,430,2,432,640,0,0,67.5,412,18,牡丹村,NULL
0,428,4,432,729,0,0,59.26,370,58,平等村,NULL
693,429,3,432,608,0,0,71.05,295,134,北汕村,NULL
163,429,3,432,793,0,0,54.48,273,156,廣溝村,NULL
0,429,3,432,793,0,0,54.48,273,156,廣溝村,NULL
207,425,7,432,623,0,0,69.34,256,169,龍壽村,NULL
675,426,6,432,535,0,0,80.75,204,222,甲頂里,NULL
170,431,1,432,623,0,0,69.34,160,271,小湖里,NULL
0,431,1,432,623,0,0,69.34,160,271,小湖里,NULL
208,431,1,432,559,0,0,77.28,153,278,大堀村,NULL
320,425,7,432,565,0,0,76.46,143,282,板頭村,NULL
0,425,7,432,565,0,0,76.46,143,282,板頭村,NULL
96,424,7,431,503,0,0,85.69,398,26,祥和里,NULL
0,424,7,431,503,0,0,85.69,398,26,祥和里,NULL
11,428,3,431,668,0,0,64.52,287,141,海豐村,NULL
558,427,4,431,611,0,0,70.54,238,189,枋山村,NULL
195,429,2,431,613,0,0,70.31,237,192,水上村,NULL
568,426,5,431,576,0,0,74.83,234,192,觀音里,NULL
0,426,5,431,576,0,0,74.83,234,192,觀音里,NULL
2099,431,0,431,545,0,0,79.08,220,211,阿柔村,NULL
0,431,0,431,545,0,0,79.08,220,211,阿柔村,NULL
162,430,1,431,597,0,0,72.19,179,251,北華村,NULL
0,430,1,431,597,0,0,72.19,179,251,北華村,NULL
218,427,4,431,719,0,0,59.94,167,260,過港村,NULL
0,427,4,431,719,0,0,59.94,167,260,過港村,NULL
108,429,2,431,536,0,0,80.41,158,271,聖南里,NULL
0,429,2,431,536,0,0,80.41,158,271,聖南里,NULL
250,424,7,431,651,0,0,66.21,154,270,長沙村,NULL
248,427,3,430,545,0,0,78.9,343,84,光輝里,NULL
0,427,3,430,545,0,0,78.9,343,84,光輝里,NULL
86,428,2,430,573,0,0,75.04,208,220,關帝里,NULL
0,428,2,430,573,0,0,75.04,208,220,關帝里,NULL
542,429,1,430,597,0,0,72.03,204,225,元埔村,NULL
0,429,1,430,597,0,0,72.03,204,225,元埔村,NULL
94,424,6,430,578,0,0,74.39,201,223,郭厝里,NULL
0,424,6,430,578,0,0,74.39,201,223,郭厝里,NULL
0,427,3,430,598,0,0,71.91,192,235,下麻村,NULL
149,428,2,430,688,0,0,62.5,173,255,新庄村,NULL
0,428,2,430,688,0,0,62.5,173,255,新庄村,NULL
488,426,3,429,550,0,0,78,163,263,筆秀村,NULL
468,424,4,428,582,0,0,73.54,193,231,南和村,NULL
47,424,3,427,612,0,0,69.77,382,42,賽嘉村,NULL
0,424,3,427,612,0,0,69.77,382,42,賽嘉村,NULL
159,422,4,426,531,0,0,80.23,292,130,城北里,NULL
0,422,4,426,531,0,0,80.23,292,130,城北里,NULL
2181,422,4,426,566,0,0,75.27,272,150,新基村,NULL
21,423,3,426,544,0,0,78.31,241,182,大東里,NULL
0,423,3,426,544,0,0,78.31,241,182,大東里,NULL
30,422,4,426,636,0,0,66.98,234,188,前寮里,NULL
0,422,4,426,636,0,0,66.98,234,188,前寮里,NULL
81,421,5,426,607,0,0,70.18,214,207,興新里,NULL
115,424,2,426,584,0,0,72.95,165,259,義亭村,NULL
0,424,2,426,584,0,0,72.95,165,259,義亭村,NULL
237,423,3,426,591,0,0,72.08,159,264,保源村,NULL
407,423,2,425,514,0,0,82.68,329,94,錦水村,NULL
0,423,2,425,514,0,0,82.68,329,94,錦水村,NULL
22,422,3,425,562,0,0,75.62,255,167,新興里,NULL
0,422,3,425,562,0,0,75.62,255,167,新興里,NULL
270,424,1,425,545,0,0,77.98,228,196,菁山里,NULL
294,422,3,425,614,0,0,69.22,219,203,太和村,NULL
168,420,5,425,603,0,0,70.48,210,210,新富村,NULL
0,420,5,425,603,0,0,70.48,210,210,新富村,NULL
584,420,5,425,653,0,0,65.08,159,261,保力村,NULL
235,419,6,425,584,0,0,72.77,116,303,嘉昌村,NULL
155,418,6,424,593,0,0,71.5,310,108,共和村,NULL
0,418,6,424,593,0,0,71.5,310,108,共和村,NULL
172,421,3,424,526,0,0,80.61,261,160,港墘里,NULL
2117,423,1,424,557,0,0,76.12,170,253,粗窟村,NULL
529,417,7,424,644,0,0,65.84,159,258,永安村,NULL
0,417,7,424,644,0,0,65.84,159,258,永安村,NULL
89,420,4,424,564,0,0,75.18,153,267,永隆村,NULL
0,420,4,424,564,0,0,75.18,153,267,永隆村,NULL
23,419,4,423,787,0,0,53.75,403,16,后盤村,NULL
0,419,4,423,787,0,0,53.75,403,16,后盤村,NULL
328,423,0,423,556,0,0,76.08,345,78,南山村,NULL
0,423,0,423,556,0,0,76.08,345,78,南山村,NULL
16,421,2,423,565,0,0,74.87,102,319,新嘉村,NULL
88,417,5,422,736,0,0,57.34,265,152,月眉里,NULL
0,417,5,422,736,0,0,57.34,265,152,月眉里,NULL
25,416,6,422,577,0,0,73.14,254,162,民權里,NULL
510,416,6,422,708,0,0,59.6,246,170,三豐村,NULL
0,416,6,422,708,0,0,59.6,246,170,三豐村,NULL
444,415,7,422,607,0,0,69.52,230,185,公田村,NULL
196,417,5,422,693,0,0,60.89,214,203,頂湖村,NULL
0,417,5,422,693,0,0,60.89,214,203,頂湖村,NULL
2247,417,5,422,596,0,0,70.81,185,232,溪底村,NULL
0,417,5,422,596,0,0,70.81,185,232,溪底村,NULL
157,421,0,421,555,0,0,75.86,382,39,佳平村,NULL
127,419,2,421,771,0,0,54.6,315,104,福文村,NULL
619,414,7,421,729,0,0,57.75,261,153,南灣里,NULL
105,420,1,421,524,0,0,80.34,214,206,民生里,NULL
0,420,1,421,524,0,0,80.34,214,206,民生里,NULL
64,419,2,421,617,0,0,68.23,136,283,內興村,NULL
0,419,2,421,617,0,0,68.23,136,283,內興村,NULL
79,415,5,420,626,0,0,67.09,265,150,南港村,NULL
2228,417,3,420,571,0,0,73.56,207,210,六股村,NULL
0,417,3,420,571,0,0,73.56,207,210,六股村,NULL
2114,417,3,420,575,0,0,73.04,204,213,水德村,NULL
0,417,3,420,575,0,0,73.04,204,213,水德村,NULL
306,416,4,420,595,0,0,70.59,152,264,雙賢村,NULL
0,416,4,420,595,0,0,70.59,152,264,雙賢村,NULL
9,417,3,420,598,0,0,70.23,132,285,三義村,NULL
497,413,6,419,629,0,0,66.61,371,42,高義村,NULL
0,413,6,419,629,0,0,66.61,371,42,高義村,NULL
151,416,3,419,788,0,0,53.17,333,83,長濱村,NULL
302,415,4,419,599,0,0,69.95,327,88,大南村,NULL
0,415,4,419,599,0,0,69.95,327,88,大南村,NULL
9,415,4,419,596,0,0,70.3,282,133,民族村,NULL
0,415,4,419,596,0,0,70.3,282,133,民族村,NULL
0,416,3,419,662,0,0,63.29,232,184,泰平村,NULL
253,417,2,419,552,0,0,75.91,191,226,仁和里,NULL
0,417,2,419,552,0,0,75.91,191,226,仁和里,NULL
366,417,1,418,527,0,0,79.32,240,177,水仙村,NULL
0,417,1,418,527,0,0,79.32,240,177,水仙村,NULL
388,413,5,418,592,0,0,70.61,227,186,坪頂村,NULL
0,413,5,418,592,0,0,70.61,227,186,坪頂村,NULL
149,410,8,418,581,0,0,71.94,200,210,岸腳村,NULL
0,416,1,417,585,0,0,71.28,258,158,福興里,NULL
1387,404,13,417,550,0,0,75.82,192,212,柑林里,NULL
83,415,2,417,520,0,0,80.19,182,233,中興里,NULL
0,415,2,417,520,0,0,80.19,182,233,中興里,NULL
278,413,4,417,604,0,0,69.04,179,234,好收里,NULL
37,414,2,416,637,0,0,65.31,289,125,五港村,NULL
180,414,2,416,658,0,0,63.22,267,147,潭東村,NULL
0,414,2,416,658,0,0,63.22,267,147,潭東村,NULL
18,414,2,416,544,0,0,76.47,120,294,頂長村,NULL
0,414,2,416,544,0,0,76.47,120,294,頂長村,NULL
20,412,4,416,556,0,0,74.82,117,295,仕安村,NULL
0,412,4,416,556,0,0,74.82,117,295,仕安村,NULL
245,410,5,415,756,0,0,54.89,384,26,德武里,NULL
0,410,5,415,756,0,0,54.89,384,26,德武里,NULL
408,412,3,415,501,0,0,82.83,335,77,大龍村,NULL
0,412,3,415,501,0,0,82.83,335,77,大龍村,NULL
115,414,1,415,534,0,0,77.72,327,87,陸豐里,NULL
0,414,1,415,534,0,0,77.72,327,87,陸豐里,NULL
0,413,2,415,573,0,0,72.43,185,228,樹林里,NULL
470,412,3,415,558,0,0,74.37,168,244,頂新里,NULL
0,412,3,415,558,0,0,74.37,168,244,頂新里,NULL
740,408,6,414,529,0,0,78.26,354,54,成功里,NULL
260,411,3,414,655,0,0,63.21,290,121,學田村,NULL
0,411,3,414,655,0,0,63.21,290,121,學田村,NULL
155,413,1,414,613,0,0,67.54,242,171,港口里,NULL
194,408,6,414,834,0,0,49.64,242,166,新興村,NULL
0,413,1,414,613,0,0,67.54,242,171,港口里,NULL
10,412,1,413,611,0,0,67.59,372,40,民權村,NULL
0,412,1,413,611,0,0,67.59,372,40,民權村,NULL
353,412,1,413,577,0,0,71.58,313,99,新隆村,NULL
0,412,1,413,577,0,0,71.58,313,99,新隆村,NULL
296,405,8,413,532,0,0,77.63,306,99,大湖村,NULL
0,405,8,413,532,0,0,77.63,306,99,大湖村,NULL
0,412,1,413,770,0,0,53.64,289,123,茄苳村,NULL
202,410,3,413,542,0,0,76.2,197,213,下寮村,NULL
431,410,2,412,545,0,0,75.6,346,64,清安村,NULL
88,409,3,412,754,0,0,54.64,166,243,竹灣村,NULL
0,409,3,412,754,0,0,54.64,166,243,竹灣村,NULL
349,411,1,412,591,0,0,69.71,160,251,延平里,NULL
448,410,2,412,584,0,0,70.55,151,259,義和里,NULL
185,408,3,411,708,0,0,58.05,389,19,廣原村,NULL
0,408,3,411,708,0,0,58.05,389,19,廣原村,NULL
263,408,3,411,507,0,0,81.07,343,65,五龍村,NULL
0,408,3,411,507,0,0,81.07,343,65,五龍村,NULL
297,409,2,411,552,0,0,74.46,284,125,中山里,NULL
164,409,2,411,655,0,0,62.75,281,128,泰和村,NULL
219,405,6,411,564,0,0,72.87,264,141,舊港里,NULL
0,405,6,411,564,0,0,72.87,264,141,舊港里,NULL
204,406,5,411,635,0,0,64.72,246,160,中明村,NULL
227,407,4,411,677,0,0,60.71,229,178,富興村,NULL
0,407,4,411,677,0,0,60.71,229,178,富興村,NULL
482,408,3,411,576,0,0,71.35,161,247,朝安里,NULL
4,407,4,411,555,0,0,74.05,138,269,侯伯村,NULL
184,403,8,411,536,0,0,76.68,130,273,硫黃村,NULL
0,403,8,411,536,0,0,76.68,130,273,硫黃村,NULL
561,407,3,410,487,0,0,84.19,380,27,連和里,NULL
180,405,5,410,635,0,0,64.57,287,118,南平里,NULL
0,405,5,410,635,0,0,64.57,287,118,南平里,NULL
805,406,4,410,501,0,0,81.84,259,147,聖化村,NULL
0,406,4,410,501,0,0,81.84,259,147,聖化村,NULL
134,402,8,410,586,0,0,69.97,225,177,導民里,NULL
382,402,8,410,635,0,0,64.57,201,201,秀峰村,NULL
0,402,8,410,635,0,0,64.57,201,201,秀峰村,NULL
98,406,4,410,554,0,0,74.01,186,220,義昌里,NULL
0,406,4,410,554,0,0,74.01,186,220,義昌里,NULL
328,408,1,409,568,0,0,72.01,370,38,錦屏村,NULL
393,405,4,409,681,0,0,60.06,305,100,新興村,NULL
0,405,4,409,681,0,0,60.06,305,100,新興村,NULL
441,402,7,409,547,0,0,74.77,173,229,三光里,NULL
0,402,7,409,547,0,0,74.77,173,229,三光里,NULL
693,408,1,409,566,0,0,72.26,154,254,新樹里,NULL
313,403,6,409,573,0,0,71.38,131,272,後港村,NULL
0,403,6,409,573,0,0,71.38,131,272,後港村,NULL
493,406,2,408,552,0,0,73.91,390,16,義盛村,NULL
0,406,2,408,552,0,0,73.91,390,16,義盛村,NULL
32,402,6,408,642,0,0,63.55,255,147,石泉里,NULL
127,405,3,408,537,0,0,75.98,219,186,石坊里,NULL
0,405,3,408,537,0,0,75.98,219,186,石坊里,NULL
41,399,9,408,569,0,0,71.7,167,232,新庄村,NULL
430,404,4,408,564,0,0,72.34,156,248,沄水村,NULL
42,405,3,408,645,0,0,63.26,130,275,大林里,NULL
0,405,3,408,645,0,0,63.26,130,275,大林里,NULL
80,404,3,407,592,0,0,68.75,183,221,砂崙里,NULL
428,403,4,407,655,0,0,62.14,177,226,三層村,NULL
0,403,4,407,655,0,0,62.14,177,226,三層村,NULL
543,403,4,407,511,0,0,79.65,164,239,永就村,NULL
196,402,5,407,605,0,0,67.27,120,282,新置村,NULL
182,403,3,406,565,0,0,71.86,93,310,姑爺里,NULL
0,403,3,406,565,0,0,71.86,93,310,姑爺里,NULL
435,403,2,405,541,0,0,74.86,337,66,象鼻村,NULL
0,403,2,405,541,0,0,74.86,337,66,象鼻村,NULL
93,404,1,405,529,0,0,76.56,220,184,驛站里,NULL
0,404,1,405,529,0,0,76.56,220,184,驛站里,NULL
388,401,4,405,566,0,0,71.55,212,189,義隆村,NULL
0,401,4,405,566,0,0,71.55,212,189,義隆村,NULL
2109,400,4,404,557,0,0,72.53,207,193,永定村,NULL
0,400,4,404,557,0,0,72.53,207,193,永定村,NULL
250,402,2,404,513,0,0,78.75,186,216,東林里,NULL
0,402,2,404,513,0,0,78.75,186,216,東林里,NULL
84,401,3,404,523,0,0,77.25,169,232,明宜里,NULL
585,401,3,404,699,0,0,57.8,162,239,保力村,NULL
568,400,3,403,529,0,0,76.18,372,28,內獅村,NULL
0,400,3,403,529,0,0,76.18,372,28,內獅村,NULL
181,398,5,403,569,0,0,70.83,226,172,八中里,NULL
0,398,5,403,569,0,0,70.83,226,172,八中里,NULL
148,401,2,403,510,0,0,79.02,204,197,港後村,NULL
473,401,2,403,544,0,0,74.08,199,202,興台里,NULL
0,401,2,403,544,0,0,74.08,199,202,興台里,NULL
62,402,1,403,532,0,0,75.75,149,253,北門村,NULL
2148,401,1,402,580,0,0,69.31,247,154,茂林村,NULL
0,401,1,402,580,0,0,69.31,247,154,茂林村,NULL
79,398,4,402,509,0,0,78.98,244,154,博愛里,NULL
460,393,9,402,531,0,0,75.71,238,155,沙田村,NULL
0,393,9,402,531,0,0,75.71,238,155,沙田村,NULL
1844,401,1,402,559,0,0,71.91,187,214,中和里,NULL
0,401,1,402,559,0,0,71.91,187,214,中和里,NULL
527,401,1,402,642,0,0,62.62,160,241,內新村,NULL
0,401,1,402,642,0,0,62.62,160,241,內新村,NULL
579,399,3,402,593,0,0,67.79,126,273,福安村,NULL
0,399,3,402,593,0,0,67.79,126,273,福安村,NULL
79,396,5,401,556,0,0,72.12,129,267,砂崙里,NULL
401,396,5,401,526,0,0,76.24,85,311,莊禮里,NULL
0,396,5,401,526,0,0,76.24,85,311,莊禮里,NULL
148,396,4,400,598,0,0,66.89,382,14,精英村,NULL
266,394,6,400,692,0,0,57.8,366,28,卓溪村,NULL
0,394,6,400,692,0,0,57.8,366,28,卓溪村,NULL
178,393,7,400,522,0,0,76.63,272,121,玉山里,NULL
0,393,7,400,522,0,0,76.63,272,121,玉山里,NULL
284,397,3,400,545,0,0,73.39,240,157,西坪里,NULL
0,397,3,400,545,0,0,73.39,240,157,西坪里,NULL
389,399,1,400,530,0,0,75.47,230,169,鯉魚潭村,NULL
111,396,4,400,517,0,0,77.37,222,174,中境里,NULL
0,396,4,400,517,0,0,77.37,222,174,中境里,NULL
552,398,2,400,556,0,0,71.94,162,236,玉峯村,NULL
0,398,2,400,556,0,0,71.94,162,236,玉峯村,NULL
110,396,4,400,531,0,0,75.33,156,240,武廟里,NULL
0,396,4,400,531,0,0,75.33,156,240,武廟里,NULL
411,394,5,399,593,0,0,67.28,251,143,豐丘村,NULL
0,394,5,399,593,0,0,67.28,251,143,豐丘村,NULL
179,395,4,399,609,0,0,65.52,243,152,北林里,NULL
0,395,4,399,609,0,0,65.52,243,152,北林里,NULL
107,395,4,399,520,0,0,76.73,188,207,水秀里,NULL
243,392,6,398,563,0,0,70.69,301,91,明德里,NULL
0,392,6,398,563,0,0,70.69,301,91,明德里,NULL
630,397,1,398,771,0,0,51.62,275,122,杉福村,NULL
0,397,1,398,771,0,0,51.62,275,122,杉福村,NULL
86,394,4,398,537,0,0,74.12,228,166,埤腳里,NULL
84,397,1,398,586,0,0,67.92,223,174,奮起里,NULL
81,393,5,398,687,0,0,57.93,220,173,通梁村,NULL
0,393,5,398,687,0,0,57.93,220,173,通梁村,NULL
69,394,4,398,557,0,0,71.45,189,205,保吉村,NULL
238,394,4,398,594,0,0,67,118,276,松中村,NULL
0,394,4,398,594,0,0,67,118,276,松中村,NULL
397,396,1,397,541,0,0,73.38,318,78,金獅村,NULL
0,396,1,397,541,0,0,73.38,318,78,金獅村,NULL
293,394,3,397,519,0,0,76.49,305,89,西坪里、坪林里,NULL
0,394,3,397,519,0,0,76.49,305,89,西坪里、坪林里,NULL
32,395,2,397,693,0,0,57.29,221,174,牛厝村,NULL
238,383,13,396,747,0,0,53.01,329,54,長良里,NULL
0,383,13,396,747,0,0,53.01,329,54,長良里,NULL
206,388,8,396,842,0,0,47.03,320,68,紅頭村,NULL
0,388,8,396,842,0,0,47.03,320,68,紅頭村,NULL
303,396,0,396,548,0,0,72.26,216,180,萬德村,NULL
0,396,0,396,548,0,0,72.26,216,180,萬德村,NULL
131,393,3,396,544,0,0,72.79,215,178,蘇南里,NULL
0,393,3,396,544,0,0,72.79,215,178,蘇南里,NULL
2084,394,2,396,526,0,0,75.29,181,213,瑞平村,NULL
0,394,2,396,526,0,0,75.29,181,213,瑞平村,NULL
85,394,2,396,526,0,0,75.29,153,241,慈福里,NULL
100,394,2,396,536,0,0,73.88,152,242,安仁里,NULL
90,393,3,396,552,0,0,71.74,75,318,南竹里,NULL
0,393,3,396,552,0,0,71.74,75,318,南竹里,NULL
156,392,3,395,587,0,0,67.29,375,17,親愛村,NULL
148,391,4,395,827,0,0,47.76,336,55,寧埔村,NULL
174,392,3,395,546,0,0,72.34,327,65,鳳信里,NULL
1955,391,4,395,547,0,0,72.21,260,131,濂洞里,NULL
0,391,4,395,547,0,0,72.21,260,131,濂洞里,NULL
0,390,5,395,604,0,0,65.4,225,165,田子里,NULL
241,394,1,395,601,0,0,65.72,119,275,本厝村,NULL
391,391,3,394,523,0,0,75.33,243,148,農富村,NULL
0,391,3,394,523,0,0,75.33,243,148,農富村,NULL
215,392,2,394,497,0,0,79.28,242,150,靖和村,NULL
0,392,2,394,497,0,0,79.28,242,150,靖和村,NULL
77,391,3,394,535,0,0,73.64,98,293,三光村,NULL
153,391,2,393,763,0,0,51.51,332,59,三間村,NULL
2009,390,3,393,471,0,0,83.44,314,76,黎明村,NULL
417,392,1,393,526,0,0,74.71,274,118,北埔村,NULL
0,392,1,393,526,0,0,74.71,274,118,北埔村,NULL
128,387,6,393,703,0,0,55.9,263,124,慶豐村,NULL
0,387,6,393,703,0,0,55.9,263,124,慶豐村,NULL
137,387,5,392,673,0,0,58.25,277,110,都蘭村,NULL
446,387,5,392,488,0,0,80.33,226,161,光華里,NULL
0,387,5,392,488,0,0,80.33,226,161,光華里,NULL
269,389,3,392,572,0,0,68.53,137,252,後溝里,NULL
242,385,6,391,656,0,0,59.6,336,49,觀音里,NULL
13,389,2,391,581,0,0,67.3,266,123,強國里,NULL
0,389,2,391,581,0,0,67.3,266,123,強國里,NULL
3,388,3,391,554,0,0,70.58,231,157,長安里,NULL
0,388,3,391,554,0,0,70.58,231,157,長安里,NULL
49,390,0,390,523,0,0,74.57,219,171,北勢里,NULL
231,387,3,390,548,0,0,71.17,199,188,振興里,NULL
26,383,7,390,590,0,0,66.1,134,249,六南村,NULL
0,383,7,390,590,0,0,66.1,134,249,六南村,NULL
162,389,0,389,607,0,0,64.09,379,10,泰武村,NULL
0,389,0,389,607,0,0,64.09,379,10,泰武村,NULL
375,384,5,389,560,0,0,69.46,222,162,內湖村,NULL
617,381,8,389,647,0,0,60.12,186,195,水泉里,NULL
439,389,0,389,511,0,0,76.13,164,225,仁里村,NULL
0,389,0,389,511,0,0,76.13,164,225,仁里村,NULL
324,383,6,389,566,0,0,68.73,102,281,北崙村,NULL
0,383,6,389,566,0,0,68.73,102,281,北崙村,NULL
111,388,1,389,474,0,0,82.07,97,291,廍北里,NULL
0,388,1,389,474,0,0,82.07,97,291,廍北里,NULL
436,387,1,388,492,0,0,78.86,375,12,士林村,NULL
0,387,1,388,492,0,0,78.86,375,12,士林村,NULL
70,386,2,388,772,0,0,50.26,345,41,和平里,NULL
0,386,2,388,772,0,0,50.26,345,41,和平里,NULL
2134,382,6,388,531,0,0,73.07,252,130,橫山村,NULL
0,382,6,388,531,0,0,73.07,252,130,橫山村,NULL
369,386,2,388,590,0,0,65.76,220,166,頂廍村,NULL
0,386,2,388,590,0,0,65.76,220,166,頂廍村,NULL
81,382,6,388,540,0,0,71.85,125,257,秀昌里,NULL
46,386,1,387,761,0,0,50.85,376,10,黃埔村,NULL
0,386,1,387,761,0,0,50.85,376,10,黃埔村,NULL
406,385,2,387,482,0,0,80.29,246,139,忠孝里,NULL
0,385,2,387,595,0,0,65.04,140,245,更寮村,NULL
30,384,3,387,497,0,0,77.87,138,246,東安里,NULL
0,384,3,387,497,0,0,77.87,138,246,東安里,NULL
40,378,9,387,564,0,0,68.62,129,249,河東里,NULL
318,384,3,387,545,0,0,71.01,110,274,西寮村,NULL
0,384,3,387,545,0,0,71.01,110,274,西寮村,NULL
48,386,0,386,720,0,0,53.61,377,9,上林村,NULL
0,386,0,386,720,0,0,53.61,377,9,上林村,NULL
179,383,3,386,475,0,0,81.26,268,115,崎頂里,NULL
458,385,1,386,550,0,0,70.18,241,144,箕湖村,NULL
312,380,6,386,572,0,0,67.48,207,173,隘寮里,NULL
0,380,6,386,572,0,0,67.48,207,173,隘寮里,NULL
217,383,3,386,523,0,0,73.8,178,205,南和村,NULL
360,380,5,385,613,0,0,62.81,234,146,信義村,NULL
0,380,5,385,613,0,0,62.81,234,146,信義村,NULL
310,380,5,385,549,0,0,70.13,208,172,林尾里,NULL
0,380,5,385,549,0,0,70.13,208,172,林尾里,NULL
44,382,3,385,596,0,0,64.6,111,271,六溪里,NULL
0,382,3,385,596,0,0,64.6,111,271,六溪里,NULL
16,381,3,384,485,0,0,79.18,363,18,土庫村,NULL
338,381,3,384,542,0,0,70.85,341,40,桃山村,NULL
10,380,4,384,603,0,0,63.68,290,90,四維里,NULL
0,380,4,384,603,0,0,63.68,290,90,四維里,NULL
64,383,1,384,494,0,0,77.73,256,127,永安村,NULL
47,381,3,384,506,0,0,75.89,206,175,富寮里,NULL
258,376,8,384,508,0,0,75.59,203,173,仁安里,NULL
0,376,8,384,508,0,0,75.59,203,173,仁安里,NULL
311,380,4,384,545,0,0,70.46,160,220,渡頭村,NULL
48,382,1,383,507,0,0,75.54,336,46,口社村,NULL
0,382,1,383,507,0,0,75.54,336,46,口社村,NULL
2245,380,3,383,515,0,0,74.37,237,143,磺潭村,NULL
0,380,3,383,515,0,0,74.37,237,143,磺潭村,NULL
65,380,3,383,595,0,0,64.37,217,163,隘門村,NULL
0,380,3,383,595,0,0,64.37,217,163,隘門村,NULL
2170,377,6,383,518,0,0,73.94,188,189,石底村,NULL
0,377,6,383,518,0,0,73.94,188,189,石底村,NULL
33,380,3,383,466,0,0,82.19,166,214,東仁里,NULL
0,380,3,383,466,0,0,82.19,166,214,東仁里,NULL
233,376,7,383,533,0,0,71.86,160,216,忠興村,NULL
178,373,9,382,577,0,0,66.2,282,91,大榮里,NULL
387,379,3,382,548,0,0,69.71,234,145,新城村,NULL
386,374,8,382,521,0,0,73.32,193,181,塘興村,NULL
2202,377,5,382,536,0,0,71.27,193,184,福連村,NULL
31,381,1,382,489,0,0,78.12,167,214,大街里,NULL
0,381,1,382,489,0,0,78.12,167,214,大街里,NULL
158,380,1,381,621,0,0,61.35,240,140,三和村,NULL
0,380,1,381,621,0,0,61.35,240,140,三和村,NULL
76,378,3,381,588,0,0,64.8,186,192,順安村,NULL
171,378,3,381,481,0,0,79.21,124,254,南勢村,NULL
0,378,3,381,481,0,0,79.21,124,254,南勢村,NULL
320,379,1,380,485,0,0,78.35,353,26,崙埤村,NULL
0,379,1,380,485,0,0,78.35,353,26,崙埤村,NULL
156,379,1,380,675,0,0,56.3,291,88,樟原村,NULL
0,379,1,380,675,0,0,56.3,291,88,樟原村,NULL
115,377,3,380,593,0,0,64.08,244,133,鹿野村,NULL
504,375,5,380,616,0,0,61.69,227,148,上山村,NULL
2233,380,0,380,588,0,0,64.63,223,157,永興村,NULL
0,380,0,380,588,0,0,64.63,223,157,永興村,NULL
333,378,2,380,506,0,0,75.1,184,194,下坪里,NULL
292,377,3,380,522,0,0,72.8,106,271,頂宅里,NULL
0,377,3,380,522,0,0,72.8,106,271,頂宅里,NULL
408,373,6,379,551,0,0,68.78,243,130,愛國村,NULL
0,373,6,379,551,0,0,68.78,243,130,愛國村,NULL
2179,374,5,379,507,0,0,74.75,243,131,雙溪村,NULL
0,374,5,379,507,0,0,74.75,243,131,雙溪村,NULL
48,376,3,379,484,0,0,78.31,183,193,東門里,NULL
0,376,3,379,484,0,0,78.31,183,193,東門里,NULL
305,377,1,378,529,0,0,71.46,283,94,武榮村,NULL
0,377,1,378,529,0,0,71.46,283,94,武榮村,NULL
360,375,3,378,504,0,0,75,226,149,德興里,NULL
124,376,2,378,503,0,0,75.15,195,181,西門里,NULL
0,376,2,378,503,0,0,75.15,195,181,西門里,NULL
126,376,2,378,496,0,0,76.21,165,211,中央里,NULL
0,376,2,378,496,0,0,76.21,165,211,中央里,NULL
96,376,2,378,491,0,0,76.99,124,252,集英里,NULL
0,376,2,378,491,0,0,76.99,124,252,集英里,NULL
43,372,5,377,632,0,0,59.65,362,10,大洋里,NULL
0,372,5,377,632,0,0,59.65,362,10,大洋里,NULL
183,370,7,377,571,0,0,66.02,349,21,崁頂村,NULL
0,370,7,377,571,0,0,66.02,349,21,崁頂村,NULL
0,370,7,377,611,0,0,61.7,346,24,公舘村,NULL
327,373,4,377,475,0,0,79.37,343,30,錦屏村,NULL
114,371,6,377,518,0,0,72.78,245,126,楓樹里,NULL
0,371,6,377,518,0,0,72.78,245,126,楓樹里,NULL
256,376,1,377,506,0,0,74.51,159,217,大同里,NULL
0,375,1,376,506,0,0,74.31,366,9,義林村,NULL
201,372,4,376,732,0,0,51.37,331,41,靜浦村,NULL
0,371,5,376,709,0,0,53.03,331,40,博愛里,NULL
0,372,4,376,732,0,0,51.37,331,41,靜浦村,NULL
250,369,7,376,703,0,0,53.49,305,64,萬寧村,NULL
0,369,7,376,703,0,0,53.49,305,64,萬寧村,NULL
76,375,1,376,491,0,0,76.58,219,156,檜村里,NULL
7,374,2,376,488,0,0,77.05,190,184,中正里,NULL
0,374,2,376,488,0,0,77.05,190,184,中正里,NULL
1969,373,2,375,485,0,0,77.32,183,190,集福村,NULL
297,373,2,375,545,0,0,68.81,170,203,赤水村,NULL
126,362,13,375,510,0,0,73.53,94,268,大莊里,NULL
0,362,13,375,510,0,0,73.53,94,268,大莊里,NULL
601,373,1,374,547,0,0,68.37,130,243,澄山村,NULL
0,373,1,374,547,0,0,68.37,130,243,澄山村,NULL
282,368,6,374,547,0,0,68.37,94,274,水埔里,NULL
0,368,6,374,547,0,0,68.37,94,274,水埔里,NULL
315,371,3,374,496,0,0,75.4,85,286,城內村,NULL
0,371,3,374,496,0,0,75.4,85,286,城內村,NULL
113,368,5,373,851,0,0,43.83,284,84,南港村,NULL
0,368,5,373,851,0,0,43.83,284,84,南港村,NULL
85,370,3,373,506,0,0,73.72,240,130,育仁里,NULL
461,372,1,373,523,0,0,71.32,208,164,三埔村,NULL
0,372,1,373,523,0,0,71.32,208,164,三埔村,NULL
177,371,2,373,546,0,0,68.32,174,197,廣福村,NULL
0,371,2,373,546,0,0,68.32,174,197,廣福村,NULL
286,370,3,373,518,0,0,72.01,171,199,永興村,NULL
0,370,3,373,518,0,0,72.01,171,199,永興村,NULL
159,368,5,373,499,0,0,74.75,95,273,南安村,NULL
258,369,3,372,643,0,0,57.85,314,55,豐南村,NULL
0,369,3,372,643,0,0,57.85,314,55,豐南村,NULL
188,370,2,372,558,0,0,66.67,225,145,永和村,NULL
0,370,2,372,558,0,0,66.67,225,145,永和村,NULL
276,370,2,372,637,0,0,58.4,121,249,大北里,NULL
0,370,2,372,637,0,0,58.4,121,249,大北里,NULL
143,367,4,371,850,0,0,43.65,295,72,北源村,NULL
343,368,3,371,554,0,0,66.97,141,227,東興村,NULL
0,368,3,371,554,0,0,66.97,141,227,東興村,NULL
135,366,5,371,533,0,0,69.61,124,242,河南里,NULL
0,366,5,371,533,0,0,69.61,124,242,河南里,NULL
160,368,2,370,496,0,0,74.6,262,106,平和村,NULL
0,368,2,370,496,0,0,74.6,262,106,平和村,NULL
17,366,4,370,523,0,0,70.75,102,264,新嘉村,NULL
723,362,7,369,491,0,0,75.15,313,49,建國里,NULL
64,366,3,369,528,0,0,69.89,249,117,永隆村,NULL
0,366,3,369,528,0,0,69.89,249,117,永隆村,NULL
0,364,5,369,511,0,0,72.21,198,166,崁頂村,NULL
524,364,5,369,529,0,0,69.75,150,214,溪墘村,NULL
0,364,5,369,529,0,0,69.75,150,214,溪墘村,NULL
182,368,1,369,516,0,0,71.51,142,226,施家村,NULL
0,368,1,369,516,0,0,71.51,142,226,施家村,NULL
495,365,3,368,536,0,0,68.66,321,44,長興村,NULL
0,365,3,368,536,0,0,68.66,321,44,長興村,NULL
314,366,2,368,469,0,0,78.46,265,101,山湖村,NULL
0,366,2,368,469,0,0,78.46,265,101,山湖村,NULL
185,365,3,368,514,0,0,71.6,197,168,爽文村,NULL
0,365,3,368,514,0,0,71.6,197,168,爽文村,NULL
53,367,1,368,562,0,0,65.48,175,192,程海村,NULL
0,367,1,368,562,0,0,65.48,175,192,程海村,NULL
20,365,3,368,455,0,0,80.88,173,192,瀰力村,NULL
0,365,3,368,455,0,0,80.88,173,192,瀰力村,NULL
235,364,4,368,512,0,0,71.88,128,236,枕山村,NULL
419,361,6,367,453,0,0,81.02,263,98,大坪村,NULL
0,361,6,367,453,0,0,81.02,263,98,大坪村,NULL
431,361,6,367,547,0,0,67.09,192,169,沄水村,NULL
247,362,5,367,496,0,0,73.99,160,202,東華里,NULL
0,362,5,367,496,0,0,73.99,160,202,東華里,NULL
594,360,7,367,520,0,0,70.58,154,206,左鎮村,NULL
0,360,7,367,520,0,0,70.58,154,206,左鎮村,NULL
307,367,0,367,495,0,0,74.14,130,237,三和村,NULL
194,363,3,366,503,0,0,72.76,347,16,正興村,NULL
0,363,3,366,503,0,0,72.76,347,16,正興村,NULL
159,364,2,366,546,0,0,67.03,336,28,萬豐村,NULL
0,364,2,366,546,0,0,67.03,336,28,萬豐村,NULL
51,363,3,366,464,0,0,78.88,271,92,國安里,NULL
0,363,3,366,464,0,0,78.88,271,92,國安里,NULL
121,360,6,366,675,0,0,54.22,255,105,瑞和村,NULL
0,360,6,366,675,0,0,54.22,255,105,瑞和村,NULL
392,360,6,366,524,0,0,69.85,234,126,車埕村,NULL
0,360,6,366,524,0,0,69.85,234,126,車埕村,NULL
1738,362,4,366,482,0,0,75.93,215,147,建德里,NULL
0,362,4,366,482,0,0,75.93,215,147,建德里,NULL
157,357,9,366,636,0,0,57.55,186,171,飛東村,NULL
0,357,9,366,636,0,0,57.55,186,171,飛東村,NULL
96,362,4,366,467,0,0,78.37,173,189,中興里,NULL
0,362,4,366,467,0,0,78.37,173,189,中興里,NULL
537,363,3,366,528,0,0,69.32,153,210,樟湖村,NULL
0,363,3,366,528,0,0,69.32,153,210,樟湖村,NULL
213,358,7,365,659,0,0,55.39,328,30,馬遠村,NULL
2133,361,4,365,496,0,0,73.59,240,121,茂長村,NULL
0,361,4,365,496,0,0,73.59,240,121,茂長村,NULL
505,360,5,365,551,0,0,66.24,217,143,上山村,NULL
195,362,3,365,546,0,0,66.85,209,153,共和村,NULL
174,364,1,365,458,0,0,79.69,137,227,福田村,NULL
0,364,1,365,458,0,0,79.69,137,227,福田村,NULL
2,361,3,364,569,0,0,63.97,333,28,建山村,NULL
0,361,3,364,569,0,0,63.97,333,28,建山村,NULL
412,358,6,364,533,0,0,68.29,305,53,新鄉村,NULL
251,358,6,364,643,0,0,56.61,305,53,新興村,NULL
0,358,6,364,533,0,0,68.29,305,53,新鄉村,NULL
0,358,6,364,643,0,0,56.61,305,53,新興村,NULL
172,361,3,364,599,0,0,60.77,284,77,南興村,NULL
0,361,3,364,599,0,0,60.77,284,77,南興村,NULL
2239,354,10,364,591,0,0,61.59,250,104,龜吼村,NULL
10,362,2,364,548,0,0,66.42,227,135,光明里,NULL
37,357,7,364,436,0,0,83.49,223,134,和南里,NULL
0,357,7,364,436,0,0,83.49,223,134,和南里,NULL
1577,363,1,364,482,0,0,75.52,178,185,東山里,NULL
0,363,1,364,482,0,0,75.52,178,185,東山里,NULL
104,362,2,364,487,0,0,74.74,161,201,社內里,NULL
0,362,2,364,487,0,0,74.74,161,201,社內里,NULL
325,361,3,364,501,0,0,72.65,152,209,海瀛村,NULL
0,361,3,364,501,0,0,72.65,152,209,海瀛村,NULL
301,362,2,364,537,0,0,67.78,151,211,天山村,NULL
0,362,2,364,537,0,0,67.78,151,211,天山村,NULL
329,359,4,363,512,0,0,70.9,314,45,梅花村,NULL
0,359,4,363,512,0,0,70.9,314,45,梅花村,NULL
43,360,3,363,510,0,0,71.18,310,50,大社村,NULL
0,360,3,363,510,0,0,71.18,310,50,大社村,NULL
98,359,4,363,531,0,0,68.36,221,138,初鹿村,NULL
47,361,2,363,513,0,0,70.76,194,167,復興村,NULL
0,361,2,363,513,0,0,70.76,194,167,復興村,NULL
203,361,1,362,599,0,0,60.43,350,11,台坂村,NULL
0,361,1,362,599,0,0,60.43,350,11,台坂村,NULL
396,361,1,362,480,0,0,75.42,265,96,龍洞村,NULL
0,361,1,362,480,0,0,75.42,265,96,龍洞村,NULL
160,361,1,362,568,0,0,63.73,228,133,北里村,NULL
0,361,1,362,568,0,0,63.73,228,133,北里村,NULL
226,358,4,362,542,0,0,66.79,189,169,檨子里,NULL
0,358,4,362,542,0,0,66.79,189,169,檨子里,NULL
70,358,4,362,637,0,0,56.83,165,193,菓葉村,NULL
0,358,4,362,637,0,0,56.83,165,193,菓葉村,NULL
73,360,2,362,552,0,0,65.58,156,204,雙春村,NULL
0,360,2,362,552,0,0,65.58,156,204,雙春村,NULL
445,359,2,361,555,0,0,65.05,186,173,公興村,NULL
0,359,2,361,555,0,0,65.05,186,173,公興村,NULL
577,356,5,361,518,0,0,69.69,142,214,福興村,NULL
228,355,6,361,490,0,0,73.67,108,247,九塊里,NULL
22,358,3,361,564,0,0,64.01,98,260,永賢村,NULL
0,358,3,361,564,0,0,64.01,98,260,永賢村,NULL
206,352,8,360,616,0,0,58.44,332,20,新社村,NULL
0,352,8,360,616,0,0,58.44,332,20,新社村,NULL
496,357,3,360,522,0,0,68.97,324,33,奎輝村,NULL
171,359,1,360,640,0,0,56.25,324,35,多良村,NULL
0,357,3,360,522,0,0,68.97,324,33,奎輝村,NULL
0,357,3,360,617,0,0,58.35,317,40,安朔村,NULL
402,358,2,360,455,0,0,79.12,299,59,平興村,NULL
0,358,2,360,455,0,0,79.12,299,59,平興村,NULL
363,356,4,360,525,0,0,68.57,201,155,鯉魚里,NULL
1946,355,5,360,524,0,0,68.7,197,158,基山里,NULL
0,355,5,360,524,0,0,68.7,197,158,基山里,NULL
67,356,3,359,514,0,0,69.84,187,169,新湖村,NULL
206,358,1,359,497,0,0,72.23,151,207,旭山村,NULL
217,357,2,359,495,0,0,72.53,148,209,漁光里,NULL
0,357,2,359,495,0,0,72.53,148,209,漁光里,NULL
1829,354,4,358,503,0,0,71.17,202,152,金圳里,NULL
0,354,4,358,503,0,0,71.17,202,152,金圳里,NULL
567,356,2,358,448,0,0,79.91,185,171,中央里,NULL
0,356,2,358,448,0,0,79.91,185,171,中央里,NULL
165,356,2,358,469,0,0,76.33,176,180,金山村,NULL
0,356,2,358,469,0,0,76.33,176,180,金山村,NULL
136,354,4,358,489,0,0,73.21,165,189,永樂里,NULL
0,354,4,358,489,0,0,73.21,165,189,永樂里,NULL
367,355,3,358,547,0,0,65.45,142,213,桶頭里,NULL
2217,353,4,357,505,0,0,70.69,201,152,豐漁村,NULL
0,353,4,357,505,0,0,70.69,201,152,豐漁村,NULL
33,353,4,357,643,0,0,55.52,168,185,泉州村,NULL
0,353,4,357,643,0,0,55.52,168,185,泉州村,NULL
12,352,5,357,467,0,0,76.45,113,239,崁頂村,NULL
0,352,5,357,467,0,0,76.45,113,239,崁頂村,NULL
12,352,4,356,540,0,0,65.93,288,64,民生村,NULL
11,353,3,356,576,0,0,61.81,256,97,光明里,NULL
742,351,5,356,462,0,0,77.06,199,152,縣口里,NULL
0,351,5,356,462,0,0,77.06,199,152,縣口里,NULL
191,352,3,355,556,0,0,63.85,324,28,西富村,NULL
221,354,1,355,590,0,0,60.17,267,87,瑞北村,NULL
0,354,1,355,590,0,0,60.17,267,87,瑞北村,NULL
262,351,4,355,455,0,0,78.02,264,87,華龍村,NULL
0,351,4,355,455,0,0,78.02,264,87,華龍村,NULL
146,350,5,355,451,0,0,78.71,208,142,清水里,NULL
0,350,5,355,451,0,0,78.71,208,142,清水里,NULL
630,347,8,355,446,0,0,79.6,157,190,內坑村,NULL
475,352,3,355,484,0,0,73.35,135,217,嘉興村,NULL
175,352,3,355,501,0,0,70.86,114,238,後寮村,NULL
0,352,3,355,501,0,0,70.86,114,238,後寮村,NULL
498,352,2,354,504,0,0,70.24,329,23,三光村,NULL
0,352,2,354,504,0,0,70.24,329,23,三光村,NULL
388,352,2,354,414,0,0,85.51,286,66,龍騰村,NULL
0,352,2,354,414,0,0,85.51,286,66,龍騰村,NULL
219,348,6,354,553,0,0,64.01,250,98,瑞良村,NULL
0,348,6,354,553,0,0,64.01,250,98,瑞良村,NULL
192,349,5,354,552,0,0,64.13,207,142,大林村,NULL
78,354,0,354,465,0,0,76.13,144,210,仁和里,NULL
0,354,0,354,465,0,0,76.13,144,210,仁和里,NULL
148,351,3,354,532,0,0,66.54,90,261,湖西村,NULL
356,351,2,353,544,0,0,64.89,328,23,復國里、中興里,NULL
0,351,2,353,544,0,0,64.89,328,23,復國里、中興里,NULL
300,346,7,353,426,0,0,82.86,262,84,南埔村,NULL
0,346,7,353,426,0,0,82.86,262,84,南埔村,NULL
597,351,2,353,449,0,0,78.62,215,136,內庄村,NULL
0,351,2,353,449,0,0,78.62,215,136,內庄村,NULL
54,350,3,353,564,0,0,62.59,125,225,紅羅村,NULL
0,350,3,353,564,0,0,62.59,125,225,紅羅村,NULL
703,349,3,352,571,0,0,61.65,301,48,平等村,NULL
202,351,1,352,550,0,0,64,228,123,五城村,NULL
459,348,4,352,504,0,0,69.84,177,171,竹圍村,NULL
1305,350,2,352,443,0,0,79.46,152,198,直潭里,NULL
52,345,7,352,591,0,0,59.56,152,193,南寮村,NULL
0,345,7,352,591,0,0,59.56,152,193,南寮村,NULL
191,350,2,352,467,0,0,75.37,147,203,人和村,NULL
206,349,3,352,589,0,0,59.76,124,225,青蚶村,NULL
0,349,3,352,589,0,0,59.76,124,225,青蚶村,NULL
424,346,5,351,556,0,0,63.13,310,36,雙龍村,NULL
0,346,5,351,556,0,0,63.13,310,36,雙龍村,NULL
39,348,3,351,519,0,0,67.63,267,81,富琦村,NULL
313,348,3,351,474,0,0,74.05,185,163,玉映里,NULL
0,348,3,351,474,0,0,74.05,185,163,玉映里,NULL
4,347,4,351,497,0,0,70.62,165,182,中央里,NULL
0,347,4,351,497,0,0,70.62,165,182,中央里,NULL
106,343,8,351,490,0,0,71.63,148,195,田尾里,NULL
7,349,2,351,472,0,0,74.36,128,221,土溝村,NULL
288,346,4,350,464,0,0,75.43,235,111,福興村,NULL
0,346,4,350,464,0,0,75.43,235,111,福興村,NULL
321,346,4,350,496,0,0,70.56,195,151,湖光村,NULL
1947,345,5,350,524,0,0,66.79,182,163,永慶里,NULL
0,345,5,350,524,0,0,66.79,182,163,永慶里,NULL
217,348,2,350,421,0,0,83.14,158,190,彰仁里,NULL
0,348,2,350,421,0,0,83.14,158,190,彰仁里,NULL
589,346,3,349,428,0,0,81.54,257,89,忠義村,NULL
376,347,2,349,441,0,0,79.14,219,128,內湖村,NULL
94,347,2,349,457,0,0,76.37,143,204,民安里,NULL
0,347,2,349,457,0,0,76.37,143,204,民安里,NULL
875,343,5,348,444,0,0,78.38,149,194,下湖村,NULL
0,343,5,348,444,0,0,78.38,149,194,下湖村,NULL
13,335,13,348,516,0,0,67.44,126,209,後廍村,NULL
0,335,13,348,516,0,0,67.44,126,209,後廍村,NULL
0,344,3,347,550,0,0,63.09,289,55,山興里,NULL
2232,342,5,347,469,0,0,73.99,188,154,萬壽村,NULL
0,342,5,347,469,0,0,73.99,188,154,萬壽村,NULL
29,344,3,347,440,0,0,78.86,186,158,東山里,NULL
0,344,3,347,440,0,0,78.86,186,158,東山里,NULL
180,344,3,347,472,0,0,73.52,179,165,義和村,NULL
492,346,1,347,485,0,0,71.55,154,192,南平里,NULL
80,343,4,347,622,0,0,55.79,149,194,後寮村,NULL
0,343,4,347,622,0,0,55.79,149,194,後寮村,NULL
191,343,4,347,526,0,0,65.97,137,206,大林村,NULL
191,344,2,346,556,0,0,62.23,330,14,武陵村,NULL
0,344,2,346,556,0,0,62.23,330,14,武陵村,NULL
211,344,2,346,593,0,0,58.35,315,29,明利村,NULL
0,344,2,346,593,0,0,58.35,315,29,明利村,NULL
134,342,4,346,462,0,0,74.89,191,151,永光里,NULL
238,344,2,346,460,0,0,75.22,191,153,友二里,NULL
0,342,4,346,462,0,0,74.89,191,151,永光里,NULL
0,344,2,346,460,0,0,75.22,191,153,友二里,NULL
1934,344,2,346,496,0,0,69.76,189,155,猴硐里,NULL
0,344,2,346,496,0,0,69.76,189,155,猴硐里,NULL
1298,344,2,346,433,0,0,79.91,186,158,粗坑里,NULL
46,339,7,346,458,0,0,75.55,142,197,關嶺里,NULL
352,344,1,345,489,0,0,70.55,249,95,盛隆村,NULL
0,344,1,345,489,0,0,70.55,249,95,盛隆村,NULL
61,340,5,345,451,0,0,76.5,231,109,光明里,NULL
2120,344,1,345,443,0,0,77.88,195,149,上德村,NULL
473,343,2,345,488,0,0,70.7,161,182,尚義村,NULL
235,339,5,344,1051,0,0,32.73,307,32,泰昌里,NULL
400,343,1,344,462,0,0,74.46,149,194,光華村,NULL
689,341,2,343,497,0,0,69.01,225,116,天輪村,NULL
0,341,2,343,497,0,0,69.01,225,116,天輪村,NULL
92,340,3,343,479,0,0,71.61,133,207,後庄里,NULL
0,340,3,343,479,0,0,71.61,133,207,後庄里,NULL
230,341,2,343,465,0,0,73.76,115,226,中華村,NULL
3,338,4,342,535,0,0,63.93,294,44,高中村,NULL
0,338,4,342,535,0,0,63.93,294,44,高中村,NULL
85,338,4,342,500,0,0,68.4,220,118,大林里,NULL
322,341,1,342,412,0,0,83.01,197,144,湖光村,NULL
132,341,1,342,493,0,0,69.37,186,155,蘇東里,NULL
0,341,1,342,493,0,0,69.37,186,155,蘇東里,NULL
2213,339,3,342,501,0,0,68.26,141,198,和美村,NULL
187,337,4,341,471,0,0,72.4,196,141,永芳村,NULL
0,337,4,341,471,0,0,72.4,196,141,永芳村,NULL
611,340,1,341,578,0,0,59,186,154,關山村,NULL
0,340,1,341,578,0,0,59,186,154,關山村,NULL
0,336,5,341,446,0,0,76.46,159,177,豐田村,NULL
58,335,6,341,482,0,0,70.75,155,180,東埔村,NULL
0,335,6,341,482,0,0,70.75,155,180,東埔村,NULL
265,336,4,340,410,0,0,82.93,279,57,永興村,NULL
0,336,4,340,410,0,0,82.93,279,57,永興村,NULL
606,339,1,340,465,0,0,73.12,209,130,中坑村,NULL
0,339,1,340,465,0,0,73.12,209,130,中坑村,NULL
112,333,7,340,531,0,0,64.03,182,151,蜈蚣里,NULL
192,338,1,339,579,0,0,58.55,304,34,鸞山村,NULL
0,338,1,339,579,0,0,58.55,304,34,鸞山村,NULL
126,337,2,339,546,0,0,62.09,205,132,福文村,NULL
2138,327,12,339,515,0,0,65.83,205,122,圓山村,NULL
0,327,12,339,515,0,0,65.83,205,122,圓山村,NULL
457,336,3,339,533,0,0,63.6,148,188,箕湖村,NULL
299,338,1,339,467,0,0,72.59,145,193,大崎村,NULL
0,338,1,339,467,0,0,72.59,145,193,大崎村,NULL
48,337,2,339,505,0,0,67.13,138,199,仙草里,NULL
441,339,0,339,413,0,0,82.08,58,281,觸口村,NULL
267,334,4,338,591,0,0,57.19,321,13,卓清村,NULL
143,338,0,338,441,0,0,76.64,299,39,大同村,NULL
5,333,5,338,523,0,0,64.63,287,46,民意里,NULL
100,333,5,338,522,0,0,64.75,282,51,景美村,NULL
206,336,2,338,430,0,0,78.6,201,135,回歸村,NULL
0,336,2,338,430,0,0,78.6,201,135,回歸村,NULL
161,335,3,338,474,0,0,71.31,162,173,後鎮村,NULL
0,335,3,338,474,0,0,71.31,162,173,後鎮村,NULL
133,336,2,338,476,0,0,71.01,120,216,貴舍里,NULL
0,335,2,337,460,0,0,73.26,208,127,共和村,NULL
882,334,3,337,429,0,0,78.55,186,148,龍船村,NULL
0,334,3,337,429,0,0,78.55,186,148,龍船村,NULL
2214,333,4,337,487,0,0,69.2,165,168,和美村,NULL
281,333,4,337,469,0,0,71.86,153,180,圳南村,NULL
0,333,4,337,469,0,0,71.86,153,180,圳南村,NULL
149,336,0,336,527,0,0,63.76,307,29,合作村,NULL
0,336,0,336,527,0,0,63.76,307,29,合作村,NULL
433,332,4,336,463,0,0,72.57,297,35,中興村,NULL
0,332,4,336,463,0,0,72.57,297,35,中興村,NULL
145,334,2,336,453,0,0,74.17,210,124,永康里,NULL
288,331,5,336,503,0,0,66.8,172,159,太平村,NULL
0,331,5,336,503,0,0,66.8,172,159,太平村,NULL
19,332,4,336,441,0,0,76.19,139,193,民生里,NULL
0,332,4,336,441,0,0,76.19,139,193,民生里,NULL
333,331,4,335,578,0,0,57.96,299,32,秀巒村,NULL
195,333,2,335,472,0,0,70.97,289,44,大進村,NULL
0,333,2,335,472,0,0,70.97,289,44,大進村,NULL
0,335,0,335,537,0,0,62.38,165,170,豊稠村,NULL
168,333,1,334,495,0,0,67.47,305,28,金崙村,NULL
207,325,9,334,855,0,0,39.06,257,68,東清村,NULL
0,325,9,334,855,0,0,39.06,257,68,東清村,NULL
209,330,4,334,538,0,0,62.08,189,141,頭社村,NULL
471,332,2,334,439,0,0,76.08,133,199,頂中里,NULL
0,332,2,334,439,0,0,76.08,133,199,頂中里,NULL
256,331,3,334,446,0,0,74.89,117,214,中山村,NULL
0,331,3,334,446,0,0,74.89,117,214,中山村,NULL
94,326,7,333,472,0,0,70.55,284,42,和平村,NULL
1909,332,1,333,654,0,0,50.92,192,140,新生里,NULL
0,332,1,333,654,0,0,50.92,192,140,新生里,NULL
0,329,4,333,462,0,0,72.08,157,172,中平村,NULL
421,328,5,333,453,0,0,73.51,151,177,北關里,NULL
0,328,5,333,453,0,0,73.51,151,177,北關里,NULL
346,328,4,332,393,0,0,84.48,157,171,德厚里,NULL
0,328,4,332,393,0,0,84.48,157,171,德厚里,NULL
62,327,5,332,460,0,0,72.17,154,173,開元里,NULL
0,327,5,332,460,0,0,72.17,154,173,開元里,NULL
259,325,6,331,564,0,0,58.69,245,80,富南村,NULL
0,325,6,331,564,0,0,58.69,245,80,富南村,NULL
392,330,1,331,467,0,0,70.88,154,176,金獅村,NULL
0,330,1,331,467,0,0,70.88,154,176,金獅村,NULL
575,329,1,330,502,0,0,65.74,308,21,高士村,NULL
0,329,1,330,502,0,0,65.74,308,21,高士村,NULL
420,325,5,330,480,0,0,68.75,144,181,社口村,NULL
587,328,2,330,467,0,0,70.66,130,198,大坑里,NULL
0,328,2,330,467,0,0,70.66,130,198,大坑里,NULL
1,329,0,329,567,0,0,58.02,298,31,寶山村,NULL
0,329,0,329,567,0,0,58.02,298,31,寶山村,NULL
2254,328,1,329,440,0,0,74.77,269,59,福山村,NULL
0,328,1,329,440,0,0,74.77,269,59,福山村,NULL
290,326,3,329,440,0,0,74.77,105,221,龍眼村,NULL
0,326,3,329,440,0,0,74.77,105,221,龍眼村,NULL
2215,327,1,328,445,0,0,73.71,193,134,和平村,NULL
0,327,1,328,445,0,0,73.71,193,134,和平村,NULL
569,327,1,328,443,0,0,74.04,164,163,竹林里,NULL
0,327,1,328,443,0,0,74.04,164,163,竹林里,NULL
329,327,0,327,411,0,0,79.56,310,17,東岳村,NULL
0,327,0,327,411,0,0,79.56,310,17,東岳村,NULL
200,322,5,327,499,0,0,65.53,216,106,大豐村,NULL
0,322,5,327,499,0,0,65.53,216,106,大豐村,NULL
49,324,3,327,456,0,0,71.71,177,147,永吉村,NULL
0,324,3,327,456,0,0,71.71,177,147,永吉村,NULL
2176,323,4,327,450,0,0,72.67,162,161,南山村,NULL
0,323,4,327,450,0,0,72.67,162,161,南山村,NULL
365,325,2,327,491,0,0,66.6,161,164,坪頂里,NULL
0,325,2,327,491,0,0,66.6,161,164,坪頂里,NULL
2189,326,0,326,481,0,0,67.78,180,146,外柑村,NULL
0,326,0,326,481,0,0,67.78,180,146,外柑村,NULL
61,324,2,326,491,0,0,66.4,167,157,石坑村,NULL
0,324,2,326,491,0,0,66.4,167,157,石坑村,NULL
72,323,3,326,558,0,0,58.42,158,165,講美村,NULL
0,323,3,326,558,0,0,58.42,158,165,講美村,NULL
358,321,5,326,489,0,0,66.67,157,164,芳中村,NULL
0,321,5,326,489,0,0,66.67,157,164,芳中村,NULL
65,325,1,326,463,0,0,70.41,143,182,馬鳴村,NULL
662,323,3,326,440,0,0,74.09,118,205,三民里,NULL
22,324,2,326,443,0,0,73.59,110,214,竹新村,NULL
288,322,3,325,427,0,0,76.11,215,107,上新里,NULL
338,320,5,325,529,0,0,61.44,170,150,秀林里,NULL
2173,323,2,325,480,0,0,67.71,154,169,東勢村,NULL
0,323,2,325,480,0,0,67.71,154,169,東勢村,NULL
219,325,0,325,461,0,0,70.5,130,195,聖賢村,NULL
238,320,5,325,438,0,0,74.2,92,228,保源村,NULL
458,322,2,324,491,0,0,65.99,288,34,山美村,NULL
0,322,2,324,491,0,0,65.99,288,34,山美村,NULL
300,323,1,324,449,0,0,72.16,131,192,三崙村,NULL
251,323,1,324,424,0,0,76.42,126,197,共榮里,NULL
0,323,1,324,424,0,0,76.42,126,197,共榮里,NULL
462,319,4,323,411,0,0,78.59,309,10,丹林村,NULL
334,321,2,323,430,0,0,75.12,301,20,金洋村,NULL
0,321,2,323,430,0,0,75.12,301,20,金洋村,NULL
166,319,4,323,531,0,0,60.83,241,78,鹽寮村,NULL
0,319,4,323,531,0,0,60.83,241,78,鹽寮村,NULL
83,321,2,323,424,0,0,76.18,236,85,中正里,NULL
440,323,0,323,442,0,0,73.08,234,89,觸口村,NULL
78,321,2,323,446,0,0,72.42,164,157,溪邊里,NULL
34,322,0,322,428,0,0,75.23,171,151,內安里,NULL
0,322,0,322,428,0,0,75.23,171,151,內安里,NULL
250,319,3,322,433,0,0,74.36,131,188,義民里,NULL
37,317,5,322,453,0,0,71.08,131,186,海埔村,NULL
0,319,3,322,433,0,0,74.36,131,188,義民里,NULL
0,317,5,322,453,0,0,71.08,131,186,海埔村,NULL
43,318,4,322,438,0,0,73.52,121,197,崁頭里,NULL
0,318,4,322,438,0,0,73.52,121,197,崁頭里,NULL
261,315,6,321,528,0,0,60.8,302,13,崙山村,NULL
0,315,6,321,528,0,0,60.8,302,13,崙山村,NULL
2100,321,0,321,412,0,0,77.91,168,153,石碇村,NULL
0,321,0,321,412,0,0,77.91,168,153,石碇村,NULL
179,319,2,321,441,0,0,72.79,145,174,角帶里,NULL
0,319,2,321,441,0,0,72.79,145,174,角帶里,NULL
66,319,2,321,477,0,0,67.3,109,210,玉港村,NULL
234,319,1,320,421,0,0,76.01,164,155,瑪南里,NULL
0,319,1,320,421,0,0,76.01,164,155,瑪南里,NULL
90,317,3,320,589,0,0,54.33,157,160,大池村,NULL
0,317,3,320,589,0,0,54.33,157,160,大池村,NULL
169,317,3,320,428,0,0,74.77,134,183,慶昌里,NULL
0,317,3,320,428,0,0,74.77,134,183,慶昌里,NULL
77,317,1,318,462,0,0,68.83,195,122,北山村,NULL
92,313,5,318,528,0,0,60.23,188,125,池東村,NULL
0,313,5,318,528,0,0,60.23,188,125,池東村,NULL
295,315,3,318,441,0,0,72.11,163,152,太和村,NULL
399,316,2,318,420,0,0,75.71,146,170,中和村,NULL
0,315,3,318,459,0,0,69.28,122,193,頂揖村,NULL
221,315,3,318,481,0,0,66.11,112,203,南溪村,NULL
0,315,3,318,481,0,0,66.11,112,203,南溪村,NULL
555,313,4,317,429,0,0,73.89,303,10,力里村,NULL
0,313,4,317,429,0,0,73.89,303,10,力里村,NULL
91,316,1,317,579,0,0,54.75,260,56,電光里,NULL
0,316,1,317,579,0,0,54.75,260,56,電光里,NULL
114,313,4,317,507,0,0,62.52,255,58,鹿野村,NULL
111,316,1,317,546,0,0,58.06,208,108,富山村,NULL
0,316,1,317,546,0,0,58.06,208,108,富山村,NULL
307,311,6,317,452,0,0,70.13,176,135,人和村,NULL
0,311,6,317,452,0,0,70.13,176,135,人和村,NULL
160,314,3,317,416,0,0,76.2,78,236,大同村,NULL
0,314,3,317,416,0,0,76.2,78,236,大同村,NULL
92,309,7,316,552,0,0,57.25,251,58,嘉新村,NULL
140,313,3,316,550,0,0,57.45,241,72,隆昌村,NULL
0,313,3,316,550,0,0,57.45,241,72,隆昌村,NULL
2182,315,1,316,458,0,0,69,147,168,三港村,NULL
0,315,1,316,458,0,0,69,147,168,三港村,NULL
2199,315,1,316,505,0,0,62.57,142,173,吉林村,NULL
0,315,1,316,505,0,0,62.57,142,173,吉林村,NULL
160,315,1,316,452,0,0,69.91,128,187,平溪村,NULL
0,315,1,316,452,0,0,69.91,128,187,平溪村,NULL
332,313,2,315,421,0,0,74.82,153,160,永安里,NULL
0,313,2,315,421,0,0,74.82,153,160,永安里,NULL
146,307,8,315,471,0,0,66.88,109,198,朝陽里,NULL
240,311,3,314,538,0,0,58.36,233,78,東豐里,NULL
0,311,3,314,538,0,0,58.36,233,78,東豐里,NULL
44,313,1,314,496,0,0,63.31,222,91,德文村,NULL
0,313,1,314,496,0,0,63.31,222,91,德文村,NULL
158,309,5,314,408,0,0,76.96,145,164,興安里,NULL
0,309,5,314,408,0,0,76.96,145,164,興安里,NULL
167,313,1,314,500,0,0,62.8,138,175,官順村,NULL
0,313,1,314,500,0,0,62.8,138,175,官順村,NULL
41,311,3,314,456,0,0,68.86,124,187,虎山里,NULL
0,311,3,314,456,0,0,68.86,124,187,虎山里,NULL
209,310,3,313,492,0,0,63.62,295,15,見晴村,NULL
0,310,3,313,492,0,0,63.62,295,15,見晴村,NULL
183,310,3,313,473,0,0,66.17,195,115,內城村,NULL
0,310,3,313,473,0,0,66.17,195,115,內城村,NULL
592,310,3,313,439,0,0,71.3,158,152,光和村,NULL
0,310,3,313,439,0,0,71.3,158,152,光和村,NULL
121,312,1,313,425,0,0,73.65,156,156,泉源里,NULL
15,311,2,313,428,0,0,73.13,130,181,菁寮村,NULL
0,311,2,313,428,0,0,73.13,130,181,菁寮村,NULL
242,311,2,313,410,0,0,76.34,122,189,本厝村,NULL
116,309,3,312,470,0,0,66.38,232,77,福龍里,NULL
0,309,3,312,470,0,0,66.38,232,77,福龍里,NULL
2253,308,4,312,415,0,0,75.18,180,128,信賢村,NULL
0,308,4,312,415,0,0,75.18,180,128,信賢村,NULL
435,308,3,311,429,0,0,72.49,160,148,內甕村,NULL
0,308,3,311,429,0,0,72.49,160,148,內甕村,NULL
598,307,4,311,456,0,0,68.2,115,192,岡林村,NULL
0,307,4,311,456,0,0,68.2,115,192,岡林村,NULL
105,309,2,311,426,0,0,73,75,234,三慶里,NULL
182,306,4,310,498,0,0,62.25,294,12,加拿村,NULL
0,306,4,310,498,0,0,62.25,294,12,加拿村,NULL
434,308,2,310,409,0,0,75.79,278,30,梅園村,NULL
0,308,2,310,409,0,0,75.79,278,30,梅園村,NULL
697,308,2,310,407,0,0,76.17,213,95,中坑村,NULL
0,308,2,310,407,0,0,76.17,213,95,中坑村,NULL
559,309,1,310,450,0,0,68.89,175,134,枋山村,NULL
553,305,5,310,380,0,0,81.58,169,136,平陽村,NULL
0,305,5,310,380,0,0,81.58,169,136,平陽村,NULL
246,308,2,310,397,0,0,78.09,160,148,慈愛里,NULL
0,308,2,310,397,0,0,78.09,160,148,慈愛里,NULL
2195,307,3,310,490,0,0,63.27,154,153,泰平村,NULL
119,307,3,310,436,0,0,71.1,150,157,港邊里,NULL
319,306,4,310,424,0,0,73.11,135,171,塩埕村,NULL
0,306,4,310,424,0,0,73.11,135,171,塩埕村,NULL
56,306,4,310,425,0,0,72.94,129,177,掌潭村,NULL
67,310,0,310,534,0,0,58.05,129,181,尖山村,NULL
0,310,0,310,534,0,0,58.05,129,181,尖山村,NULL
323,305,4,309,398,0,0,77.64,225,80,福德村,NULL
0,305,4,309,398,0,0,77.64,225,80,福德村,NULL
171,306,3,309,454,0,0,68.06,114,192,東榮村,NULL
0,306,3,309,454,0,0,68.06,114,192,東榮村,NULL
331,308,1,309,408,0,0,75.74,107,201,碧山里,NULL
576,305,3,308,557,0,0,55.3,283,22,四林村,NULL
0,305,3,308,557,0,0,55.3,283,22,四林村,NULL
205,304,4,308,661,0,0,46.6,269,35,椰油村,NULL
0,304,4,308,661,0,0,46.6,269,35,椰油村,NULL
333,306,2,308,406,0,0,75.86,257,49,武塔村,NULL
0,306,2,308,406,0,0,75.86,257,49,武塔村,NULL
588,306,2,308,512,0,0,60.16,141,165,射寮村,NULL
0,306,2,308,512,0,0,60.16,141,165,射寮村,NULL
608,306,2,308,467,0,0,65.95,128,178,茄湖里,NULL
0,306,2,308,467,0,0,65.95,128,178,茄湖里,NULL
129,306,2,308,466,0,0,66.09,117,189,孫厝里,NULL
0,306,2,308,466,0,0,66.09,117,189,孫厝里,NULL
2122,307,1,308,455,0,0,67.69,104,203,漁光村,NULL
432,304,3,307,430,0,0,71.4,288,16,大興村,NULL
0,304,3,307,430,0,0,71.4,288,16,大興村,NULL
0,307,0,307,529,0,0,58.03,201,106,和平村,NULL
55,302,5,307,415,0,0,73.98,153,149,內南村,NULL
0,302,5,307,415,0,0,73.98,153,149,內南村,NULL
123,303,4,307,503,0,0,61.03,90,213,瑞豐村,NULL
163,306,0,306,401,0,0,76.31,299,7,互助村,NULL
492,304,2,306,460,0,0,66.52,282,22,霞雲村,NULL
0,304,2,306,460,0,0,66.52,282,22,霞雲村,NULL
257,301,5,306,500,0,0,61.2,229,72,永豐村,NULL
0,301,5,306,500,0,0,61.2,229,72,永豐村,NULL
304,300,6,306,460,0,0,66.52,207,93,貴林村,NULL
0,300,6,306,460,0,0,66.52,207,93,貴林村,NULL
124,302,4,306,442,0,0,69.23,195,107,建國里,NULL
0,302,4,306,442,0,0,69.23,195,107,建國里,NULL
229,301,5,306,438,0,0,69.86,190,111,內城村,NULL
96,302,4,306,399,0,0,76.69,172,130,梅埔里,NULL
2167,304,2,306,436,0,0,70.18,139,165,薯榔村,NULL
0,304,2,306,436,0,0,70.18,139,165,薯榔村,NULL
156,304,2,306,441,0,0,69.39,134,170,五厝村,NULL
0,304,2,306,441,0,0,69.39,134,170,五厝村,NULL
263,301,4,305,522,0,0,58.43,278,23,立山村,NULL
434,300,5,305,392,0,0,77.81,216,84,新興村,NULL
0,300,5,305,392,0,0,77.81,216,84,新興村,NULL
418,303,2,305,471,0,0,64.76,187,116,神木村,NULL
1953,303,2,305,414,0,0,73.67,182,121,新山里,NULL
0,303,2,305,414,0,0,73.67,182,121,新山里,NULL
156,301,3,304,432,0,0,70.37,142,159,三和村,NULL
0,301,3,304,432,0,0,70.37,142,159,三和村,NULL
106,303,1,304,400,0,0,76,141,162,慶昇里,NULL
0,303,1,304,400,0,0,76,141,162,慶昇里,NULL
287,297,7,304,427,0,0,71.19,113,184,半天村,NULL
0,297,7,304,427,0,0,71.19,113,184,半天村,NULL
6,300,3,303,423,0,0,71.63,171,129,榮光里,NULL
0,300,3,303,423,0,0,71.63,171,129,榮光里,NULL
270,303,0,303,398,0,0,76.13,108,195,後溝里,NULL
95,302,0,302,472,0,0,63.98,144,158,美農村,NULL
341,297,5,302,405,0,0,74.57,122,175,豊收村,NULL
368,296,5,301,456,0,0,66.01,174,122,桶頭里,NULL
248,298,2,300,520,0,0,57.69,234,64,吳江村,NULL
0,298,2,300,520,0,0,57.69,234,64,吳江村,NULL
409,297,3,300,414,0,0,72.46,191,106,自強村,NULL
289,296,4,300,421,0,0,71.26,170,126,太興村,NULL
0,296,4,300,421,0,0,71.26,170,126,太興村,NULL
71,296,4,300,450,0,0,66.67,153,143,中屯村,NULL
0,296,4,300,450,0,0,66.67,153,143,中屯村,NULL
549,297,3,300,421,0,0,71.26,140,157,玉泉村,NULL
0,297,3,300,421,0,0,71.26,140,157,玉泉村,NULL
485,297,3,300,392,0,0,76.53,89,208,港東村,NULL
35,299,0,299,419,0,0,71.36,281,18,多納村,NULL
0,299,0,299,419,0,0,71.36,281,18,多納村,NULL
170,298,1,299,436,0,0,68.58,152,146,福盛村,NULL
11,299,0,299,394,0,0,75.89,117,182,茄苳村,NULL
494,299,0,299,381,0,0,78.48,89,210,新復村,NULL
0,299,0,299,381,0,0,78.48,89,210,新復村,NULL
421,295,3,298,391,0,0,76.21,256,39,百壽村,NULL
0,295,3,298,391,0,0,76.21,256,39,百壽村,NULL
1787,295,3,298,383,0,0,77.81,163,132,秀川里,NULL
0,295,3,298,383,0,0,77.81,163,132,秀川里,NULL
770,287,10,297,724,0,0,41.02,277,10,碧峰里,NULL
77,297,0,297,564,0,0,52.66,228,69,三仙里,NULL
79,293,4,297,580,0,0,51.21,227,66,忠孝里,NULL
152,295,2,297,607,0,0,48.93,213,82,忠勇村,NULL
0,295,2,297,607,0,0,48.93,213,82,忠勇村,NULL
0,293,4,297,410,0,0,72.44,190,103,草山村,NULL
246,294,3,297,431,0,0,68.91,122,172,三吉村,NULL
0,294,3,297,431,0,0,68.91,122,172,三吉村,NULL
302,294,2,296,373,0,0,79.36,217,77,南坑村,NULL
0,294,2,296,373,0,0,79.36,217,77,南坑村,NULL
35,293,3,296,464,0,0,63.79,162,131,安宅里,NULL
0,293,3,296,464,0,0,63.79,162,131,安宅里,NULL
104,295,1,296,464,0,0,63.79,127,168,三慶里,NULL
94,294,2,296,549,0,0,53.92,106,188,赤馬村,NULL
0,294,2,296,549,0,0,53.92,106,188,赤馬村,NULL
240,293,3,296,410,0,0,72.2,91,202,苓和村,NULL
49,287,8,295,426,0,0,69.25,273,14,仙草里,NULL
147,293,2,295,600,0,0,49.17,273,20,寧埔村,NULL
415,291,4,295,469,0,0,62.9,215,76,望美村,NULL
469,293,2,295,493,0,0,59.84,182,111,西興村,NULL
0,293,2,295,493,0,0,59.84,182,111,西興村,NULL
318,293,2,295,454,0,0,64.98,164,129,富山里、廣明里,NULL
0,293,2,295,454,0,0,64.98,164,129,富山里、廣明里,NULL
197,295,0,295,389,0,0,75.84,99,196,二結村,NULL
0,295,0,295,389,0,0,75.84,99,196,二結村,NULL
195,292,2,294,420,0,0,70,264,28,新興村,NULL
0,292,2,294,420,0,0,70,264,28,新興村,NULL
693,294,0,294,379,0,0,77.57,260,34,自由村,NULL
372,291,3,294,415,0,0,70.84,167,124,彰雅村,NULL
119,291,3,294,424,0,0,69.34,153,138,九龍里,NULL
0,291,3,294,424,0,0,69.34,153,138,九龍里,NULL
71,293,1,294,420,0,0,70,119,174,鯤江村,NULL
109,293,1,294,386,0,0,76.17,118,175,三生里,NULL
0,293,1,294,386,0,0,76.17,118,175,三生里,NULL
131,289,5,294,390,0,0,75.38,64,225,下林里,NULL
0,289,5,294,390,0,0,75.38,64,225,下林里,NULL
417,292,1,293,447,0,0,65.55,181,111,同富村,NULL
176,283,9,292,489,0,0,59.71,271,12,大竹村,NULL
67,291,1,292,575,0,0,50.78,243,48,信義里,NULL
377,287,5,292,531,0,0,54.99,153,134,五俊村,NULL
0,287,5,292,531,0,0,54.99,153,134,五俊村,NULL
182,291,1,292,443,0,0,65.91,74,217,卓運村,NULL
0,291,1,292,443,0,0,65.91,74,217,卓運村,NULL
153,290,1,291,472,0,0,61.65,277,13,力行村,NULL
0,290,1,291,472,0,0,61.65,277,13,力行村,NULL
369,290,1,291,384,0,0,75.78,209,81,飛鳳村,NULL
0,290,1,291,384,0,0,75.78,209,81,飛鳳村,NULL
190,284,7,291,408,0,0,71.32,183,101,暖東里,NULL
0,284,7,291,408,0,0,71.32,183,101,暖東里,NULL
56,289,2,291,438,0,0,66.44,146,143,成功村,NULL
0,289,2,291,438,0,0,66.44,146,143,成功村,NULL
609,288,3,291,465,0,0,62.58,106,182,頭溝里,NULL
0,288,3,291,465,0,0,62.58,106,182,頭溝里,NULL
425,290,0,290,461,0,0,62.91,279,11,潭南村,NULL
0,290,0,290,461,0,0,62.91,279,11,潭南村,NULL
0,288,2,290,439,0,0,66.06,180,108,菜舖里,NULL
192,286,4,290,398,0,0,72.86,145,141,三角村,NULL
249,284,6,290,403,0,0,71.96,123,161,中和里,NULL
0,284,6,290,403,0,0,71.96,123,161,中和里,NULL
50,289,0,289,387,0,0,74.68,250,39,安坡村,NULL
0,289,0,289,387,0,0,74.68,250,39,安坡村,NULL
356,285,4,289,438,0,0,65.98,164,121,田子里,NULL
369,287,2,289,383,0,0,75.46,147,140,甘棠村,NULL
0,287,2,289,383,0,0,75.46,147,140,甘棠村,NULL
589,285,4,289,463,0,0,62.42,134,151,後灣村,NULL
0,285,4,289,463,0,0,62.42,134,151,後灣村,NULL
1304,288,1,289,407,0,0,71.01,112,176,直潭里,NULL
2116,286,3,289,408,0,0,70.83,100,186,石村,NULL
0,286,3,289,408,0,0,70.83,100,186,石村,NULL
2198,283,5,288,437,0,0,65.9,142,141,龍崗村,NULL
0,283,5,288,437,0,0,65.9,142,141,龍崗村,NULL
594,285,3,288,511,0,0,56.36,116,169,响林村,NULL
0,285,3,288,511,0,0,56.36,116,169,响林村,NULL
870,285,3,288,356,0,0,80.9,103,182,布袋村,NULL
180,279,7,286,485,0,0,58.97,257,22,公舘村,NULL
0,284,2,286,518,0,0,55.21,245,39,翠華村,NULL
420,280,6,286,386,0,0,74.09,213,67,永和村,NULL
0,280,6,286,386,0,0,74.09,213,67,永和村,NULL
374,284,2,286,354,0,0,80.79,198,86,鳴鳳村,NULL
0,284,2,286,354,0,0,80.79,198,86,鳴鳳村,NULL
290,285,1,286,342,0,0,83.63,178,107,沙坑村,NULL
6,282,4,286,525,0,0,54.48,143,139,瓦磘村,NULL
134,282,4,286,401,0,0,71.32,107,175,飯店里,NULL
0,282,4,286,401,0,0,71.32,107,175,飯店里,NULL
29,285,1,286,434,0,0,65.9,92,193,更寮村,NULL
588,283,2,285,385,0,0,74.03,215,68,忠義村,NULL
1954,281,4,285,412,0,0,69.17,196,85,石山里,NULL
0,281,4,285,412,0,0,69.17,196,85,石山里,NULL
20,284,1,285,406,0,0,70.2,157,127,鐵花里,NULL
0,284,1,285,406,0,0,70.2,157,127,鐵花里,NULL
162,282,2,284,393,0,0,72.26,228,54,志學村,NULL
48,280,4,284,467,0,0,60.81,149,131,永興村,NULL
0,280,4,284,467,0,0,60.81,149,131,永興村,NULL
2200,282,2,284,445,0,0,63.82,127,155,雙玉村,NULL
161,283,1,284,397,0,0,71.54,116,167,田寮村,NULL
0,283,1,284,397,0,0,71.54,116,167,田寮村,NULL
2212,278,6,284,392,0,0,72.45,104,174,美豐村,NULL
262,281,2,283,487,0,0,58.11,258,23,立山村,NULL
237,282,1,283,389,0,0,72.75,166,116,東山里,NULL
0,282,1,283,389,0,0,72.75,166,116,東山里,NULL
209,282,1,283,378,0,0,74.87,80,202,大堀村,NULL
330,275,7,282,395,0,0,71.39,248,27,玉峰村,NULL
71,281,1,282,362,0,0,77.9,218,63,瑞峰里,NULL
0,281,1,282,362,0,0,77.9,218,63,瑞峰里,NULL
165,281,1,282,462,0,0,61.04,189,92,香蘭村,NULL
0,277,5,282,549,0,0,51.37,181,96,嘉豐村,NULL
2211,279,3,282,407,0,0,69.29,117,162,美豐村,NULL
244,280,2,282,415,0,0,67.95,96,184,將貴村,NULL
142,274,7,281,483,0,0,58.18,257,17,建興村,NULL
325,277,4,281,351,0,0,80.06,245,32,嘉樂村,NULL
0,277,4,281,351,0,0,80.06,245,32,嘉樂村,NULL
236,277,4,281,350,0,0,80.29,144,133,瑪西里,NULL
0,277,4,281,350,0,0,80.29,144,133,瑪西里,NULL
72,277,3,280,374,0,0,74.87,213,64,軟橋里,NULL
0,277,3,280,374,0,0,74.87,213,64,軟橋里,NULL
582,277,3,280,417,0,0,67.15,139,138,統埔村,NULL
0,277,3,280,417,0,0,67.15,139,138,統埔村,NULL
883,278,2,280,404,0,0,69.31,135,143,石村,NULL
0,278,2,280,404,0,0,69.31,135,143,石村,NULL
55,277,3,280,472,0,0,59.32,132,145,西溪村,NULL
0,277,3,280,472,0,0,59.32,132,145,西溪村,NULL
201,274,6,280,385,0,0,72.73,131,143,大雁村,NULL
100,278,2,280,421,0,0,66.51,74,204,光華里,NULL
791,276,3,279,329,0,0,84.8,251,25,忠貞里,NULL
0,276,3,279,329,0,0,84.8,251,25,忠貞里,NULL
212,276,3,279,394,0,0,70.81,248,28,馬遠村,NULL
587,274,5,279,446,0,0,62.56,141,133,埔墘村,NULL
0,274,5,279,446,0,0,62.56,141,133,埔墘村,NULL
383,278,1,279,428,0,0,65.19,110,168,秀峰村、永隆村,NULL
0,278,1,279,428,0,0,65.19,110,168,秀峰村、永隆村,NULL
138,274,4,278,408,0,0,68.14,264,10,曲溪里,NULL
433,273,4,277,360,0,0,76.94,180,93,中崙村,NULL
0,273,4,277,360,0,0,76.94,180,93,中崙村,NULL
318,275,2,277,350,0,0,79.14,158,117,七星村,NULL
2190,275,2,277,408,0,0,67.89,107,168,長源村,NULL
0,275,2,277,408,0,0,67.89,107,168,長源村,NULL
6,273,3,276,555,0,0,49.73,266,7,青帆村、田沃村、西坵村,NULL
0,273,3,276,555,0,0,49.73,266,7,青帆村、田沃村、西坵村,NULL
169,275,1,276,388,0,0,71.13,135,140,八仙村,NULL
265,274,2,276,387,0,0,71.32,113,161,中坑里,NULL
107,272,4,276,341,0,0,80.94,84,188,聖西里,NULL
222,273,3,276,465,0,0,59.35,84,189,水雲村,NULL
0,272,4,276,341,0,0,80.94,84,188,聖西里,NULL
0,273,3,276,465,0,0,59.35,84,189,水雲村,NULL
192,274,1,275,456,0,0,60.31,198,76,西富村,NULL
122,273,2,275,458,0,0,60.04,155,118,瑞豐村,NULL
450,272,3,275,367,0,0,74.93,133,139,建功村,NULL
153,274,1,275,372,0,0,73.92,132,142,鹿埔村,NULL
0,274,1,275,372,0,0,73.92,132,142,鹿埔村,NULL
271,271,4,275,420,0,0,65.48,94,177,新厝里,NULL
0,271,4,275,420,0,0,65.48,94,177,新厝里,NULL
133,272,3,275,381,0,0,72.18,82,190,大豐里,NULL
0,272,3,275,381,0,0,72.18,82,190,大豐里,NULL
70,273,1,274,378,0,0,72.49,213,60,上坪里,NULL
0,273,1,274,378,0,0,72.49,213,60,上坪里,NULL
24,271,3,274,440,0,0,62.27,198,73,復興里,NULL
0,271,3,274,440,0,0,62.27,198,73,復興里,NULL
596,272,2,274,378,0,0,72.49,133,139,睦光村,NULL
0,272,2,274,378,0,0,72.49,133,139,睦光村,NULL
112,272,2,274,382,0,0,71.73,111,161,水仙里,NULL
0,272,2,274,382,0,0,71.73,111,161,水仙里,NULL
205,265,8,273,389,0,0,70.18,126,139,中明村,NULL
586,270,3,273,407,0,0,67.08,97,173,新街村,NULL
0,270,3,273,407,0,0,67.08,97,173,新街村,NULL
59,272,1,273,445,0,0,61.35,88,184,四美村,NULL
208,271,1,272,417,0,0,65.23,165,106,頭社村,NULL
51,267,5,272,413,0,0,65.86,102,165,東崙村,NULL
164,271,0,271,342,0,0,79.24,261,10,新生村,NULL
0,271,0,271,342,0,0,79.24,261,10,新生村,NULL
1950,270,1,271,380,0,0,71.32,159,111,頌德里,NULL
0,270,1,271,380,0,0,71.32,159,111,頌德里,NULL
507,270,1,271,420,0,0,64.52,152,118,公館村,NULL
655,269,2,271,343,0,0,79.01,148,121,橫路里,NULL
0,269,2,271,343,0,0,79.01,148,121,橫路里,NULL
364,271,0,271,379,0,0,71.5,121,150,溪州里,NULL
0,271,0,271,379,0,0,71.5,121,150,溪州里,NULL
38,271,0,271,420,0,0,64.52,111,160,鐵線里,NULL
0,271,0,271,420,0,0,64.52,111,160,鐵線里,NULL
235,270,1,271,382,0,0,70.94,93,177,溪北村,NULL
198,265,4,269,497,0,0,54.12,204,61,大興村,NULL
0,265,4,269,497,0,0,54.12,204,61,大興村,NULL
323,264,5,269,348,0,0,77.3,134,130,溪南村,NULL
0,264,5,269,348,0,0,77.3,134,130,溪南村,NULL
246,267,2,269,378,0,0,71.16,100,167,柳溝村,NULL
337,267,2,269,367,0,0,73.3,85,182,鹽田村,NULL
0,267,2,269,367,0,0,73.3,85,182,鹽田村,NULL
209,265,4,269,383,0,0,70.23,81,184,台子村,NULL
332,265,3,268,361,0,0,74.24,255,10,金岳村,NULL
0,265,3,268,361,0,0,74.24,255,10,金岳村,NULL
426,267,1,268,366,0,0,73.22,198,69,新豐村,NULL
0,267,1,268,366,0,0,73.22,198,69,新豐村,NULL
236,268,0,268,358,0,0,74.86,184,84,軍功里,NULL
120,264,4,268,384,0,0,69.79,148,116,岑海里,NULL
52,265,3,268,399,0,0,67.17,116,149,東崙村,NULL
2121,267,1,268,401,0,0,66.83,83,184,漁光村,NULL
567,264,3,267,419,0,0,63.72,239,25,獅子村,NULL
0,264,3,267,419,0,0,63.72,239,25,獅子村,NULL
100,265,2,267,454,0,0,58.81,185,80,明峰村,NULL
210,267,0,267,425,0,0,62.82,176,91,武登村,NULL
432,266,1,267,348,0,0,76.72,137,129,東興村,NULL
0,266,1,267,348,0,0,76.72,137,129,東興村,NULL
153,266,0,266,375,0,0,70.93,232,34,排灣村,NULL
0,266,0,266,375,0,0,70.93,232,34,排灣村,NULL
339,266,0,266,413,0,0,64.41,150,116,大鞍里,NULL
0,266,0,266,413,0,0,64.41,150,116,大鞍里,NULL
398,264,2,266,428,0,0,62.15,145,119,中和村,NULL
13,264,2,266,366,0,0,72.68,86,178,正義村,NULL
389,260,5,265,381,0,0,69.55,253,7,忠孝里,NULL
63,263,2,265,370,0,0,71.62,150,113,北門村,NULL
879,264,1,265,331,0,0,80.06,123,141,楠坑村,NULL
0,264,1,265,331,0,0,80.06,123,141,楠坑村,NULL
34,261,4,265,474,0,0,55.91,94,167,五榔村,NULL
0,261,4,265,474,0,0,55.91,94,167,五榔村,NULL
2227,261,3,264,375,0,0,70.4,133,128,兩湖村,NULL
0,261,3,264,375,0,0,70.4,133,128,兩湖村,NULL
223,262,2,264,411,0,0,64.23,86,176,林安村,NULL
0,262,2,264,411,0,0,64.23,86,176,林安村,NULL
74,261,2,263,373,0,0,70.51,183,78,新城村,NULL
362,263,0,263,373,0,0,70.51,168,95,福興里,NULL
254,262,1,263,367,0,0,71.66,120,142,賜福里,NULL
0,262,1,263,367,0,0,71.66,120,142,賜福里,NULL
60,260,2,262,351,0,0,74.64,188,72,好茶村,NULL
0,260,2,262,351,0,0,74.64,188,72,好茶村,NULL
284,257,5,262,328,0,0,79.88,183,74,豐田村,NULL
0,257,5,262,328,0,0,79.88,183,74,豐田村,NULL
1076,261,1,262,332,0,0,78.92,135,126,雙鳳里,NULL
83,255,5,260,399,0,0,65.16,201,54,大漢村,NULL
359,259,1,260,359,0,0,72.42,137,122,德興里,NULL
38,259,1,260,353,0,0,73.65,121,138,鎮南里,NULL
0,259,1,260,353,0,0,73.65,121,138,鎮南里,NULL
270,255,4,259,428,0,0,60.51,242,13,古風村,NULL
201,257,2,259,331,0,0,78.25,132,125,粗溪村,NULL
159,257,1,258,407,0,0,63.39,142,115,三姓村,NULL
0,257,1,258,407,0,0,63.39,142,115,三姓村,NULL
554,257,1,258,385,0,0,67.01,101,156,豐德村,NULL
0,257,1,258,385,0,0,67.01,101,156,豐德村,NULL
98,257,0,257,356,0,0,72.19,155,102,東昌里,NULL
573,253,3,256,400,0,0,64,207,46,東源村,NULL
0,253,3,256,400,0,0,64,207,46,東源村,NULL
131,254,2,256,337,0,0,75.96,184,70,福林里,NULL
113,253,3,256,435,0,0,58.85,176,77,利吉村,NULL
0,253,3,256,435,0,0,58.85,176,77,利吉村,NULL
159,252,4,256,376,0,0,68.09,172,80,平和村,NULL
387,255,1,256,375,0,0,68.27,162,93,塘興村,NULL
117,255,1,256,359,0,0,71.31,92,163,存仁里,NULL
80,254,1,255,529,0,0,48.2,203,51,忠孝里,NULL
178,253,2,255,344,0,0,74.13,88,165,舊廍里,NULL
0,253,2,255,344,0,0,74.13,88,165,舊廍里,NULL
145,252,2,254,461,0,0,55.1,185,67,北源村,NULL
448,253,1,254,332,0,0,76.51,133,120,新埤村,NULL
72,251,3,254,372,0,0,68.28,64,187,鯤江村,NULL
454,252,1,253,358,0,0,70.67,133,119,萬隆村,NULL
84,252,1,253,338,0,0,74.85,123,129,育仁里,NULL
443,253,0,253,367,0,0,68.94,108,145,公田村,NULL
400,253,0,253,304,0,0,83.22,58,195,嘉峰里,NULL
400,245,7,252,374,0,0,67.38,152,93,新山村,NULL
0,245,7,252,374,0,0,67.38,152,93,新山村,NULL
460,250,1,251,309,0,0,81.23,242,8,義林村,NULL
1935,249,2,251,347,0,0,72.33,128,121,光復里,NULL
0,249,2,251,347,0,0,72.33,128,121,光復里,NULL
2103,249,2,251,339,0,0,74.04,120,129,彭山村,NULL
0,249,2,251,339,0,0,74.04,120,129,彭山村,NULL
47,250,1,251,364,0,0,68.96,105,145,震安里,NULL
0,250,1,251,364,0,0,68.96,105,145,震安里,NULL
471,250,1,251,327,0,0,76.76,100,150,新莊村,NULL
157,247,3,250,345,0,0,72.46,116,131,中平村,NULL
157,248,1,249,360,0,0,69.17,233,15,親愛村,NULL
253,248,1,249,444,0,0,56.08,193,55,羅山村,NULL
0,248,1,249,444,0,0,56.08,193,55,羅山村,NULL
190,246,3,249,332,0,0,75,103,143,後堀村,NULL
337,244,4,248,318,0,0,77.99,186,58,北河村,NULL
0,244,4,248,318,0,0,77.99,186,58,北河村,NULL
168,247,1,248,376,0,0,65.96,137,110,八仙村,NULL
2193,243,5,248,360,0,0,68.89,118,125,魚行村,NULL
65,245,3,248,378,0,0,65.61,97,148,永華村,NULL
0,245,3,248,378,0,0,65.61,97,148,永華村,NULL
58,243,4,247,369,0,0,66.94,206,37,大武村,NULL
0,243,4,247,369,0,0,66.94,206,37,大武村,NULL
192,244,3,247,334,0,0,73.95,120,124,人和村,NULL
590,242,3,245,400,0,0,61.25,202,40,光武村,NULL
0,242,3,245,400,0,0,61.25,202,40,光武村,NULL
161,243,1,244,366,0,0,66.67,220,23,佳興村,NULL
0,243,1,244,366,0,0,66.67,220,23,佳興村,NULL
152,242,2,244,387,0,0,63.05,171,71,合興里,NULL
0,242,2,244,387,0,0,63.05,171,71,合興里,NULL
791,243,1,244,328,0,0,74.39,111,132,成功村,NULL
57,243,0,243,358,0,0,67.88,181,62,掌潭村,NULL
319,241,2,243,389,0,0,62.47,172,69,富山里,NULL
0,241,2,243,389,0,0,62.47,172,69,富山里,NULL
448,242,1,243,371,0,0,65.5,161,81,中山村,NULL
0,242,1,243,371,0,0,65.5,161,81,中山村,NULL
1545,240,3,243,320,0,0,75.94,129,111,信望里,NULL
0,240,3,243,320,0,0,75.94,129,111,信望里,NULL
5,241,1,242,468,0,0,51.71,237,4,白沙村、板里村、芹壁村,NULL
0,241,1,242,468,0,0,51.71,237,4,白沙村、板里村、芹壁村,NULL
148,242,0,242,346,0,0,69.94,126,116,石城里,NULL
0,242,0,242,346,0,0,69.94,126,116,石城里,NULL
178,241,1,242,348,0,0,69.54,118,123,永福村,NULL
881,240,2,242,319,0,0,75.86,98,142,大坪村,NULL
0,240,2,242,319,0,0,75.86,98,142,大坪村,NULL
331,240,1,241,346,0,0,69.65,203,37,玉峰村,NULL
2180,240,1,241,310,0,0,77.74,171,69,新基村,NULL
287,240,0,240,271,0,0,88.56,195,45,力行村,NULL
134,236,3,239,423,0,0,56.5,191,45,富興村,NULL
0,236,3,239,423,0,0,56.5,191,45,富興村,NULL
2185,237,2,239,347,0,0,68.88,128,109,三貂村,NULL
0,237,2,239,347,0,0,68.88,128,109,三貂村,NULL
54,235,4,239,336,0,0,71.13,121,114,瑞山村,NULL
0,235,4,239,336,0,0,71.13,121,114,瑞山村,NULL
236,235,4,239,330,0,0,72.42,79,156,嘉昌村,NULL
696,238,0,238,296,0,0,80.41,212,26,達觀村,NULL
1786,237,1,238,310,0,0,76.77,133,104,三峽里,NULL
0,237,1,238,310,0,0,76.77,133,104,三峽里,NULL
90,234,3,237,310,0,0,76.45,132,102,長興里,NULL
0,234,3,237,310,0,0,76.45,132,102,長興里,NULL
2104,233,4,237,304,0,0,77.96,99,134,豐田村,NULL
2203,234,3,237,398,0,0,59.55,79,155,福連村,NULL
265,231,5,236,363,0,0,65.01,211,20,太平村,NULL
2147,234,2,236,325,0,0,72.62,140,94,乾華村,NULL
0,234,2,236,325,0,0,72.62,140,94,乾華村,NULL
407,235,1,236,377,0,0,62.6,125,110,明德村,NULL
131,235,1,236,310,0,0,76.13,91,144,樹林里,NULL
67,235,1,236,315,0,0,74.92,63,172,玉港村,NULL
341,232,3,235,315,0,0,74.6,209,23,竹林村,NULL
0,232,3,235,315,0,0,74.6,209,23,竹林村,NULL
404,235,0,235,354,0,0,66.38,130,105,永興村,NULL
0,235,0,235,354,0,0,66.38,130,105,永興村,NULL
112,230,5,235,360,0,0,65.28,121,109,富源村,NULL
0,230,5,235,360,0,0,65.28,121,109,富源村,NULL
0,234,1,235,329,0,0,71.43,110,124,考試里,NULL
2201,235,0,235,359,0,0,65.46,109,126,雙玉村,NULL
154,232,2,234,425,0,0,55.06,207,25,三間村,NULL
255,232,2,234,384,0,0,60.94,170,62,明里村,NULL
0,232,2,234,384,0,0,60.94,170,62,明里村,NULL
2123,232,2,234,339,0,0,69.03,126,106,八賢村,NULL
0,232,2,234,339,0,0,69.03,126,106,八賢村,NULL
1948,229,5,234,366,0,0,63.93,121,108,崇文里,NULL
0,229,5,234,366,0,0,63.93,121,108,崇文里,NULL
127,233,1,234,303,0,0,77.23,61,172,桐寮里,NULL
0,233,1,234,303,0,0,77.23,61,172,桐寮里,NULL
401,232,1,233,365,0,0,63.84,166,66,郡坑村,NULL
0,232,1,233,365,0,0,63.84,166,66,郡坑村,NULL
125,233,0,233,337,0,0,69.14,148,85,成功里,NULL
0,233,0,233,337,0,0,69.14,148,85,成功里,NULL
268,227,5,232,386,0,0,60.1,216,11,卓清村,NULL
694,230,2,232,326,0,0,71.17,184,46,自由村,NULL
534,230,2,232,308,0,0,75.32,101,129,華南村,NULL
0,230,2,232,308,0,0,75.32,101,129,華南村,NULL
323,229,2,231,343,0,0,67.35,188,41,英士村,NULL
0,229,2,231,343,0,0,67.35,188,41,英士村,NULL
2168,226,5,231,311,0,0,74.28,141,85,菁桐村,NULL
0,226,5,231,311,0,0,74.28,141,85,菁桐村,NULL
44,231,0,231,369,0,0,62.6,132,99,港口村,NULL
0,231,0,231,369,0,0,62.6,132,99,港口村,NULL
591,228,3,231,384,0,0,60.16,108,120,里德村,NULL
0,228,3,231,384,0,0,60.16,108,120,里德村,NULL
107,227,3,230,310,0,0,74.19,92,135,通運里,NULL
0,227,3,230,310,0,0,74.19,92,135,通運里,NULL
108,227,3,230,308,0,0,74.68,84,143,港尾里,NULL
169,225,4,229,419,0,0,54.65,201,24,金崙村,NULL
118,226,3,229,368,0,0,62.23,183,43,永安村,NULL
144,227,2,229,322,0,0,71.12,129,98,東澳里,NULL
0,227,2,229,322,0,0,71.12,129,98,東澳里,NULL
138,228,1,229,308,0,0,74.35,126,102,江山里,NULL
0,228,1,229,308,0,0,74.35,126,102,江山里,NULL
244,227,1,228,295,0,0,77.29,207,20,荔宅里,NULL
0,227,1,228,295,0,0,77.29,207,20,荔宅里,NULL
324,223,4,227,305,0,0,74.43,197,26,義興村,NULL
0,223,4,227,305,0,0,74.43,197,26,義興村,NULL
144,226,1,227,289,0,0,78.55,188,38,大同村,NULL
880,225,2,227,300,0,0,75.67,97,128,牛埔村,NULL
0,225,2,227,300,0,0,75.67,97,128,牛埔村,NULL
150,224,2,226,339,0,0,66.67,208,16,發祥村,NULL
29,224,2,226,345,0,0,65.51,152,72,光華里,NULL
0,224,2,226,345,0,0,65.51,152,72,光華里,NULL
2192,225,1,226,304,0,0,74.34,125,100,共和村,NULL
130,222,3,225,355,0,0,63.38,132,90,房里里,NULL
29,223,2,225,323,0,0,69.66,103,120,大津村,NULL
0,223,2,225,323,0,0,69.66,103,120,大津村,NULL
569,223,1,224,321,0,0,69.78,204,19,南世村,NULL
0,223,1,224,321,0,0,69.78,204,19,南世村,NULL
574,223,1,224,381,0,0,58.79,170,53,旭海村,NULL
0,223,1,224,381,0,0,58.79,170,53,旭海村,NULL
171,221,3,224,362,0,0,61.88,146,75,福盛村,NULL
46,222,2,224,584,0,0,38.36,139,83,虎井里,NULL
0,222,2,224,584,0,0,38.36,139,83,虎井里,NULL
235,223,1,224,295,0,0,75.93,134,89,瑪東里,NULL
0,223,1,224,295,0,0,75.93,134,89,瑪東里,NULL
2194,222,2,224,328,0,0,68.29,129,93,魚行村,NULL
2119,221,3,224,308,0,0,72.73,85,136,上德村,NULL
103,223,1,224,604,0,0,37.09,48,175,將軍村,NULL
324,222,1,223,309,0,0,72.17,206,16,樂水村,NULL
0,222,1,223,309,0,0,72.17,206,16,樂水村,NULL
199,220,3,223,356,0,0,62.64,147,73,大富村,NULL
0,220,3,223,356,0,0,62.64,147,73,大富村,NULL
33,222,1,223,344,0,0,64.83,128,94,菜園里,NULL
0,222,1,223,344,0,0,64.83,128,94,菜園里,NULL
193,222,1,223,295,0,0,75.59,98,124,下麻村,NULL
34,221,1,222,288,0,0,77.08,210,11,萬山村,NULL
0,221,1,222,288,0,0,77.08,210,11,萬山村,NULL
78,217,4,221,298,0,0,74.16,161,56,康樂村,NULL
423,217,4,221,313,0,0,70.61,110,107,石硦村,NULL
328,219,1,220,308,0,0,71.43,150,69,開礦村,NULL
0,219,1,220,308,0,0,71.43,150,69,開礦村,NULL
410,219,1,220,335,0,0,65.67,142,77,自強村,NULL
132,219,1,220,386,0,0,56.99,127,92,錦園村,NULL
0,219,1,220,386,0,0,56.99,127,92,錦園村,NULL
413,217,3,220,294,0,0,74.83,112,105,和平里,NULL
0,217,3,220,294,0,0,74.83,112,105,和平里,NULL
189,219,0,219,410,0,0,53.41,198,21,紅葉村,NULL
0,219,0,219,410,0,0,53.41,198,21,紅葉村,NULL
454,217,2,219,331,0,0,66.16,166,51,來吉村,NULL
0,217,2,219,331,0,0,66.16,166,51,來吉村,NULL
2169,215,4,219,286,0,0,76.57,98,117,白石村,NULL
0,215,4,219,286,0,0,76.57,98,117,白石村,NULL
332,217,1,218,281,0,0,77.58,175,42,秀巒村,NULL
179,218,0,218,319,0,0,68.34,91,127,豊稠村,NULL
792,216,1,217,276,0,0,78.62,204,12,仁和村,NULL
0,216,1,217,276,0,0,78.62,204,12,仁和村,NULL
303,215,2,217,308,0,0,70.45,130,85,外坪村,NULL
0,215,2,217,308,0,0,70.45,130,85,外坪村,NULL
384,212,5,217,324,0,0,66.98,84,128,桃源村,NULL
43,215,1,216,326,0,0,66.26,123,92,井垵里,NULL
0,215,1,216,326,0,0,66.26,123,92,井垵里,NULL
102,215,1,216,599,0,0,36.06,62,153,將軍村,NULL
135,214,1,215,422,0,0,50.95,183,31,振興村,NULL
0,214,1,215,422,0,0,50.95,183,31,振興村,NULL
205,209,6,215,405,0,0,53.09,178,31,豐濱村,NULL
0,213,2,215,344,0,0,62.5,145,68,永樂村,NULL
98,213,2,215,446,0,0,48.21,118,95,東安村,NULL
0,213,2,215,446,0,0,48.21,118,95,東安村,NULL
110,212,2,214,472,0,0,45.34,158,54,中和村,NULL
0,212,2,214,472,0,0,45.34,158,54,中和村,NULL
141,211,3,214,304,0,0,70.39,134,77,南豐村,NULL
597,213,1,214,338,0,0,63.31,100,113,港仔村,NULL
0,213,1,214,338,0,0,63.31,100,113,港仔村,NULL
197,212,2,214,284,0,0,75.35,88,124,重溪村,NULL
149,213,0,213,321,0,0,66.36,183,30,瑪家村,NULL
0,213,0,213,321,0,0,66.36,183,30,瑪家村,NULL
319,210,3,213,278,0,0,76.62,128,82,七星村,NULL
1956,210,3,213,309,0,0,68.93,126,84,濂新里,NULL
0,210,3,213,309,0,0,68.93,126,84,濂新里,NULL
236,210,2,212,291,0,0,72.85,86,124,溪北村,NULL
49,209,2,211,297,0,0,71.04,175,34,馬兒村,NULL
0,209,2,211,297,0,0,71.04,175,34,馬兒村,NULL
201,210,1,211,345,0,0,61.16,174,36,森永村,NULL
0,210,1,211,345,0,0,61.16,174,36,森永村,NULL
149,209,2,211,314,0,0,67.2,147,62,樹湖村,NULL
0,209,2,211,314,0,0,67.2,147,62,樹湖村,NULL
460,210,1,211,324,0,0,65.12,139,71,茶山村,NULL
0,210,1,211,324,0,0,65.12,139,71,茶山村,NULL
364,209,2,211,348,0,0,60.63,107,102,鯉魚里,NULL
646,206,4,210,255,0,0,82.35,129,77,慶西村,NULL
552,208,1,209,320,0,0,65.31,196,12,士文村,NULL
0,208,1,209,320,0,0,65.31,196,12,士文村,NULL
502,208,1,209,288,0,0,72.57,174,34,大鵬里,NULL
0,208,1,209,288,0,0,72.57,174,34,大鵬里,NULL
109,207,2,209,447,0,0,46.76,151,56,西湖村,NULL
0,207,2,209,447,0,0,46.76,151,56,西湖村,NULL
2,209,0,209,308,0,0,67.86,147,62,復興里,NULL
0,209,0,209,308,0,0,67.86,147,62,復興里,NULL
69,206,2,208,393,0,0,52.93,187,19,信義里,NULL
200,206,2,208,310,0,0,67.1,119,87,大雁村,NULL
81,204,3,207,407,0,0,50.86,184,20,博愛里,NULL
166,207,0,207,363,0,0,57.02,155,52,香蘭村,NULL
199,206,1,207,306,0,0,67.65,104,102,新城村,NULL
194,205,2,207,303,0,0,68.32,94,111,下麻村,NULL
4,203,3,206,279,0,0,73.84,141,62,工廠村,NULL
0,203,3,206,279,0,0,73.84,141,62,工廠村,NULL
211,205,1,206,318,0,0,64.78,125,80,武登村,NULL
298,202,4,206,287,0,0,71.78,93,109,嘉南村,NULL
0,202,4,206,287,0,0,71.78,93,109,嘉南村,NULL
175,203,2,205,324,0,0,63.27,172,31,山興里,NULL
217,205,0,205,277,0,0,74.01,126,79,八德里,NULL
109,203,2,205,265,0,0,77.36,105,98,港尾里,NULL
599,205,0,205,320,0,0,64.06,104,101,草山村,NULL
0,205,0,205,320,0,0,64.06,104,101,草山村,NULL
518,204,1,205,317,0,0,64.67,101,103,荷苞村,NULL
7,204,0,204,428,0,0,47.66,187,17,大坪村、福正村,NULL
0,204,0,204,428,0,0,47.66,187,17,大坪村、福正村,NULL
77,203,1,204,294,0,0,69.39,100,103,順安村,NULL
207,202,1,203,346,0,0,58.67,190,12,磯崎村,NULL
0,202,1,203,346,0,0,58.67,190,12,磯崎村,NULL
105,203,0,203,279,0,0,72.76,181,22,文蘭村,NULL
0,200,3,203,312,0,0,65.06,144,56,十字村,NULL
441,200,3,203,268,0,0,75.75,114,86,石湖村,NULL
197,200,2,202,302,0,0,66.89,191,9,歷坵村,NULL
0,200,2,202,302,0,0,66.89,191,9,歷坵村,NULL
430,201,1,202,297,0,0,68.01,173,28,清安村,NULL
208,194,8,202,515,0,0,39.22,138,56,朗島村,NULL
0,194,8,202,515,0,0,39.22,138,56,朗島村,NULL
453,199,3,202,295,0,0,68.47,103,96,豐山村,NULL
0,199,3,202,295,0,0,68.47,103,96,豐山村,NULL
2110,202,0,202,249,0,0,81.12,83,119,光明村,NULL
0,202,0,202,249,0,0,81.12,83,119,光明村,NULL
571,199,2,201,303,0,0,66.34,181,18,石門村,NULL
322,196,5,201,285,0,0,70.53,124,72,復興村,NULL
0,196,5,201,285,0,0,70.53,124,72,復興村,NULL
87,198,3,201,387,0,0,51.94,94,104,合界村,NULL
0,198,3,201,387,0,0,51.94,94,104,合界村,NULL
132,198,3,201,272,0,0,73.9,51,147,田寮里,NULL
0,198,3,201,272,0,0,73.9,51,147,田寮里,NULL
12,199,2,201,270,0,0,74.44,39,160,正義村,NULL
269,198,2,200,342,0,0,58.48,185,13,古風村,NULL
85,200,0,200,269,0,0,74.35,95,105,順安里,NULL
0,200,0,200,269,0,0,74.35,95,105,順安里,NULL
765,197,2,199,276,0,0,72.1,119,78,新厝村,NULL
0,197,2,199,276,0,0,72.1,119,78,新厝村,NULL
1785,197,2,199,254,0,0,78.35,108,89,東湖里,NULL
0,197,2,199,254,0,0,78.35,108,89,東湖里,NULL
45,198,0,198,294,0,0,67.35,170,28,達來村,NULL
0,198,0,198,294,0,0,67.35,170,28,達來村,NULL
403,193,5,198,330,0,0,60,86,107,興隆村,NULL
0,193,5,198,330,0,0,60,86,107,興隆村,NULL
264,193,4,197,296,0,0,66.55,185,8,太平村,NULL
1933,195,2,197,288,0,0,68.4,108,87,弓橋里,NULL
0,195,2,197,288,0,0,68.4,108,87,弓橋里,NULL
59,195,1,196,286,0,0,68.53,178,17,佳暮村,NULL
0,195,1,196,286,0,0,68.53,178,17,佳暮村,NULL
54,192,4,196,273,0,0,71.79,158,34,霧臺村,NULL
129,192,3,195,360,0,0,54.17,150,42,大坡村,NULL
0,192,3,195,360,0,0,54.17,150,42,大坡村,NULL
2171,193,2,195,274,0,0,71.17,130,63,平溪村,NULL
0,193,2,195,274,0,0,71.17,130,63,平溪村,NULL
291,192,3,195,275,0,0,70.91,93,99,碧湖村,NULL
0,192,3,195,275,0,0,70.91,93,99,碧湖村,NULL
196,191,2,193,283,0,0,68.2,183,8,賓茂村,NULL
0,191,2,193,283,0,0,68.2,183,8,賓茂村,NULL
202,193,0,193,321,0,0,60.12,173,20,新化村,NULL
0,193,0,193,321,0,0,60.12,173,20,新化村,NULL
261,191,2,193,268,0,0,72.01,132,59,大糖里,NULL
0,191,2,193,268,0,0,72.01,132,59,大糖里,NULL
133,192,1,193,331,0,0,58.31,90,102,萬安村,NULL
0,192,1,193,331,0,0,58.31,90,102,萬安村,NULL
401,191,0,191,282,0,0,67.73,117,74,光華村,NULL
166,187,4,191,270,0,0,70.74,106,81,崁頂村,NULL
194,191,0,191,269,0,0,71,98,93,共和村,NULL
2187,190,1,191,290,0,0,65.86,88,102,平林村,NULL
472,189,1,190,220,0,0,86.36,151,38,新莊村,NULL
463,189,0,189,235,0,0,80.43,182,7,丹林村,NULL
466,189,0,189,360,0,0,52.5,120,69,茄苳村,NULL
60,188,1,189,393,0,0,48.09,112,76,鼎灣村,NULL
0,188,1,189,393,0,0,48.09,112,76,鼎灣村,NULL
231,186,2,188,267,0,0,70.41,96,90,中華村,NULL
177,187,0,187,325,0,0,57.54,173,14,大竹村,NULL
154,185,2,187,309,0,0,60.52,171,14,翠華村,NULL
199,184,3,187,330,0,0,56.67,164,20,安朔村,NULL
283,185,2,187,266,0,0,70.3,129,56,豐鄉村,NULL
0,185,2,187,266,0,0,70.3,129,56,豐鄉村,NULL
134,187,0,187,262,0,0,71.37,123,64,合成里,NULL
1957,184,3,187,253,0,0,73.91,112,72,南雅里,NULL
0,184,3,187,253,0,0,73.91,112,72,南雅里,NULL
107,185,2,187,239,0,0,78.24,105,80,田尾里,NULL
134,184,3,187,274,0,0,68.25,79,105,貴舍里,NULL
53,183,3,186,291,0,0,63.92,85,98,北寮村,NULL
0,183,3,186,291,0,0,63.92,85,98,北寮村,NULL
71,185,0,185,388,0,0,47.68,142,43,忠仁里,NULL
49,182,3,185,303,0,0,61.06,117,65,湖東村,NULL
0,182,3,185,303,0,0,61.06,117,65,湖東村,NULL
2107,185,0,185,236,0,0,78.39,93,92,豐林村,NULL
0,185,0,185,236,0,0,78.39,93,92,豐林村,NULL
186,181,3,184,265,0,0,69.43,177,4,霧鹿村,NULL
0,181,3,184,265,0,0,69.43,177,4,霧鹿村,NULL
175,182,2,184,269,0,0,68.4,106,76,復興村,NULL
0,182,2,184,269,0,0,68.4,106,76,復興村,NULL
428,183,0,183,272,0,0,67.28,159,24,八卦村,NULL
0,183,0,183,272,0,0,67.28,159,24,八卦村,NULL
459,181,2,183,301,0,0,60.8,156,25,新美村,NULL
0,181,2,183,301,0,0,60.8,156,25,新美村,NULL
147,179,4,183,262,0,0,69.85,58,121,朝陽里,NULL
0,178,3,181,287,0,0,63.07,135,43,米棧村,NULL
650,180,1,181,249,0,0,72.69,134,46,福興村,NULL
337,180,1,181,242,0,0,74.79,97,83,秀林里,NULL
96,180,1,181,337,0,0,53.71,96,84,美農村,NULL
150,181,0,181,239,0,0,75.73,79,102,岸腳村,NULL
692,179,1,180,224,0,0,80.36,139,40,自由村,NULL
456,179,1,180,255,0,0,70.59,83,96,新峰里,NULL
419,177,2,179,268,0,0,66.79,140,37,神木村,NULL
136,179,0,179,323,0,0,55.42,120,59,都蘭村,NULL
132,178,1,179,263,0,0,68.06,94,84,樹林里,NULL
167,177,1,178,241,0,0,73.86,92,85,崁頂村,NULL
198,177,1,178,282,0,0,63.12,91,86,新城村,NULL
46,176,2,178,268,0,0,66.42,73,103,鰲鼓村,NULL
144,177,0,177,412,0,0,42.96,151,26,北源村,NULL
416,175,2,177,235,0,0,75.32,144,31,頂寮村,NULL
0,175,2,177,235,0,0,75.32,144,31,頂寮村,NULL
190,175,1,176,263,0,0,66.92,168,7,永康村,NULL
0,175,1,176,263,0,0,66.92,168,7,永康村,NULL
7,176,0,176,275,0,0,64,133,43,梅蘭村,NULL
0,176,0,176,275,0,0,64,133,43,梅蘭村,NULL
336,173,2,175,235,0,0,74.47,145,28,南河村,NULL
0,173,2,175,235,0,0,74.47,145,28,南河村,NULL
1952,171,3,174,236,0,0,73.73,99,72,銅山里,NULL
0,171,3,174,236,0,0,73.73,99,72,銅山里,NULL
198,173,0,173,287,0,0,60.28,153,20,安朔村,NULL
698,173,0,173,320,0,0,54.06,139,34,梨山村,NULL
2118,170,3,173,231,0,0,74.89,90,80,粗窟村,NULL
480,171,1,172,208,0,0,82.69,166,5,白樹村,NULL
566,172,0,172,250,0,0,68.8,134,38,竹坑村,NULL
0,172,0,172,250,0,0,68.8,134,38,竹坑村,NULL
11,170,2,172,250,0,0,68.8,30,140,正義村,NULL
170,170,1,171,253,0,0,67.59,164,6,多良村,NULL
457,169,1,170,254,0,0,66.93,150,19,里佳村,NULL
0,169,1,170,254,0,0,66.93,150,19,里佳村,NULL
82,167,2,169,302,0,0,55.96,147,20,博愛里,NULL
600,167,2,169,226,0,0,74.78,85,82,二寮村,NULL
0,167,2,169,226,0,0,74.78,85,82,二寮村,NULL
140,168,0,168,244,0,0,68.85,111,57,菜舖里,NULL
300,167,1,168,235,0,0,71.49,87,80,員山村,NULL
0,167,1,168,235,0,0,71.49,87,80,員山村,NULL
245,165,3,168,224,0,0,75,59,106,將貴村,NULL
1949,166,1,167,239,0,0,69.87,108,58,福住里,NULL
0,166,1,167,239,0,0,69.87,108,58,福住里,NULL
397,167,0,167,265,0,0,63.02,61,106,仁壽村,NULL
0,167,0,167,265,0,0,63.02,61,106,仁壽村,NULL
6,164,1,165,236,0,0,69.92,64,100,嘉苳村,NULL
200,163,1,164,261,0,0,62.84,150,13,南田村,NULL
0,163,1,164,261,0,0,62.84,150,13,南田村,NULL
152,162,1,163,266,0,0,61.28,156,6,發祥村,NULL
79,163,0,163,284,0,0,57.39,85,78,三協里,NULL
188,162,1,163,233,0,0,69.96,50,112,竹山村,NULL
61,158,3,161,221,0,0,72.85,67,91,潭邊村,NULL
0,158,3,161,221,0,0,72.85,67,91,潭邊村,NULL
462,160,0,160,277,0,0,57.76,118,42,和平村,NULL
451,157,3,160,241,0,0,66.39,114,43,十字村,NULL
41,160,0,160,213,0,0,75.12,62,98,頂揖村,NULL
101,154,5,159,319,0,0,49.84,80,74,嘉豐村,NULL
224,158,0,158,352,0,0,44.89,149,9,奇美村,NULL
0,158,0,158,352,0,0,44.89,149,9,奇美村,NULL
6,154,4,158,265,0,0,59.62,137,17,復興村,NULL
0,154,4,158,265,0,0,59.62,137,17,復興村,NULL
79,157,1,158,277,0,0,57.04,96,61,瓦硐村,NULL
0,157,1,158,277,0,0,57.04,96,61,瓦硐村,NULL
447,156,2,158,230,0,0,68.7,92,64,草山村,NULL
42,155,3,158,246,0,0,64.23,60,95,頂揖村,NULL
5,156,1,157,246,0,0,63.82,142,14,勤和村,NULL
0,156,1,157,246,0,0,63.82,142,14,勤和村,NULL
373,156,1,157,207,0,0,75.85,119,37,明德村,NULL
1951,156,1,157,229,0,0,68.56,105,51,瓜山里,NULL
0,156,1,157,229,0,0,68.56,105,51,瓜山里,NULL
99,156,1,157,230,0,0,68.26,76,80,安仁里,NULL
187,153,3,156,257,0,0,60.7,130,23,利稻村,NULL
0,153,3,156,257,0,0,60.7,130,23,利稻村,NULL
565,154,1,155,237,0,0,65.4,144,10,內文村,NULL
0,154,1,155,237,0,0,65.4,144,10,內文村,NULL
99,154,1,155,322,0,0,48.14,121,33,西安村,NULL
0,154,1,155,322,0,0,48.14,121,33,西安村,NULL
422,154,0,154,257,0,0,59.92,105,49,人和村,NULL
361,153,1,154,212,0,0,72.64,90,63,福興里,NULL
389,153,1,154,234,0,0,65.81,71,82,龍山村,NULL
202,150,2,152,204,0,0,74.51,34,116,神農村,NULL
701,149,2,151,258,0,0,58.53,129,20,梨山村,NULL
75,149,2,151,249,0,0,60.64,96,53,港子村,NULL
0,149,2,151,249,0,0,60.64,96,53,港子村,NULL
2006,147,3,150,193,0,0,77.72,101,46,大科村,NULL
57,148,0,148,206,0,0,71.84,140,8,阿禮村,NULL
0,148,0,148,206,0,0,71.84,140,8,阿禮村,NULL
463,147,0,147,252,0,0,58.33,83,64,和平村,NULL
2231,142,4,146,196,0,0,74.49,89,53,西湖村,NULL
0,142,4,146,196,0,0,74.49,89,53,西湖村,NULL
51,145,1,146,250,0,0,58.4,80,65,白坑村,NULL
0,145,1,146,250,0,0,58.4,80,65,白坑村,NULL
8,144,1,145,254,0,0,57.09,136,8,梅山村,NULL
0,144,1,145,254,0,0,57.09,136,8,梅山村,NULL
89,143,1,144,250,0,0,57.6,129,14,小門村,NULL
0,143,1,144,250,0,0,57.6,129,14,小門村,NULL
63,144,0,144,197,0,0,73.1,96,48,城北村,NULL
0,144,0,144,197,0,0,73.1,96,48,城北村,NULL
196,141,3,144,200,0,0,72,80,61,共和村,NULL
101,143,1,144,302,0,0,47.68,72,71,水垵村,NULL
0,143,1,144,302,0,0,47.68,72,71,水垵村,NULL
142,143,1,144,201,0,0,71.64,71,72,考試里,NULL
878,141,2,143,209,0,0,68.42,61,80,中坑村,NULL
0,141,2,143,209,0,0,68.42,61,80,中坑村,NULL
176,141,1,142,226,0,0,62.83,117,24,山興里,NULL
282,141,1,142,187,0,0,75.94,104,37,南昌村,NULL
0,141,1,142,187,0,0,75.94,104,37,南昌村,NULL
94,140,2,142,233,0,0,60.94,59,81,美農村,NULL
334,140,1,141,214,0,0,65.89,88,52,秀巒村,NULL
120,138,2,140,221,0,0,63.35,122,16,岳明里,NULL
0,138,2,140,221,0,0,63.35,122,16,岳明里,NULL
155,140,0,140,281,0,0,49.82,113,27,樟原村、三間村,NULL
0,140,0,140,281,0,0,49.82,113,27,樟原村、三間村,NULL
92,140,0,140,199,0,0,70.35,59,81,中寮里,NULL
0,140,0,140,199,0,0,70.35,59,81,中寮里,NULL
207,140,0,140,191,0,0,73.3,48,92,旭山村,NULL
450,137,2,139,233,0,0,59.66,113,24,香林村,NULL
0,137,2,139,233,0,0,59.66,113,24,香林村,NULL
446,137,2,139,180,0,0,77.22,98,39,草山村,NULL
596,135,3,138,273,0,0,50.55,57,78,九棚村,NULL
0,135,3,138,273,0,0,50.55,57,78,九棚村,NULL
146,136,0,136,248,0,0,54.84,94,42,尚德村,NULL
0,136,0,136,248,0,0,54.84,94,42,尚德村,NULL
86,134,2,136,246,0,0,55.28,82,52,橫礁村,NULL
0,134,2,136,246,0,0,55.28,82,52,橫礁村,NULL
326,133,1,134,172,0,0,77.91,125,8,茂安村,NULL
0,133,1,134,172,0,0,77.91,125,8,茂安村,NULL
0,131,1,132,335,438,76.48,39.4,125,6,烏坵鄉,Wuqiu Township
449,127,2,129,196,0,0,65.82,88,39,中正村,NULL
0,127,2,129,196,0,0,65.82,88,39,中正村,NULL
465,126,0,126,182,0,0,69.23,93,33,永樂村,NULL
10,123,3,126,187,0,0,67.38,39,84,三義村,NULL
461,125,0,125,197,0,0,63.45,124,1,義林村,NULL
84,125,0,125,219,0,0,57.08,94,31,員貝村,NULL
0,125,0,125,219,0,0,57.08,94,31,員貝村,NULL
111,124,0,124,290,0,0,42.76,92,32,平和村,NULL
0,124,0,124,290,0,0,42.76,92,32,平和村,NULL
102,123,0,123,230,0,0,53.48,101,22,嘉豐村,NULL
2252,122,1,123,155,0,0,79.35,63,59,孝義村,NULL
0,122,1,123,155,0,0,79.35,63,59,孝義村,NULL
158,121,1,122,174,0,0,70.11,109,12,佳平村,NULL
2177,122,0,122,185,0,0,65.95,78,44,新寮村,NULL
0,122,0,122,185,0,0,65.95,78,44,新寮村,NULL
139,120,2,122,195,0,0,62.56,69,51,菜舖里,NULL
204,120,2,122,154,0,0,79.22,34,86,果毅村,NULL
2178,119,0,119,180,0,0,66.11,64,55,平湖村,NULL
0,119,0,119,180,0,0,66.11,64,55,平湖村,NULL
50,117,2,119,210,0,0,56.67,62,55,青螺村,NULL
0,117,2,119,210,0,0,56.67,62,55,青螺村,NULL
42,118,0,118,194,0,0,60.82,85,33,五德里,NULL
0,118,0,118,194,0,0,60.82,85,33,五德里,NULL
203,117,1,118,176,0,0,67.05,60,57,五城村,NULL
180,117,0,117,218,0,0,53.67,74,43,豊稠村,NULL
189,116,0,116,215,0,0,53.95,107,9,東富村,NULL
468,115,1,116,249,0,0,46.59,87,28,茄苳村,NULL
163,113,3,116,185,0,0,62.7,82,31,米棧村,NULL
76,116,0,116,202,0,0,57.43,70,46,岐頭村,NULL
0,116,0,116,202,0,0,57.43,70,46,岐頭村,NULL
174,114,0,114,140,0,0,81.43,17,97,溪洲村,NULL
2191,110,1,111,156,0,0,71.15,83,27,共和村,NULL
62,109,1,110,163,0,0,67.48,70,39,許家村,NULL
0,109,1,110,163,0,0,67.48,70,39,許家村,NULL
700,107,2,109,235,0,0,46.38,100,7,梨山村,NULL
271,104,5,109,172,0,0,63.37,97,7,古風村,NULL
2196,109,0,109,172,0,0,63.37,78,31,泰平村,NULL
338,108,1,109,145,0,0,75.17,48,60,港北里,NULL
0,108,1,109,145,0,0,75.17,48,60,港北里,NULL
183,108,0,108,146,0,0,73.97,90,18,森榮里,NULL
0,108,0,108,146,0,0,73.97,90,18,森榮里,NULL
467,108,0,108,161,0,0,67.08,82,26,茄苳村,NULL
100,103,5,108,266,0,0,40.6,46,57,中社村,NULL
0,103,5,108,266,0,0,40.6,46,57,中社村,NULL
750,105,2,107,180,0,0,59.44,67,38,海澄里、海昌里、海豐里、海原里、海城里,NULL
0,105,2,107,180,0,0,59.44,67,38,海澄里、海昌里、海豐里、海原里、海城里,NULL
357,105,1,106,166,0,0,63.86,61,44,田子里,NULL
59,103,3,106,179,0,0,59.22,60,43,中西村,NULL
0,103,3,106,179,0,0,59.22,60,43,中西村,NULL
97,104,1,105,185,0,0,56.76,92,12,富世村,NULL
203,104,0,104,192,0,0,54.17,100,4,豐濱村,NULL
2105,103,1,104,142,0,0,73.24,60,43,豐田村,NULL
93,103,1,104,191,0,0,54.45,43,60,池西村,NULL
0,103,1,104,191,0,0,54.45,43,60,池西村,NULL
170,103,1,104,163,0,0,63.8,21,82,東光村,NULL
53,101,0,101,137,0,0,73.72,69,32,霧臺村,NULL
30,100,1,101,161,0,0,62.73,48,52,更寮村,NULL
155,99,0,99,209,0,0,47.37,74,25,翠華村,NULL
77,99,0,99,150,0,0,66,53,46,小赤村,NULL
0,99,0,99,150,0,0,66,53,46,小赤村,NULL
2175,98,0,98,143,0,0,68.53,44,54,望古村,NULL
0,98,0,98,143,0,0,68.53,44,54,望古村,NULL
112,97,0,97,272,0,0,35.66,60,37,海豐村,NULL
0,97,0,97,272,0,0,35.66,60,37,海豐村,NULL
108,90,5,95,230,0,0,41.3,67,23,東湖村,NULL
0,90,5,95,230,0,0,41.3,67,23,東湖村,NULL
85,92,2,94,196,0,0,47.96,51,41,大倉村,NULL
0,92,2,94,196,0,0,47.96,51,41,大倉村,NULL
107,91,2,93,260,0,0,35.77,80,11,花嶼村,NULL
0,91,2,93,260,0,0,35.77,80,11,花嶼村,NULL
181,91,0,91,126,0,0,72.22,89,2,公舘村,NULL
141,91,0,91,128,0,0,71.09,39,52,考試里,NULL
168,88,1,89,125,0,0,71.2,70,18,水璉村,NULL
464,87,2,89,162,0,0,54.94,52,35,永樂村,NULL
91,88,1,89,153,0,0,58.17,37,51,二崁村,NULL
0,88,1,89,153,0,0,58.17,37,51,二崁村,NULL
110,86,2,88,166,0,0,53.01,19,67,溫泉村,NULL
158,82,1,83,117,0,0,70.94,41,41,中平村,NULL
56,81,1,82,112,0,0,73.21,74,7,吉露村,NULL
0,81,1,82,112,0,0,73.21,74,7,吉露村,NULL
396,81,0,81,127,0,0,63.78,56,25,緞繻村,NULL
702,79,1,80,158,0,0,50.63,69,10,平等村,NULL
74,78,2,80,124,0,0,64.52,60,18,鎮海村,NULL
0,78,2,80,124,0,0,64.52,60,18,鎮海村,NULL
47,78,0,78,225,0,0,34.67,53,25,桶盤里,NULL
0,78,0,78,225,0,0,34.67,53,25,桶盤里,NULL
158,73,2,75,106,0,0,70.75,70,3,親愛村,NULL
1936,75,0,75,105,0,0,71.43,48,27,碩仁里,NULL
0,75,0,75,105,0,0,71.43,48,27,碩仁里,NULL
197,68,1,69,112,0,0,61.61,47,21,大全村,NULL
151,67,1,68,119,0,0,57.14,63,4,發祥村,NULL
105,67,0,67,365,0,0,18.36,13,54,東坪村,NULL
0,67,0,67,365,0,0,18.36,13,54,東坪村,NULL
50,66,0,66,160,0,0,41.25,63,3,大坵村,NULL
0,66,0,66,160,0,0,41.25,63,3,大坵村,NULL
51,65,1,66,175,0,0,37.71,62,3,小坵村,NULL
0,65,1,66,175,0,0,37.71,62,3,小坵村,NULL
145,63,2,65,95,0,0,68.42,55,8,榮興村,NULL
0,63,2,65,95,0,0,68.42,55,8,榮興村,NULL
164,65,0,65,102,0,0,63.73,53,12,米棧村,NULL
73,63,0,63,102,0,0,61.76,42,21,城前村,NULL
0,63,0,63,102,0,0,61.76,42,21,城前村,NULL
64,62,0,62,108,0,0,57.41,44,18,太武村,NULL
0,62,0,62,108,0,0,57.41,44,18,太武村,NULL
57,59,1,60,102,0,0,58.82,28,31,東石村,NULL
0,59,1,60,102,0,0,58.82,28,31,東石村,NULL
104,59,0,59,320,0,0,18.44,28,31,東吉村,NULL
0,59,0,59,320,0,0,18.44,28,31,東吉村,NULL
335,56,1,57,83,0,0,68.67,21,35,玉峰村,NULL
325,47,1,48,82,0,0,58.54,23,24,太平村,NULL
0,47,1,48,82,0,0,58.54,23,24,太平村,NULL
452,43,0,43,71,0,0,60.56,30,13,十字村,NULL
106,30,0,30,191,0,0,15.71,17,13,西坪村,NULL
0,30,0,30,191,0,0,15.71,17,13,西坪村,NULL
1,20,0,20,30,0,0,66.67,13,7,新復里,NULL
0,20,0,20,30,0,0,66.67,13,7,新復里,NULL
