PollN,ValidBallot,InvalBallot,TotalVote,EligVoter,TotalPop,PerEligVoter,PerActVote,"陳水扁 Chen Shui-bian, 呂秀蓮 Annette Lu: Dem.Prog.Party","連戰 Lien Chan, 宋楚瑜 James Soong: Kuo.Min.Tang",AName,ANameE
0,12914422,337297,13251719,16507179,22573965,73.12,80.28,6442452,6471970,"全國",National
0,1588249,30789,1619038,1981562,2695294,73.52,81.71,897870,690379,"臺北市",Taipei City
0,899073,15012,914085,1117380,1517289,73.64,81.81,398769,500304,"高雄市",Kaohsiung City
0,2130880,52948,2183828,2685778,3858942,69.6,81.31,1130615,1000265,"臺北縣",Taipei County
0,256209,8885,265094,337886,452967,74.59,78.46,108361,147848,"宜蘭縣",Yilan County
0,1004458,30838,1035296,1273026,1765854,72.09,81.33,555688,448770,"桃園縣",Taoyuan County
0,257603,6737,264340,323148,434218,74.42,81.8,165027,92576,"新竹縣",Hsinchu County
0,314486,10868,325354,407634,546229,74.63,79.82,191059,123427,"苗栗縣",Miaoli County
0,850561,21270,871831,1070877,1441975,74.26,81.41,410082,440479,"臺中縣",Taichung County
0,733424,26288,759712,947526,1271684,74.51,80.18,350128,383296,"彰化縣",Changhua County
0,300328,8784,309112,396464,532261,74.49,77.97,153913,146415,"南投縣",Nantou County
0,403035,16748,419783,552795,741745,74.53,75.94,159906,243129,"雲林縣",Yunlin County
0,317655,11554,329209,421904,566351,74.5,78.03,118189,199466,"嘉義縣",Chiayi County
0,651211,19313,670524,826288,1117225,73.96,81.15,229284,421927,"臺南縣",Tainan County
0,728202,21903,750105,919717,1242420,74.03,81.56,302937,425265,"高雄縣",Kaohsiung County
0,515117,13383,528500,669646,897336,74.63,78.92,215796,299321,"屏東縣",Pingtung County
0,116585,3198,119783,180255,242541,74.32,66.45,76382,40203,"臺東縣",Taitung County
0,179542,4523,184065,259334,349507,74.2,70.98,126041,53501,"花蓮縣",Hualien County
0,44801,1213,46014,69545,93690,74.23,66.16,22639,22162,"澎湖縣",Penghu County
0,222565,4996,227561,290439,391188,74.25,78.35,132289,90276,"基隆市",Keelung City
0,215742,5143,220885,271967,364552,74.6,81.22,118924,96818,"新竹市",Hsinchu City
0,564193,10566,574759,710555,983143,72.27,80.89,297098,267095,"臺中市",Taichung City
0,152878,2905,155783,193458,261233,74.06,80.53,67176,85702,"嘉義市",Chiayi City
0,435183,8247,443430,547903,736190,74.42,80.93,183786,251397,"臺南市",Tainan City
0,28134,1069,29203,45353,60973,74.38,64.39,26433,1701,"金門縣",Jinmen County
0,4308,117,4425,6739,9158,73.59,65.66,4060,248,"連江縣",Lianjiang County
0,150756,3089,153845,186612,0,0,82.44,77823,72933,"北投區",Beitou District
0,176657,3447,180104,219100,0,0,82.2,86822,89835,"士林區",Shilin District
0,132972,2620,135592,168717,0,0,80.37,69699,63273,"中山區",Zhongshan Area
0,78789,1736,80525,99402,0,0,81.01,33462,45327,"大同區",Datong District
0,122896,1997,124893,153856,0,0,81.18,72105,50791,"松山區",Songshan District
0,144362,2987,147349,180516,0,0,81.63,87796,56566,"信義區",Xinyi District
0,68453,1402,69855,84290,0,0,82.87,38440,30013,"南港區",Nangang District
0,152150,2693,154843,185598,0,0,83.43,89329,62821,"內湖區",Neihu District
0,187381,3170,190551,238486,0,0,79.9,118343,69038,"大安區",Daan District
0,93917,1775,95692,118651,0,0,80.65,56655,37262,"中正區",Zhongzheng District
0,125428,2905,128333,156419,0,0,82.04,64988,60440,"萬華區",Wanhua District
0,154488,2968,157456,189915,0,0,82.91,102408,52080,"文山區",Wenshan District
0,18840,313,19153,23615,0,0,81.11,7571,11269,"鹽埕區",Yancheng District
0,66508,1126,67634,82500,0,0,81.98,30720,35788,"鼓山區",Gushan District
0,17958,376,18334,23029,0,0,79.61,6244,11714,"旗津區",Qijin District
0,104587,1660,106247,128750,0,0,82.52,57822,46765,"左營區",Zuoying District
0,92280,1421,93701,112791,0,0,83.07,42931,49349,"楠梓區",Nanxun District
0,213750,3280,217030,264702,0,0,81.99,89449,124301,"三民區",Sanmin District
0,37050,589,37639,46686,0,0,80.62,16325,20725,"新興區",Emerging area
0,20062,315,20377,25414,0,0,80.18,8833,11229,"前金區",Former gold district
0,119486,1973,121459,149275,0,0,81.37,54465,65021,"苓雅區",Yuya District
0,121413,2291,123704,150642,0,0,82.12,49897,71516,"前鎮區",Former town area
0,87139,1668,88807,109976,0,0,80.75,34512,52627,"小港區",Xiaogang District
0,316926,7527,324453,396206,0,0,81.89,156927,159999,"板橋市",Banqiao City
0,226859,5882,232741,283912,0,0,81.98,100247,126612,"三重市",Mie City
0,249308,6198,255506,310297,0,0,82.34,152858,96450,"中和市",Zhonghe City
0,140244,2945,143189,174553,0,0,82.03,92347,47897,"永和市",Yonghe City
0,214296,4545,218841,267968,0,0,81.67,101445,112851,"新莊市",Xinzhuang City
0,171104,3736,174840,214307,0,0,81.58,113518,57586,"新店市",Xindian City
0,129883,2796,132679,163849,0,0,80.98,68043,61840,"土城市",Tucheng
0,97142,2152,99294,121956,0,0,81.42,42896,54246,"蘆洲市",Luzhou City
0,101958,2111,104069,130240,0,0,79.91,58246,43712,"汐止市",Yushi City
0,86936,2310,89246,110498,0,0,80.77,41671,45265,"樹林市",Wood City
0,45100,1197,46297,57571,0,0,80.42,21692,23408,"鶯歌鎮",Yingge Town
0,45819,1426,47245,58950,0,0,80.14,23011,22808,"三峽鎮",Three Gorges Town
0,71933,1909,73842,91841,0,0,80.4,38778,33155,"淡水鎮",Tamsui Town
0,25712,992,26704,34951,0,0,76.4,14129,11583,"瑞芳鎮",Ruifang Town
0,40517,1003,41520,51304,0,0,80.93,19575,20942,"五股鄉",Wuxiang Township
0,37792,778,38570,46726,0,0,82.55,18948,18844,"泰山鄉",Taishan Township
0,29301,858,30159,37016,0,0,81.48,15212,14089,"林口鄉",Linkou Township
0,12278,340,12618,15671,0,0,80.52,6845,5433,"深坑鄉",Shenkeng Township
0,4663,224,4887,6026,0,0,81.1,1916,2747,"石碇鄉",Shijie Township
0,3789,234,4023,5142,0,0,78.24,1348,2441,"坪林鄉",Pinglin Township
0,12690,550,13240,17065,0,0,77.59,7075,5615,"三芝鄉",Sanzhi Township
0,6385,338,6723,8588,0,0,78.28,3622,2763,"石門鄉",Shimen Township
0,17439,561,18000,22310,0,0,80.68,9051,8388,"八里鄉",Bali Township
0,3583,233,3816,4978,0,0,76.66,1679,1904,"平溪鄉",Pingxi Township
0,5941,376,6317,8308,0,0,76.04,2958,2983,"雙溪鄉",Shuangxi Township
0,7899,499,8398,11186,0,0,75.08,3035,4864,"貢寮鄉",Gongga Township
0,11859,613,12472,16023,0,0,77.84,5911,5948,"金山鄉",Jinshan Township
0,10725,546,11271,14776,0,0,76.28,5870,4855,"萬里鄉",Wanli Township
0,2799,69,2868,3560,0,0,80.56,1762,1037,"烏來鄉",Wulai Township
0,51164,1273,52437,66459,0,0,78.9,24599,26565,"宜蘭市",Yilan City
0,39074,838,39912,50174,0,0,79.55,16435,22639,"羅東鎮",Luodong Town
0,24982,921,25903,33859,0,0,76.5,10453,14529,"蘇澳鎮",Suao Town
0,17669,705,18374,24182,0,0,75.98,9465,8204,"頭城鎮",Head town
0,20871,859,21730,27634,0,0,78.64,8670,12201,"礁溪鄉",Jiaoxi Township
0,14411,605,15016,19263,0,0,77.95,5251,9160,"壯圍鄉",Zhuangwei Township
0,18207,919,19126,24604,0,0,77.74,6667,11540,"員山鄉",Yuanshan Township
0,29372,1107,30479,38132,0,0,79.93,9809,19563,"冬山鄉",Dongshan Township
0,22022,766,22788,28792,0,0,79.15,7567,14455,"五結鄉",Wujie Township
0,12307,692,12999,16698,0,0,77.85,4168,8139,"三星鄉",Samsung Township
0,3111,121,3232,4112,0,0,78.6,2529,582,"大同鄉",Datong Township
0,3019,79,3098,3977,0,0,77.9,2748,271,"南澳鄉",South Australia Township
0,197586,4563,202149,247841,0,0,81.56,106310,91276,"桃園市",Taoyuan City
0,5656,308,5964,8049,0,0,74.1,36020,30856,"龜山鄉",Guishan Township
0,61020,1909,62929,76993,0,0,81.73,55297,38557,"八德市",Bade City
0,190763,5395,196158,239584,0,0,81.87,29220,31800,"蘆竹鄉",Luzhu Township
0,108920,3083,112003,136538,0,0,82.03,19068,22681,"大園鄉",Dayuan Township
0,47378,1804,49182,60041,0,0,81.91,23395,23983,"大溪鎮",Daxi Town
0,29999,1422,31421,38780,0,0,81.02,4271,1385,"復興鄉",Fuxing Township
0,66876,2080,68956,86438,0,0,79.78,115072,75691,"中壢市",Zhongli City
0,93854,3084,96938,119454,0,0,81.15,64043,44877,"平鎮市",Pingzhen City
0,41749,1817,43566,54132,0,0,80.48,41787,30513,"楊梅鎮",Yangmei Town
0,72300,2404,74704,93205,0,0,80.15,37233,23093,"龍潭鄉",Longtan Township
0,28031,1130,29161,35565,0,0,81.99,12197,15834,"新屋鄉",Xinwu Township
0,60326,1839,62165,76406,0,0,81.36,11775,18224,"觀音鄉",Guanyin Township
0,55236,1260,56496,68628,0,0,82.32,32552,22684,"竹北市",Zhubei
0,51388,1160,52548,64338,0,0,81.67,36010,15378,"竹東鎮",Zhudong Town
0,21431,740,22171,26934,0,0,82.32,12210,9221,"新埔鎮",Xinpu Town
0,19359,602,19961,24214,0,0,82.44,11669,7690,"關西鎮",Kansai Town
0,38776,1033,39809,48677,0,0,81.78,25934,12842,"湖口鄉",Hukou Township
0,25780,668,26448,32800,0,0,80.63,16004,9776,"新豐鄉",Xinfeng Township
0,12007,364,12371,14883,0,0,83.12,7819,4188,"芎林鄉",Yulin Township
0,9008,228,9236,11181,0,0,82.6,6153,2855,"橫山鄉",Hengshan Township
0,6150,228,6378,7800,0,0,81.77,4009,2141,"北埔鄉",Beipu Township
0,7674,158,7832,9557,0,0,81.95,4878,2796,"寶山鄉",Baoshan Township
0,3953,157,4110,4977,0,0,82.58,2158,1795,"峨眉鄉",Emei Township
0,4219,109,4328,5663,0,0,76.43,3458,761,"尖石鄉",Jianshi Township
0,2622,30,2652,3496,0,0,75.86,2173,449,"五峰鄉",Wufeng Township
0,51950,1332,53282,66257,0,0,80.42,35499,16451,"苗栗市",Miaoli City
0,27602,1096,28698,35521,0,0,80.79,11657,15945,"苑裡鎮",Yuanli Town
0,22828,1015,23843,30116,0,0,79.17,10978,11850,"通霄鎮",Tongyu Town
0,39531,1190,40721,50527,0,0,80.59,21636,17895,"竹南鎮",Zhunan Town
0,50097,1428,51525,64215,0,0,80.24,34467,15630,"頭份鎮",Head town
0,22987,993,23980,30819,0,0,77.81,12282,10705,"後龍鎮",Houlong Town
0,11233,424,11657,14468,0,0,80.57,5288,5945,"卓蘭鎮",Zhuolan Town
0,9385,403,9788,12743,0,0,76.81,6310,3075,"大湖鄉",Dahu Township
0,19213,647,19860,24944,0,0,79.62,12051,7162,"公館鄉",Gongguan Township
0,11591,439,12030,15137,0,0,79.47,7724,3867,"銅鑼鄉",Tonglu Township
0,6728,283,7011,9206,0,0,76.16,4840,1888,"南庄鄉",Nanzhuang Township
0,7254,212,7466,9273,0,0,80.51,4959,2295,"頭屋鄉",Tou Township
0,10227,364,10591,12992,0,0,81.52,6695,3532,"三義鄉",Sanyi Township
0,4897,199,5096,6545,0,0,77.86,3462,1435,"西湖鄉",Xihu Township
0,8054,342,8396,10471,0,0,80.18,5361,2693,"造橋鄉",Bridge township
0,4478,212,4690,5776,0,0,81.2,2920,1558,"三灣鄉",Sanwan Township
0,3167,193,3360,4357,0,0,77.12,2192,975,"獅潭鄉",Shitan Township
0,3264,96,3360,4267,0,0,78.74,2738,526,"泰安鄉",Tai'an Township
0,92723,2034,94757,114458,0,0,82.79,41057,51666,"豐原市",Fengyuan City
0,99808,1826,101634,125062,0,0,81.27,47754,52054,"大里市",Dali City
0,93960,2151,96111,119093,0,0,80.7,47422,46538,"太平市",Taiping City
0,32531,1140,33671,41920,0,0,80.32,16707,15824,"東勢鎮",Dongshi Town
0,42912,1278,44190,54871,0,0,80.53,20308,22604,"大甲鎮",Dajia Town
0,47853,1297,49150,61029,0,0,80.54,21399,26454,"清水鎮",Qingshui Town
0,41240,1016,42256,52065,0,0,81.16,20293,20947,"沙鹿鎮",Shalu Town
0,28680,630,29310,36156,0,0,81.07,13799,14881,"梧棲鎮",Qiqi Town
0,32179,919,33098,40204,0,0,82.33,15859,16320,"后里鄉",Houlixiang
0,36334,1045,37379,45144,0,0,82.8,14808,21526,"神岡鄉",Shengang Township
0,52635,1154,53789,65383,0,0,82.27,25480,27155,"潭子鄉",Tanzi Township
0,45088,1001,46089,56795,0,0,81.15,23056,22032,"大雅鄉",Daya Township
0,15670,639,16309,19932,0,0,81.82,7624,8046,"新社鄉",Xinshe Township
0,9325,307,9632,11638,0,0,82.76,4806,4519,"石岡鄉",Shigang Township
0,17420,576,17996,22468,0,0,80.1,9385,8035,"外埔鄉",Waipu Township
0,12081,420,12501,15531,0,0,80.49,5617,6464,"大安鄉",Daan Township
0,37463,933,38396,46345,0,0,82.85,18101,19362,"烏日鄉",Wuri Township
0,31295,759,32054,39105,0,0,81.97,15719,15576,"大肚鄉",Dadu Township
0,37317,979,38296,47793,0,0,80.13,18306,19011,"龍井鄉",Longjing Township
0,37748,1000,38748,47013,0,0,82.42,18177,19571,"霧峰鄉",Wufeng Township
0,6299,166,6465,8872,0,0,72.87,4405,1894,"和平鄉",Peace township
0,131823,2957,134780,164488,0,0,81.94,65996,65827,"彰化市",Changhua City
0,26177,729,26906,33309,0,0,80.78,13179,12998,"花壇鄉",Huatan Township
0,14869,709,15578,19525,0,0,79.78,6129,8740,"芬園鄉",Fenyuan Township
0,46548,1525,48073,59619,0,0,80.63,20099,26449,"鹿港鎮",Lugang Town
0,26659,1084,27743,34552,0,0,80.29,11580,15079,"褔興鄉",Yanxing Township
0,21499,712,22211,26959,0,0,82.39,9483,12016,"秀水鄉",Xiushui Township
0,49064,1396,50460,62269,0,0,81.04,23816,25248,"和美鎮",Hemei Town
0,9378,318,9696,12174,0,0,79.65,5334,4044,"線西鄉",Line Xixiang
0,18856,679,19535,24297,0,0,80.4,9486,9370,"伸港鄉",Shengang Township
0,70512,1937,72449,89334,0,0,81.1,35459,35053,"員林鎮",Lin Linzhen
0,20595,749,21344,26297,0,0,81.17,9946,10649,"大村鄉",Da Village Township
0,22885,853,23738,29150,0,0,81.43,10911,11974,"永靖鄉",Yongjing Township
0,30359,1049,31408,38917,0,0,80.71,15063,15296,"溪湖鎮",Xihu Town
0,19985,846,20831,25954,0,0,80.26,10580,9405,"埔鹽鄉",Puyan Township
0,20241,745,20986,25673,0,0,81.74,8888,11353,"埔心鄉",Puxin Township
0,25924,930,26854,34087,0,0,78.78,12614,13310,"田中鎮",Tanaka Town
0,25995,934,26929,32744,0,0,82.24,11507,14488,"社頭鄉",Shetou Township
0,10764,433,11197,13853,0,0,80.83,4826,5938,"二水鄉",Ershui Township
0,18759,658,19417,24145,0,0,80.42,8787,9972,"北斗鎮",Beidou Town
0,18172,998,19170,24570,0,0,78.02,6862,11310,"溪州鄉",Xizhou Township
0,16394,744,17138,21405,0,0,80.07,7791,8603,"田尾鄉",Tianwei Township
0,17507,1025,18532,23946,0,0,77.39,7555,9952,"埤頭鄉",Shantou Township
0,30068,1635,31703,41190,0,0,76.97,15992,14076,"二林鎮",Erlin Town
0,20177,1394,21571,29605,0,0,72.86,8848,11329,"芳苑鄉",Fangyuan Township
0,10747,766,11513,16346,0,0,70.43,5591,5156,"大城鄉",Dacheng
0,9467,483,9950,13118,0,0,75.85,3806,5661,"竹塘鄉",Zhutang Township
0,59043,1317,60360,74780,0,0,80.72,32721,26322,"南投市",Nantou City
0,47340,1302,48642,64014,0,0,75.99,24854,22486,"埔里鎮",Puli Town
0,55716,1444,57160,71291,0,0,80.18,28496,27220,"草屯鎮",Caojing Town
0,33712,1048,34760,44855,0,0,77.49,14615,19097,"竹山鎮",Zhushan Town
0,7090,237,7327,9446,0,0,77.57,3577,3513,"集集鎮",Jiji Town
0,24522,833,25355,31724,0,0,79.92,9761,14761,"名間鄉",Mingxiang Township
0,11658,411,12069,15631,0,0,77.21,5517,6141,"鹿谷鄉",Lugu Township
0,10086,392,10478,13517,0,0,77.52,4551,5535,"中寮鄉",Zhongyu Township
0,9674,332,10006,13705,0,0,73.01,4399,5275,"魚池鄉",Yuchi Township
0,12296,512,12808,17375,0,0,73.72,6502,5794,"國姓鄉",Country name
0,12221,366,12587,16770,0,0,75.06,6148,6073,"水里鄉",Shuili Township
0,8752,340,9092,12124,0,0,74.99,5761,2991,"信義鄉",Xinyi Township
0,8218,250,8468,11232,0,0,75.39,7011,1207,"仁愛鄉",Renai Township
0,57458,1536,58994,73059,0,0,80.75,27275,30183,"斗六市",Douliu City
0,27365,918,28283,35283,0,0,80.16,11475,15890,"斗南鎮",Dounan Town
0,38239,1127,39366,50093,0,0,78.59,17695,20544,"虎尾鎮",Huwei Town
0,27700,1155,28855,36452,0,0,79.16,9282,18418,"西螺鎮",Xiluo Town
0,17258,771,18029,24013,0,0,75.08,6433,10825,"土庫鎮",Turku Town
0,25483,843,26326,33948,0,0,77.55,8928,16555,"北港鎮",Beigang Town
0,20163,830,20993,26823,0,0,78.26,7130,13033,"古坑鄉",Gukeng Township
0,12676,605,13281,17250,0,0,76.99,4595,8081,"大埤鄉",Datun Township
0,18264,731,18995,23632,0,0,80.38,6001,12263,"莿桐鄉",Wutong Township
0,11753,395,12148,15301,0,0,79.39,4886,6867,"林內鄉",Linnei Township
0,18029,919,18948,24452,0,0,77.49,5381,12648,"二崙鄉",Erlun Township
0,16102,722,16824,22196,0,0,75.8,6360,9742,"崙背鄉",Lunbei Township
0,16457,687,17144,24234,0,0,70.74,8307,8150,"麥寮鄉",Maixiao Township
0,9492,544,10036,14531,0,0,69.07,4079,5413,"東勢鄉",Dongshi Township
0,8016,470,8486,11534,0,0,73.57,3245,4771,"褒忠鄉",Qi Zhongxiang
0,13856,786,14642,22029,0,0,66.47,7039,6817,"台西鄉",Taixi Township
0,16635,977,17612,24743,0,0,71.18,5762,10873,"元長鄉",Yuanchang Township
0,14300,909,15209,23146,0,0,65.71,5873,8427,"四湖鄉",Sihu Township
0,16767,883,17650,25192,0,0,70.06,5561,11206,"口湖鄉",Kouhu Township
0,17022,940,17962,24884,0,0,72.18,4599,12423,"水林鄉",Shuilin Township
0,18860,563,19423,24289,0,0,79.97,6920,11940,"太保市",Taibao City
0,24525,786,25311,32215,0,0,78.57,8339,16186,"朴子市",Puzi City
0,18372,650,19022,25427,0,0,74.81,7353,11019,"布袋鎮",Budai Town
0,20352,692,21044,26642,0,0,78.99,8354,11998,"大林鎮",Dalin Town
0,40529,1271,41800,52135,0,0,80.18,15570,24959,"民雄鄉",Minxiong Township
0,10164,418,10582,13536,0,0,78.18,2706,7458,"溪口鄉",Xikou Township
0,20390,755,21145,26764,0,0,79.01,5854,14536,"新港鄉",Xingang Township
0,16135,769,16904,22567,0,0,74.91,4703,11432,"六腳鄉",Liujiao Township
0,16793,774,17567,23808,0,0,73.79,6410,10383,"東石鄉",Dongshi Township
0,13159,627,13786,17927,0,0,76.9,4634,8525,"義竹鄉",Yizhu Township
0,10360,561,10921,14193,0,0,76.95,3375,6985,"鹿草鄉",Lucao Township
0,32288,1062,33350,41796,0,0,79.79,13501,18787,"水上鄉",Water township
0,27137,917,28054,35776,0,0,78.42,10551,16586,"中埔鄉",Zhongpu Township
0,23168,848,24016,30670,0,0,78.3,8745,14423,"竹崎鄉",Zhuqi Township
0,13237,460,13697,17425,0,0,78.61,5053,8184,"梅山鄉",Meishan Township
0,6975,243,7218,9147,0,0,78.91,2688,4287,"番路鄉",Fanlu Township
0,1884,60,1944,2879,0,0,67.52,1071,813,"大埔鄉",Tai Po Township
0,3327,98,3425,4708,0,0,72.75,2362,965,"阿里山鄉",Alishan Township
0,43527,1170,44697,56166,0,0,79.58,17777,25750,"新營市",Xinying City
0,16759,610,17369,21891,0,0,79.34,5028,11731,"鹽水鎮",Salt water town
0,19657,821,20478,26473,0,0,77.35,6362,13295,"白河鎮",Baihe Town
0,14203,559,14762,18378,0,0,80.32,4583,9620,"柳營鄉",Liuying Township
0,16803,691,17494,21808,0,0,80.22,4704,12099,"後壁鄉",Houbi Township
0,13743,743,14486,19359,0,0,74.83,4824,8919,"東山鄉",Dongshan Township
0,28989,713,29702,35324,0,0,84.08,6568,22421,"麻豆鎮",Madou Town
0,16478,491,16969,21021,0,0,80.72,5096,11382,"下營鄉",Xiaying Township
0,14435,440,14875,18316,0,0,81.21,4352,10083,"六甲鄉",Liujia Township
0,14467,510,14977,17849,0,0,83.91,3984,10483,"官田鄉",Guantian Township
0,7599,336,7935,9671,0,0,82.05,2446,5153,"大內鄉",Da Nei Xiang
0,34382,840,35222,43294,0,0,81.36,11176,23206,"佳里鎮",Jiali Town
0,17513,439,17952,22338,0,0,80.37,4846,12667,"學甲鎮",Xuejia Town
0,15438,444,15882,19226,0,0,82.61,4356,11082,"西港鄉",Xigang Township
0,15696,590,16286,20217,0,0,80.56,4580,11116,"七股鄉",Qixiang Township
0,14093,477,14570,18435,0,0,79.03,3663,10430,"將軍鄉",General army
0,7863,267,8130,10465,0,0,77.69,2620,5243,"北門鄉",Beimen Township
0,26284,743,27027,33434,0,0,80.84,10824,15460,"新化鎮",Xinhua Town
0,24857,747,25604,31235,0,0,81.97,8072,16785,"善化鎮",Shanhua Town
0,20213,572,20785,25021,0,0,83.07,6686,13527,"新市鄉",Xinshi Township
0,17834,683,18517,22254,0,0,83.21,5674,12160,"安定鄉",Anding Township
0,4932,203,5135,6257,0,0,82.07,1672,3260,"山上鄉",Shanshang Township
0,9854,385,10239,12752,0,0,80.29,4664,5190,"玉井鄉",Yujing Township
0,6836,261,7097,9052,0,0,78.4,3723,3113,"楠西鄉",Nanxi Township
0,5649,185,5834,7361,0,0,79.26,2684,2965,"南化鄉",Nanhua Township
0,3756,156,3912,4901,0,0,79.82,1393,2363,"左鎮鄉",Zuozhen Township
0,41053,1099,42152,50924,0,0,82.77,15958,25095,"仁德鄉",Rende Township
0,36968,920,37888,45836,0,0,82.66,12503,24465,"歸仁鄉",Guiren Township
0,23155,752,23907,28802,0,0,83,7775,15380,"關廟鄉",Guanmiao Township
0,2936,173,3109,3747,0,0,82.97,1152,1784,"龍崎鄉",Longqixiang Township
0,115239,2293,117532,144481,0,0,81.35,49539,65700,"永康市",Yongkang City
0,194958,3719,198677,242411,0,0,81.96,89322,105636,"鳳山市",Fengshan City
0,39941,1296,41237,51019,0,0,80.83,14333,25608,"林園鄉",Linyuan Township
0,67318,1823,69141,84577,0,0,81.75,28466,38852,"大寮鄉",Datun Township
0,27290,863,28153,33880,0,0,83.1,9479,17811,"大樹鄉",Dashu Township
0,19640,643,20283,24357,0,0,83.27,6991,12649,"大社鄉",Dashe Township
0,34394,890,35284,42685,0,0,82.66,12197,22197,"仁武鄉",Renwu Township
0,24860,519,25379,30771,0,0,82.48,10031,14829,"鳥松鄉",Bird pine township
0,55521,1548,57069,68601,0,0,83.19,25923,29598,"岡山鎮",Okayama Town
0,23222,799,24021,28423,0,0,84.51,7620,15602,"橋頭鄉",Qiaotou Township
0,18730,904,19634,24032,0,0,81.7,7514,11216,"燕巢鄉",Yanchao Township
0,5903,333,6236,7696,0,0,81.03,1899,4004,"田寮鄉",Tian Yi Township
0,17744,781,18525,22387,0,0,82.75,6265,11479,"阿蓮鄉",Alian Township
0,31393,1321,32714,39392,0,0,83.05,13117,18276,"路竹鄉",Luzhu Township
0,17374,570,17944,21723,0,0,82.6,6393,10981,"湖內鄉",Lake Township
0,19125,591,19716,24535,0,0,80.36,7009,12116,"茄萣鄉",Township
0,8386,317,8703,10661,0,0,81.63,3629,4757,"永安鄉",Yongan Township
0,12726,551,13277,15916,0,0,83.42,5562,7164,"彌陀鄉",Mito Township
0,22992,805,23797,28920,0,0,82.29,8167,14825,"梓官鄉",Yuguan Township
0,24926,885,25811,32687,0,0,78.96,9969,14957,"旗山鎮",Qishan Town
0,26430,962,27392,35174,0,0,77.88,11527,14903,"美濃鎮",Mino Town
0,8567,529,9096,12826,0,0,70.92,3394,5173,"六龜鄉",Liugui Township
0,5045,229,5274,6787,0,0,77.71,2598,2447,"甲仙鄉",Jiaxian Township
0,6852,375,7227,9832,0,0,73.5,3073,3779,"杉林鄉",Shanlin Township
0,10139,516,10655,13588,0,0,78.41,4357,5782,"內門鄉",Inner gate township
0,947,25,972,1257,0,0,77.33,862,85,"茂林鄉",Maolin Township
0,2251,72,2323,3354,0,0,69.26,1929,322,"桃源鄉",Taoyuan Township
0,1528,37,1565,2226,0,0,70.31,1311,217,"三民鄉",Sanmin Township
0,125724,2320,128044,158286,0,0,80.89,60596,65128,"屏東市",Pingtung City
0,32312,654,32966,41940,0,0,78.6,13051,19261,"潮州鎮",Chaozhou Town
0,27612,677,28289,35703,0,0,79.23,9728,17884,"東港鎮",Donggang Town
0,15790,584,16374,23276,0,0,70.35,6939,8851,"恆春鎮",Hengchun Town
0,31678,905,32583,39562,0,0,82.36,11689,19989,"萬丹鄉",Wandan Township
0,18126,458,18584,23179,0,0,80.18,7004,11122,"長治鄉",Changzhi Township
0,7489,125,7614,9140,0,0,83.3,2571,4918,"麟洛鄉",Linluo Township
0,14005,347,14352,17197,0,0,83.46,4048,9957,"九如鄉",Jiuru Township
0,16076,411,16487,19977,0,0,82.53,5150,10926,"里港鄉",Ligang Township
0,15937,467,16404,20918,0,0,78.42,6844,9093,"鹽埔鄉",Yanpu Township
0,17028,655,17683,22537,0,0,78.46,5117,11911,"高樹鄉",Gaoshu Township
0,13915,347,14262,18010,0,0,79.19,4567,9348,"萬巒鄉",Wanxiang Township
0,35045,869,35914,45531,0,0,78.88,13200,21845,"內埔鄉",Neipu Township
0,11640,244,11884,14553,0,0,81.66,3937,7703,"竹田鄉",Zhutian Township
0,6751,253,7004,9114,0,0,76.85,2847,3904,"新埤鄉",Xinyi Township
0,16384,470,16854,22057,0,0,76.41,6684,9700,"枋寮鄉",Fangliao Township
0,23526,686,24212,29909,0,0,80.95,7010,16516,"新園鄉",Xinyuan Township
0,8615,270,8885,11051,0,0,80.4,2831,5784,"崁頂鄉",Yuding Township
0,13118,380,13498,17072,0,0,79.07,4789,8329,"林邊鄉",Linbian Township
0,7719,196,7915,9853,0,0,80.33,2847,4872,"南州鄉",Nanzhou Township
0,13370,459,13829,17550,0,0,78.8,4646,8724,"佳冬鄉",Jiadong Township
0,5835,263,6098,10086,0,0,60.46,3117,2718,"琉球鄉",Ryukyu Township
0,5502,241,5743,8171,0,0,70.29,2028,3474,"車城鄉",Car and urban
0,4414,216,4630,6855,0,0,67.54,1888,2526,"滿州鄉",Manzhou Township
0,3470,136,3606,4970,0,0,72.56,1441,2029,"枋山鄉",Lushan Township
0,3964,123,4087,5402,0,0,75.66,3378,586,"三地門鄉",Sandimen Township
0,1787,53,1840,2377,0,0,77.41,1445,342,"霧臺鄉",Wutai Township
0,3604,88,3692,4796,0,0,76.98,3079,525,"瑪家鄉",Majia Township
0,2707,75,2782,3544,0,0,78.5,2417,290,"泰武鄉",Taiwu Township
0,4410,110,4520,5782,0,0,78.17,4081,329,"來義鄉",Laiyixiang
0,2567,129,2696,3644,0,0,73.98,2353,214,"春日鄉",Chunri Township
0,2522,58,2580,3788,0,0,68.11,2335,187,"獅子鄉",Lion Township
0,2475,114,2589,3816,0,0,67.85,2139,336,"牡丹鄉",Peony Township
0,55645,1260,56905,79552,0,0,71.53,34031,21614,"台東市",Taitung City
0,7579,235,7814,13601,0,0,57.45,5676,1903,"成功鎮",Successful town
0,5060,158,5218,7882,0,0,66.2,3350,1710,"關山鎮",Guanshan Town
0,10139,325,10464,15232,0,0,68.7,6038,4101,"卑南鄉",Beinan Township
0,4586,135,4721,7371,0,0,64.05,2667,1919,"鹿野鄉",Luye Township
0,4789,161,4950,7937,0,0,62.37,2877,1912,"池上鄉",Chishang Township
0,4828,169,4997,8621,0,0,57.96,3429,1399,"東河鄉",Donghe Township
0,4163,133,4296,7838,0,0,54.81,2982,1181,"長濱鄉",Changbin Township
0,6399,195,6594,9925,0,0,66.44,4067,2332,"太麻里鄉",Taima Lixiang
0,3514,94,3608,6015,0,0,59.98,2553,961,"大武鄉",Dawu Township
0,1347,26,1373,2357,0,0,58.25,1191,156,"綠島鄉",Green Island Township
0,2007,69,2076,3220,0,0,64.47,1830,177,"海端鄉",Haiduan Township
0,1731,51,1782,2726,0,0,65.37,1488,243,"延平鄉",Yanping Township
0,1737,33,1770,2446,0,0,72.36,1616,121,"金峰鄉",Jinfeng Township
0,1870,45,1915,3042,0,0,62.95,1682,188,"達仁鄉",Daren Township
0,1191,109,1300,2490,0,0,52.21,905,286,"蘭嶼鄉",Lanyu Township
0,57188,975,58163,77559,0,0,74.99,38709,18479,"花蓮市",Hualien City
0,11271,296,11567,15924,0,0,72.64,8135,3136,"新城鄉",New urban and rural
0,7136,266,7402,10236,0,0,72.31,6135,1001,"秀林鄉",Xiulin Township
0,42466,900,43366,58374,0,0,74.29,28629,13837,"吉安鄉",Ji'an Township
0,10952,359,11311,15730,0,0,71.91,7278,3674,"壽豐鄉",Shoufeng Township
0,7225,230,7455,10569,0,0,70.54,4962,2263,"鳳林鎮",Fenglin Town
0,7802,252,8054,12166,0,0,66.2,5744,2058,"光復鄉",Guangfu Township
0,2586,100,2686,4661,0,0,57.63,2109,477,"豐濱鄉",Fengbin Township
0,3130,99,3229,4939,0,0,65.38,2814,316,"萬榮鄉",Wanrong Township
0,6822,245,7067,10975,0,0,64.39,4739,2083,"瑞穗鄉",Ruisui Township
0,13951,520,14471,23223,0,0,62.31,9816,4135,"玉里鎮",Yuli Town
0,6110,209,6319,10229,0,0,61.78,4295,1815,"富里鄉",Fuli Township
0,2903,72,2975,4749,0,0,62.64,2676,227,"卓溪鄉",Zhuoxi Township
0,27280,587,27867,39554,0,0,70.45,14443,12837,"馬公市",Magong City
0,6733,232,6965,10168,0,0,68.5,2760,3973,"湖西鄉",Huxi Township
0,4274,108,4382,7336,0,0,59.73,2030,2244,"白沙鄉",Baisha Township
0,3921,127,4048,6691,0,0,60.5,1962,1959,"西嶼鄉",Xiyu Township
0,1425,92,1517,3394,0,0,44.7,554,871,"望安鄉",Wangan Township
0,1168,67,1235,2402,0,0,51.42,890,278,"七美鄉",Qimei Township
0,33340,773,34113,44522,0,0,76.62,20351,12989,"中正區",Zhongzheng District
0,29527,560,30087,38131,0,0,78.9,19146,10381,"信義區",Xinyi District
0,29259,675,29934,37742,0,0,79.31,15809,13450,"仁愛區",Renai District
0,30829,777,31606,40634,0,0,77.78,17786,13043,"中山區",Zhongshan Area
0,46994,1077,48071,61114,0,0,78.66,28022,18972,"安樂區",Anle District
0,21219,450,21669,27732,0,0,78.14,13382,7837,"暖暖區",Warm zone
0,31397,684,32081,40564,0,0,79.09,17793,13604,"七堵區",Seven blocks
0,101281,2280,103561,127098,0,0,81.48,60784,40497,"東區",Eastern District
0,76769,1785,78554,96898,0,0,81.07,40411,36358,"北區",North District
0,37692,1078,38770,47971,0,0,80.82,17729,19963,"香山區",Xiangshan District
0,12532,267,12799,16112,0,0,79.44,5868,6664,"中區",Central District
0,41526,861,42387,52134,0,0,81.3,19194,22332,"東區",Eastern District
0,64854,1088,65942,81959,0,0,80.46,33079,31775,"西區",West District
0,59538,1104,60642,74974,0,0,80.88,30003,29535,"南區",South area
0,83546,1660,85206,107691,0,0,79.12,45931,37615,"北區",North District
0,100794,1801,102595,126536,0,0,81.08,54699,46095,"西屯區",Xitun District
0,74172,1375,75547,91543,0,0,82.53,39291,34881,"南屯區",Nanxun District
0,127231,2410,129641,159606,0,0,81.23,69033,58198,"北屯區",Beibei District
0,75218,1344,76562,94861,0,0,80.71,35861,39357,"東區",Eastern District
0,77660,1561,79221,98597,0,0,80.35,31315,46345,"西區",West District
0,106618,1829,108447,133350,0,0,81.33,52895,53723,"東區",Eastern District
0,80082,1526,81608,100615,0,0,81.11,31780,48302,"南區",South area
0,51049,935,51984,64710,0,0,80.33,20950,30099,"中西區",Central and Western District
0,73736,1425,75161,92488,0,0,81.27,32476,41260,"北區",North District
0,94062,2065,96127,118991,0,0,80.79,32615,61447,"安南區",Annan District
0,29636,467,30103,37749,0,0,79.75,13070,16566,"安平區",Anping District
0,9357,337,9694,14971,0,0,64.75,8755,602,"金城鎮",Golden town
0,5029,248,5277,8166,0,0,64.62,4710,319,"金寧鄉",Jinning Township
0,6391,164,6555,9895,0,0,66.25,5946,445,"金湖鎮",Jinhu Town
0,4689,221,4910,7658,0,0,64.12,4461,228,"金沙鎮",Jinsha Town
0,2547,99,2646,4397,0,0,60.18,2450,97,"烈嶼鄉",Lieyu Township
0,121,0,121,266,0,0,45.49,111,10,"烏坵鄉",Wuqiu Township
0,2524,85,2609,3872,0,0,67.38,2354,170,"南竿鄉",Nanxun Township
0,800,15,815,1381,0,0,59.02,757,43,"北竿鄉",Beijiao Township
0,506,9,515,839,0,0,61.38,488,18,"莒光鄉",Shuguang Township
0,478,8,486,647,0,0,75.12,461,17,"東引鄉",Dongxiang Township
0,3122,59,3181,3833,0,0,82.99,1517,1605,"建民里",NULL
0,3011,59,3070,3640,0,0,84.34,1370,1641,"文林里",NULL
0,3512,68,3580,4285,0,0,83.55,1635,1877,"石牌里",NULL
0,4454,89,4543,5353,0,0,84.87,2231,2223,"福興里",NULL
0,4679,80,4759,5703,0,0,83.45,2435,2244,"榮光里",NULL
0,4896,74,4970,6083,0,0,81.7,2725,2171,"榮華里",NULL
0,4446,92,4538,5447,0,0,83.31,2375,2071,"裕民里",NULL
0,5266,103,5369,6441,0,0,83.36,2894,2372,"振華里",NULL
0,5234,110,5344,6606,0,0,80.9,2742,2492,"永和里",NULL
0,4267,70,4337,5319,0,0,81.54,2656,1611,"永欣里",NULL
0,2915,57,2972,3577,0,0,83.09,1594,1321,"永明里",NULL
0,3060,47,3107,3632,0,0,85.55,1768,1292,"東華里",NULL
0,4239,74,4313,5192,0,0,83.07,2460,1779,"吉利里",NULL
0,3359,53,3412,4043,0,0,84.39,1593,1766,"吉慶里",NULL
0,3136,69,3205,3848,0,0,83.29,1448,1688,"尊賢里",NULL
0,3391,73,3464,4166,0,0,83.15,1661,1730,"立賢里",NULL
0,5659,79,5738,6746,0,0,85.06,2803,2856,"立農里",NULL
0,3188,68,3256,3946,0,0,82.51,1493,1695,"八仙里",NULL
0,1189,25,1214,1459,0,0,83.21,354,835,"洲美里",NULL
0,6163,142,6305,7666,0,0,82.25,3171,2992,"奇岩里",NULL
0,5694,135,5829,7512,0,0,77.6,2670,3024,"清江里",NULL
0,4857,103,4960,6085,0,0,81.51,2158,2699,"中央里",NULL
0,3714,88,3802,4634,0,0,82.05,1810,1904,"長安里",NULL
0,3931,80,4011,4817,0,0,83.27,1825,2106,"大同里",NULL
0,4148,41,4189,5128,0,0,81.69,2178,1970,"溫泉里",NULL
0,2106,47,2153,2775,0,0,77.59,1382,724,"林泉里",NULL
0,3702,83,3785,4818,0,0,78.56,1988,1714,"中心里",NULL
0,2791,61,2852,3434,0,0,83.05,1334,1457,"中庸里",NULL
0,4165,83,4248,5183,0,0,81.96,2296,1869,"開明里",NULL
0,3310,76,3386,4074,0,0,83.11,1860,1450,"中和里",NULL
0,3956,79,4035,4809,0,0,83.91,2285,1671,"智仁里",NULL
0,2313,49,2362,2897,0,0,81.53,1298,1015,"秀山里",NULL
0,2836,40,2876,3362,0,0,85.54,2009,827,"文化里",NULL
0,2715,57,2772,3348,0,0,82.8,1453,1262,"豐年里",NULL
0,3045,69,3114,3918,0,0,79.48,1768,1277,"稻香里",NULL
0,3419,69,3488,4170,0,0,83.65,1559,1860,"桃源里",NULL
0,4075,112,4187,5097,0,0,82.15,1757,2318,"一德里",NULL
0,6512,188,6700,8166,0,0,82.05,3358,3154,"關渡里",NULL
0,1574,40,1614,1957,0,0,82.47,698,876,"泉源里",NULL
0,1353,47,1400,1707,0,0,82.02,692,661,"湖山里",NULL
0,762,32,794,990,0,0,80.2,250,512,"大屯里",NULL
0,592,19,611,746,0,0,81.9,270,322,"湖田里",NULL
0,2880,44,2924,3520,0,0,83.07,1307,1573,"仁勇里",NULL
0,2114,64,2178,2670,0,0,81.57,1057,1057,"義信里",NULL
0,2610,40,2650,3266,0,0,81.14,1623,987,"福林里",NULL
0,3016,53,3069,4410,0,0,69.59,1551,1465,"福德里",NULL
0,4723,95,4818,5805,0,0,83,2582,2141,"福志里",NULL
0,4355,78,4433,5321,0,0,83.31,2114,2241,"舊佳里",NULL
0,4996,75,5071,6047,0,0,83.86,2437,2559,"福佳里",NULL
0,5128,88,5216,6350,0,0,82.14,2237,2891,"後港里",NULL
0,3622,77,3699,4438,0,0,83.35,1509,2113,"福中里",NULL
0,2893,43,2936,3529,0,0,83.2,1239,1654,"前港里",NULL
0,4738,108,4846,5788,0,0,83.72,2120,2618,"百齡里",NULL
0,3639,76,3715,4470,0,0,83.11,1830,1809,"承德里",NULL
0,4419,108,4527,5552,0,0,81.54,2184,2235,"福華里",NULL
0,3249,82,3331,4051,0,0,82.23,1498,1751,"明勝里",NULL
0,3509,85,3594,4385,0,0,81.96,1359,2150,"福順里",NULL
0,3883,88,3971,4872,0,0,81.51,1584,2299,"富光里",NULL
0,4794,103,4897,5810,0,0,84.29,2341,2453,"葫蘆里",NULL
0,2528,49,2577,3133,0,0,82.25,996,1532,"葫東里",NULL
0,4157,99,4256,5104,0,0,83.39,1671,2486,"社子里",NULL
0,5395,143,5538,6705,0,0,82.6,2141,3254,"社新里",NULL
0,4683,86,4769,5671,0,0,84.09,1780,2903,"社園里",NULL
0,4773,121,4894,5886,0,0,83.15,1811,2962,"永倫里",NULL
0,3256,74,3330,3974,0,0,83.79,769,2487,"福安里",NULL
0,3641,108,3749,4459,0,0,84.08,1093,2548,"富洲里",NULL
0,2451,41,2492,3119,0,0,79.9,1527,924,"岩山里",NULL
0,4663,85,4748,5720,0,0,83.01,2643,2020,"名山里",NULL
0,2675,39,2714,3315,0,0,81.87,1328,1347,"德行里",NULL
0,3717,65,3782,4588,0,0,82.43,1753,1964,"德華里",NULL
0,3465,60,3525,4259,0,0,82.77,2187,1278,"聖山里",NULL
0,3846,46,3892,4603,0,0,84.55,2649,1197,"忠誠里",NULL
0,4710,70,4780,5736,0,0,83.33,2596,2114,"芝山里",NULL
0,3360,65,3425,4059,0,0,84.38,2180,1180,"東山里",NULL
0,3723,48,3771,4576,0,0,82.41,1923,1800,"三玉里",NULL
0,5367,98,5465,6776,0,0,80.65,2821,2546,"蘭雅里",NULL
0,4046,70,4116,4965,0,0,82.9,2040,2006,"蘭興里",NULL
0,4059,62,4121,5002,0,0,82.39,2274,1785,"天福里",NULL
0,3418,62,3480,4200,0,0,82.86,1765,1653,"天祿里",NULL
0,3050,44,3094,3783,0,0,81.79,1651,1399,"天壽里",NULL
0,4767,80,4847,5951,0,0,81.45,2697,2070,"天和里",NULL
0,4395,65,4460,5573,0,0,80.03,2436,1959,"天山里",NULL
0,5349,83,5432,6704,0,0,81.03,2987,2362,"天玉里",NULL
0,4060,77,4137,5121,0,0,80.79,2311,1749,"天母里",NULL
0,916,14,930,1144,0,0,81.29,354,562,"永福里",NULL
0,982,32,1014,1247,0,0,81.32,338,644,"公館里",NULL
0,1395,39,1434,1757,0,0,81.62,592,803,"新安里",NULL
0,2160,43,2203,2824,0,0,78.01,1120,1040,"陽明里",NULL
0,1107,32,1139,1386,0,0,82.18,466,641,"菁山里",NULL
0,990,27,1017,1197,0,0,84.96,259,731,"平等里",NULL
0,990,35,1025,1251,0,0,81.93,379,611,"溪山里",NULL
0,2072,38,2110,2562,0,0,82.36,1600,472,"翠山里",NULL
0,1923,40,1963,2466,0,0,79.6,1113,810,"臨溪里",NULL
0,1944,50,1994,2480,0,0,80.4,971,973,"正守里",NULL
0,2770,57,2827,3708,0,0,76.24,1553,1217,"正義里",NULL
0,1993,35,2028,2662,0,0,76.18,1105,888,"正得里",NULL
0,3243,35,3278,4160,0,0,78.8,1537,1706,"民安里",NULL
0,1391,37,1428,1904,0,0,75,800,591,"康樂里",NULL
0,3465,53,3518,4565,0,0,77.06,1858,1607,"中山里",NULL
0,2062,59,2121,2851,0,0,74.39,1051,1011,"聚盛里",NULL
0,3791,84,3875,4823,0,0,80.34,1680,2111,"集英里",NULL
0,2412,46,2458,3135,0,0,78.41,1232,1180,"聚葉里",NULL
0,2041,51,2092,2725,0,0,76.77,1056,985,"恆安里",NULL
0,2589,77,2666,3509,0,0,75.98,1426,1163,"晴光里",NULL
0,2354,48,2402,3050,0,0,78.75,1126,1228,"圓山里",NULL
0,3255,51,3306,4033,0,0,81.97,1584,1671,"新庄里",NULL
0,2576,54,2630,3177,0,0,82.78,2211,365,"劍潭里",NULL
0,6332,103,6435,7743,0,0,83.11,3821,2511,"大直里",NULL
0,2055,41,2096,2438,0,0,85.97,1153,902,"成功里",NULL
0,5478,80,5558,6643,0,0,83.67,3082,2396,"永安里",NULL
0,814,5,819,970,0,0,84.43,263,551,"大佳里",NULL
0,3212,55,3267,4029,0,0,81.09,1490,1722,"新喜里",NULL
0,3230,63,3293,4192,0,0,78.55,1420,1810,"新福里",NULL
0,4037,81,4118,5072,0,0,81.19,1943,2094,"松江里",NULL
0,3219,67,3286,4036,0,0,81.42,1460,1759,"新生里",NULL
0,3588,108,3696,4603,0,0,80.3,1640,1948,"中庄里",NULL
0,3712,66,3778,5577,0,0,67.74,1842,1870,"行政里",NULL
0,5427,118,5545,6664,0,0,83.21,2559,2868,"行仁里",NULL
0,2799,46,2845,3433,0,0,82.87,1332,1467,"行孝里",NULL
0,4886,95,4981,6045,0,0,82.4,2455,2431,"下埤里",NULL
0,4415,87,4502,5486,0,0,82.06,2336,2079,"江寧里",NULL
0,5104,91,5195,6346,0,0,81.86,2460,2644,"江山里",NULL
0,3357,60,3417,4175,0,0,81.84,1513,1844,"中吉里",NULL
0,3022,53,3075,3865,0,0,79.56,1445,1577,"中原里",NULL
0,3218,59,3277,4160,0,0,78.77,1625,1593,"興亞里",NULL
0,2306,42,2348,2912,0,0,80.63,1245,1061,"中央里",NULL
0,4004,113,4117,5044,0,0,81.62,2176,1828,"朱馥里",NULL
0,3572,51,3623,4343,0,0,83.42,2685,887,"龍洲里",NULL
0,2879,51,2930,3630,0,0,80.72,1437,1442,"朱園里",NULL
0,2668,66,2734,3368,0,0,81.18,1519,1149,"埤頭里",NULL
0,2032,39,2071,2565,0,0,80.74,992,1040,"朱崙里",NULL
0,3835,76,3911,4884,0,0,80.08,1827,2008,"力行里",NULL
0,2552,66,2618,3233,0,0,80.98,1548,1004,"復華里",NULL
0,1971,33,2004,2363,0,0,84.81,1346,625,"北安里",NULL
0,3362,68,3430,4116,0,0,83.33,1895,1467,"金泰里",NULL
0,2198,53,2251,2923,0,0,77.01,1115,1083,"玉泉里",NULL
0,2232,53,2285,2848,0,0,80.23,896,1336,"建明里",NULL
0,3035,92,3127,3915,0,0,79.87,1332,1703,"建功里",NULL
0,2421,45,2466,3041,0,0,81.09,975,1446,"建泰里",NULL
0,3354,77,3431,4265,0,0,80.45,1390,1964,"永樂里",NULL
0,2537,67,2604,3296,0,0,79,1119,1418,"朝陽里",NULL
0,3158,56,3214,3985,0,0,80.65,1424,1734,"星明里",NULL
0,3445,63,3508,4242,0,0,82.7,1426,2019,"光能里",NULL
0,3274,72,3346,4060,0,0,82.41,1319,1955,"大有里",NULL
0,2510,50,2560,3257,0,0,78.6,1152,1358,"延平里",NULL
0,6156,108,6264,7682,0,0,81.54,2564,3592,"雙連里",NULL
0,2671,66,2737,3369,0,0,81.24,1146,1525,"南芳里",NULL
0,4158,97,4255,5209,0,0,81.69,2090,2068,"民權里",NULL
0,1906,45,1951,2399,0,0,81.33,786,1120,"景星里",NULL
0,2179,47,2226,2720,0,0,81.84,855,1324,"隆和里",NULL
0,3043,58,3101,3890,0,0,79.72,1294,1749,"蓬萊里",NULL
0,2138,43,2181,2671,0,0,81.65,783,1355,"國順里",NULL
0,2532,51,2583,3163,0,0,81.66,1080,1452,"國慶里",NULL
0,2201,67,2268,3049,0,0,74.39,900,1301,"揚雅里",NULL
0,3582,91,3673,4526,0,0,81.15,1468,2114,"斯文里",NULL
0,4243,116,4359,5303,0,0,82.2,1663,2580,"鄰江里",NULL
0,5120,87,5207,6363,0,0,81.83,2143,2977,"至聖里",NULL
0,3888,82,3970,4836,0,0,82.09,1599,2289,"老師里",NULL
0,3815,82,3897,4703,0,0,82.86,1767,2048,"重慶里",NULL
0,2993,68,3061,3687,0,0,83.02,1176,1817,"保安里",NULL
0,3913,77,3990,4831,0,0,82.59,2299,1614,"莊敬里",NULL
0,5569,89,5658,6919,0,0,81.77,3246,2323,"東榮里",NULL
0,4542,66,4608,5686,0,0,81.04,2796,1746,"三民里",NULL
0,3065,38,3103,3799,0,0,81.68,1667,1398,"新益里",NULL
0,3442,45,3487,4258,0,0,81.89,2141,1301,"富錦里",NULL
0,3219,61,3280,4034,0,0,81.31,1795,1424,"新東里",NULL
0,2953,34,2987,3731,0,0,80.06,1925,1028,"富泰里",NULL
0,2866,49,2915,3645,0,0,79.97,1560,1306,"介壽里",NULL
0,2850,27,2877,3638,0,0,79.08,1781,1069,"精忠里",NULL
0,4787,73,4860,6106,0,0,79.59,2879,1908,"東光里",NULL
0,5536,48,5584,6786,0,0,82.29,4063,1473,"龍田里",NULL
0,1741,27,1768,2161,0,0,81.81,967,774,"東昌里",NULL
0,2825,53,2878,3516,0,0,81.85,1542,1283,"東勢里",NULL
0,3915,49,3964,4864,0,0,81.5,2414,1501,"中華里",NULL
0,5593,81,5674,7118,0,0,79.71,3013,2580,"民有里",NULL
0,4426,80,4506,5461,0,0,82.51,2846,1580,"民福里",NULL
0,4003,64,4067,5604,0,0,72.57,1810,2193,"慈祐里",NULL
0,5613,118,5731,6965,0,0,82.28,2777,2836,"安平里",NULL
0,3843,73,3916,4803,0,0,81.53,2652,1191,"鵬程里",NULL
0,4616,67,4683,5627,0,0,83.22,3651,965,"自強里",NULL
0,5373,86,5459,6668,0,0,81.87,3134,2239,"吉祥里",NULL
0,4763,96,4859,5956,0,0,81.58,2606,2157,"新聚里",NULL
0,4310,94,4404,5317,0,0,82.83,2590,1720,"復盛里",NULL
0,5081,81,5162,6440,0,0,80.16,2627,2454,"中正里",NULL
0,2480,47,2527,3074,0,0,82.21,1330,1150,"中崙里",NULL
0,2089,30,2119,2584,0,0,82,1099,990,"美仁里",NULL
0,2512,48,2560,3138,0,0,81.58,1475,1037,"吉仁里",NULL
0,4506,81,4587,5552,0,0,82.62,2390,2116,"敦化里",NULL
0,2007,36,2043,2492,0,0,81.98,1215,792,"復源里",NULL
0,2444,41,2485,3065,0,0,81.08,1475,969,"復建里",NULL
0,3879,72,3951,4796,0,0,82.38,2083,1796,"復勢里",NULL
0,1656,25,1681,2109,0,0,79.71,948,708,"福成里",NULL
0,2479,41,2520,3113,0,0,80.95,1309,1170,"松基里",NULL
0,3338,48,3386,4731,0,0,71.57,2646,692,"西村里",NULL
0,3185,51,3236,3987,0,0,81.16,2183,1002,"正和里",NULL
0,1990,33,2023,2557,0,0,79.12,1324,666,"興隆里",NULL
0,1955,29,1984,2586,0,0,76.72,1190,765,"中興里",NULL
0,2381,48,2429,3067,0,0,79.2,1655,726,"新仁里",NULL
0,3820,69,3889,4820,0,0,80.68,2270,1550,"興雅里",NULL
0,3076,53,3129,3955,0,0,79.12,1815,1261,"敦厚里",NULL
0,4676,67,4743,5814,0,0,81.58,2964,1712,"廣居里",NULL
0,4857,87,4944,6081,0,0,81.3,2922,1935,"安康里",NULL
0,2372,47,2419,2904,0,0,83.3,1269,1103,"六藝里",NULL
0,3261,67,3328,4037,0,0,82.44,1739,1522,"雅祥里",NULL
0,2463,54,2517,3103,0,0,81.12,1395,1068,"五常里",NULL
0,3579,66,3645,4366,0,0,83.49,1768,1811,"五全里",NULL
0,3010,105,3115,3820,0,0,81.54,1271,1739,"永吉里",NULL
0,2928,112,3040,3682,0,0,82.56,1535,1393,"長春里",NULL
0,3844,71,3915,4663,0,0,83.96,1932,1912,"四育里",NULL
0,3706,61,3767,4634,0,0,81.29,2257,1449,"四維里",NULL
0,3597,110,3707,4460,0,0,83.12,1920,1677,"永春里",NULL
0,2502,44,2546,3105,0,0,82,1832,670,"富臺里",NULL
0,4724,86,4810,5810,0,0,82.79,2897,1827,"國業里",NULL
0,1778,53,1831,2302,0,0,79.54,1063,715,"松隆里",NULL
0,4264,86,4350,5291,0,0,82.22,2662,1602,"松友里",NULL
0,3655,73,3728,4507,0,0,82.72,2024,1631,"松光里",NULL
0,3149,49,3198,3839,0,0,83.3,1785,1364,"中坡里",NULL
0,5346,121,5467,6599,0,0,82.85,2917,2429,"中行里",NULL
0,4356,126,4482,5398,0,0,83.03,2362,1994,"大道里",NULL
0,3495,156,3651,4587,0,0,79.59,2047,1448,"大仁里",NULL
0,3272,45,3317,4045,0,0,82,2198,1074,"景新里",NULL
0,4555,107,4662,5576,0,0,83.61,2991,1564,"惠安里",NULL
0,6173,122,6295,7673,0,0,82.04,4027,2146,"三張里",NULL
0,3313,41,3354,4148,0,0,80.86,2142,1171,"三犁里",NULL
0,4387,75,4462,5541,0,0,80.53,3027,1360,"六合里",NULL
0,5297,108,5405,6608,0,0,81.79,3314,1983,"泰和里",NULL
0,3192,54,3246,3967,0,0,81.83,1910,1282,"景聯里",NULL
0,3053,70,3123,3757,0,0,83.12,2002,1051,"景勤里",NULL
0,4875,96,4971,6055,0,0,82.1,3120,1755,"雙和里",NULL
0,2247,44,2291,2757,0,0,83.1,1281,966,"嘉興里",NULL
0,2873,46,2919,3568,0,0,81.81,1854,1019,"黎順里",NULL
0,4659,86,4745,5743,0,0,82.62,2876,1783,"黎平里",NULL
0,3346,56,3402,4088,0,0,83.22,2009,1337,"黎忠里",NULL
0,1813,65,1878,2285,0,0,82.19,1401,412,"黎安里",NULL
0,3722,75,3797,4803,0,0,79.05,1958,1764,"南港里",NULL
0,2667,87,2754,3361,0,0,81.94,1304,1363,"中南里",NULL
0,2646,68,2714,3253,0,0,83.43,1311,1335,"新富里",NULL
0,2080,53,2133,2643,0,0,80.7,1038,1042,"三重里",NULL
0,4689,85,4774,5717,0,0,83.51,2598,2091,"東新里",NULL
0,2756,56,2812,3404,0,0,82.61,1676,1080,"新光里",NULL
0,3066,60,3126,3827,0,0,81.68,1859,1207,"東明里",NULL
0,2886,61,2947,3581,0,0,82.3,1253,1633,"西新里",NULL
0,3034,55,3089,3727,0,0,82.88,1527,1507,"玉成里",NULL
0,4196,94,4290,5108,0,0,83.99,2312,1884,"合成里",NULL
0,5092,88,5180,6135,0,0,84.43,3114,1978,"成福里",NULL
0,2804,47,2851,3379,0,0,84.37,1769,1035,"萬福里",NULL
0,3172,66,3238,3836,0,0,84.41,1728,1444,"鴻福里",NULL
0,3316,58,3374,4037,0,0,83.58,1796,1520,"百福里",NULL
0,3609,41,3650,4306,0,0,84.77,2134,1475,"聯成里",NULL
0,5457,156,5613,6876,0,0,81.63,2865,2592,"舊莊里",NULL
0,5971,113,6084,7292,0,0,83.43,3518,2453,"中研里",NULL
0,3647,80,3727,4553,0,0,81.86,2288,1359,"九如里",NULL
0,3643,59,3702,4452,0,0,83.15,2392,1251,"仁福里",NULL
0,5055,73,5128,6178,0,0,83,2737,2318,"西湖里",NULL
0,5285,91,5376,6377,0,0,84.3,3328,1957,"西康里",NULL
0,4063,68,4131,4930,0,0,83.79,2427,1636,"西安里",NULL
0,3653,73,3726,4423,0,0,84.24,2026,1627,"港墘里",NULL
0,3354,44,3398,4030,0,0,84.32,1840,1514,"港都里",NULL
0,3487,60,3547,4240,0,0,83.66,1775,1712,"麗山里",NULL
0,5925,112,6037,7173,0,0,84.16,3184,2741,"港富里",NULL
0,5195,100,5295,6261,0,0,84.57,2895,2300,"港華里",NULL
0,3591,54,3645,4428,0,0,82.32,2222,1369,"內湖里",NULL
0,4754,85,4839,5803,0,0,83.39,3028,1726,"湖濱里",NULL
0,5386,84,5470,6502,0,0,84.13,3071,2315,"紫星里",NULL
0,3196,58,3254,3976,0,0,81.84,2009,1187,"大湖里",NULL
0,3847,69,3916,4730,0,0,82.79,2387,1460,"秀湖里",NULL
0,3724,86,3810,4585,0,0,83.1,2172,1552,"金龍里",NULL
0,4163,73,4236,5000,0,0,84.72,2439,1724,"金瑞里",NULL
0,4374,71,4445,5314,0,0,83.65,2611,1763,"碧山里",NULL
0,3633,107,3740,4414,0,0,84.73,2445,1188,"紫雲里",NULL
0,4214,84,4298,5200,0,0,82.65,2671,1543,"清白里",NULL
0,5831,58,5889,7001,0,0,84.12,3737,2094,"葫洲里",NULL
0,3830,51,3881,4632,0,0,83.79,2463,1367,"金湖里",NULL
0,4923,77,5000,6039,0,0,82.8,3078,1845,"康寧里",NULL
0,3009,61,3070,3594,0,0,85.42,1768,1241,"明湖里",NULL
0,626,7,633,791,0,0,80.03,273,353,"蘆洲里",NULL
0,4834,68,4902,5861,0,0,83.64,2914,1920,"紫陽里",NULL
0,5449,74,5523,6402,0,0,86.27,3931,1518,"瑞陽里",NULL
0,3109,54,3163,3725,0,0,84.91,2137,972,"瑞光里",NULL
0,5662,110,5772,6977,0,0,82.73,3008,2654,"五分里",NULL
0,4888,74,4962,5975,0,0,83.05,2695,2193,"東湖里",NULL
0,4375,92,4467,5279,0,0,84.62,2534,1841,"安湖里",NULL
0,4836,107,4943,5977,0,0,82.7,2640,2196,"樂康里",NULL
0,2696,49,2745,3285,0,0,83.56,1510,1186,"內溝里",NULL
0,2963,51,3014,3613,0,0,83.42,1762,1201,"週美里",NULL
0,3268,70,3338,3970,0,0,84.08,1368,1900,"行善里",NULL
0,4248,99,4347,5215,0,0,83.36,2213,2035,"石潭里",NULL
0,1229,39,1268,1579,0,0,80.3,656,573,"湖興里",NULL
0,6108,110,6218,8064,0,0,77.11,3446,2662,"湖元里",NULL
0,3367,50,3417,4055,0,0,84.27,1929,1438,"東湖里",NULL
0,3604,44,3648,4630,0,0,78.79,2358,1246,"德安里",NULL
0,2993,55,3048,3920,0,0,77.76,1762,1231,"仁慈里",NULL
0,4036,54,4090,5060,0,0,80.83,2614,1422,"和安里",NULL
0,4927,76,5003,6379,0,0,78.43,2860,2067,"民炤里",NULL
0,3447,42,3489,4678,0,0,74.58,2110,1337,"仁愛里",NULL
0,4370,65,4435,5512,0,0,80.46,3234,1136,"義村里",NULL
0,4342,67,4409,5541,0,0,79.57,2524,1818,"民輝里",NULL
0,2101,46,2147,2729,0,0,78.67,1110,991,"昌隆里",NULL
0,2915,38,2953,3735,0,0,79.06,1626,1289,"誠安里",NULL
0,4967,73,5040,6538,0,0,77.09,3014,1953,"光武里",NULL
0,3731,58,3789,4659,0,0,81.33,2462,1269,"龍坡里",NULL
0,2898,43,2941,3690,0,0,79.7,1740,1158,"龍泉里",NULL
0,2636,52,2688,3342,0,0,80.43,1570,1066,"古風里",NULL
0,4035,64,4099,5104,0,0,80.31,2428,1607,"古莊里",NULL
0,3768,59,3827,5698,0,0,67.16,2339,1429,"龍安里",NULL
0,3240,48,3288,4055,0,0,81.09,2084,1156,"錦安里",NULL
0,3471,62,3533,4375,0,0,80.75,2173,1298,"福住里",NULL
0,2089,32,2121,2631,0,0,80.62,1310,779,"永康里",NULL
0,2381,38,2419,2949,0,0,82.03,1553,828,"光明里",NULL
0,3241,54,3295,3941,0,0,83.61,2306,935,"錦泰里",NULL
0,3340,55,3395,4128,0,0,82.24,2116,1224,"錦華里",NULL
0,4195,56,4251,5396,0,0,78.78,2686,1509,"龍圖里",NULL
0,4173,53,4226,5173,0,0,81.69,3089,1084,"新龍里",NULL
0,2379,43,2422,3043,0,0,79.59,1476,903,"龍陣里",NULL
0,3270,60,3330,4114,0,0,80.94,1985,1285,"龍雲里",NULL
0,4063,50,4113,5003,0,0,82.21,2702,1361,"龍生里",NULL
0,3494,74,3568,4426,0,0,80.61,2155,1339,"住安里",NULL
0,3530,47,3577,4518,0,0,79.17,2342,1188,"義安里",NULL
0,4059,91,4150,5053,0,0,82.13,2107,1952,"通化里",NULL
0,3726,90,3816,4748,0,0,80.37,2245,1481,"通安里",NULL
0,2815,67,2882,3543,0,0,81.34,1616,1199,"臨江里",NULL
0,2817,62,2879,3551,0,0,81.08,1853,964,"法治里",NULL
0,2773,47,2820,3525,0,0,80,1736,1037,"全安里",NULL
0,3923,61,3984,5036,0,0,79.11,2615,1308,"群賢里",NULL
0,4906,62,4968,6007,0,0,82.7,3893,1013,"群英里",NULL
0,2090,45,2135,2646,0,0,80.69,1397,693,"虎嘯里",NULL
0,1365,32,1397,1760,0,0,79.38,946,419,"臥龍里",NULL
0,5592,89,5681,6959,0,0,81.64,3576,2016,"龍淵里",NULL
0,2546,49,2595,3293,0,0,78.8,1561,985,"龍門里",NULL
0,5018,109,5127,6528,0,0,78.54,3129,1889,"大學里",NULL
0,4122,89,4211,5076,0,0,82.96,2645,1477,"芳和里",NULL
0,3741,90,3831,4581,0,0,83.63,2283,1458,"黎元里",NULL
0,5131,92,5223,6228,0,0,83.86,3239,1892,"黎孝里",NULL
0,2905,66,2971,3615,0,0,82.19,1943,962,"黎和里",NULL
0,3155,54,3209,4174,0,0,76.88,2004,1151,"建安里",NULL
0,3815,52,3867,4927,0,0,78.49,2375,1440,"建倫里",NULL
0,3971,59,4030,5035,0,0,80.04,2324,1647,"敦安里",NULL
0,3127,52,3179,4009,0,0,79.3,2045,1082,"正聲里",NULL
0,3792,41,3833,4811,0,0,79.67,2217,1575,"敦煌里",NULL
0,2766,49,2815,3537,0,0,79.59,1725,1041,"華聲里",NULL
0,4155,59,4214,5315,0,0,79.29,2429,1726,"車層里",NULL
0,4962,89,5051,6315,0,0,79.98,3002,1960,"光信里",NULL
0,2473,66,2539,3247,0,0,78.2,1710,763,"學府里",NULL
0,2095,35,2130,2607,0,0,81.7,1146,949,"水源里",NULL
0,1976,39,2015,2544,0,0,79.21,1562,414,"富水里",NULL
0,1799,31,1830,2278,0,0,80.33,1042,757,"文盛里",NULL
0,3190,66,3256,4017,0,0,81.06,2080,1110,"林興里",NULL
0,3028,43,3071,3857,0,0,79.62,1947,1081,"河堤里",NULL
0,3784,59,3843,4700,0,0,81.77,2235,1549,"頂東里",NULL
0,3548,58,3606,4489,0,0,80.33,2144,1404,"網溪里",NULL
0,2226,56,2282,2866,0,0,79.62,1297,929,"板溪里",NULL
0,3601,62,3663,4467,0,0,82,2148,1453,"螢圃里",NULL
0,2957,68,3025,3681,0,0,82.18,1752,1205,"螢雪里",NULL
0,4079,87,4166,5090,0,0,81.85,2172,1907,"永功里",NULL
0,3546,74,3620,4459,0,0,81.18,1971,1575,"永昌里",NULL
0,2567,37,2604,3137,0,0,83.01,1449,1118,"龍興里",NULL
0,4571,123,4694,5811,0,0,80.78,2741,1830,"忠勤里",NULL
0,2439,54,2493,3056,0,0,81.58,1380,1059,"廈安里",NULL
0,1983,35,2018,2498,0,0,80.78,1116,867,"愛國里",NULL
0,1814,28,1842,2304,0,0,79.95,1254,560,"南門里",NULL
0,2312,34,2346,2896,0,0,81.01,1462,850,"龍光里",NULL
0,5021,89,5110,6209,0,0,82.3,2993,2028,"南福里",NULL
0,4045,67,4112,5375,0,0,76.5,2517,1528,"龍福里",NULL
0,5236,94,5330,6332,0,0,84.18,3558,1678,"新營里",NULL
0,845,9,854,1150,0,0,74.26,585,260,"建國里",NULL
0,2297,47,2344,3006,0,0,77.98,1282,1015,"光復里",NULL
0,1807,39,1846,2458,0,0,75.1,1110,697,"黎明里",NULL
0,2222,43,2265,2882,0,0,78.59,1304,918,"梅花里",NULL
0,2900,68,2968,3717,0,0,79.85,1733,1167,"幸福里",NULL
0,2691,48,2739,3483,0,0,78.64,1462,1229,"幸市里",NULL
0,2859,54,2913,3615,0,0,80.58,1957,902,"東門里",NULL
0,3234,52,3286,4145,0,0,79.28,1882,1352,"文北里",NULL
0,4432,91,4523,5445,0,0,83.07,2648,1784,"文祥里",NULL
0,4813,85,4898,6077,0,0,80.6,2726,2087,"三愛里",NULL
0,3332,73,3405,4268,0,0,79.78,1835,1497,"福星里",NULL
0,2066,53,2119,2824,0,0,75.04,1118,948,"萬壽里",NULL
0,2195,55,2250,2936,0,0,76.63,1325,870,"西門里",NULL
0,4598,140,4738,5885,0,0,80.51,2523,2075,"新起里",NULL
0,3957,106,4063,5269,0,0,77.11,1882,2075,"菜園里",NULL
0,3500,92,3592,4528,0,0,79.33,1595,1905,"青山里",NULL
0,3396,81,3477,4233,0,0,82.14,1426,1970,"富民里",NULL
0,2530,57,2587,3107,0,0,83.26,1186,1344,"福音里",NULL
0,2932,63,2995,3630,0,0,82.51,1439,1493,"仁德里",NULL
0,3210,50,3260,3866,0,0,84.32,1415,1795,"富福里",NULL
0,3651,80,3731,4551,0,0,81.98,1731,1920,"糖廍里",NULL
0,3113,98,3211,3972,0,0,80.84,1586,1527,"綠堤里",NULL
0,5628,127,5755,7072,0,0,81.38,2663,2965,"華江里",NULL
0,3639,72,3711,4557,0,0,81.44,1522,2117,"柳鄉里",NULL
0,5444,105,5549,6948,0,0,79.86,2225,3219,"頂碩里",NULL
0,3470,83,3553,4393,0,0,80.88,1547,1923,"雙園里",NULL
0,2647,55,2702,3334,0,0,81.04,2176,471,"新忠里",NULL
0,6165,126,6291,7431,0,0,84.66,4802,1363,"新和里",NULL
0,4907,122,5029,6080,0,0,82.71,2011,2896,"和平里",NULL
0,2681,54,2735,3231,0,0,84.65,1252,1429,"日善里",NULL
0,4359,110,4469,5432,0,0,82.27,2813,1546,"新安里",NULL
0,3072,75,3147,3778,0,0,83.3,1310,1762,"忠德里",NULL
0,2265,36,2301,2741,0,0,83.95,941,1324,"孝德里",NULL
0,4737,100,4837,5968,0,0,81.05,2038,2699,"和德里",NULL
0,3621,99,3720,4450,0,0,83.6,1715,1906,"錦德里",NULL
0,2865,56,2921,3534,0,0,82.65,1422,1443,"全德里",NULL
0,2052,42,2094,2482,0,0,84.37,959,1093,"保德里",NULL
0,3317,60,3377,4016,0,0,84.09,1548,1769,"銘德里",NULL
0,2701,70,2771,3258,0,0,85.05,1287,1414,"榮德里",NULL
0,3359,68,3427,4049,0,0,84.64,1668,1691,"壽德里",NULL
0,3222,82,3304,4004,0,0,82.52,1458,1764,"興德里",NULL
0,4283,104,4387,5223,0,0,83.99,1964,2319,"華中里",NULL
0,3996,111,4107,4891,0,0,83.97,2669,1327,"日祥里",NULL
0,3553,72,3625,4307,0,0,84.17,2558,995,"忠貞里",NULL
0,2814,82,2896,3526,0,0,82.13,1939,875,"凌霄里",NULL
0,2151,46,2197,2645,0,0,83.06,1440,711,"騰雲里",NULL
0,3496,72,3568,4346,0,0,82.1,1859,1637,"景行里",NULL
0,4263,66,4329,5254,0,0,82.39,2908,1355,"景東里",NULL
0,2876,40,2916,3534,0,0,82.51,1767,1109,"景美里",NULL
0,4073,93,4166,5022,0,0,82.95,2592,1481,"景慶里",NULL
0,2931,49,2980,3595,0,0,82.89,1910,1021,"景仁里",NULL
0,3654,56,3710,4485,0,0,82.72,2360,1294,"景華里",NULL
0,3125,62,3187,3754,0,0,84.9,2004,1121,"萬有里",NULL
0,2959,42,3001,3573,0,0,83.99,1864,1095,"萬祥里",NULL
0,4610,58,4668,5649,0,0,82.63,3154,1456,"萬隆里",NULL
0,3487,70,3557,4333,0,0,82.09,2163,1324,"萬年里",NULL
0,2275,57,2332,2783,0,0,83.79,1800,475,"萬和里",NULL
0,3109,66,3175,3836,0,0,82.77,2105,1004,"萬盛里",NULL
0,5644,134,5778,6902,0,0,83.71,3814,1830,"興豐里",NULL
0,2073,46,2119,2562,0,0,82.71,1367,706,"興光里",NULL
0,4877,73,4950,5951,0,0,83.18,3365,1512,"興家里",NULL
0,4048,72,4120,5030,0,0,81.91,2685,1363,"興得里",NULL
0,3648,60,3708,4759,0,0,77.92,2677,971,"興業里",NULL
0,4098,65,4163,4976,0,0,83.66,2836,1262,"興安里",NULL
0,3949,56,4005,4665,0,0,85.85,2507,1442,"興福里",NULL
0,4547,90,4637,5607,0,0,82.7,3226,1321,"興旺里",NULL
0,2515,58,2573,3103,0,0,82.92,1710,805,"興泰里",NULL
0,4040,79,4119,5011,0,0,82.2,2894,1146,"興昌里",NULL
0,4209,51,4260,5059,0,0,84.21,3048,1161,"試院里",NULL
0,4919,84,5003,5987,0,0,83.56,3287,1632,"華興里",NULL
0,2973,141,3114,3985,0,0,78.14,1987,986,"明義里",NULL
0,4651,92,4743,5671,0,0,83.64,3258,1393,"明興里",NULL
0,4920,85,5005,5901,0,0,84.82,3513,1407,"木柵里",NULL
0,5619,105,5724,7045,0,0,81.25,3443,2176,"木新里",NULL
0,4468,85,4553,5462,0,0,83.36,2767,1701,"順興里",NULL
0,2483,56,2539,3001,0,0,84.61,1835,648,"忠順里",NULL
0,5448,94,5542,6630,0,0,83.59,3699,1749,"樟林里",NULL
0,7363,156,7519,8979,0,0,83.74,4714,2649,"樟新里",NULL
0,5900,114,6014,7181,0,0,83.75,3704,2196,"樟腳里",NULL
0,4685,88,4773,5731,0,0,83.28,3237,1448,"萬芳里",NULL
0,4215,85,4300,5284,0,0,81.38,2829,1386,"萬美里",NULL
0,3025,72,3097,3799,0,0,81.52,1921,1104,"博嘉里",NULL
0,6868,116,6984,8390,0,0,83.24,4386,2482,"萬興里",NULL
0,1871,63,1934,2369,0,0,81.64,996,875,"指南里",NULL
0,574,17,591,711,0,0,83.12,217,357,"老泉里",NULL
0,1040,22,1062,1282,0,0,82.84,348,692,"藍橋里",NULL
0,398,8,406,498,0,0,81.53,183,215,"慈愛里",NULL
0,583,17,600,736,0,0,81.52,189,394,"博愛里",NULL
0,1059,27,1086,1341,0,0,80.98,462,597,"壽星里",NULL
0,961,14,975,1214,0,0,80.31,397,564,"中山里",NULL
0,1822,21,1843,2245,0,0,82.09,719,1103,"教仁里",NULL
0,760,7,767,928,0,0,82.65,330,430,"新樂里",NULL
0,560,3,563,700,0,0,80.43,242,318,"中原里",NULL
0,990,8,998,1248,0,0,79.97,396,594,"光明里",NULL
0,675,9,684,851,0,0,80.38,282,393,"育仁里",NULL
0,1479,19,1498,1841,0,0,81.37,632,847,"河濱里",NULL
0,872,12,884,1097,0,0,80.58,304,568,"沙地里",NULL
0,898,20,918,1128,0,0,81.38,394,504,"南端里",NULL
0,916,22,938,1186,0,0,79.09,377,539,"港都里",NULL
0,1013,10,1023,1238,0,0,82.63,369,644,"江西里",NULL
0,509,15,524,624,0,0,83.97,252,257,"新豐里",NULL
0,1399,25,1424,1807,0,0,78.8,590,809,"府北里",NULL
0,1009,21,1030,1273,0,0,80.91,441,568,"陸橋里",NULL
0,596,9,605,729,0,0,82.99,201,395,"瀨南里",NULL
0,581,10,591,706,0,0,83.71,252,329,"新化里",NULL
0,720,14,734,943,0,0,77.84,211,509,"江南里",NULL
0,1702,27,1729,2102,0,0,82.25,991,711,"鼓峰里",NULL
0,1683,25,1708,2093,0,0,81.61,1204,479,"雄峰里",NULL
0,3583,64,3647,4319,0,0,84.44,2024,1559,"前峰里",NULL
0,3198,54,3252,3912,0,0,83.13,1013,2185,"光榮里",NULL
0,1231,17,1248,1488,0,0,83.87,536,695,"民族里",NULL
0,996,21,1017,1206,0,0,84.33,290,706,"內惟里",NULL
0,1755,32,1787,2109,0,0,84.73,718,1037,"建國里",NULL
0,3277,36,3313,4008,0,0,82.66,1401,1876,"忠正里",NULL
0,713,13,726,851,0,0,85.31,676,37,"自強里",NULL
0,1202,30,1232,1523,0,0,80.89,506,696,"龍井里",NULL
0,1510,21,1531,1856,0,0,82.49,509,1001,"正德里",NULL
0,2499,49,2548,3031,0,0,84.06,861,1638,"平和里",NULL
0,2330,60,2390,2844,0,0,84.04,893,1437,"民強里",NULL
0,1872,35,1907,2279,0,0,83.68,594,1278,"厚生里",NULL
0,4206,68,4274,5236,0,0,81.63,1868,2338,"龍子里",NULL
0,1272,12,1284,1579,0,0,81.32,680,592,"龍水里",NULL
0,8386,133,8519,10342,0,0,82.37,4658,3728,"明誠里",NULL
0,2933,35,2968,3555,0,0,83.49,1737,1196,"華豐里",NULL
0,2391,43,2434,2936,0,0,82.9,1379,1012,"裕興里",NULL
0,1884,19,1903,2298,0,0,82.81,1252,632,"裕豐里",NULL
0,1185,25,1210,1513,0,0,79.97,403,782,"鼓岩里",NULL
0,930,11,941,1149,0,0,81.9,282,648,"樹德里",NULL
0,842,3,845,1173,0,0,72.04,304,538,"寶樹里",NULL
0,1208,17,1225,1503,0,0,81.5,543,665,"興宗里",NULL
0,1261,9,1270,1562,0,0,81.31,624,637,"光化里",NULL
0,1100,26,1126,1408,0,0,79.97,592,508,"山下里",NULL
0,1261,25,1286,1570,0,0,81.91,514,747,"河邊里",NULL
0,1296,40,1336,1615,0,0,82.72,465,831,"綠川里",NULL
0,608,3,611,820,0,0,74.51,268,340,"登山里",NULL
0,785,22,807,1037,0,0,77.82,301,484,"峰南里",NULL
0,895,29,924,1187,0,0,77.84,339,556,"麗興里",NULL
0,889,20,909,1160,0,0,78.36,283,606,"新民里",NULL
0,734,9,743,923,0,0,80.5,237,497,"延平里",NULL
0,1135,15,1150,1463,0,0,78.61,361,774,"維生里",NULL
0,1117,19,1136,1445,0,0,78.62,360,757,"惠安里",NULL
0,1205,34,1239,1586,0,0,78.12,425,780,"壽山里",NULL
0,930,16,946,1199,0,0,78.9,408,522,"哨船頭里",NULL
0,504,9,513,620,0,0,82.74,221,283,"桃源里",NULL
0,953,34,987,1249,0,0,79.02,331,622,"旗下里",NULL
0,845,18,863,1102,0,0,78.31,289,556,"永安里",NULL
0,1321,10,1331,1700,0,0,78.29,457,864,"振興里",NULL
0,1623,32,1655,2104,0,0,78.66,571,1052,"慈愛里",NULL
0,2123,53,2176,2772,0,0,78.5,920,1203,"復興里",NULL
0,1030,24,1054,1281,0,0,82.28,321,709,"中華里",NULL
0,1006,30,1036,1353,0,0,76.57,693,313,"實踐里",NULL
0,1931,33,1964,2451,0,0,80.13,703,1228,"北汕里",NULL
0,1330,20,1350,1676,0,0,80.55,372,958,"南汕里",NULL
0,1984,42,2026,2568,0,0,78.89,524,1460,"上竹里",NULL
0,1282,25,1307,1623,0,0,80.53,330,952,"中洲里",NULL
0,753,18,771,955,0,0,80.73,186,567,"安順里",NULL
0,1777,37,1814,2195,0,0,82.64,547,1230,"中興里",NULL
0,1284,22,1306,1889,0,0,69.14,645,639,"進學里",NULL
0,984,20,1004,1198,0,0,83.81,313,671,"尾西里",NULL
0,489,10,499,602,0,0,82.89,178,311,"頂北里",NULL
0,611,9,620,731,0,0,84.82,151,460,"中北里",NULL
0,456,12,468,569,0,0,82.25,89,367,"中南里",NULL
0,769,16,785,923,0,0,85.05,176,593,"廟東里",NULL
0,865,20,885,1043,0,0,84.85,200,665,"廟北里",NULL
0,681,24,705,838,0,0,84.13,167,514,"尾南里",NULL
0,2437,50,2487,2980,0,0,83.46,962,1475,"尾北里",NULL
0,1216,29,1245,1496,0,0,83.22,888,328,"屏山里",NULL
0,480,13,493,598,0,0,82.44,444,36,"祥和里",NULL
0,1658,45,1703,2101,0,0,81.06,1543,115,"永清里",NULL
0,1023,22,1045,1265,0,0,82.61,955,68,"復興里",NULL
0,1413,24,1437,1719,0,0,83.6,973,440,"莒光里",NULL
0,2028,41,2069,2486,0,0,83.23,1197,831,"光輝里",NULL
0,1112,14,1126,1357,0,0,82.98,1069,43,"合群里",NULL
0,943,23,966,1193,0,0,80.97,888,55,"自治里",NULL
0,1214,12,1226,1536,0,0,79.82,1174,40,"明建里",NULL
0,43,0,43,71,0,0,60.56,39,4,"自立里",NULL
0,988,20,1008,1171,0,0,86.08,267,721,"頂西里",NULL
0,781,13,794,950,0,0,83.58,182,599,"聖后里",NULL
0,312,10,322,382,0,0,84.29,86,226,"聖西里",NULL
0,474,7,481,587,0,0,81.94,153,321,"聖南里",NULL
0,473,5,478,563,0,0,84.9,138,335,"城南里",NULL
0,654,9,663,791,0,0,83.82,208,446,"路東里",NULL
0,446,8,454,537,0,0,84.54,94,352,"廍北里",NULL
0,626,16,642,766,0,0,83.81,241,385,"廍南里",NULL
0,919,12,931,1126,0,0,82.68,382,537,"埤西里",NULL
0,1111,32,1143,1428,0,0,80.04,719,392,"埤北里",NULL
0,976,19,995,1218,0,0,81.69,465,511,"埤東里",NULL
0,4229,80,4309,5072,0,0,84.96,3785,444,"海勝里",NULL
0,66,2,68,123,0,0,55.28,53,13,"自勉里",NULL
0,937,16,953,1138,0,0,83.74,896,41,"崇實里",NULL
0,1908,42,1950,2376,0,0,82.07,1753,155,"自助里",NULL
0,1600,32,1632,1940,0,0,84.12,1455,145,"果貿里",NULL
0,1282,26,1308,1582,0,0,82.68,1018,264,"果惠里",NULL
0,1426,27,1453,1765,0,0,82.32,1270,156,"果峰里",NULL
0,8066,109,8175,9864,0,0,82.88,4201,3865,"新下里",NULL
0,15477,218,15695,18928,0,0,82.92,7394,8083,"新上里",NULL
0,3799,65,3864,4583,0,0,84.31,1228,2571,"新中里",NULL
0,7504,100,7604,9114,0,0,83.43,3724,3780,"新光里",NULL
0,14248,190,14438,17481,0,0,82.59,7132,7116,"菜公里",NULL
0,16579,196,16775,20670,0,0,81.16,8927,7652,"福山里",NULL
0,7366,118,7484,9075,0,0,82.47,2996,4370,"清豐里",NULL
0,1858,27,1885,2275,0,0,82.86,846,1012,"東寧里",NULL
0,3449,37,3486,4281,0,0,81.43,1296,2153,"五常里",NULL
0,2263,31,2294,2729,0,0,84.06,902,1361,"享平里",NULL
0,2211,32,2243,2697,0,0,83.17,710,1501,"中陽里",NULL
0,1893,30,1923,2537,0,0,75.8,841,1052,"惠楠里",NULL
0,2630,57,2687,3237,0,0,83.01,1070,1560,"惠民里",NULL
0,2279,32,2311,2877,0,0,80.33,1123,1156,"惠豐里",NULL
0,2854,30,2884,3408,0,0,84.62,793,2061,"錦屏里",NULL
0,1924,32,1956,2303,0,0,84.93,453,1471,"玉屏里",NULL
0,2670,32,2702,3217,0,0,83.99,666,2004,"金田里",NULL
0,1354,27,1381,1609,0,0,85.83,301,1053,"稔田里",NULL
0,2558,23,2581,3166,0,0,81.52,1020,1538,"瑞屏里",NULL
0,8894,125,9019,11114,0,0,81.15,5326,3568,"翠屏里",NULL
0,1391,13,1404,1706,0,0,82.3,906,485,"宏南里",NULL
0,2446,22,2468,2896,0,0,85.22,989,1457,"宏毅里",NULL
0,1761,51,1812,2104,0,0,86.12,1020,741,"宏榮里",NULL
0,2527,58,2585,3043,0,0,84.95,1259,1268,"廣昌里",NULL
0,1806,34,1840,2263,0,0,81.31,958,848,"久昌里",NULL
0,1664,35,1699,2043,0,0,83.16,1004,660,"大昌里",NULL
0,1514,25,1539,1817,0,0,84.7,626,888,"福昌里",NULL
0,3351,37,3388,4040,0,0,83.86,1803,1548,"盛昌里",NULL
0,1289,30,1319,1571,0,0,83.96,607,682,"泰昌里",NULL
0,2504,37,2541,3049,0,0,83.34,1122,1382,"興昌里",NULL
0,1941,34,1975,2372,0,0,83.26,995,946,"建昌里",NULL
0,1948,21,1969,2365,0,0,83.26,1101,847,"宏昌里",NULL
0,1789,30,1819,2129,0,0,85.44,938,851,"和昌里",NULL
0,2572,46,2618,3061,0,0,85.53,1356,1216,"慶昌里",NULL
0,2682,44,2726,3263,0,0,83.54,1443,1239,"隆昌里",NULL
0,1628,46,1674,2024,0,0,82.71,852,776,"秀昌里",NULL
0,2313,37,2350,2752,0,0,85.39,942,1371,"裕昌里",NULL
0,2599,37,2636,3136,0,0,84.06,1270,1329,"國昌里",NULL
0,4791,57,4848,5845,0,0,82.94,2907,1884,"加昌里",NULL
0,2795,39,2834,3489,0,0,81.23,1665,1130,"仁昌里",NULL
0,761,27,788,919,0,0,85.75,310,451,"藍田里",NULL
0,726,7,733,859,0,0,85.33,200,526,"中興里",NULL
0,1279,21,1300,1520,0,0,85.53,315,964,"中和里",NULL
0,2448,61,2509,3108,0,0,80.73,944,1504,"鼎金里",NULL
0,4683,71,4754,5793,0,0,82.06,2039,2644,"鼎盛里",NULL
0,2820,45,2865,3452,0,0,83,1067,1753,"鼎強里",NULL
0,2740,44,2784,3404,0,0,81.79,1076,1664,"鼎力里",NULL
0,4356,95,4451,5431,0,0,81.96,1693,2663,"鼎西里",NULL
0,2678,40,2718,3121,0,0,87.09,982,1696,"鼎中里",NULL
0,13441,165,13606,16417,0,0,82.88,6800,6641,"鼎泰里",NULL
0,6057,107,6164,7454,0,0,82.69,2484,3573,"本館里",NULL
0,4763,60,4823,5858,0,0,82.33,2108,2655,"本和里",NULL
0,1687,29,1716,2036,0,0,84.28,705,982,"本文里",NULL
0,1244,20,1264,1498,0,0,84.38,419,825,"本武里",NULL
0,3552,55,3607,4380,0,0,82.35,1558,1994,"本元里",NULL
0,3151,45,3196,3776,0,0,84.64,1482,1669,"本安里",NULL
0,3408,47,3455,4097,0,0,84.33,1731,1677,"本上里",NULL
0,5348,66,5414,6485,0,0,83.48,2470,2878,"本揚里",NULL
0,2782,42,2824,3456,0,0,81.71,1213,1569,"寶獅里",NULL
0,3636,33,3669,4484,0,0,81.82,1487,2149,"寶德里",NULL
0,2481,35,2516,3107,0,0,80.98,1105,1376,"寶泰里",NULL
0,4238,68,4306,5209,0,0,82.66,1734,2504,"寶興里",NULL
0,2199,31,2230,2666,0,0,83.65,847,1352,"寶中里",NULL
0,2289,19,2308,2781,0,0,82.99,1150,1139,"寶華里",NULL
0,5211,80,5291,6352,0,0,83.3,2292,2919,"寶國里",NULL
0,2115,38,2153,2615,0,0,82.33,959,1156,"寶民里",NULL
0,1907,36,1943,2439,0,0,79.66,859,1048,"寶慶里",NULL
0,3396,51,3447,4188,0,0,82.31,1517,1879,"寶業里",NULL
0,3242,37,3279,3973,0,0,82.53,1506,1736,"寶盛里",NULL
0,4735,61,4796,5950,0,0,80.61,2190,2545,"寶安里",NULL
0,3194,66,3260,3947,0,0,82.59,1350,1844,"寶龍里",NULL
0,3693,50,3743,4893,0,0,76.5,1547,2146,"寶珠里",NULL
0,5589,93,5682,6928,0,0,82.02,2603,2986,"寶玉里",NULL
0,2410,36,2446,3068,0,0,79.73,970,1440,"灣子里",NULL
0,2238,54,2292,2904,0,0,78.93,780,1458,"灣愛里",NULL
0,3218,52,3270,4045,0,0,80.84,1216,2002,"灣中里",NULL
0,2136,40,2176,2635,0,0,82.58,847,1289,"灣華里",NULL
0,1652,26,1678,2026,0,0,82.82,567,1085,"灣勝里",NULL
0,2642,45,2687,3240,0,0,82.93,905,1737,"灣利里",NULL
0,2322,39,2361,2951,0,0,80.01,909,1413,"灣復里",NULL
0,7096,72,7168,8776,0,0,81.68,3439,3657,"正興里",NULL
0,2642,43,2685,3289,0,0,81.64,1037,1605,"正順里",NULL
0,1268,21,1289,1559,0,0,82.68,437,831,"灣興里",NULL
0,1618,25,1643,2007,0,0,81.86,624,994,"灣成里",NULL
0,2318,34,2352,2978,0,0,78.98,825,1493,"安康里",NULL
0,1599,34,1633,2044,0,0,79.89,569,1030,"安寧里",NULL
0,3358,47,3405,4239,0,0,80.33,1447,1911,"安吉里",NULL
0,3346,60,3406,4146,0,0,82.15,1553,1793,"安發里",NULL
0,2564,38,2602,3167,0,0,82.16,995,1569,"安東里",NULL
0,2210,40,2250,2690,0,0,83.64,737,1473,"安和里",NULL
0,1231,21,1252,1472,0,0,85.05,441,790,"達德里",NULL
0,1413,12,1425,1696,0,0,84.02,519,894,"達明里",NULL
0,1193,13,1206,1467,0,0,82.21,493,700,"達仁里",NULL
0,850,16,866,1073,0,0,80.71,344,506,"達勇里",NULL
0,2258,29,2287,2755,0,0,83.01,878,1380,"同德里",NULL
0,2008,25,2033,2448,0,0,83.05,765,1243,"德智里",NULL
0,1548,24,1572,1954,0,0,80.45,677,871,"德仁里",NULL
0,1394,34,1428,1686,0,0,84.7,490,904,"安生里",NULL
0,726,12,738,876,0,0,84.25,266,460,"德東里",NULL
0,897,10,907,1106,0,0,82.01,308,589,"德行里",NULL
0,1314,31,1345,1618,0,0,83.13,544,770,"精華里",NULL
0,1698,27,1725,2063,0,0,83.62,569,1129,"民享里",NULL
0,2652,53,2705,3212,0,0,84.22,927,1725,"安宜里",NULL
0,3203,50,3253,3985,0,0,81.63,1231,1972,"安泰里",NULL
0,2916,47,2963,3932,0,0,75.36,1107,1809,"安邦里",NULL
0,1300,13,1313,1582,0,0,83,469,831,"十全里",NULL
0,1467,21,1488,1811,0,0,82.16,532,935,"十美里",NULL
0,1628,29,1657,2058,0,0,80.52,602,1026,"德北里",NULL
0,756,14,770,942,0,0,81.74,276,480,"立誠里",NULL
0,927,10,937,1118,0,0,83.81,325,602,"立業里",NULL
0,1113,16,1129,1433,0,0,78.79,397,716,"港東里",NULL
0,1159,12,1171,1451,0,0,80.7,500,659,"港新里",NULL
0,666,13,679,837,0,0,81.12,258,408,"港西里",NULL
0,354,4,358,437,0,0,81.92,166,188,"港北里",NULL
0,879,18,897,1166,0,0,76.93,365,514,"博愛里",NULL
0,3255,48,3303,4021,0,0,82.14,1425,1830,"博惠里",NULL
0,930,14,944,1154,0,0,81.8,415,515,"長明里",NULL
0,819,9,828,1131,0,0,73.21,333,486,"建東里",NULL
0,1336,18,1354,1685,0,0,80.36,531,805,"興德里",NULL
0,950,8,958,1132,0,0,84.63,292,658,"鳳南里",NULL
0,1555,22,1577,1905,0,0,82.78,524,1031,"鳳北里",NULL
0,990,14,1004,1237,0,0,81.16,368,622,"德西里",NULL
0,354,13,367,454,0,0,80.84,302,52,"九如里",NULL
0,2167,39,2206,2689,0,0,82.04,863,1304,"豐裕里",NULL
0,1514,23,1537,1907,0,0,80.6,523,991,"川東里",NULL
0,586,22,608,733,0,0,82.95,221,365,"裕民里",NULL
0,975,11,986,1166,0,0,84.56,400,575,"力行里",NULL
0,978,19,997,1193,0,0,83.57,413,565,"千歲里",NULL
0,1095,16,1111,1351,0,0,82.24,488,607,"立德里",NULL
0,1037,24,1061,1287,0,0,82.44,373,664,"千北里",NULL
0,1939,30,1969,2417,0,0,81.46,755,1184,"千秋里",NULL
0,1603,25,1628,1977,0,0,82.35,816,787,"浩然里",NULL
0,959,10,969,1257,0,0,77.09,437,522,"振成里",NULL
0,1951,31,1982,2448,0,0,80.96,959,992,"德生里",NULL
0,1020,18,1038,1302,0,0,79.72,525,495,"振華里",NULL
0,1340,18,1358,1626,0,0,83.52,598,742,"正氣里",NULL
0,584,10,594,742,0,0,80.05,302,282,"德政里",NULL
0,618,7,625,827,0,0,75.57,263,355,"仁聲里",NULL
0,1610,22,1632,2056,0,0,79.38,772,838,"德望里",NULL
0,830,11,841,1066,0,0,78.89,362,468,"華聲里",NULL
0,643,10,653,792,0,0,82.45,256,387,"蕉園里",NULL
0,1140,29,1169,1452,0,0,80.51,488,652,"永寧里",NULL
0,841,20,861,1090,0,0,78.99,355,486,"玉衡里",NULL
0,1707,31,1738,2110,0,0,82.37,664,1043,"順昌里",NULL
0,2139,24,2163,2609,0,0,82.91,1023,1116,"文昌里",NULL
0,1939,26,1965,2416,0,0,81.33,914,1025,"光耀里",NULL
0,1513,20,1533,1810,0,0,84.7,711,802,"興昌里",NULL
0,2486,25,2511,3020,0,0,83.15,1121,1365,"開平里",NULL
0,958,9,967,1185,0,0,81.6,487,471,"成功里",NULL
0,884,15,899,1156,0,0,77.77,305,579,"新江里",NULL
0,720,26,746,946,0,0,78.86,294,426,"黎明里",NULL
0,735,10,745,905,0,0,82.32,290,445,"愛平里",NULL
0,1838,32,1870,2286,0,0,81.8,720,1118,"南港里",NULL
0,2021,33,2054,2693,0,0,76.27,1032,989,"中東里",NULL
0,670,10,680,853,0,0,79.72,261,409,"明莊里",NULL
0,919,24,943,1207,0,0,78.13,340,579,"大明里",NULL
0,729,10,739,993,0,0,74.42,260,469,"秋山里",NULL
0,705,10,715,917,0,0,77.97,291,414,"長驛里",NULL
0,745,9,754,932,0,0,80.9,270,475,"建興里",NULL
0,751,20,771,978,0,0,78.83,275,476,"建華里",NULL
0,720,14,734,873,0,0,84.08,249,471,"漢民里",NULL
0,639,7,646,802,0,0,80.55,293,346,"榮治里",NULL
0,1093,23,1116,1360,0,0,82.06,392,701,"東坡里",NULL
0,674,12,686,817,0,0,83.97,204,470,"三川里",NULL
0,916,15,931,1155,0,0,80.61,444,472,"草江里",NULL
0,1152,25,1177,1457,0,0,80.78,389,763,"長城里",NULL
0,730,12,742,911,0,0,81.45,270,460,"北金里",NULL
0,701,9,710,920,0,0,77.17,288,413,"東金里",NULL
0,2611,35,2646,3208,0,0,82.48,1231,1380,"新生里",NULL
0,762,12,774,976,0,0,79.3,341,421,"後金里",NULL
0,893,14,907,1172,0,0,77.39,421,472,"長興里",NULL
0,1130,15,1145,1425,0,0,80.35,535,595,"青山里",NULL
0,583,8,591,757,0,0,78.07,250,333,"民生里",NULL
0,819,12,831,1047,0,0,79.37,416,403,"復元里",NULL
0,932,13,945,1249,0,0,75.66,435,497,"林投里",NULL
0,860,13,873,1094,0,0,79.8,359,501,"國民里",NULL
0,1428,18,1446,1758,0,0,82.25,670,758,"社東里",NULL
0,948,18,966,1172,0,0,82.42,429,519,"社西里",NULL
0,737,14,751,964,0,0,77.9,319,418,"博孝里",NULL
0,1207,16,1223,1559,0,0,78.45,589,618,"長生里",NULL
0,1007,20,1027,1288,0,0,79.74,392,615,"榮復里",NULL
0,871,16,887,1101,0,0,80.56,386,485,"文西里",NULL
0,1101,18,1119,1384,0,0,80.85,465,636,"文東里",NULL
0,504,5,509,642,0,0,79.28,288,216,"博仁里",NULL
0,1097,25,1122,1387,0,0,80.89,523,574,"苓洲里",NULL
0,1125,24,1149,1440,0,0,79.79,540,585,"苓昇里",NULL
0,1372,25,1397,1670,0,0,83.65,553,819,"苓中里",NULL
0,1172,24,1196,1472,0,0,81.25,552,620,"苓雅里",NULL
0,1180,25,1205,1511,0,0,79.75,470,710,"苓東里",NULL
0,1192,20,1212,1538,0,0,78.8,500,692,"城北里",NULL
0,559,10,569,695,0,0,81.87,214,345,"城西里",NULL
0,1374,20,1394,1722,0,0,80.95,548,826,"城東里",NULL
0,2003,23,2026,2700,0,0,75.04,1046,957,"意誠里",NULL
0,955,15,970,1186,0,0,81.79,346,609,"鼓中里",NULL
0,1174,24,1198,1466,0,0,81.72,485,689,"田西里",NULL
0,1531,11,1542,1931,0,0,79.85,657,874,"人和里",NULL
0,1416,21,1437,1802,0,0,79.74,640,776,"仁政里",NULL
0,1623,29,1652,1968,0,0,83.94,617,1006,"廣澤里",NULL
0,1005,16,1021,1274,0,0,80.14,452,553,"美田里",NULL
0,2356,44,2400,3052,0,0,78.64,1047,1309,"華堂里",NULL
0,1834,28,1862,2306,0,0,80.75,832,1002,"日中里",NULL
0,2138,41,2179,2662,0,0,81.86,928,1210,"普照里",NULL
0,1757,16,1773,2172,0,0,81.63,753,1004,"和煦里",NULL
0,984,12,996,1633,0,0,60.99,447,537,"晴朗里",NULL
0,2309,24,2333,2872,0,0,81.23,1107,1202,"普天里",NULL
0,1448,14,1462,1806,0,0,80.95,724,724,"林富里",NULL
0,1697,33,1730,2113,0,0,81.87,892,805,"林圍里",NULL
0,1283,20,1303,1580,0,0,82.47,644,639,"林安里",NULL
0,643,14,657,784,0,0,83.8,243,400,"光華里",NULL
0,1223,15,1238,1474,0,0,83.99,428,795,"林興里",NULL
0,2464,44,2508,3019,0,0,83.07,1025,1439,"林華里",NULL
0,1450,21,1471,1824,0,0,80.65,665,785,"林西里",NULL
0,2629,43,2672,3273,0,0,81.64,1188,1441,"林中里",NULL
0,1488,10,1498,1851,0,0,80.93,830,658,"林泉里",NULL
0,2274,34,2308,2869,0,0,80.45,1248,1026,"林南里",NULL
0,2033,18,2051,2540,0,0,80.75,1024,1009,"中正里",NULL
0,1105,17,1122,1432,0,0,78.35,528,577,"尚義里",NULL
0,1298,19,1317,1578,0,0,83.46,700,598,"同慶里",NULL
0,1603,41,1644,1943,0,0,84.61,937,666,"凱旋里",NULL
0,1871,34,1905,2372,0,0,80.31,958,913,"安祥里",NULL
0,1345,25,1370,1653,0,0,82.88,675,670,"奏捷里",NULL
0,1263,24,1287,1553,0,0,82.87,417,846,"福壽里",NULL
0,1935,43,1978,2376,0,0,83.25,610,1325,"福南里",NULL
0,1555,21,1576,1967,0,0,80.12,712,843,"五權里",NULL
0,3112,61,3173,3861,0,0,82.18,1462,1650,"民主里",NULL
0,1383,28,1411,1731,0,0,81.51,674,709,"林德里",NULL
0,1084,23,1107,1335,0,0,82.92,493,591,"林貴里",NULL
0,3208,41,3249,3969,0,0,81.86,1606,1602,"林榮里",NULL
0,1685,35,1720,2068,0,0,83.17,639,1046,"英明里",NULL
0,1345,20,1365,1659,0,0,82.28,838,507,"林靖里",NULL
0,1257,22,1279,1512,0,0,84.59,532,725,"朝陽里",NULL
0,2236,39,2275,2766,0,0,82.25,982,1254,"福隆里",NULL
0,1065,20,1085,1314,0,0,82.57,453,612,"福祥里",NULL
0,852,9,861,1046,0,0,82.31,434,418,"福海里",NULL
0,1640,31,1671,1976,0,0,84.56,578,1062,"福康里",NULL
0,1761,43,1804,2219,0,0,81.3,739,1022,"福人里",NULL
0,2362,41,2403,2934,0,0,81.9,1056,1306,"福地里",NULL
0,2329,45,2374,2872,0,0,82.66,918,1411,"福居里",NULL
0,2086,27,2113,2585,0,0,81.74,964,1122,"福東里",NULL
0,1736,39,1775,2146,0,0,82.71,713,1023,"福西里",NULL
0,1917,45,1962,2338,0,0,83.92,950,967,"永康里",NULL
0,1412,26,1438,1782,0,0,80.7,594,818,"正文里",NULL
0,2203,35,2238,2769,0,0,80.82,973,1230,"正言里",NULL
0,3584,59,3643,4590,0,0,79.37,1787,1797,"正大里",NULL
0,3141,44,3185,3928,0,0,81.08,1487,1654,"五福里",NULL
0,2885,55,2940,3629,0,0,81.01,1383,1502,"正心里",NULL
0,3359,43,3402,4148,0,0,82.02,1573,1786,"正道里",NULL
0,1970,22,1992,2391,0,0,83.31,841,1129,"正義里",NULL
0,2015,34,2049,2431,0,0,84.29,1014,1001,"正仁里",NULL
0,3179,49,3228,3920,0,0,82.35,1309,1870,"文昌里",NULL
0,1676,36,1712,2082,0,0,82.23,643,1033,"建軍里",NULL
0,1737,29,1766,2166,0,0,81.53,837,900,"衛武里",NULL
0,6699,132,6831,8600,0,0,79.43,2394,4305,"草衙里",NULL
0,1957,52,2009,2492,0,0,80.62,608,1349,"明孝里",NULL
0,2614,53,2667,3270,0,0,81.56,901,1713,"明正里",NULL
0,1511,23,1534,1815,0,0,84.52,589,922,"明義里",NULL
0,1160,30,1190,1503,0,0,79.17,328,832,"仁愛里",NULL
0,1590,33,1623,2038,0,0,79.64,716,874,"德昌里",NULL
0,1425,37,1462,2172,0,0,67.31,439,986,"平等里",NULL
0,601,8,609,734,0,0,82.97,150,451,"平昌里",NULL
0,1455,15,1470,1782,0,0,82.49,392,1063,"明禮里",NULL
0,1250,28,1278,1589,0,0,80.43,319,931,"信義里",NULL
0,1956,48,2004,2527,0,0,79.3,675,1281,"信德里",NULL
0,1023,25,1048,1288,0,0,81.37,254,769,"明道里",NULL
0,625,23,648,794,0,0,81.61,133,492,"興化里",NULL
0,751,9,760,932,0,0,81.55,162,589,"興仁里",NULL
0,1230,30,1260,1540,0,0,81.82,386,844,"前鎮里",NULL
0,1603,43,1646,1969,0,0,83.6,465,1138,"鎮東里",NULL
0,1889,50,1939,2341,0,0,82.83,626,1263,"鎮榮里",NULL
0,1694,28,1722,2082,0,0,82.71,556,1138,"鎮昌里",NULL
0,3180,71,3251,3922,0,0,82.89,1211,1969,"鎮海里",NULL
0,930,27,957,1149,0,0,83.29,318,612,"鎮陽里",NULL
0,1666,41,1707,2078,0,0,82.15,800,866,"興邦里",NULL
0,668,17,685,855,0,0,80.12,219,449,"鎮中里",NULL
0,846,19,865,1038,0,0,83.33,262,584,"鎮北里",NULL
0,3168,61,3229,3860,0,0,83.65,2581,587,"忠純里",NULL
0,1792,44,1836,2115,0,0,86.81,1613,179,"忠誠里",NULL
0,2675,42,2717,3326,0,0,81.69,1306,1369,"西山里",NULL
0,3189,38,3227,3863,0,0,83.54,1709,1480,"民權里",NULL
0,702,18,720,903,0,0,79.73,328,374,"建隆里",NULL
0,1525,27,1552,1920,0,0,80.83,643,882,"振興里",NULL
0,2069,26,2095,2589,0,0,80.92,1114,955,"良和里",NULL
0,1613,37,1650,1986,0,0,83.08,615,998,"西甲里",NULL
0,1976,32,2008,2543,0,0,78.96,1010,966,"盛興里",NULL
0,2260,37,2297,2879,0,0,79.78,1024,1236,"盛豐里",NULL
0,2437,52,2489,3140,0,0,79.27,1132,1305,"興中里",NULL
0,3723,43,3766,4554,0,0,82.7,1725,1998,"興東里",NULL
0,1940,43,1983,2356,0,0,84.17,989,951,"忠孝里",NULL
0,2339,28,2367,2851,0,0,83.02,934,1405,"復國里",NULL
0,2125,54,2179,2634,0,0,82.73,759,1366,"竹內里",NULL
0,1673,28,1701,2110,0,0,80.62,774,899,"竹東里",NULL
0,2155,46,2201,2663,0,0,82.65,844,1311,"竹南里",NULL
0,1618,24,1642,2026,0,0,81.05,756,862,"竹北里",NULL
0,3143,38,3181,3760,0,0,84.6,1411,1732,"竹西里",NULL
0,2263,33,2296,2749,0,0,83.52,1035,1228,"竹中里",NULL
0,1022,37,1059,1286,0,0,82.35,312,710,"瑞竹里",NULL
0,3738,80,3818,4585,0,0,83.27,1419,2319,"瑞南里",NULL
0,1912,54,1966,2364,0,0,83.16,735,1177,"瑞豐里",NULL
0,3950,62,4012,4752,0,0,84.43,1723,2227,"瑞祥里",NULL
0,2016,36,2052,2455,0,0,83.58,737,1279,"瑞東里",NULL
0,1620,32,1652,2007,0,0,82.31,510,1110,"瑞和里",NULL
0,2995,49,3044,3626,0,0,83.95,1125,1870,"瑞平里",NULL
0,2867,51,2918,3557,0,0,82.04,1091,1776,"瑞隆里",NULL
0,2367,42,2409,2923,0,0,82.42,859,1508,"瑞北里",NULL
0,2189,49,2238,2637,0,0,84.87,1038,1151,"瑞西里",NULL
0,2113,34,2147,2523,0,0,85.1,740,1373,"瑞崗里",NULL
0,2134,27,2161,2639,0,0,81.89,740,1394,"瑞興里",NULL
0,1970,25,1995,2445,0,0,81.6,771,1199,"瑞誠里",NULL
0,1994,31,2025,2412,0,0,83.96,665,1329,"瑞文里",NULL
0,3587,31,3618,4303,0,0,84.08,1487,2100,"瑞華里",NULL
0,2231,58,2289,2791,0,0,82.01,740,1491,"瑞昌里",NULL
0,1376,30,1406,1751,0,0,80.3,511,865,"小港里",NULL
0,2678,28,2706,3276,0,0,82.6,1355,1323,"港口里",NULL
0,2030,35,2065,2507,0,0,82.37,1087,943,"港正里",NULL
0,1319,19,1338,1581,0,0,84.63,546,773,"港墘里",NULL
0,2416,46,2462,3001,0,0,82.04,974,1442,"港明里",NULL
0,1579,24,1603,1984,0,0,80.8,639,940,"港后里",NULL
0,1115,15,1130,1579,0,0,71.56,399,716,"港南里",NULL
0,1677,37,1714,2042,0,0,83.94,585,1092,"港興里",NULL
0,1513,17,1530,1888,0,0,81.04,584,929,"鳳宮里",NULL
0,3563,54,3617,4495,0,0,80.47,1417,2146,"店鎮里",NULL
0,1813,39,1852,2218,0,0,83.5,728,1085,"大苓里",NULL
0,2466,56,2522,3059,0,0,82.45,937,1529,"二苓里",NULL
0,1974,24,1998,2454,0,0,81.42,828,1146,"三苓里",NULL
0,2602,47,2649,3351,0,0,79.05,1171,1431,"正苓里",NULL
0,2881,30,2911,3561,0,0,81.75,1284,1597,"順苓里",NULL
0,1274,18,1292,1528,0,0,84.55,553,721,"六苓里",NULL
0,2005,28,2033,2523,0,0,80.58,875,1130,"宏亮里",NULL
0,1936,22,1958,2427,0,0,80.68,1076,860,"山東里",NULL
0,1396,33,1429,1750,0,0,81.66,968,428,"青島里",NULL
0,2464,56,2520,3089,0,0,81.58,1399,1065,"濟南里",NULL
0,1732,26,1758,2127,0,0,82.65,725,1007,"泰山里",NULL
0,4446,74,4520,5538,0,0,81.62,1720,2726,"山明里",NULL
0,2454,63,2517,3121,0,0,80.65,928,1526,"高松里",NULL
0,1675,12,1687,2078,0,0,81.18,691,984,"松金里",NULL
0,1508,42,1550,1919,0,0,80.77,569,939,"松山里",NULL
0,1018,32,1050,1255,0,0,83.67,286,732,"大坪里",NULL
0,1027,30,1057,1297,0,0,81.5,255,772,"坪頂里",NULL
0,2492,55,2547,3174,0,0,80.25,1038,1454,"孔宅里",NULL
0,1491,31,1522,1846,0,0,82.45,528,963,"廈莊里",NULL
0,1784,30,1814,2214,0,0,81.93,621,1163,"合作里",NULL
0,4899,100,4999,6067,0,0,82.4,1862,3037,"桂林里",NULL
0,2262,31,2293,2835,0,0,80.88,812,1450,"中厝里",NULL
0,1839,46,1885,2249,0,0,83.82,735,1104,"鳳鳴里",NULL
0,1700,45,1745,2088,0,0,83.57,608,1092,"龍鳳里",NULL
0,1246,31,1277,1492,0,0,85.59,415,831,"鳳森里",NULL
0,1606,34,1640,2043,0,0,80.27,466,1140,"鳳林里",NULL
0,1277,26,1303,1584,0,0,82.26,346,931,"鳳興里",NULL
0,1833,33,1866,2318,0,0,80.5,545,1288,"鳳源里",NULL
0,3348,77,3425,4477,0,0,76.5,1097,2251,"海澄里",NULL
0,1669,46,1715,2289,0,0,74.92,537,1132,"海昌里",NULL
0,1777,50,1827,2363,0,0,77.32,511,1266,"海豐里",NULL
0,1986,48,2034,2742,0,0,74.18,666,1320,"海原里",NULL
0,1993,48,2041,2796,0,0,73,635,1358,"海城里",NULL
0,944,18,962,1180,0,0,81.53,514,430,"留侯里",NULL
0,947,24,971,1231,0,0,78.88,486,461,"流芳里",NULL
0,528,12,540,662,0,0,81.57,290,238,"赤松里",NULL
0,815,20,835,1017,0,0,82.1,399,416,"黃石里",NULL
0,1144,21,1165,1442,0,0,80.79,715,429,"挹秀里",NULL
0,2999,99,3098,3780,0,0,81.96,1497,1502,"湳興里",NULL
0,1999,49,2048,2537,0,0,80.73,997,1002,"新興里",NULL
0,3874,102,3976,5349,0,0,74.33,1927,1947,"社後里",NULL
0,2868,66,2934,3562,0,0,82.37,1321,1547,"香社里",NULL
0,1769,45,1814,2189,0,0,82.87,873,896,"香雅里",NULL
0,2840,64,2904,3558,0,0,81.62,1389,1451,"中正里",NULL
0,3685,76,3761,4486,0,0,83.84,2317,1368,"自強里",NULL
0,1950,62,2012,2396,0,0,83.97,937,1013,"自立里",NULL
0,1852,41,1893,2268,0,0,83.47,1018,834,"光華里",NULL
0,1698,42,1740,2154,0,0,80.78,947,751,"光榮里",NULL
0,2798,50,2848,3329,0,0,85.55,2168,630,"國光里",NULL
0,1749,36,1785,2079,0,0,85.86,893,856,"港尾里",NULL
0,3026,56,3082,3703,0,0,83.23,1483,1543,"新生里",NULL
0,2682,80,2762,3379,0,0,81.74,1277,1405,"金華里",NULL
0,3300,105,3405,4184,0,0,81.38,1488,1812,"港德里",NULL
0,2023,49,2072,2482,0,0,83.48,1116,907,"民權里",NULL
0,1450,34,1484,1772,0,0,83.75,809,641,"民安里",NULL
0,2567,58,2625,3177,0,0,82.63,1193,1374,"建國里",NULL
0,3048,51,3099,3725,0,0,83.19,1608,1440,"漢生里",NULL
0,2825,77,2902,3584,0,0,80.97,1445,1380,"新民里",NULL
0,2554,70,2624,3178,0,0,82.57,1201,1353,"公館里",NULL
0,2747,57,2804,3389,0,0,82.74,1287,1460,"幸福里",NULL
0,2017,49,2066,2520,0,0,81.98,1022,995,"文德里",NULL
0,1929,27,1956,2332,0,0,83.88,1336,593,"忠誠里",NULL
0,2000,44,2044,2462,0,0,83.02,962,1038,"陽明里",NULL
0,1679,35,1714,2080,0,0,82.4,806,873,"百壽里",NULL
0,2034,51,2085,2549,0,0,81.8,1005,1029,"介壽里",NULL
0,1614,45,1659,2013,0,0,82.41,777,837,"新埔里",NULL
0,3372,69,3441,4126,0,0,83.4,1661,1711,"華江里",NULL
0,3177,80,3257,3996,0,0,81.51,1391,1786,"江翠里",NULL
0,3435,69,3504,4211,0,0,83.21,1572,1863,"純翠里",NULL
0,3899,95,3994,4880,0,0,81.84,1709,2190,"溪頭里",NULL
0,2637,32,2669,3239,0,0,82.4,1351,1286,"聯翠里",NULL
0,2136,55,2191,2647,0,0,82.77,958,1178,"文化里",NULL
0,2103,60,2163,2642,0,0,81.87,952,1151,"宏翠里",NULL
0,2121,74,2195,2731,0,0,80.37,783,1338,"仁翠里",NULL
0,4956,87,5043,6130,0,0,82.27,2384,2572,"新翠里",NULL
0,2379,47,2426,2903,0,0,83.57,1017,1362,"朝陽里",NULL
0,2487,60,2547,3030,0,0,84.06,1091,1396,"吉翠里",NULL
0,3924,80,4004,4759,0,0,84.14,1983,1941,"德翠里",NULL
0,2308,39,2347,2888,0,0,81.27,1046,1262,"新海里",NULL
0,2216,46,2262,2755,0,0,82.11,891,1325,"滿翠里",NULL
0,3312,60,3372,4087,0,0,82.51,1461,1851,"明翠里",NULL
0,2355,55,2410,3028,0,0,79.59,1096,1259,"松翠里",NULL
0,2356,66,2422,2933,0,0,82.58,1081,1275,"柏翠里",NULL
0,2956,75,3031,3644,0,0,83.18,1220,1736,"龍翠里",NULL
0,1420,32,1452,1822,0,0,79.69,652,768,"松柏里",NULL
0,2205,54,2259,2692,0,0,83.92,968,1237,"華翠里",NULL
0,2053,54,2107,2536,0,0,83.08,925,1128,"莒光里",NULL
0,5643,110,5753,6825,0,0,84.29,2927,2716,"忠翠里",NULL
0,1757,49,1806,2199,0,0,82.13,761,996,"嵐翠里",NULL
0,2410,59,2469,2947,0,0,83.78,1092,1318,"文聖里",NULL
0,2882,60,2942,3538,0,0,83.15,1362,1520,"文翠里",NULL
0,1991,45,2036,2529,0,0,80.51,845,1146,"青翠里",NULL
0,3699,76,3775,4735,0,0,79.73,1628,2071,"懷翠里",NULL
0,1166,42,1208,1490,0,0,81.07,608,558,"福翠里",NULL
0,3572,70,3642,4466,0,0,81.55,1702,1870,"港嘴里",NULL
0,2854,62,2916,3459,0,0,84.3,1280,1574,"振興里",NULL
0,2766,87,2853,3475,0,0,82.1,1199,1567,"振義里",NULL
0,2052,48,2100,2527,0,0,83.1,913,1139,"光復里",NULL
0,3292,89,3381,4143,0,0,81.61,1560,1732,"埔墘里",NULL
0,1523,42,1565,1891,0,0,82.76,786,737,"富貴里",NULL
0,1952,55,2007,2400,0,0,83.63,959,993,"長壽里",NULL
0,2100,65,2165,2606,0,0,83.08,1063,1037,"福壽里",NULL
0,2023,41,2064,2479,0,0,83.26,966,1057,"居仁里",NULL
0,4428,79,4507,5390,0,0,83.62,2144,2284,"海山里",NULL
0,1914,37,1951,2350,0,0,83.02,811,1103,"九如里",NULL
0,2003,51,2054,2429,0,0,84.56,944,1059,"正泰里",NULL
0,3225,83,3308,4080,0,0,81.08,1527,1698,"玉光里",NULL
0,1947,62,2009,2391,0,0,84.02,891,1056,"光仁里",NULL
0,2422,60,2482,3004,0,0,82.62,1149,1273,"埤墘里",NULL
0,2337,48,2385,2796,0,0,85.3,1132,1205,"莊敬里",NULL
0,2185,39,2224,2689,0,0,82.71,994,1191,"永安里",NULL
0,2387,74,2461,2955,0,0,83.28,1077,1310,"雙玉里",NULL
0,2300,55,2355,2939,0,0,80.13,1098,1202,"廣新里",NULL
0,3474,65,3539,4303,0,0,82.24,1961,1513,"深丘里",NULL
0,2416,72,2488,3002,0,0,82.88,1191,1225,"香丘里",NULL
0,1755,50,1805,2192,0,0,82.34,836,919,"西安里",NULL
0,2788,76,2864,3413,0,0,83.91,1204,1584,"東丘里",NULL
0,1236,37,1273,1584,0,0,80.37,566,670,"民生里",NULL
0,2436,54,2490,2963,0,0,84.04,1182,1254,"長安里",NULL
0,1737,30,1767,2638,0,0,66.98,790,947,"東安里",NULL
0,1328,33,1361,1664,0,0,81.79,744,584,"福丘里",NULL
0,2321,50,2371,2954,0,0,80.26,1364,957,"福祿里",NULL
0,2495,47,2542,3040,0,0,83.62,1217,1278,"民族里",NULL
0,2045,40,2085,2573,0,0,81.03,1114,931,"國泰里",NULL
0,2320,51,2371,2877,0,0,82.41,1272,1048,"後埔里",NULL
0,3394,78,3472,4140,0,0,83.86,1707,1687,"福德里",NULL
0,2133,51,2184,2686,0,0,81.31,1075,1058,"景星里",NULL
0,2263,48,2311,2749,0,0,84.07,1103,1160,"福星里",NULL
0,2346,57,2403,2881,0,0,83.41,1214,1132,"鄉雲里",NULL
0,3872,91,3963,4774,0,0,83.01,2049,1823,"廣德里",NULL
0,3046,64,3110,3829,0,0,81.22,1577,1469,"大豐里",NULL
0,5134,123,5257,6432,0,0,81.73,2798,2336,"重慶里",NULL
0,2241,51,2292,2754,0,0,83.22,1500,741,"仁愛里",NULL
0,711,18,729,918,0,0,79.41,386,325,"和平里",NULL
0,2144,63,2207,2735,0,0,80.69,1033,1111,"廣福里",NULL
0,2954,53,3007,3632,0,0,82.79,1516,1438,"五權里",NULL
0,2600,56,2656,3254,0,0,81.62,1365,1235,"華興里",NULL
0,1900,69,1969,2373,0,0,82.98,960,940,"華貴里",NULL
0,1441,23,1464,1760,0,0,83.18,764,677,"華福里",NULL
0,4166,86,4252,5254,0,0,80.93,2280,1886,"華德里",NULL
0,3630,68,3698,4460,0,0,82.91,2111,1519,"華東里",NULL
0,2664,66,2730,3360,0,0,81.25,1335,1329,"信義里",NULL
0,2512,64,2576,3595,0,0,71.66,1167,1345,"浮洲里",NULL
0,3388,77,3465,4296,0,0,80.66,1511,1877,"華中里",NULL
0,2413,72,2485,3032,0,0,81.96,1165,1248,"僑中里",NULL
0,2231,55,2286,2767,0,0,82.62,1019,1212,"大觀里",NULL
0,811,20,831,986,0,0,84.28,367,444,"歡園里",NULL
0,3055,90,3145,3970,0,0,79.22,1863,1192,"中山里",NULL
0,1209,126,1335,1856,0,0,71.93,905,304,"復興里",NULL
0,2720,62,2782,3459,0,0,80.43,1350,1370,"大安里",NULL
0,1801,48,1849,2244,0,0,82.4,1017,784,"福安里",NULL
0,3190,96,3286,4086,0,0,80.42,1481,1709,"聚安里",NULL
0,1909,75,1984,2427,0,0,81.75,859,1050,"龍安里",NULL
0,4721,120,4841,6034,0,0,80.23,2311,2410,"崑崙里",NULL
0,2876,61,2937,3698,0,0,79.42,1367,1509,"成和里",NULL
0,3443,89,3532,4405,0,0,80.18,1689,1754,"溪洲里",NULL
0,6571,121,6692,8356,0,0,80.09,3350,3221,"溪福里",NULL
0,2093,45,2138,2649,0,0,80.71,1019,1074,"溪北里",NULL
0,2402,44,2446,2993,0,0,81.72,1160,1242,"堂春里",NULL
0,2865,73,2938,3544,0,0,82.9,1260,1605,"大有里",NULL
0,2977,74,3051,3678,0,0,82.95,1461,1516,"博愛里",NULL
0,1350,44,1394,1746,0,0,79.84,533,817,"二重里",NULL
0,1431,32,1463,1767,0,0,82.8,550,881,"頂崁里",NULL
0,925,20,945,1117,0,0,84.6,372,553,"谷王里",NULL
0,1496,49,1545,1863,0,0,82.93,648,848,"五谷里",NULL
0,2483,64,2547,3076,0,0,82.8,1077,1406,"中興里",NULL
0,318,10,328,391,0,0,83.89,107,211,"德厚里",NULL
0,3392,73,3465,4179,0,0,82.91,1638,1754,"成功里",NULL
0,2510,54,2564,3152,0,0,81.35,1192,1318,"福祉里",NULL
0,2524,55,2579,3175,0,0,81.23,1114,1410,"福德里",NULL
0,2116,53,2169,2630,0,0,82.47,980,1136,"福民里",NULL
0,3532,91,3623,4833,0,0,74.96,1848,1684,"過田里",NULL
0,1406,33,1439,1752,0,0,82.13,621,785,"錦田里",NULL
0,1973,61,2034,2390,0,0,85.1,855,1118,"重明里",NULL
0,2899,60,2959,3550,0,0,83.35,1406,1493,"光田里",NULL
0,4057,90,4147,4972,0,0,83.41,1820,2237,"光陽里",NULL
0,2812,52,2864,3421,0,0,83.72,1260,1552,"田心里",NULL
0,2312,42,2354,2799,0,0,84.1,955,1357,"福田里",NULL
0,3788,80,3868,4604,0,0,84.01,1480,2308,"田中里",NULL
0,3924,123,4047,4923,0,0,82.21,1816,2108,"田安里",NULL
0,2070,42,2112,2555,0,0,82.66,916,1154,"三民里",NULL
0,3963,103,4066,5035,0,0,80.75,1903,2060,"光明里",NULL
0,1202,32,1234,1559,0,0,79.15,681,521,"光正里",NULL
0,1139,47,1186,1537,0,0,77.16,660,479,"同安里",NULL
0,1159,35,1194,1483,0,0,80.51,581,578,"同慶里",NULL
0,1399,32,1431,1732,0,0,82.62,666,733,"菜寮里",NULL
0,1178,31,1209,1481,0,0,81.63,601,577,"永春里",NULL
0,926,31,957,1183,0,0,80.9,423,503,"中正里",NULL
0,991,35,1026,1271,0,0,80.72,494,497,"吉利里",NULL
0,1231,16,1247,1568,0,0,79.53,575,656,"大同里",NULL
0,917,36,953,1163,0,0,81.94,473,444,"中民里",NULL
0,1106,48,1154,1463,0,0,78.88,514,592,"平和里",NULL
0,1120,43,1163,1426,0,0,81.56,563,557,"大安里",NULL
0,1494,53,1547,1899,0,0,81.46,652,842,"仁德里",NULL
0,1256,31,1287,1625,0,0,79.2,524,732,"忠孝里",NULL
0,896,25,921,1099,0,0,83.8,453,443,"仁義里",NULL
0,864,35,899,1112,0,0,80.85,384,480,"光榮里",NULL
0,1265,29,1294,1545,0,0,83.75,683,582,"光輝里",NULL
0,629,24,653,792,0,0,82.45,302,327,"福星里",NULL
0,1246,20,1266,1580,0,0,80.13,619,627,"福利里",NULL
0,2521,50,2571,3126,0,0,82.25,1243,1278,"清和里",NULL
0,944,23,967,1193,0,0,81.06,467,477,"永興里",NULL
0,1731,40,1771,2116,0,0,83.7,798,933,"中山里",NULL
0,1699,33,1732,2152,0,0,80.48,716,983,"大園里",NULL
0,1791,48,1839,2179,0,0,84.4,855,936,"國隆里",NULL
0,2326,53,2379,2920,0,0,81.47,1068,1258,"重陽里",NULL
0,3036,74,3110,3729,0,0,83.4,1284,1752,"民生里",NULL
0,1060,32,1092,1323,0,0,82.54,454,606,"重新里",NULL
0,812,26,838,1017,0,0,82.4,338,474,"正德里",NULL
0,1218,30,1248,1521,0,0,82.05,565,653,"正義里",NULL
0,1318,50,1368,1660,0,0,82.41,595,723,"正安里",NULL
0,1302,44,1346,1624,0,0,82.88,548,754,"自強里",NULL
0,1738,39,1777,2126,0,0,83.58,738,1000,"文化里",NULL
0,1250,38,1288,1540,0,0,83.64,541,709,"中央里",NULL
0,637,27,664,833,0,0,79.71,299,338,"雙園里",NULL
0,1133,43,1176,1475,0,0,79.73,542,591,"錦通里",NULL
0,1408,26,1434,1754,0,0,81.76,650,758,"錦安里",NULL
0,1514,56,1570,1958,0,0,80.18,751,763,"長安里",NULL
0,1312,17,1329,1656,0,0,80.25,612,700,"光華里",NULL
0,637,8,645,773,0,0,83.44,228,409,"長生里",NULL
0,1065,13,1078,1311,0,0,82.23,449,616,"開元里",NULL
0,531,17,548,649,0,0,84.44,242,289,"大德里",NULL
0,1721,51,1772,2155,0,0,82.23,769,952,"長元里",NULL
0,1338,43,1381,1720,0,0,80.29,578,760,"長江里",NULL
0,1602,51,1653,2068,0,0,79.93,712,890,"長泰里",NULL
0,1120,31,1151,1434,0,0,80.26,516,604,"長福里",NULL
0,841,30,871,1084,0,0,80.35,372,469,"介壽里",NULL
0,1377,44,1421,1724,0,0,82.42,648,729,"萬壽里",NULL
0,1639,40,1679,2088,0,0,80.41,718,921,"錦江里",NULL
0,2144,52,2196,2630,0,0,83.5,903,1241,"龍濱里",NULL
0,1316,31,1347,1659,0,0,81.19,574,742,"龍門里",NULL
0,940,26,966,1159,0,0,83.35,410,530,"秀江里",NULL
0,1053,36,1089,1334,0,0,81.63,415,638,"奕壽里",NULL
0,1836,46,1882,2296,0,0,81.97,818,1018,"三安里",NULL
0,2011,77,2088,2545,0,0,82.04,837,1174,"福安里",NULL
0,1305,27,1332,1607,0,0,82.89,580,725,"信安里",NULL
0,1452,47,1499,1860,0,0,80.59,580,872,"安慶里",NULL
0,3038,73,3111,3810,0,0,81.65,1348,1690,"幸福里",NULL
0,2586,63,2649,3190,0,0,83.04,1107,1479,"六合里",NULL
0,3517,63,3580,4271,0,0,83.82,1409,2108,"六福里",NULL
0,1495,48,1543,1876,0,0,82.25,693,802,"順德里",NULL
0,1313,50,1363,1664,0,0,81.91,627,686,"承德里",NULL
0,1741,44,1785,2141,0,0,83.37,709,1032,"瑞德里",NULL
0,2781,65,2846,3441,0,0,82.71,1179,1602,"崇德里",NULL
0,2329,57,2386,2811,0,0,84.88,974,1355,"厚德里",NULL
0,2001,54,2055,2463,0,0,83.43,817,1184,"維德里",NULL
0,2182,52,2234,2729,0,0,81.86,1062,1120,"尚德里",NULL
0,2310,56,2366,2820,0,0,83.9,991,1319,"培德里",NULL
0,2238,49,2287,2750,0,0,83.16,967,1271,"立德里",NULL
0,3288,86,3374,4110,0,0,82.09,1430,1858,"永德里",NULL
0,1759,50,1809,2189,0,0,82.64,643,1116,"永輝里",NULL
0,3021,46,3067,3643,0,0,84.19,1123,1898,"永發里",NULL
0,2242,58,2300,2858,0,0,80.48,918,1324,"永盛里",NULL
0,1924,37,1961,2399,0,0,81.74,828,1096,"永吉里",NULL
0,2210,50,2260,2764,0,0,81.77,992,1218,"永安里",NULL
0,3168,55,3223,3965,0,0,81.29,1285,1883,"永豐里",NULL
0,3254,82,3336,4101,0,0,81.35,1378,1876,"永福里",NULL
0,3621,96,3717,4478,0,0,83.01,1543,2078,"永清里",NULL
0,3003,83,3086,3793,0,0,81.36,1219,1784,"永順里",NULL
0,4420,114,4534,5654,0,0,80.19,1925,2495,"溪美里",NULL
0,2461,51,2512,3112,0,0,80.72,1059,1402,"福隆里",NULL
0,2695,84,2779,3346,0,0,83.05,1177,1518,"五常里",NULL
0,1781,60,1841,2272,0,0,81.03,775,1006,"五福里",NULL
0,2111,62,2173,2691,0,0,80.75,952,1159,"仁忠里",NULL
0,1591,36,1627,1992,0,0,81.68,668,923,"慈福里",NULL
0,1626,26,1652,2043,0,0,80.86,729,897,"慈生里",NULL
0,1593,47,1640,2001,0,0,81.96,601,992,"慈惠里",NULL
0,2545,77,2622,3174,0,0,82.61,1052,1493,"慈愛里",NULL
0,1645,57,1702,2084,0,0,81.67,706,939,"慈化里",NULL
0,2889,90,2979,3672,0,0,81.13,1223,1666,"慈祐里",NULL
0,1720,57,1777,2213,0,0,80.3,769,951,"富華里",NULL
0,2108,47,2155,2648,0,0,81.38,880,1228,"富貴里",NULL
0,1390,43,1433,1786,0,0,80.24,578,812,"富福里",NULL
0,2361,65,2426,2862,0,0,84.77,914,1447,"五華里",NULL
0,1714,47,1761,2165,0,0,81.34,795,919,"碧華里",NULL
0,2433,52,2485,2989,0,0,83.14,1008,1425,"福樂里",NULL
0,2493,75,2568,3157,0,0,81.34,1053,1440,"仁華里",NULL
0,2443,75,2518,3117,0,0,80.78,1068,1375,"五順里",NULL
0,3109,77,3186,3917,0,0,81.34,1566,1543,"中原里",NULL
0,827,18,845,1045,0,0,80.86,554,273,"連和里",NULL
0,4110,77,4187,5016,0,0,83.47,2568,1542,"連城里",NULL
0,3575,76,3651,4344,0,0,84.05,2186,1389,"力行里",NULL
0,1758,34,1792,2233,0,0,80.25,1114,644,"正行里",NULL
0,3034,44,3078,3737,0,0,82.37,1896,1138,"德行里",NULL
0,2372,55,2427,2986,0,0,81.28,1327,1045,"枋寮里",NULL
0,2280,49,2329,2768,0,0,84.14,1304,976,"漳和里",NULL
0,3010,84,3094,3826,0,0,80.87,1696,1314,"廟美里",NULL
0,2759,87,2846,3449,0,0,82.52,1467,1292,"福真里",NULL
0,2870,53,2923,3548,0,0,82.38,1740,1130,"福善里",NULL
0,3201,78,3279,3951,0,0,82.99,1871,1330,"福美里",NULL
0,3140,88,3228,3918,0,0,82.39,1738,1402,"福祥里",NULL
0,3393,103,3496,4210,0,0,83.04,1949,1444,"瓦窯里",NULL
0,2586,75,2661,3245,0,0,82,1431,1155,"福和里",NULL
0,3333,69,3402,4100,0,0,82.98,1970,1363,"佳和里",NULL
0,5236,108,5344,6409,0,0,83.38,3358,1878,"新南里",NULL
0,3362,60,3422,4093,0,0,83.61,2054,1308,"南山里",NULL
0,5405,129,5534,6721,0,0,82.34,3100,2305,"平河里",NULL
0,2879,100,2979,3635,0,0,81.95,1559,1320,"信和里",NULL
0,2832,91,2923,3557,0,0,82.18,1624,1208,"仁和里",NULL
0,2685,93,2778,3415,0,0,81.35,1515,1170,"中正里",NULL
0,1715,50,1765,2111,0,0,83.61,946,769,"中山里",NULL
0,2672,77,2749,3295,0,0,83.43,1830,842,"建和里",NULL
0,2196,51,2247,2690,0,0,83.53,1138,1058,"碧河里",NULL
0,1253,35,1288,1596,0,0,80.7,848,405,"宜安里",NULL
0,2523,49,2572,3051,0,0,84.3,1730,793,"安樂里",NULL
0,2038,40,2078,2510,0,0,82.79,1324,714,"安和里",NULL
0,2860,65,2925,3528,0,0,82.91,1898,962,"安順里",NULL
0,3246,80,3326,3997,0,0,83.21,2263,983,"安平里",NULL
0,2915,48,2963,3498,0,0,84.71,2028,887,"中安里",NULL
0,2673,66,2739,3313,0,0,82.67,1651,1022,"泰安里",NULL
0,3012,83,3095,3717,0,0,83.27,1901,1111,"秀山里",NULL
0,2414,45,2459,2958,0,0,83.13,1526,888,"秀成里",NULL
0,1881,49,1930,2319,0,0,83.23,1156,725,"秀義里",NULL
0,3373,64,3437,4104,0,0,83.75,2166,1207,"秀福里",NULL
0,4340,73,4413,5333,0,0,82.75,2968,1372,"秀景里",NULL
0,3293,71,3364,4109,0,0,81.87,2446,847,"秀明里",NULL
0,2800,64,2864,3421,0,0,83.72,2031,769,"秀峰里",NULL
0,1737,76,1813,2232,0,0,81.23,1246,491,"秀士里",NULL
0,2743,89,2832,3450,0,0,82.09,1946,797,"秀水里",NULL
0,1883,63,1946,2367,0,0,82.21,1203,680,"秀仁里",NULL
0,2520,82,2602,3222,0,0,80.76,1759,761,"正南里",NULL
0,2122,53,2175,2598,0,0,83.72,1492,630,"頂南里",NULL
0,4403,109,4512,5619,0,0,80.3,3090,1313,"華新里",NULL
0,3214,71,3285,3923,0,0,83.74,2665,549,"東南里",NULL
0,2753,81,2834,3399,0,0,83.38,1958,795,"華南里",NULL
0,3482,114,3596,4422,0,0,81.32,2500,982,"忠孝里",NULL
0,2567,47,2614,3116,0,0,83.89,1816,751,"崇南里",NULL
0,2305,69,2374,2914,0,0,81.47,1563,742,"興南里",NULL
0,2237,54,2291,2763,0,0,82.92,1512,725,"景南里",NULL
0,1549,56,1605,1951,0,0,82.27,935,614,"景本里",NULL
0,247,15,262,322,0,0,81.37,122,125,"橫路里",NULL
0,3367,89,3456,4234,0,0,81.62,2241,1126,"內南里",NULL
0,1779,29,1808,2216,0,0,81.59,1105,674,"壽南里",NULL
0,2510,90,2600,3203,0,0,81.17,1795,715,"福南里",NULL
0,2771,55,2826,3907,0,0,72.33,1760,1011,"外南里",NULL
0,3119,68,3187,3876,0,0,82.22,1955,1164,"中興里",NULL
0,1671,36,1707,2038,0,0,83.76,1071,600,"吉興里",NULL
0,3701,92,3793,4625,0,0,82.01,2431,1270,"復興里",NULL
0,2995,71,3066,3729,0,0,82.22,1923,1072,"和興里",NULL
0,3077,67,3144,3926,0,0,80.08,2042,1035,"景平里",NULL
0,2484,78,2562,3147,0,0,81.41,1578,906,"景新里",NULL
0,3434,59,3493,4290,0,0,81.42,2261,1173,"景福里",NULL
0,3395,100,3495,4229,0,0,82.64,2232,1163,"景安里",NULL
0,2162,45,2207,2600,0,0,84.88,1360,802,"景文里",NULL
0,3173,59,3232,3881,0,0,83.28,1826,1347,"錦和里",NULL
0,2491,62,2553,3080,0,0,82.89,1368,1123,"錦中里",NULL
0,1153,27,1180,1418,0,0,83.22,774,379,"錦昌里",NULL
0,2572,70,2642,3188,0,0,82.87,1435,1137,"錦盛里",NULL
0,401,14,415,516,0,0,80.43,190,211,"灰窯里",NULL
0,3648,94,3742,4577,0,0,81.76,1932,1716,"積穗里",NULL
0,1840,56,1896,2204,0,0,86.03,933,907,"民享里",NULL
0,2111,60,2171,2616,0,0,82.99,1154,957,"民有里",NULL
0,2907,80,2987,3619,0,0,82.54,1499,1408,"員山里",NULL
0,1676,53,1729,2458,0,0,70.34,774,902,"員富里",NULL
0,1811,34,1845,2214,0,0,83.33,996,815,"嘉穗里",NULL
0,2660,70,2730,3374,0,0,80.91,1448,1212,"嘉慶里",NULL
0,3755,105,3860,4677,0,0,82.53,1925,1830,"文元里",NULL
0,2452,56,2508,3071,0,0,81.67,1351,1101,"嘉新里",NULL
0,3039,77,3116,3766,0,0,82.74,1584,1455,"民安里",NULL
0,2448,84,2532,3070,0,0,82.48,1166,1282,"安穗里",NULL
0,1477,38,1515,1833,0,0,82.65,902,575,"瑞穗里",NULL
0,2410,51,2461,2975,0,0,82.72,1296,1114,"冠穗里",NULL
0,2747,45,2792,3368,0,0,82.9,1436,1311,"明穗里",NULL
0,2234,64,2298,2793,0,0,82.28,1152,1082,"清穗里",NULL
0,3275,73,3348,4063,0,0,82.4,1666,1609,"自強里",NULL
0,2983,65,3048,3694,0,0,82.51,1676,1307,"德穗里",NULL
0,2886,72,2958,3526,0,0,83.89,1555,1331,"民生里",NULL
0,2498,59,2557,3096,0,0,82.59,1336,1162,"國光里",NULL
0,2069,71,2140,2624,0,0,81.55,1021,1048,"國華里",NULL
0,2715,73,2788,3273,0,0,85.18,2066,649,"壽德里",NULL
0,2690,70,2760,3332,0,0,82.83,1399,1291,"明德里",NULL
0,1176,25,1201,1484,0,0,80.93,784,392,"光復里",NULL
0,837,23,860,1068,0,0,80.52,572,265,"網溪里",NULL
0,1722,44,1766,2194,0,0,80.49,1195,527,"復興里",NULL
0,2680,72,2752,3396,0,0,81.04,1797,883,"竹林里",NULL
0,2548,61,2609,3204,0,0,81.43,1802,746,"桂林里",NULL
0,2507,55,2562,3176,0,0,80.67,1789,718,"上林里",NULL
0,2479,36,2515,3061,0,0,82.16,1592,887,"福林里",NULL
0,862,16,878,1081,0,0,81.22,499,363,"勵行里",NULL
0,2075,47,2122,2644,0,0,80.26,1375,700,"中興里",NULL
0,2319,80,2399,2936,0,0,81.71,1577,742,"永興里",NULL
0,1618,33,1651,2039,0,0,80.97,1080,538,"正興里",NULL
0,2531,44,2575,3752,0,0,68.63,1730,801,"豫溪里",NULL
0,2159,45,2204,2721,0,0,81,1458,701,"光明里",NULL
0,3263,39,3302,4078,0,0,80.97,2256,1007,"福和里",NULL
0,3087,54,3141,3733,0,0,84.14,2131,956,"得和里",NULL
0,2515,47,2562,3091,0,0,82.89,1626,889,"永貞里",NULL
0,2096,36,2132,2578,0,0,82.7,1414,682,"永福里",NULL
0,1973,47,2020,2475,0,0,81.62,1263,710,"河濱里",NULL
0,3260,60,3320,3950,0,0,84.05,2037,1223,"秀和里",NULL
0,3297,72,3369,4049,0,0,83.21,2118,1179,"永元里",NULL
0,3137,66,3203,3821,0,0,83.83,2097,1040,"民權里",NULL
0,3065,54,3119,3775,0,0,82.62,2108,957,"民族里",NULL
0,2661,75,2736,3361,0,0,81.4,1634,1027,"秀朗里",NULL
0,2041,38,2079,2519,0,0,82.53,1263,778,"秀成里",NULL
0,2392,61,2453,2933,0,0,83.63,1415,977,"秀林里",NULL
0,1875,33,1908,2290,0,0,83.32,1178,697,"秀得里",NULL
0,2255,31,2286,2743,0,0,83.34,1430,825,"秀元里",NULL
0,2860,56,2916,3468,0,0,84.08,1797,1063,"民生里",NULL
0,2037,52,2089,2540,0,0,82.24,1310,727,"民本里",NULL
0,2134,33,2167,2542,0,0,85.25,1358,776,"民富里",NULL
0,3050,65,3115,3755,0,0,82.96,2125,925,"民樂里",NULL
0,2079,60,2139,2616,0,0,81.77,1442,637,"民治里",NULL
0,2351,53,2404,2952,0,0,81.44,1631,720,"智光里",NULL
0,3226,49,3275,4006,0,0,81.75,2194,1032,"潭安里",NULL
0,2886,63,2949,3622,0,0,81.42,2042,844,"潭墘里",NULL
0,2608,46,2654,3278,0,0,80.96,1751,857,"店街里",NULL
0,1771,38,1809,2174,0,0,83.21,1200,571,"大新里",NULL
0,2915,43,2958,3565,0,0,82.97,1925,990,"永安里",NULL
0,1689,41,1730,2128,0,0,81.3,1072,617,"永樂里",NULL
0,2806,44,2850,3479,0,0,81.92,1903,903,"水源里",NULL
0,2144,43,2187,2648,0,0,82.59,1350,794,"協和里",NULL
0,2671,70,2741,3275,0,0,83.69,1780,891,"雙和里",NULL
0,2529,44,2573,3124,0,0,82.36,1753,776,"安和里",NULL
0,1392,12,1404,1761,0,0,79.73,927,465,"前溪里",NULL
0,3024,68,3092,3714,0,0,83.25,1873,1151,"和平里",NULL
0,3143,71,3214,3866,0,0,83.14,1886,1257,"保平里",NULL
0,3416,79,3495,4178,0,0,83.65,2052,1364,"中溪里",NULL
0,4460,77,4537,5355,0,0,84.72,2851,1609,"保安里",NULL
0,4214,62,4276,5130,0,0,83.35,2783,1431,"保順里",NULL
0,2629,82,2711,3298,0,0,82.2,1571,1058,"下溪里",NULL
0,723,39,762,903,0,0,84.39,560,163,"大同里",NULL
0,591,32,623,789,0,0,78.96,435,156,"新生里",NULL
0,714,34,748,956,0,0,78.24,637,77,"永成里",NULL
0,583,18,601,714,0,0,84.17,496,87,"忠義里",NULL
0,1927,61,1988,2414,0,0,82.35,1324,603,"文化里",NULL
0,1778,34,1812,2232,0,0,81.18,1116,662,"仁愛里",NULL
0,1736,23,1759,2199,0,0,79.99,1061,675,"信義里",NULL
0,1227,32,1259,1585,0,0,79.43,707,520,"後溪里",NULL
0,1380,37,1417,1761,0,0,80.47,891,489,"上溪里",NULL
0,1825,18,1843,2241,0,0,82.24,1152,673,"頂溪里",NULL
0,1596,33,1629,2003,0,0,81.33,1032,564,"河堤里",NULL
0,1700,39,1739,2130,0,0,81.64,1140,560,"新廍里",NULL
0,3606,95,3701,4486,0,0,82.5,1723,1883,"海山里",NULL
0,2809,66,2875,3413,0,0,84.24,1321,1488,"全安里",NULL
0,3535,55,3590,4269,0,0,84.09,1927,1608,"全泰里",NULL
0,3041,74,3115,3757,0,0,82.91,1454,1587,"忠孝里",NULL
0,1463,43,1506,1757,0,0,85.71,701,762,"文衡里",NULL
0,2485,59,2544,3045,0,0,83.55,1343,1142,"文聖里",NULL
0,2589,55,2644,3159,0,0,83.7,1366,1223,"興漢里",NULL
0,2116,45,2161,3370,0,0,64.12,1132,984,"榮和里",NULL
0,1169,31,1200,1449,0,0,82.82,596,573,"文德里",NULL
0,1273,36,1309,1588,0,0,82.43,622,651,"文明里",NULL
0,1778,51,1829,2200,0,0,83.14,714,1064,"化成里",NULL
0,2605,41,2646,3253,0,0,81.34,944,1661,"頭前里",NULL
0,1673,42,1715,2064,0,0,83.09,778,895,"福基里",NULL
0,2538,42,2580,3105,0,0,83.09,1212,1326,"福興里",NULL
0,2249,39,2288,2819,0,0,81.16,1221,1028,"昌平里",NULL
0,3229,49,3278,3921,0,0,83.6,1415,1814,"和平里",NULL
0,2903,89,2992,3684,0,0,81.22,1232,1671,"幸福里",NULL
0,2251,34,2285,2710,0,0,84.32,1131,1120,"昌隆里",NULL
0,3415,90,3505,4339,0,0,80.78,1585,1830,"信義里",NULL
0,1902,23,1925,2334,0,0,82.48,983,919,"昌信里",NULL
0,2217,33,2250,2677,0,0,84.05,1005,1212,"昌明里",NULL
0,2240,56,2296,2875,0,0,79.86,916,1324,"仁義里",NULL
0,1915,47,1962,2365,0,0,82.96,839,1076,"仁愛里",NULL
0,1601,47,1648,2032,0,0,81.1,675,926,"自信里",NULL
0,3199,68,3267,4016,0,0,81.35,1439,1760,"自立里",NULL
0,1896,50,1946,2439,0,0,79.79,816,1080,"自強里",NULL
0,3485,55,3540,4331,0,0,81.74,1487,1998,"思源里",NULL
0,2578,76,2654,3201,0,0,82.91,1174,1404,"思賢里",NULL
0,1263,19,1282,1590,0,0,80.63,530,733,"中華里",NULL
0,3791,96,3887,4711,0,0,82.51,1788,2003,"中美里",NULL
0,3021,66,3087,3723,0,0,82.92,1540,1481,"恆安里",NULL
0,1438,36,1474,1729,0,0,85.25,900,538,"立人里",NULL
0,1835,35,1870,2229,0,0,83.89,939,896,"立德里",NULL
0,3045,62,3107,3761,0,0,82.61,1350,1695,"中和里",NULL
0,3175,69,3244,3882,0,0,83.57,1353,1822,"中泰里",NULL
0,2199,36,2235,2720,0,0,82.17,1013,1186,"中宏里",NULL
0,2311,39,2350,2867,0,0,81.97,932,1379,"中全里",NULL
0,2520,53,2573,3103,0,0,82.92,1085,1435,"立志里",NULL
0,1946,34,1980,2392,0,0,82.78,884,1062,"立廷里",NULL
0,3723,59,3782,4587,0,0,82.45,1892,1831,"立基里",NULL
0,1382,34,1416,1769,0,0,80.05,554,828,"中誠里",NULL
0,3810,60,3870,4650,0,0,83.23,1860,1950,"中港里",NULL
0,4626,89,4715,5733,0,0,82.24,2112,2514,"中信里",NULL
0,4514,62,4576,5597,0,0,81.76,2505,2009,"中平里",NULL
0,4687,74,4761,5751,0,0,82.79,2235,2452,"中原里",NULL
0,2165,31,2196,2738,0,0,80.2,1019,1146,"中隆里",NULL
0,2508,66,2574,3142,0,0,81.92,1141,1367,"立功里",NULL
0,3041,77,3118,3780,0,0,82.49,1487,1554,"立泰里",NULL
0,3222,43,3265,3963,0,0,82.39,1604,1618,"立言里",NULL
0,2470,40,2510,3054,0,0,82.19,1130,1340,"豐年里",NULL
0,1148,36,1184,1421,0,0,83.32,559,589,"國泰里",NULL
0,1629,37,1666,2033,0,0,81.95,870,759,"泰豐里",NULL
0,3616,103,3719,4622,0,0,80.46,1549,2067,"瓊林里",NULL
0,1639,43,1682,2016,0,0,83.43,732,907,"福營里",NULL
0,1580,42,1622,1948,0,0,83.26,732,848,"營盤里",NULL
0,4177,119,4296,5407,0,0,79.45,2141,2036,"丹鳳里",NULL
0,2837,56,2893,3649,0,0,79.28,1362,1475,"合鳳里",NULL
0,1443,35,1478,1784,0,0,82.85,716,727,"祥鳳里",NULL
0,3386,62,3448,4324,0,0,79.74,1627,1759,"雙鳳里",NULL
0,1214,27,1241,1552,0,0,79.96,640,574,"龍福里",NULL
0,3472,71,3543,4330,0,0,81.82,1651,1821,"龍鳳里",NULL
0,4015,99,4114,5067,0,0,81.19,1851,2164,"裕民里",NULL
0,1523,38,1561,1948,0,0,80.13,737,786,"龍安里",NULL
0,1656,32,1688,2063,0,0,81.82,714,942,"富國里",NULL
0,2130,57,2187,2692,0,0,81.24,1043,1087,"富民里",NULL
0,1826,26,1852,2244,0,0,82.53,929,897,"後德里",NULL
0,2092,53,2145,2652,0,0,80.88,978,1114,"萬安里",NULL
0,1591,34,1625,1984,0,0,81.91,766,825,"建福里",NULL
0,4029,83,4112,4988,0,0,82.44,1963,2066,"後港里",NULL
0,2969,53,3022,3844,0,0,78.62,1281,1688,"四維里",NULL
0,3078,55,3133,3872,0,0,80.91,1495,1583,"南港里",NULL
0,3630,48,3678,4478,0,0,82.13,1815,1815,"建安里",NULL
0,1936,33,1969,2403,0,0,81.94,926,1010,"民全里",NULL
0,1948,49,1997,2488,0,0,80.27,821,1127,"民本里",NULL
0,2006,38,2044,2523,0,0,81.01,984,1022,"八德里",NULL
0,2965,78,3043,3745,0,0,81.26,1457,1508,"民安里",NULL
0,2860,54,2914,3630,0,0,80.28,1337,1523,"成德里",NULL
0,2337,57,2394,2986,0,0,80.17,1063,1274,"光明里",NULL
0,3386,90,3476,4476,0,0,77.66,1657,1729,"光華里",NULL
0,2334,45,2379,2907,0,0,81.84,1153,1181,"光榮里",NULL
0,2213,59,2272,2729,0,0,83.25,1003,1210,"光正里",NULL
0,1567,30,1597,1953,0,0,81.77,699,868,"光和里",NULL
0,2211,40,2251,2797,0,0,80.48,1094,1117,"民有里",NULL
0,3401,92,3493,4284,0,0,81.54,1496,1905,"西盛里",NULL
0,1160,42,1202,1461,0,0,82.27,579,581,"新店里",NULL
0,877,26,903,1113,0,0,81.13,469,408,"張南里",NULL
0,1716,52,1768,2240,0,0,78.93,1074,642,"國校里",NULL
0,1084,33,1117,1414,0,0,79,736,348,"文中里",NULL
0,578,24,602,704,0,0,85.51,256,322,"廣明里",NULL
0,1780,38,1818,2118,0,0,85.84,1048,732,"文明里",NULL
0,3780,70,3850,5388,0,0,71.46,2692,1088,"中興里",NULL
0,3918,74,3992,4837,0,0,82.53,2689,1229,"新生里",NULL
0,1828,42,1870,2287,0,0,81.77,1112,716,"新德里",NULL
0,4349,93,4442,5526,0,0,80.38,2974,1375,"張北里",NULL
0,4759,93,4852,5873,0,0,82.62,3321,1438,"五峰里",NULL
0,1632,19,1651,1982,0,0,83.3,1215,417,"長春里",NULL
0,2413,51,2464,3004,0,0,82.02,1709,704,"新安里",NULL
0,1839,34,1873,2233,0,0,83.88,1267,572,"忠誠里",NULL
0,4595,87,4682,5777,0,0,81.05,3170,1425,"中正里",NULL
0,2523,58,2581,3172,0,0,81.37,1868,655,"中華里",NULL
0,1697,33,1730,2103,0,0,82.26,1231,466,"仁愛里",NULL
0,2059,30,2089,2528,0,0,82.63,1538,521,"建國里",NULL
0,2779,65,2844,3402,0,0,83.6,1970,809,"百忍里",NULL
0,2311,44,2355,2813,0,0,83.72,1571,740,"百和里",NULL
0,2732,37,2769,3363,0,0,82.34,1921,811,"福德里",NULL
0,2065,44,2109,2539,0,0,83.06,1427,638,"百福里",NULL
0,2759,65,2824,3461,0,0,81.59,2150,609,"福民里",NULL
0,1860,55,1915,2384,0,0,80.33,1246,614,"中山里",NULL
0,659,35,694,833,0,0,83.31,476,183,"和平里",NULL
0,2940,33,2973,3585,0,0,82.93,2124,816,"中央里",NULL
0,2407,48,2455,3010,0,0,81.56,1806,601,"國豐里",NULL
0,2936,60,2996,3618,0,0,82.81,1913,1023,"明德里",NULL
0,2574,42,2616,3166,0,0,82.63,1727,847,"大豐里",NULL
0,2759,41,2800,3318,0,0,84.39,1745,1014,"大同里",NULL
0,3165,51,3216,3858,0,0,83.36,2172,993,"江陵里",NULL
0,2444,52,2496,3108,0,0,80.31,1473,971,"復興里",NULL
0,3060,73,3133,3801,0,0,82.43,2021,1039,"寶興里",NULL
0,3619,76,3695,4480,0,0,82.48,2469,1150,"寶福里",NULL
0,3693,78,3771,4601,0,0,81.96,2600,1093,"寶安里",NULL
0,4484,87,4571,5541,0,0,82.49,2871,1613,"信義里",NULL
0,2160,54,2214,2674,0,0,82.8,1568,592,"忠孝里",NULL
0,1414,16,1430,1657,0,0,86.3,1293,121,"大鵬里",NULL
0,2027,60,2087,2568,0,0,81.27,1381,646,"太平里",NULL
0,1740,39,1779,2137,0,0,83.25,1206,534,"美城里",NULL
0,1030,50,1080,1381,0,0,78.2,616,414,"頂城里",NULL
0,1421,48,1469,1789,0,0,82.11,800,621,"下城里",NULL
0,4844,133,4977,6036,0,0,82.46,3004,1840,"柴埕里",NULL
0,3320,86,3406,4155,0,0,81.97,2029,1291,"安和里",NULL
0,3286,68,3354,4085,0,0,82.11,1979,1307,"永安里",NULL
0,2563,43,2606,3142,0,0,82.94,1798,765,"新和里",NULL
0,3248,74,3322,4028,0,0,82.47,2062,1186,"永平里",NULL
0,5323,105,5428,6737,0,0,80.57,3326,1997,"公崙里",NULL
0,2578,28,2606,3198,0,0,81.49,1729,849,"安昌里",NULL
0,3775,112,3887,4728,0,0,82.21,2221,1554,"德安里",NULL
0,2125,24,2149,2661,0,0,80.76,1557,568,"達觀里",NULL
0,2066,25,2091,2586,0,0,80.86,1556,510,"明城里",NULL
0,2326,33,2359,2785,0,0,84.7,1754,572,"小城里",NULL
0,3664,89,3753,4638,0,0,80.92,2113,1551,"雙城里",NULL
0,3644,68,3712,4694,0,0,79.08,2660,984,"香坡里",NULL
0,3432,92,3524,4398,0,0,80.13,1999,1433,"日興里",NULL
0,3658,51,3709,4527,0,0,81.93,2617,1041,"玫瑰里",NULL
0,2768,62,2830,3482,0,0,81.28,2117,651,"吉祥里",NULL
0,558,27,585,732,0,0,79.92,144,414,"塗潭里",NULL
0,1189,12,1201,1456,0,0,82.49,768,421,"華城里",NULL
0,3165,76,3241,3931,0,0,82.45,1983,1182,"青潭里",NULL
0,3260,77,3337,4041,0,0,82.58,2176,1084,"美潭里",NULL
0,2352,78,2430,3042,0,0,79.88,1445,907,"員潭里",NULL
0,549,24,573,780,0,0,73.46,209,340,"雙坑里",NULL
0,1644,46,1690,2142,0,0,78.9,974,670,"粗坑里",NULL
0,1695,52,1747,2233,0,0,78.24,878,817,"屈尺里",NULL
0,1051,20,1071,1374,0,0,77.95,492,559,"龜山里",NULL
0,818,53,871,1103,0,0,78.97,263,555,"廣興里",NULL
0,578,26,604,746,0,0,80.97,171,407,"直潭里",NULL
0,995,33,1028,1250,0,0,82.24,449,546,"祖田里",NULL
0,615,17,632,766,0,0,82.51,500,115,"頂新里",NULL
0,2840,102,2942,3644,0,0,80.74,1482,1358,"頂福里",NULL
0,2911,82,2993,3731,0,0,80.22,1668,1243,"頂埔里",NULL
0,2024,66,2090,2624,0,0,79.65,899,1125,"沛陂里",NULL
0,4471,115,4586,5861,0,0,78.25,2369,2102,"永寧里",NULL
0,2843,70,2913,3629,0,0,80.27,1391,1452,"大安里",NULL
0,3227,87,3314,4225,0,0,78.44,1702,1525,"員仁里",NULL
0,1991,65,2056,3103,0,0,66.26,1003,988,"埤塘里",NULL
0,1348,28,1376,1702,0,0,80.85,724,624,"土城里",NULL
0,1343,12,1355,1583,0,0,85.6,1162,181,"長風里",NULL
0,2547,52,2599,3238,0,0,80.27,1434,1113,"員信里",NULL
0,3447,83,3530,4307,0,0,81.96,1899,1548,"員林里",NULL
0,3389,75,3464,4200,0,0,82.48,1738,1651,"員福里",NULL
0,3336,58,3394,4190,0,0,81,1510,1826,"日和里",NULL
0,2974,69,3043,3768,0,0,80.76,1404,1570,"日新里",NULL
0,3531,81,3612,4484,0,0,80.55,1777,1754,"裕生里",NULL
0,2487,49,2536,3120,0,0,81.28,1144,1343,"貨饒里",NULL
0,2138,62,2200,2631,0,0,83.62,961,1177,"瑞興里",NULL
0,2827,51,2878,3548,0,0,81.12,1401,1426,"復興里",NULL
0,3318,47,3365,4030,0,0,83.5,1914,1404,"廣福里",NULL
0,2051,46,2097,2527,0,0,82.98,951,1100,"學成里",NULL
0,4846,83,4929,5938,0,0,83.01,2686,2160,"埤林里",NULL
0,2037,39,2076,2520,0,0,82.38,1092,945,"廣興里",NULL
0,3340,56,3396,4172,0,0,81.4,1774,1566,"樂利里",NULL
0,2165,45,2210,2721,0,0,81.22,1170,995,"學府里",NULL
0,2683,35,2718,3279,0,0,82.89,1552,1131,"明德里",NULL
0,2768,31,2799,3381,0,0,82.79,1504,1264,"學士里",NULL
0,1818,43,1861,2377,0,0,78.29,879,939,"柑林里",NULL
0,1788,47,1835,2257,0,0,81.3,1002,786,"中正里",NULL
0,1856,44,1900,2254,0,0,84.29,891,965,"青雲里",NULL
0,3689,85,3774,4820,0,0,78.3,1687,2002,"清和里",NULL
0,1050,33,1083,1323,0,0,81.86,514,536,"清化里",NULL
0,4233,93,4326,5269,0,0,82.1,2497,1736,"清溪里",NULL
0,1876,44,1920,2368,0,0,81.08,1050,826,"青山里",NULL
0,4528,91,4619,5628,0,0,82.07,2400,2128,"清水里",NULL
0,1861,50,1911,2393,0,0,79.86,993,868,"永豐里",NULL
0,3125,66,3191,4047,0,0,78.85,1678,1447,"永富里",NULL
0,2780,48,2828,3429,0,0,82.47,1375,1405,"廷寮里",NULL
0,3377,47,3424,4176,0,0,81.99,1992,1385,"金城里",NULL
0,4465,94,4559,5610,0,0,81.27,2286,2179,"峰廷里",NULL
0,2748,67,2815,3464,0,0,81.26,1332,1416,"延吉里",NULL
0,2792,39,2831,3477,0,0,81.42,1413,1379,"延壽里",NULL
0,2588,48,2636,3250,0,0,81.11,1299,1289,"延祿里",NULL
0,4195,89,4284,5180,0,0,82.7,2087,2108,"平和里",NULL
0,3048,64,3112,3772,0,0,82.5,1522,1526,"安和里",NULL
0,3574,65,3639,4583,0,0,79.4,1886,1688,"延和里",NULL
0,3245,95,3340,3992,0,0,83.67,1640,1605,"光華里",NULL
0,2642,59,2701,3352,0,0,80.58,1155,1487,"光明里",NULL
0,2222,59,2281,2715,0,0,84.01,959,1263,"中路里",NULL
0,2435,48,2483,3023,0,0,82.14,1071,1364,"永安里",NULL
0,2991,60,3051,3710,0,0,82.24,1347,1644,"九芎里",NULL
0,2292,37,2329,2812,0,0,82.82,999,1293,"延平里",NULL
0,1961,72,2033,2443,0,0,83.22,887,1074,"中華里",NULL
0,2474,50,2524,3115,0,0,81.03,1074,1400,"中原里",NULL
0,2757,62,2819,3552,0,0,79.36,1174,1583,"長安里",NULL
0,1345,31,1376,1713,0,0,80.33,615,730,"忠義里",NULL
0,518,8,526,645,0,0,81.55,234,284,"正義里",NULL
0,3226,56,3282,4032,0,0,81.4,1389,1837,"南港里",NULL
0,3417,66,3483,4264,0,0,81.68,1540,1877,"永樂里",NULL
0,3597,58,3655,4489,0,0,81.42,1514,2083,"成功里",NULL
0,3447,79,3526,4273,0,0,82.52,1452,1995,"永康里",NULL
0,2449,32,2481,3040,0,0,81.61,1076,1373,"永德里",NULL
0,3357,68,3425,4183,0,0,81.88,1580,1777,"樓厝里",NULL
0,2489,67,2556,3113,0,0,82.11,1059,1430,"信義里",NULL
0,2947,68,3015,3709,0,0,81.29,1323,1624,"玉清里",NULL
0,2167,48,2215,2716,0,0,81.55,820,1347,"復興里",NULL
0,1865,42,1907,2293,0,0,83.17,767,1098,"福安里",NULL
0,3266,66,3332,4116,0,0,80.95,1485,1781,"鷺江里",NULL
0,3698,93,3791,4730,0,0,80.15,1737,1961,"恆德里",NULL
0,2083,37,2120,2611,0,0,81.19,858,1225,"溪墘里",NULL
0,1265,32,1297,1573,0,0,82.45,572,693,"仁復里",NULL
0,3201,71,3272,3965,0,0,82.52,1353,1848,"仁德里",NULL
0,1834,42,1876,2665,0,0,70.39,755,1079,"仁義里",NULL
0,2259,41,2300,2775,0,0,82.88,961,1298,"得勝里",NULL
0,1734,42,1776,2149,0,0,82.64,759,975,"得仁里",NULL
0,1643,38,1681,2090,0,0,80.43,764,879,"保和里",NULL
0,2067,55,2122,2608,0,0,81.37,963,1104,"樹德里",NULL
0,1887,73,1960,2404,0,0,81.53,880,1007,"民和里",NULL
0,4905,97,5002,6184,0,0,80.89,2193,2712,"水湳里",NULL
0,4963,98,5061,6204,0,0,81.58,2241,2722,"水河里",NULL
0,3051,70,3121,3872,0,0,80.6,1347,1704,"仁愛里",NULL
0,1405,27,1432,1743,0,0,82.16,573,832,"忠孝里",NULL
0,2342,60,2402,2976,0,0,80.71,1056,1286,"保佑里",NULL
0,1696,45,1741,2107,0,0,82.63,724,972,"保新里",NULL
0,1195,38,1233,1525,0,0,80.85,624,571,"仁德里",NULL
0,948,29,977,1208,0,0,80.88,520,428,"義民里",NULL
0,694,25,719,938,0,0,76.65,348,346,"禮門里",NULL
0,2251,31,2282,2826,0,0,80.75,1342,909,"智慧里",NULL
0,1494,36,1530,1934,0,0,79.11,935,559,"大同里",NULL
0,315,6,321,407,0,0,78.87,157,158,"信望里",NULL
0,3443,74,3517,4357,0,0,80.72,1791,1652,"新昌里",NULL
0,1874,41,1915,2349,0,0,81.52,1025,849,"福安里",NULL
0,2318,55,2373,2967,0,0,79.98,1152,1166,"秀峰里",NULL
0,2275,37,2312,2828,0,0,81.75,1298,977,"秀山里",NULL
0,3956,61,4017,5217,0,0,77,2374,1582,"復興里",NULL
0,2648,74,2722,3428,0,0,79.4,1402,1246,"自強里",NULL
0,2106,47,2153,2653,0,0,81.15,1175,931,"文化里",NULL
0,2491,42,2533,3147,0,0,80.49,1430,1061,"白雲里",NULL
0,2374,61,2435,3110,0,0,78.3,1186,1188,"茄苳里",NULL
0,2516,67,2583,3233,0,0,79.89,1359,1157,"崇德里",NULL
0,6695,103,6798,8369,0,0,81.23,4042,2653,"橋東里",NULL
0,1070,26,1096,1386,0,0,79.08,499,571,"長安里",NULL
0,975,30,1005,1271,0,0,79.07,515,460,"保安里",NULL
0,385,18,403,497,0,0,81.09,169,216,"東山里",NULL
0,2896,70,2966,3819,0,0,77.66,1496,1400,"保長里",NULL
0,1316,19,1335,1672,0,0,79.84,711,605,"鄉長里",NULL
0,3283,68,3351,4196,0,0,79.86,1716,1567,"江北里",NULL
0,2688,69,2757,3560,0,0,77.44,1616,1072,"拱北里",NULL
0,907,30,937,1177,0,0,79.61,477,430,"烘內里",NULL
0,611,18,629,789,0,0,79.72,305,306,"八連里",NULL
0,710,12,722,903,0,0,79.96,460,250,"長青里",NULL
0,2513,84,2597,3266,0,0,79.52,1262,1251,"北峰里",NULL
0,2921,58,2979,3795,0,0,78.5,1681,1240,"金龍里",NULL
0,1319,37,1356,1685,0,0,80.47,631,688,"樟樹里",NULL
0,4100,92,4192,5316,0,0,78.86,2481,1619,"忠孝里",NULL
0,3540,65,3605,4562,0,0,79.02,2207,1333,"厚德里",NULL
0,1446,26,1472,1911,0,0,77.03,1002,444,"山光里",NULL
0,4022,89,4111,5175,0,0,79.44,2121,1901,"中興里",NULL
0,1732,35,1767,2283,0,0,77.4,957,775,"福德里",NULL
0,1733,17,1750,2166,0,0,80.79,1044,689,"興福里",NULL
0,1905,39,1944,2413,0,0,80.56,1120,785,"康福里",NULL
0,3525,53,3578,4470,0,0,80.04,2209,1316,"湖光里",NULL
0,3056,39,3095,3953,0,0,78.29,2070,986,"湖興里",NULL
0,3262,64,3326,4085,0,0,81.42,1886,1376,"北山里",NULL
0,2075,30,2105,2520,0,0,83.53,1329,746,"忠山里",NULL
0,768,28,796,984,0,0,80.89,311,457,"環河里",NULL
0,3183,71,3254,3972,0,0,81.92,1856,1327,"橫科里",NULL
0,2323,24,2347,2875,0,0,81.63,1387,936,"福山里",NULL
0,1955,41,1996,2415,0,0,82.65,1251,704,"宜興里",NULL
0,2146,32,2178,2628,0,0,82.88,1317,829,"東勢里",NULL
0,2808,85,2893,3726,0,0,77.64,1371,1437,"三興里",NULL
0,2622,69,2691,3328,0,0,80.86,1391,1231,"三福里",NULL
0,2360,57,2417,2972,0,0,81.33,1064,1296,"三多里",NULL
0,1196,40,1236,1525,0,0,81.05,557,639,"三龍里",NULL
0,2768,62,2830,3517,0,0,80.47,1298,1470,"羌寮里",NULL
0,2121,57,2178,2785,0,0,78.2,1048,1073,"光興里",NULL
0,2343,70,2413,2999,0,0,80.46,1116,1227,"金寮里",NULL
0,2576,70,2646,3472,0,0,76.21,1149,1427,"潭底里",NULL
0,2930,73,3003,3716,0,0,80.81,1484,1446,"文林里",NULL
0,3959,98,4057,4918,0,0,82.49,1957,2002,"保安里",NULL
0,2059,33,2092,2614,0,0,80.03,903,1156,"圳安里",NULL
0,2494,55,2549,3135,0,0,81.31,1206,1288,"圳福里",NULL
0,1527,32,1559,1950,0,0,79.95,762,765,"圳民里",NULL
0,1003,19,1022,1252,0,0,81.63,398,605,"圳生里",NULL
0,2349,66,2415,2948,0,0,81.92,1212,1137,"樹德里",NULL
0,1524,36,1560,1901,0,0,82.06,776,748,"樹福里",NULL
0,3351,63,3414,4096,0,0,83.35,1679,1672,"樹西里",NULL
0,2319,58,2377,2932,0,0,81.07,1195,1124,"樹興里",NULL
0,2010,40,2050,2471,0,0,82.96,1115,895,"樹人里",NULL
0,1902,43,1945,2356,0,0,82.56,956,946,"育英里",NULL
0,2585,61,2646,3214,0,0,82.33,1346,1239,"樹南里",NULL
0,1019,37,1056,1280,0,0,82.5,457,562,"坡內里",NULL
0,853,18,871,1059,0,0,82.25,451,402,"樹東里",NULL
0,830,11,841,1015,0,0,82.86,421,409,"樹北里",NULL
0,2965,100,3065,3851,0,0,79.59,1385,1580,"彭福里",NULL
0,2509,75,2584,3224,0,0,80.15,1124,1385,"和平里",NULL
0,3286,83,3369,4316,0,0,78.06,1488,1798,"彭興里",NULL
0,2807,65,2872,3542,0,0,81.08,1318,1489,"彭厝里",NULL
0,1901,39,1940,2382,0,0,81.44,1025,876,"大同里",NULL
0,1780,42,1822,2275,0,0,80.09,923,857,"中華里",NULL
0,1626,44,1670,2081,0,0,80.25,819,807,"太順里",NULL
0,2430,74,2504,3038,0,0,82.42,1115,1315,"東昇里",NULL
0,3284,94,3378,4238,0,0,79.71,1623,1661,"東陽里",NULL
0,2064,66,2130,2635,0,0,80.83,947,1117,"東山里",NULL
0,2486,75,2561,3164,0,0,80.94,1179,1307,"山佳里",NULL
0,2411,91,2502,3117,0,0,80.27,1167,1244,"中山里",NULL
0,1040,46,1086,1339,0,0,81.11,480,560,"樂山里",NULL
0,1036,32,1068,1262,0,0,84.63,438,598,"柑園里",NULL
0,1015,31,1046,1329,0,0,78.71,308,707,"西園里",NULL
0,529,21,550,651,0,0,84.49,181,348,"南園里",NULL
0,1056,48,1104,1348,0,0,81.9,368,688,"東園里",NULL
0,1203,31,1234,1525,0,0,80.92,471,732,"北園里",NULL
0,340,7,347,446,0,0,77.8,173,167,"建德里",NULL
0,720,20,740,904,0,0,81.86,322,398,"東鶯里",NULL
0,1051,27,1078,1433,0,0,75.23,558,493,"北鶯里",NULL
0,1459,31,1490,1832,0,0,81.33,666,793,"西鶯里",NULL
0,682,5,687,825,0,0,83.27,328,354,"中鶯里",NULL
0,3345,97,3442,4205,0,0,81.85,1574,1771,"南鶯里",NULL
0,3355,71,3426,4398,0,0,77.9,1667,1688,"建國里",NULL
0,651,24,675,809,0,0,83.44,266,385,"二甲里",NULL
0,3855,117,3972,4993,0,0,79.55,1686,2169,"二橋里",NULL
0,3490,86,3576,4396,0,0,81.35,1629,1861,"尖山里",NULL
0,2222,43,2265,2736,0,0,82.79,1010,1212,"南靖里",NULL
0,1102,22,1124,1351,0,0,83.2,467,635,"同慶里",NULL
0,4830,105,4935,6217,0,0,79.38,2388,2442,"永昌里",NULL
0,2955,75,3030,3700,0,0,81.89,1409,1546,"永吉里",NULL
0,2661,74,2735,3489,0,0,78.39,1285,1376,"鳳祥里",NULL
0,2772,88,2860,3533,0,0,80.95,1347,1425,"鳳鳴里",NULL
0,2788,84,2872,3538,0,0,81.18,1322,1466,"鳳福里",NULL
0,3274,84,3358,4129,0,0,81.33,1851,1423,"大湖里",NULL
0,3377,123,3500,4411,0,0,79.35,1670,1707,"中湖里",NULL
0,171,14,185,226,0,0,81.86,74,97,"東湖里",NULL
0,283,9,292,351,0,0,83.19,148,135,"三峽里",NULL
0,321,10,331,402,0,0,82.34,158,163,"秀川里",NULL
0,2098,57,2155,2626,0,0,82.06,1044,1054,"八張里",NULL
0,1172,17,1189,1483,0,0,80.18,622,550,"中埔里",NULL
0,735,32,767,930,0,0,82.47,271,464,"弘道里",NULL
0,3969,110,4079,5032,0,0,81.06,2006,1963,"永館里",NULL
0,4462,134,4596,5747,0,0,79.97,2230,2232,"鳶山里",NULL
0,4261,79,4340,5403,0,0,80.33,2163,2098,"龍埔里",NULL
0,2494,51,2545,3142,0,0,81,1325,1169,"礁溪里",NULL
0,4060,91,4151,5168,0,0,80.32,2308,1752,"安溪里",NULL
0,2853,60,2913,3744,0,0,77.8,1403,1450,"介壽里",NULL
0,2685,81,2766,3420,0,0,80.88,1303,1382,"中正里",NULL
0,2436,98,2534,3180,0,0,79.69,1374,1062,"大埔里",NULL
0,1917,73,1990,2591,0,0,76.8,1225,692,"嘉添里",NULL
0,770,38,808,988,0,0,81.78,344,426,"添福里",NULL
0,328,32,360,465,0,0,77.42,149,179,"金圳里",NULL
0,674,43,717,881,0,0,81.38,343,331,"五寮里",NULL
0,589,51,640,811,0,0,78.91,244,345,"插角里",NULL
0,558,43,601,793,0,0,75.79,220,338,"有木里",NULL
0,1911,44,1955,2451,0,0,79.76,1136,775,"二鬮里",NULL
0,988,38,1026,1254,0,0,81.82,425,563,"溪南里",NULL
0,1522,12,1534,1862,0,0,82.38,602,920,"溪北里",NULL
0,1794,68,1862,2370,0,0,78.57,877,917,"溪東里",NULL
0,683,17,700,830,0,0,84.34,261,422,"成福里",NULL
0,1335,79,1414,1751,0,0,80.75,507,828,"竹崙里",NULL
0,921,59,980,1275,0,0,76.86,323,598,"安坑里",NULL
0,444,28,472,577,0,0,81.8,176,268,"中和里",NULL
0,730,41,771,959,0,0,80.4,327,403,"屯山里",NULL
0,1027,48,1075,1338,0,0,80.34,576,451,"賢孝里",NULL
0,1079,50,1129,1397,0,0,80.82,512,567,"興仁里",NULL
0,563,21,584,791,0,0,73.83,316,247,"蕃薯里",NULL
0,662,28,690,820,0,0,84.15,325,337,"忠山里",NULL
0,1630,72,1702,2178,0,0,78.15,832,798,"義山里",NULL
0,1389,64,1453,1838,0,0,79.05,548,841,"水源里",NULL
0,754,56,810,999,0,0,81.08,289,465,"忠寮里",NULL
0,586,30,616,780,0,0,78.97,201,385,"樹興里",NULL
0,825,30,855,1047,0,0,81.66,420,405,"坪頂里",NULL
0,3808,75,3883,4760,0,0,81.58,2393,1415,"福德里",NULL
0,5354,135,5489,6751,0,0,81.31,3066,2288,"竹圍里",NULL
0,3311,72,3383,4241,0,0,79.77,1806,1505,"民生里",NULL
0,1396,40,1436,1784,0,0,80.49,752,644,"八勢里",NULL
0,2710,51,2761,3457,0,0,79.87,1490,1220,"竿蓁里",NULL
0,1049,14,1063,1263,0,0,84.16,552,497,"崁頂里",NULL
0,827,31,858,1071,0,0,80.11,334,493,"埤島里",NULL
0,7236,137,7373,9075,0,0,81.25,4043,3193,"水碓里",NULL
0,11034,243,11277,14181,0,0,79.52,6163,4871,"新興里",NULL
0,1297,45,1342,1675,0,0,80.12,649,648,"北投里",NULL
0,8122,196,8318,10273,0,0,80.97,4521,3601,"鄧公里",NULL
0,2804,75,2879,3556,0,0,80.96,1496,1308,"中興里",NULL
0,1179,19,1198,1474,0,0,81.28,559,620,"長庚里",NULL
0,787,27,814,1056,0,0,77.08,381,406,"清文里",NULL
0,661,33,694,811,0,0,85.57,253,408,"草東里",NULL
0,1086,34,1120,1375,0,0,81.45,569,517,"協元里",NULL
0,595,18,613,739,0,0,82.95,304,291,"永吉里",NULL
0,589,8,597,736,0,0,81.11,240,349,"民安里",NULL
0,368,7,375,638,0,0,58.78,194,174,"新生里",NULL
0,1162,28,1190,1498,0,0,79.44,657,505,"文化里",NULL
0,2983,78,3061,3756,0,0,81.5,1738,1245,"油車里",NULL
0,3886,75,3961,4947,0,0,80.07,2096,1790,"沙崙里",NULL
0,612,15,627,767,0,0,81.75,349,263,"龍潭里",NULL
0,1324,35,1359,1686,0,0,80.6,762,562,"龍興里",NULL
0,944,42,986,1298,0,0,75.96,511,433,"龍鎮里",NULL
0,462,19,481,634,0,0,75.87,272,190,"龍安里",NULL
0,1192,45,1237,1596,0,0,77.51,653,539,"龍川里",NULL
0,948,30,978,1292,0,0,75.7,548,400,"龍山里",NULL
0,2757,128,2885,3604,0,0,80.05,1470,1287,"爪峰里",NULL
0,1844,81,1925,2612,0,0,73.7,1122,722,"新峰里",NULL
0,1364,28,1392,1820,0,0,76.48,712,652,"東和里",NULL
0,824,52,876,1112,0,0,78.78,398,426,"柑坪里",NULL
0,206,9,215,298,0,0,72.15,100,106,"弓橋里",NULL
0,351,23,374,504,0,0,74.21,176,175,"侯硐里",NULL
0,249,17,266,347,0,0,76.66,120,129,"光復里",NULL
0,80,3,83,118,0,0,70.34,40,40,"碩仁里",NULL
0,1204,50,1254,1640,0,0,76.46,662,542,"吉慶里",NULL
0,2146,62,2208,2803,0,0,78.77,1181,965,"吉安里",NULL
0,955,49,1004,1270,0,0,79.06,480,475,"上天里",NULL
0,1354,43,1397,1819,0,0,76.8,670,684,"傑魚里",NULL
0,381,20,401,557,0,0,71.99,182,199,"基山里",NULL
0,383,19,402,558,0,0,72.04,164,219,"永慶里",NULL
0,276,8,284,420,0,0,67.62,139,137,"崇文里",NULL
0,169,11,180,249,0,0,72.29,89,80,"福住里",NULL
0,283,6,289,397,0,0,72.8,147,136,"頌德里",NULL
0,183,7,190,264,0,0,71.97,104,79,"瓜山里",NULL
0,212,7,219,287,0,0,76.31,130,82,"銅山里",NULL
0,335,10,345,447,0,0,77.18,175,160,"新山里",NULL
0,309,14,323,452,0,0,71.46,190,119,"石山里",NULL
0,430,21,451,612,0,0,73.69,271,159,"濂洞里",NULL
0,253,10,263,338,0,0,77.81,132,121,"濂新里",NULL
0,189,6,195,258,0,0,75.58,97,92,"南雅里",NULL
0,519,22,541,767,0,0,70.53,290,229,"鼻頭里",NULL
0,732,32,764,1004,0,0,76.1,439,293,"海濱里",NULL
0,1427,35,1462,1937,0,0,75.48,826,601,"瑞濱里",NULL
0,815,33,848,1184,0,0,71.62,528,287,"深澳里",NULL
0,3057,69,3126,3830,0,0,81.62,1180,1877,"興珍村",NULL
0,885,42,927,1137,0,0,81.53,278,607,"更寮村",NULL
0,1930,47,1977,2465,0,0,80.2,912,1018,"集福村",NULL
0,2173,51,2224,2742,0,0,81.11,975,1198,"集賢村",NULL
0,970,50,1020,1281,0,0,79.63,321,649,"觀音村",NULL
0,3242,77,3319,4135,0,0,80.27,1337,1905,"成州村",NULL
0,1775,56,1831,2285,0,0,80.13,669,1106,"成德村",NULL
0,2361,50,2411,3113,0,0,77.45,995,1366,"成功村",NULL
0,2075,75,2150,2641,0,0,81.41,819,1256,"成泰村",NULL
0,913,45,958,1179,0,0,81.26,285,628,"五龍村",NULL
0,2292,52,2344,2896,0,0,80.94,1276,1016,"五福村",NULL
0,2141,29,2170,2612,0,0,83.08,1318,823,"六福村",NULL
0,2504,41,2545,3220,0,0,79.04,1182,1322,"五股村",NULL
0,1323,16,1339,1610,0,0,83.17,607,716,"陸一村、五股村",NULL
0,2039,53,2092,2573,0,0,81.31,1103,936,"民義村",NULL
0,2931,62,2993,3634,0,0,82.36,1566,1365,"德音村",NULL
0,4102,101,4203,5143,0,0,81.72,2025,2077,"水碓村",NULL
0,3705,72,3777,4772,0,0,79.15,1955,1750,"德泰村",NULL
0,1422,31,1453,1646,0,0,88.27,1379,43,"貿商村",NULL
0,724,24,748,900,0,0,83.11,301,423,"大科村",NULL
0,2376,39,2415,2843,0,0,84.95,1258,1118,"黎明村",NULL
0,3508,69,3577,4430,0,0,80.74,1869,1639,"山腳村",NULL
0,3796,85,3881,4632,0,0,83.79,1938,1858,"福泰村",NULL
0,2108,45,2153,2620,0,0,82.18,1038,1070,"楓樹村",NULL
0,2528,54,2582,3119,0,0,82.78,1383,1145,"同榮村",NULL
0,2587,60,2647,3231,0,0,81.93,1244,1343,"同興村",NULL
0,2530,54,2584,3196,0,0,80.85,1201,1329,"義學村",NULL
0,3466,79,3545,4224,0,0,83.93,1534,1932,"義仁村",NULL
0,2428,40,2468,3007,0,0,82.08,1252,1176,"明志村",NULL
0,1458,27,1485,1796,0,0,82.68,742,716,"泰友村",NULL
0,2212,43,2255,2739,0,0,82.33,1074,1138,"新明村",NULL
0,2528,52,2580,3122,0,0,82.64,1261,1267,"貴子村",NULL
0,2418,45,2463,2972,0,0,82.87,1259,1159,"貴賢村",NULL
0,3125,62,3187,3895,0,0,81.82,1594,1531,"貴和村",NULL
0,2741,81,2822,3482,0,0,81.05,1311,1430,"東林村",NULL
0,2748,65,2813,3550,0,0,79.24,1460,1288,"林口村",NULL
0,2622,85,2707,3299,0,0,82.06,1363,1259,"西林村",NULL
0,2615,74,2689,3261,0,0,82.46,1292,1323,"菁湖村",NULL
0,1877,63,1940,2363,0,0,82.1,899,978,"中湖村",NULL
0,872,42,914,1098,0,0,83.24,295,577,"湖北村",NULL
0,1058,18,1076,1292,0,0,83.28,429,629,"湖南村",NULL
0,590,26,616,774,0,0,79.59,225,365,"南勢村",NULL
0,2711,43,2754,3342,0,0,82.41,1726,985,"仁愛村",NULL
0,3133,45,3178,3898,0,0,81.53,2010,1123,"麗林村",NULL
0,3199,70,3269,4074,0,0,80.24,1831,1368,"東勢村",NULL
0,2203,46,2249,2774,0,0,81.07,1268,935,"麗園村",NULL
0,707,57,764,963,0,0,79.34,227,480,"頂福村",NULL
0,729,44,773,931,0,0,83.03,351,378,"下福村",NULL
0,522,39,561,653,0,0,85.91,193,329,"嘉寶村",NULL
0,335,27,362,453,0,0,79.91,122,213,"瑞平村",NULL
0,639,33,672,809,0,0,83.07,210,429,"太平村",NULL
0,1503,49,1552,1927,0,0,80.54,760,743,"萬順村",NULL
0,1456,41,1497,1878,0,0,79.71,739,717,"萬福村",NULL
0,1635,48,1683,2083,0,0,80.8,896,739,"土庫村",NULL
0,1194,28,1222,1540,0,0,79.35,770,424,"賴仲村",NULL
0,1929,62,1991,2450,0,0,81.27,1041,888,"深坑村",NULL
0,2976,57,3033,3739,0,0,81.12,1760,1216,"埔新村",NULL
0,1215,37,1252,1587,0,0,78.89,720,495,"昇高村",NULL
0,370,18,388,467,0,0,83.08,159,211,"阿柔村",NULL
0,323,9,332,392,0,0,84.69,148,175,"石碇村",NULL
0,507,40,547,674,0,0,81.16,243,264,"潭邊村",NULL
0,507,9,516,607,0,0,85.01,158,349,"烏塗村",NULL
0,224,14,238,300,0,0,79.33,102,122,"彭山村",NULL
0,327,22,349,426,0,0,81.92,123,204,"豐田村",NULL
0,543,8,551,696,0,0,79.17,225,318,"隆盛村",NULL
0,173,8,181,230,0,0,78.7,85,88,"豐林村",NULL
0,584,29,613,764,0,0,80.24,258,326,"中民村",NULL
0,425,23,448,583,0,0,76.84,186,239,"永定村",NULL
0,193,11,204,245,0,0,83.27,77,116,"光明村",NULL
0,328,20,348,430,0,0,80.93,138,190,"永安村",NULL
0,529,31,560,679,0,0,82.47,173,356,"格頭村",NULL
0,812,45,857,1046,0,0,81.93,310,502,"坪林村",NULL
0,438,25,463,571,0,0,81.09,182,256,"水德村",NULL
0,645,39,684,939,0,0,72.84,185,460,"大林村",NULL
0,245,26,271,375,0,0,72.27,73,172,"石曹村",NULL
0,567,9,576,728,0,0,79.12,211,356,"粗窟村",NULL
0,518,43,561,707,0,0,79.35,239,279,"上德村",NULL
0,564,47,611,776,0,0,78.74,148,416,"漁光村",NULL
0,283,17,300,381,0,0,78.74,121,162,"八賢村",NULL
0,2781,75,2856,3650,0,0,78.25,1576,1205,"埔頭村",NULL
0,647,40,687,920,0,0,74.67,363,284,"古庄村",NULL
0,595,29,624,800,0,0,78,345,250,"新庄村",NULL
0,3658,125,3783,5024,0,0,75.3,2218,1440,"埔坪村",NULL
0,339,18,357,444,0,0,80.41,197,142,"茂長村",NULL
0,411,27,438,545,0,0,80.37,229,182,"橫山村",NULL
0,610,19,629,770,0,0,81.69,299,311,"錫板村",NULL
0,1242,47,1289,1609,0,0,80.11,776,466,"後厝村",NULL
0,487,33,520,665,0,0,78.2,267,220,"福德村",NULL
0,372,27,399,507,0,0,78.7,162,210,"圓山村",NULL
0,459,44,503,630,0,0,79.84,144,315,"店子村",NULL
0,806,49,855,1120,0,0,76.34,378,428,"興華村",NULL
0,666,25,691,901,0,0,76.69,339,327,"德茂村",NULL
0,837,42,879,1094,0,0,80.35,494,343,"富基村",NULL
0,1291,85,1376,1798,0,0,76.53,662,629,"老梅村",NULL
0,529,40,569,735,0,0,77.41,308,221,"山溪村",NULL
0,942,33,975,1221,0,0,79.85,573,369,"石門村",NULL
0,939,49,988,1247,0,0,79.23,552,387,"尖鹿村",NULL
0,217,11,228,307,0,0,74.27,124,93,"乾華村",NULL
0,388,24,412,518,0,0,79.54,213,175,"茂林村",NULL
0,576,29,605,767,0,0,78.88,357,219,"草里村",NULL
0,3522,73,3595,4406,0,0,81.59,1961,1561,"龍源村",NULL
0,1785,74,1859,2304,0,0,80.69,876,909,"米倉村",NULL
0,1159,53,1212,1504,0,0,80.59,560,599,"大崁村",NULL
0,1916,69,1985,2463,0,0,80.59,914,1002,"埤頭村",NULL
0,903,32,935,1141,0,0,81.95,419,484,"頂罟村",NULL
0,3384,77,3461,4423,0,0,78.25,1774,1610,"舊城村",NULL
0,2021,59,2080,2571,0,0,80.9,1076,945,"訊塘村",NULL
0,1006,35,1041,1313,0,0,79.28,482,524,"荖阡村",NULL
0,892,45,937,1113,0,0,84.19,465,427,"長坑村",NULL
0,851,44,895,1072,0,0,83.49,524,327,"下罟村",NULL
0,317,26,343,448,0,0,76.56,128,189,"薯榔村",NULL
0,228,11,239,308,0,0,77.6,131,97,"菁桐村",NULL
0,225,6,231,281,0,0,82.21,90,135,"白石村",NULL
0,412,25,437,561,0,0,77.9,174,238,"石底村",NULL
0,190,14,204,271,0,0,75.28,112,78,"平溪村",NULL
0,473,38,511,685,0,0,74.6,236,237,"嶺腳村",NULL
0,308,20,328,428,0,0,76.64,139,169,"東勢村",NULL
0,706,43,749,1000,0,0,74.9,338,368,"十分村",NULL
0,116,6,122,152,0,0,80.26,55,61,"望古村",NULL
0,356,29,385,492,0,0,78.25,147,209,"南山村",NULL
0,130,9,139,185,0,0,75.14,69,61,"新寮村",NULL
0,122,6,128,167,0,0,76.65,60,62,"平湖村",NULL
0,414,21,435,562,0,0,77.4,217,197,"雙溪村",NULL
0,698,21,719,898,0,0,80.07,421,277,"新基村",NULL
0,307,28,335,460,0,0,72.83,120,187,"三港村",NULL
0,1283,87,1370,1794,0,0,76.37,659,624,"牡丹村",NULL
0,257,20,277,355,0,0,78.03,135,122,"三貂村",NULL
0,698,40,738,946,0,0,78.01,374,324,"平林村",NULL
0,493,36,529,704,0,0,75.14,223,270,"上林村",NULL
0,335,31,366,501,0,0,73.05,143,192,"外柑村",NULL
0,287,28,315,421,0,0,74.82,80,207,"長源村",NULL
0,336,12,348,477,0,0,72.96,188,148,"共和村",NULL
0,483,27,510,662,0,0,77.04,236,247,"魚行村",NULL
0,350,25,375,528,0,0,71.02,162,188,"泰平村",NULL
0,654,45,699,908,0,0,76.98,301,353,"貢寮村",NULL
0,311,26,337,443,0,0,76.07,129,182,"龍崗村",NULL
0,330,23,353,514,0,0,68.68,143,187,"吉林村",NULL
0,566,41,607,788,0,0,77.03,210,356,"雙玉村",NULL
0,1174,61,1235,1614,0,0,76.52,562,612,"福隆村",NULL
0,613,32,645,866,0,0,74.48,223,390,"福連村",NULL
0,485,26,511,689,0,0,74.17,162,323,"龍門村",NULL
0,1198,69,1267,1669,0,0,75.91,495,703,"仁里村",NULL
0,1357,67,1424,1941,0,0,73.36,387,970,"真理村",NULL
0,571,64,635,830,0,0,76.51,186,385,"美豐村",NULL
0,640,45,685,924,0,0,74.13,237,403,"和美村",NULL
0,344,11,355,449,0,0,79.06,172,172,"和平村",NULL
0,510,8,518,644,0,0,80.43,289,221,"大同村",NULL
0,343,22,365,479,0,0,76.2,166,177,"豐漁村",NULL
0,1116,73,1189,1584,0,0,75.06,435,681,"磺港村",NULL
0,5168,183,5351,6850,0,0,78.12,2765,2403,"美田村",NULL
0,1095,54,1149,1447,0,0,79.41,548,547,"五湖村",NULL
0,690,45,735,976,0,0,75.31,297,393,"重和村",NULL
0,280,35,315,389,0,0,80.98,138,142,"兩湖村",NULL
0,402,29,431,535,0,0,80.56,173,229,"六股村",NULL
0,428,36,464,587,0,0,79.05,189,239,"三界村",NULL
0,587,50,637,836,0,0,76.2,299,288,"清泉村",NULL
0,153,12,165,200,0,0,82.5,72,81,"西湖村",NULL
0,348,24,372,461,0,0,80.69,173,175,"萬壽村",NULL
0,395,31,426,586,0,0,72.7,195,200,"永興村",NULL
0,2358,127,2485,3149,0,0,78.91,1348,1010,"萬里村",NULL
0,1415,55,1470,2083,0,0,70.57,889,526,"北基村",NULL
0,1160,83,1243,1744,0,0,71.27,666,494,"龜吼村",NULL
0,1768,78,1846,2406,0,0,76.72,906,862,"野柳村",NULL
0,1683,48,1731,2216,0,0,78.11,931,752,"大鵬村",NULL
0,371,21,392,477,0,0,82.18,215,156,"磺潭村",NULL
0,589,52,641,781,0,0,82.07,236,353,"雙興村",NULL
0,393,25,418,537,0,0,77.84,150,243,"溪底村",NULL
0,405,22,427,560,0,0,76.25,187,218,"崁腳村",NULL
0,583,35,618,823,0,0,75.09,342,241,"中幅村",NULL
0,793,23,816,1012,0,0,80.63,485,308,"忠治村",NULL
0,1307,25,1332,1650,0,0,80.73,814,493,"烏來村",NULL
0,116,3,119,142,0,0,83.8,52,64,"孝義村",NULL
0,262,16,278,341,0,0,81.52,154,108,"信賢村",NULL
0,321,2,323,415,0,0,77.83,257,64,"福山村",NULL
0,464,10,474,618,0,0,76.7,260,204,"南門里",NULL
0,1724,44,1768,2205,0,0,80.18,900,824,"負郭里",NULL
0,1810,45,1855,2293,0,0,80.9,1010,800,"民族里",NULL
0,2017,31,2048,2582,0,0,79.32,1093,924,"建軍里",NULL
0,2261,51,2312,2877,0,0,80.36,1299,962,"復興里",NULL
0,3660,59,3719,4635,0,0,80.24,2037,1623,"思源里",NULL
0,2180,48,2228,2816,0,0,79.12,1160,1020,"文化里",NULL
0,501,5,506,648,0,0,78.09,272,229,"神農里",NULL
0,340,11,351,427,0,0,82.2,120,220,"民生里",NULL
0,549,13,562,697,0,0,80.63,222,327,"昇平里",NULL
0,426,10,436,552,0,0,78.99,193,233,"大東里",NULL
0,476,12,488,612,0,0,79.74,241,235,"新興里",NULL
0,1630,29,1659,2126,0,0,78.03,907,723,"和睦里",NULL
0,1206,23,1229,1630,0,0,75.4,684,522,"民權里",NULL
0,3703,51,3754,4723,0,0,79.48,1899,1804,"進士里",NULL
0,530,19,549,691,0,0,79.45,214,316,"南橋里",NULL
0,749,29,778,1028,0,0,75.68,312,437,"建業里",NULL
0,581,28,609,792,0,0,76.89,206,375,"南津里",NULL
0,806,38,844,1069,0,0,78.95,318,488,"凱旋里",NULL
0,1008,38,1046,1303,0,0,80.28,397,611,"黎明里",NULL
0,2921,59,2980,3729,0,0,79.91,1462,1459,"東村里",NULL
0,2956,66,3022,3795,0,0,79.63,1504,1452,"延平里",NULL
0,898,47,945,1178,0,0,80.22,298,600,"七張里",NULL
0,3062,68,3130,4067,0,0,76.96,1597,1465,"慈安里",NULL
0,505,16,521,659,0,0,79.06,207,298,"新民里",NULL
0,437,9,446,545,0,0,81.83,180,257,"東門里",NULL
0,461,14,475,619,0,0,76.74,200,261,"中正里",NULL
0,1015,27,1042,1304,0,0,79.91,506,509,"小東里",NULL
0,1040,27,1067,1342,0,0,79.51,504,536,"菜園里",NULL
0,765,29,794,1009,0,0,78.69,320,445,"孝廉里",NULL
0,1668,54,1722,2196,0,0,78.42,676,992,"新生里",NULL
0,1350,41,1391,1822,0,0,76.34,504,846,"茭白里",NULL
0,1146,33,1179,1508,0,0,78.18,457,689,"北津里",NULL
0,1947,55,2002,2520,0,0,79.44,699,1248,"梅洲里",NULL
0,718,14,732,921,0,0,79.48,310,408,"北門里",NULL
0,533,19,552,724,0,0,76.24,193,340,"慶和里",NULL
0,592,16,608,800,0,0,76,213,379,"鄂王里",NULL
0,957,30,987,1257,0,0,78.52,386,571,"西門里",NULL
0,549,26,575,781,0,0,73.62,199,350,"中山里",NULL
0,1023,29,1052,1359,0,0,77.41,440,583,"大道里",NULL
0,372,10,382,498,0,0,76.71,144,228,"開羅里",NULL
0,423,15,438,539,0,0,81.26,141,282,"開元里",NULL
0,368,21,389,500,0,0,77.8,138,230,"東明里",NULL
0,955,20,975,1243,0,0,78.44,372,583,"大新里",NULL
0,1906,41,1947,2456,0,0,79.28,770,1136,"東安里",NULL
0,1586,51,1637,2069,0,0,79.12,513,1073,"新群里",NULL
0,1592,31,1623,2083,0,0,77.92,665,927,"羅莊里",NULL
0,1776,45,1821,2293,0,0,79.42,881,895,"南昌里",NULL
0,1034,35,1069,1316,0,0,81.23,425,609,"南豪里",NULL
0,1039,21,1060,1270,0,0,83.46,457,582,"成功里",NULL
0,682,20,702,863,0,0,81.34,287,395,"仁德里",NULL
0,546,15,561,734,0,0,76.43,232,314,"居仁里",NULL
0,624,19,643,832,0,0,77.28,243,381,"義和里",NULL
0,491,14,505,616,0,0,81.98,210,281,"羅東里",NULL
0,556,13,569,710,0,0,80.14,214,342,"浮崙里",NULL
0,2757,55,2812,3530,0,0,79.66,1273,1484,"漢民里",NULL
0,3889,61,3950,4985,0,0,79.24,1679,2210,"西安里",NULL
0,4376,77,4453,5525,0,0,80.6,1765,2611,"北成里",NULL
0,2649,62,2711,3454,0,0,78.49,1195,1454,"賢文里",NULL
0,1490,27,1517,1865,0,0,81.34,653,837,"公正里",NULL
0,794,9,803,1051,0,0,76.4,332,462,"集祥里",NULL
0,2377,47,2424,3047,0,0,79.55,1030,1347,"信義里",NULL
0,2682,41,2723,3438,0,0,79.2,1237,1445,"樹林里",NULL
0,2020,55,2075,2644,0,0,78.48,786,1234,"竹林里",NULL
0,2090,33,2123,2613,0,0,81.25,793,1297,"仁愛里",NULL
0,2287,100,2387,3028,0,0,78.83,811,1476,"龍德里",NULL
0,622,31,653,775,0,0,84.26,193,429,"頂寮里",NULL
0,2332,66,2398,3015,0,0,79.54,917,1415,"永榮里",NULL
0,743,26,769,959,0,0,80.19,238,505,"存仁里",NULL
0,887,54,941,1199,0,0,78.48,316,571,"港邊里",NULL
0,154,2,156,253,0,0,61.66,141,13,"岳明里",NULL
0,1599,57,1656,2124,0,0,77.97,601,998,"隘丁里",NULL
0,825,29,854,1098,0,0,77.78,331,494,"新城里",NULL
0,3742,106,3848,5075,0,0,75.82,1832,1910,"聖湖里",NULL
0,1780,56,1836,2358,0,0,77.86,876,904,"蘇西里",NULL
0,915,24,939,1217,0,0,77.16,447,468,"蘇北里",NULL
0,415,19,434,562,0,0,77.22,191,224,"蘇南里",NULL
0,358,14,372,535,0,0,69.53,159,199,"蘇東里",NULL
0,460,19,479,613,0,0,78.14,223,237,"長安里",NULL
0,385,8,393,495,0,0,79.39,192,193,"永光里",NULL
0,451,20,471,642,0,0,73.36,170,281,"永春里",NULL
0,361,29,390,503,0,0,77.53,157,204,"永樂里",NULL
0,798,31,829,1065,0,0,77.84,324,474,"南安里",NULL
0,761,15,776,1048,0,0,74.05,290,471,"南正里",NULL
0,880,45,925,1249,0,0,74.06,351,529,"南成里",NULL
0,1129,56,1185,1657,0,0,71.51,514,615,"南興里",NULL
0,821,28,849,1144,0,0,74.21,357,464,"南寧里",NULL
0,956,22,978,1324,0,0,73.87,348,608,"南建里",NULL
0,223,7,230,303,0,0,75.91,106,117,"東澳里",NULL
0,592,25,617,872,0,0,70.76,219,373,"南強里",NULL
0,506,32,538,746,0,0,72.12,149,357,"朝陽里",NULL
0,253,17,270,374,0,0,72.19,117,136,"石城里",NULL
0,505,33,538,739,0,0,72.8,259,246,"大里里",NULL
0,484,20,504,652,0,0,77.3,276,208,"龜山里",NULL
0,657,34,691,929,0,0,74.38,275,382,"大溪里",NULL
0,281,20,301,403,0,0,74.69,150,131,"合興里",NULL
0,965,46,1011,1409,0,0,71.75,564,401,"更新里",NULL
0,603,47,650,937,0,0,69.37,319,284,"外澳里",NULL
0,467,21,488,641,0,0,76.13,233,234,"港口里",NULL
0,1075,39,1114,1447,0,0,76.99,650,425,"武營里",NULL
0,898,31,929,1208,0,0,76.9,467,431,"大坑里",NULL
0,594,12,606,745,0,0,81.34,353,241,"城東里",NULL
0,421,16,437,560,0,0,78.04,263,158,"城北里",NULL
0,501,3,504,632,0,0,79.75,284,217,"城西里",NULL
0,494,11,505,628,0,0,80.41,310,184,"城南里",NULL
0,1437,43,1480,2020,0,0,73.27,764,673,"竹安里",NULL
0,1324,39,1363,1793,0,0,76.02,684,640,"新建里",NULL
0,1038,36,1074,1406,0,0,76.39,557,481,"拔雅里",NULL
0,744,32,776,1004,0,0,77.29,350,394,"福成里",NULL
0,1207,51,1258,1669,0,0,75.37,668,539,"金面里",NULL
0,515,26,541,711,0,0,76.09,275,240,"金盈里",NULL
0,964,33,997,1274,0,0,78.26,534,430,"頂埔里",NULL
0,716,27,743,962,0,0,77.23,355,361,"下埔里",NULL
0,726,31,757,963,0,0,78.61,386,340,"中崙里",NULL
0,800,37,837,1076,0,0,77.79,372,428,"二城里",NULL
0,1041,56,1097,1406,0,0,78.02,476,565,"白雲村",NULL
0,1245,56,1301,1660,0,0,78.37,608,637,"玉石村",NULL
0,2573,74,2647,3505,0,0,75.52,1478,1095,"德陽村",NULL
0,1644,56,1700,2157,0,0,78.81,937,707,"大忠村",NULL
0,510,22,532,665,0,0,80,210,300,"大義村",NULL
0,1077,29,1106,1394,0,0,79.34,590,487,"六結村",NULL
0,843,33,876,1092,0,0,80.22,316,527,"二龍村",NULL
0,1005,45,1050,1380,0,0,76.09,304,701,"時潮村",NULL
0,1391,72,1463,1859,0,0,78.7,376,1015,"玉田村",NULL
0,1703,82,1785,2290,0,0,77.95,711,992,"三民村",NULL
0,815,57,872,1085,0,0,80.37,294,521,"林美村",NULL
0,567,22,589,737,0,0,79.92,225,342,"白鵝村",NULL
0,760,27,787,963,0,0,81.72,216,544,"玉光村",NULL
0,839,41,880,1109,0,0,79.35,305,534,"光武村",NULL
0,1664,54,1718,2190,0,0,78.45,676,988,"吳沙村",NULL
0,2151,98,2249,2773,0,0,81.1,630,1521,"龍潭村",NULL
0,712,25,737,955,0,0,77.17,232,480,"匏崙村",NULL
0,331,10,341,414,0,0,82.37,86,245,"二結村",NULL
0,1408,52,1460,1845,0,0,79.13,577,831,"吉祥村",NULL
0,719,22,741,936,0,0,79.17,236,483,"古結村",NULL
0,1224,50,1274,1616,0,0,78.84,468,756,"美福村",NULL
0,677,37,714,872,0,0,81.88,249,428,"新南村",NULL
0,733,8,741,989,0,0,74.92,271,462,"東港村",NULL
0,1180,55,1235,1602,0,0,77.09,409,771,"復興村",NULL
0,1155,44,1199,1576,0,0,76.08,420,735,"過嶺村",NULL
0,623,26,649,857,0,0,75.73,184,439,"永鎮村",NULL
0,1558,66,1624,2086,0,0,77.85,583,975,"忠孝村",NULL
0,950,43,993,1264,0,0,78.56,308,642,"古亭村",NULL
0,746,40,786,986,0,0,79.72,267,479,"功勞村",NULL
0,1488,60,1548,1944,0,0,79.63,521,967,"美城村",NULL
0,772,43,815,1066,0,0,76.45,303,469,"新社村",NULL
0,1178,59,1237,1624,0,0,76.17,455,723,"大福村",NULL
0,3285,95,3380,4333,0,0,78.01,1514,1771,"員山村",NULL
0,1381,68,1449,1880,0,0,77.07,491,890,"尚德村",NULL
0,962,42,1004,1228,0,0,81.76,276,686,"惠好村",NULL
0,712,38,750,958,0,0,78.29,329,383,"七賢村",NULL
0,1020,52,1072,1435,0,0,74.7,287,733,"深溝村",NULL
0,836,50,886,1190,0,0,74.45,237,599,"蓁巷村",NULL
0,1026,72,1098,1436,0,0,76.46,574,452,"內城村",NULL
0,505,39,544,731,0,0,74.42,154,351,"中華村",NULL
0,1231,49,1280,1620,0,0,79.01,478,753,"永和村",NULL
0,811,50,861,1064,0,0,80.92,295,516,"頭分村",NULL
0,1603,70,1673,2098,0,0,79.74,434,1169,"枕山村",NULL
0,1884,81,1965,2492,0,0,78.85,688,1196,"同樂村",NULL
0,593,43,636,850,0,0,74.82,224,369,"湖東村",NULL
0,598,41,639,824,0,0,77.55,153,445,"逸仙村",NULL
0,727,52,779,1008,0,0,77.28,257,470,"湖北村",NULL
0,1033,77,1110,1457,0,0,76.18,276,757,"湖西村",NULL
0,1056,44,1100,1346,0,0,81.72,322,734,"珍珠村",NULL
0,766,33,799,988,0,0,80.87,220,546,"補城村",NULL
0,613,39,652,820,0,0,79.51,188,425,"三奇村",NULL
0,737,26,763,956,0,0,79.81,219,518,"大興村",NULL
0,944,33,977,1223,0,0,79.89,339,605,"東城村",NULL
0,1592,78,1670,2071,0,0,80.64,536,1056,"香和村",NULL
0,1512,45,1557,1915,0,0,81.31,543,969,"南興村",NULL
0,520,20,540,702,0,0,76.92,149,371,"安平村",NULL
0,631,19,650,833,0,0,78.03,232,399,"冬山村",NULL
0,1074,45,1119,1321,0,0,84.71,346,728,"太和村",NULL
0,612,21,633,796,0,0,79.52,181,431,"八寶村",NULL
0,999,43,1042,1276,0,0,81.66,308,691,"丸山村",NULL
0,365,17,382,449,0,0,85.08,93,272,"中山村",NULL
0,3278,98,3376,4344,0,0,77.72,1058,2220,"順安村",NULL
0,1582,58,1640,2048,0,0,80.08,528,1054,"永美村",NULL
0,820,42,862,1055,0,0,81.71,242,578,"武淵村",NULL
0,3562,78,3640,4507,0,0,80.76,1364,2198,"群英村",NULL
0,2056,52,2108,2706,0,0,77.9,727,1329,"清溝村",NULL
0,1642,99,1741,2212,0,0,78.71,538,1104,"鹿埔村",NULL
0,771,39,810,1050,0,0,77.14,293,478,"得安村",NULL
0,1724,64,1788,2209,0,0,80.94,589,1135,"廣興村",NULL
0,1002,49,1051,1347,0,0,78.03,362,640,"廣安村",NULL
0,870,28,898,1111,0,0,80.83,277,593,"柯林村",NULL
0,644,37,681,847,0,0,80.4,155,489,"大進村",NULL
0,1163,59,1222,1572,0,0,77.74,315,848,"三興村",NULL
0,1174,34,1208,1476,0,0,81.84,483,691,"二結村",NULL
0,1618,27,1645,2070,0,0,79.47,541,1077,"鎮安村",NULL
0,1139,27,1166,1466,0,0,79.54,418,721,"上四村",NULL
0,784,26,810,1040,0,0,77.88,263,521,"中興村",NULL
0,1620,52,1672,2089,0,0,80.04,701,919,"四結村",NULL
0,1149,42,1191,1499,0,0,79.45,375,774,"福興村",NULL
0,2163,52,2215,2781,0,0,79.65,846,1317,"五結村",NULL
0,2196,66,2262,2776,0,0,81.48,816,1380,"大吉村",NULL
0,1803,59,1862,2366,0,0,78.7,560,1243,"協和村",NULL
0,999,55,1054,1361,0,0,77.44,266,733,"孝威村",NULL
0,1075,67,1142,1467,0,0,77.85,333,742,"錦眾村",NULL
0,1489,60,1549,1970,0,0,78.63,489,1000,"利澤村",NULL
0,1786,67,1853,2355,0,0,78.68,537,1249,"成興村",NULL
0,1864,73,1937,2504,0,0,77.36,624,1240,"季新村",NULL
0,185,3,188,246,0,0,76.42,79,106,"員山村",NULL
0,412,20,432,584,0,0,73.97,159,253,"天山村",NULL
0,547,42,589,796,0,0,73.99,163,384,"天福村",NULL
0,472,39,511,672,0,0,76.04,145,327,"雙賢村",NULL
0,335,26,361,463,0,0,77.97,151,184,"人和村",NULL
0,817,46,863,1103,0,0,78.24,381,436,"義德村",NULL
0,870,40,910,1184,0,0,76.86,335,535,"集慶村",NULL
0,586,41,627,800,0,0,78.38,240,346,"月眉村",NULL
0,743,57,800,1004,0,0,79.68,225,518,"拱照村",NULL
0,2340,110,2450,3156,0,0,77.63,820,1520,"大隱村",NULL
0,479,33,512,667,0,0,76.76,153,326,"行健村",NULL
0,418,28,446,585,0,0,76.24,198,220,"萬德村",NULL
0,349,16,365,495,0,0,73.74,158,191,"貴林村",NULL
0,505,27,532,678,0,0,78.47,155,350,"萬富村",NULL
0,810,39,849,1087,0,0,78.1,211,599,"大義村",NULL
0,573,41,614,783,0,0,78.42,171,402,"尚武村",NULL
0,987,41,1028,1257,0,0,81.78,239,748,"大洲村",NULL
0,879,43,922,1138,0,0,81.02,185,694,"尾塹村",NULL
0,579,25,604,753,0,0,80.21,527,52,"寒溪村",NULL
0,369,9,378,479,0,0,78.91,338,31,"崙埤村",NULL
0,423,17,440,557,0,0,78.99,285,138,"松羅村",NULL
0,204,9,213,291,0,0,73.2,103,101,"復興村",NULL
0,221,6,227,331,0,0,68.58,168,53,"英士村",NULL
0,222,11,233,303,0,0,76.9,191,31,"樂水村",NULL
0,44,2,46,68,0,0,67.65,19,25,"太平村",NULL
0,150,2,152,174,0,0,87.36,138,12,"茂安村",NULL
0,457,29,486,613,0,0,79.28,431,26,"四季村",NULL
0,442,11,453,543,0,0,83.43,329,113,"南山村",NULL
0,320,10,330,417,0,0,79.14,297,23,"東岳村",NULL
0,788,16,804,1019,0,0,78.9,721,67,"南澳村",NULL
0,585,13,598,736,0,0,81.25,544,41,"碧候村",NULL
0,273,3,276,364,0,0,75.82,255,18,"金岳村",NULL
0,303,4,307,409,0,0,75.06,238,65,"武塔村",NULL
0,299,15,314,407,0,0,77.15,281,18,"金洋村",NULL
0,451,18,469,625,0,0,75.04,412,39,"澳花村",NULL
0,4352,85,4437,5330,0,0,83.25,2097,2255,"大林里",NULL
0,3859,81,3940,4758,0,0,82.81,2217,1642,"雲林里",NULL
0,3373,83,3456,4166,0,0,82.96,1711,1662,"大豐里",NULL
0,3655,97,3752,4479,0,0,83.77,1943,1712,"福林里",NULL
0,2611,79,2690,3287,0,0,81.84,1361,1250,"福安里",NULL
0,4062,100,4162,5088,0,0,81.8,2102,1960,"豐林里",NULL
0,3415,72,3487,4296,0,0,81.17,1840,1575,"建國里",NULL
0,2058,24,2082,2607,0,0,79.86,1138,920,"東門里",NULL
0,1455,34,1489,1858,0,0,80.14,711,744,"東山里",NULL
0,721,31,752,914,0,0,82.28,352,369,"萬壽里",NULL
0,1162,50,1212,1542,0,0,78.6,559,603,"武陵里",NULL
0,1122,31,1153,1409,0,0,81.83,533,589,"民生里",NULL
0,640,12,652,806,0,0,80.89,369,271,"文化里",NULL
0,1107,42,1149,1406,0,0,81.72,598,509,"文明里",NULL
0,760,10,770,944,0,0,81.57,314,446,"文昌里",NULL
0,3845,92,3937,4798,0,0,82.06,2027,1818,"南門里",NULL
0,1128,22,1150,1375,0,0,83.64,481,647,"南華里",NULL
0,1052,29,1081,1376,0,0,78.56,506,546,"西門里",NULL
0,1097,22,1119,1334,0,0,83.88,570,527,"西湖里",NULL
0,757,11,768,925,0,0,83.03,300,457,"長美里",NULL
0,1391,38,1429,1726,0,0,82.79,553,838,"永興里",NULL
0,3839,92,3931,4738,0,0,82.97,1832,2007,"中興里",NULL
0,3490,91,3581,4687,0,0,76.4,1706,1784,"光興里",NULL
0,2470,52,2522,3077,0,0,81.96,1390,1080,"中路里",NULL
0,2929,69,2998,3698,0,0,81.07,1534,1395,"中信里",NULL
0,3595,65,3660,4437,0,0,82.49,1960,1635,"中山里",NULL
0,2737,63,2800,3453,0,0,81.09,1568,1169,"中平里",NULL
0,2246,43,2289,2771,0,0,82.61,1384,862,"中原里",NULL
0,4840,71,4911,6011,0,0,81.7,3172,1668,"中泰里",NULL
0,3476,103,3579,4342,0,0,82.43,1870,1606,"中德里",NULL
0,3386,76,3462,4145,0,0,83.52,1888,1498,"中正里",NULL
0,2038,48,2086,2505,0,0,83.27,1088,950,"文中里",NULL
0,2892,83,2975,3651,0,0,81.48,1378,1514,"中成里",NULL
0,3328,92,3420,4210,0,0,81.24,1602,1726,"玉山里",NULL
0,2400,69,2469,3013,0,0,81.94,1275,1125,"泰山里",NULL
0,3034,54,3088,3770,0,0,81.91,1901,1133,"龍岡里",NULL
0,2417,42,2459,2992,0,0,82.19,1347,1070,"龍安里",NULL
0,3562,75,3637,4463,0,0,81.49,2175,1387,"龍鳳里",NULL
0,4551,93,4644,5750,0,0,80.77,2712,1839,"龍祥里",NULL
0,2609,107,2716,3356,0,0,80.93,1575,1034,"龍山里",NULL
0,3225,90,3315,4044,0,0,81.97,1476,1749,"東埔里",NULL
0,3268,90,3358,4156,0,0,80.8,1572,1696,"信光里",NULL
0,3063,91,3154,3847,0,0,81.99,1281,1782,"永安里",NULL
0,5953,74,6027,7361,0,0,81.88,3446,2507,"中寧里",NULL
0,1563,61,1624,1947,0,0,83.41,556,1007,"中埔里",NULL
0,2415,32,2447,2966,0,0,82.5,1245,1170,"南埔里",NULL
0,4470,79,4549,5626,0,0,80.86,2685,1785,"寶慶里",NULL
0,5095,88,5183,6530,0,0,79.37,2955,2140,"北埔里",NULL
0,1968,84,2052,2410,0,0,85.15,660,1308,"西埔里",NULL
0,3508,94,3602,4449,0,0,80.96,1770,1738,"慈文里",NULL
0,4391,102,4493,5401,0,0,83.19,2596,1795,"新埔里",NULL
0,4061,75,4136,5119,0,0,80.8,2150,1911,"同安里",NULL
0,4101,65,4166,5136,0,0,81.11,2529,1572,"莊敬里",NULL
0,3896,50,3946,4773,0,0,82.67,2256,1640,"自強里",NULL
0,2262,66,2328,2867,0,0,81.2,1084,1178,"長安里",NULL
0,2538,64,2602,3208,0,0,81.11,1227,1311,"長德里",NULL
0,1160,28,1188,1408,0,0,84.38,450,710,"中和里",NULL
0,1267,41,1308,1584,0,0,82.58,550,717,"北門里",NULL
0,1445,51,1496,1867,0,0,80.13,681,764,"朝陽里",NULL
0,3426,87,3513,4252,0,0,82.62,1526,1900,"青溪里",NULL
0,2799,41,2840,3386,0,0,83.87,1563,1236,"成功里",NULL
0,2903,62,2965,3587,0,0,82.66,1880,1023,"三民里",NULL
0,5192,128,5320,6588,0,0,80.75,3130,2062,"忠義里",NULL
0,4662,119,4781,5900,0,0,81.03,2421,2241,"大興里",NULL
0,3786,64,3850,4952,0,0,77.75,2376,1410,"會稽里",NULL
0,2044,38,2082,2600,0,0,80.08,1348,696,"大有里",NULL
0,3597,62,3659,4585,0,0,79.8,2173,1424,"寶山里",NULL
0,3421,102,3523,4463,0,0,78.94,1846,1575,"春日里",NULL
0,2646,102,2748,3336,0,0,82.37,1239,1407,"汴洲里",NULL
0,2621,74,2695,3383,0,0,79.66,1645,976,"後寮里",NULL
0,2827,57,2884,3508,0,0,82.21,1558,1269,"明德里",NULL
0,4333,105,4438,5521,0,0,80.38,3134,1199,"至善里",NULL
0,2785,68,2853,3453,0,0,82.62,1629,1156,"龍興里",NULL
0,1980,59,2039,2492,0,0,81.82,1359,621,"龍德里",NULL
0,3150,102,3252,3890,0,0,83.6,2321,829,"龍岡里",NULL
0,3383,106,3489,4140,0,0,84.28,2773,610,"龍東里",NULL
0,3609,126,3735,4539,0,0,82.29,2545,1064,"龍昌里",NULL
0,2304,83,2387,2813,0,0,84.86,1905,399,"龍平里",NULL
0,2005,65,2070,2423,0,0,85.43,1704,301,"龍安里",NULL
0,2832,65,2897,3505,0,0,82.65,1846,986,"仁美里",NULL
0,2914,87,3001,3723,0,0,80.61,2096,818,"仁福里",NULL
0,1698,48,1746,2114,0,0,82.59,1023,675,"仁愛里",NULL
0,1718,40,1758,2152,0,0,81.69,1251,467,"華愛里",NULL
0,1964,79,2043,2471,0,0,82.68,1467,497,"仁德里",NULL
0,1795,46,1841,2279,0,0,80.78,1274,521,"仁和里",NULL
0,2130,70,2200,2673,0,0,82.3,1594,536,"仁祥里",NULL
0,2338,90,2428,2848,0,0,85.25,1884,454,"華勛里",NULL
0,3147,123,3270,3972,0,0,82.33,2722,425,"中堅里",NULL
0,2667,83,2750,3424,0,0,80.32,1545,1122,"普仁里",NULL
0,1981,54,2035,2521,0,0,80.72,1229,752,"普忠里",NULL
0,2407,43,2450,2913,0,0,84.11,1570,837,"普強里",NULL
0,2588,57,2645,3161,0,0,83.68,1550,1038,"信義里",NULL
0,2712,56,2768,3432,0,0,80.65,1539,1173,"正義里",NULL
0,1851,51,1902,2295,0,0,82.88,1084,767,"普慶里",NULL
0,1491,29,1520,1869,0,0,81.33,916,575,"普義里",NULL
0,1816,52,1868,2255,0,0,82.84,994,822,"德義里",NULL
0,1889,41,1930,2417,0,0,79.85,1015,874,"仁義里",NULL
0,1204,32,1236,1515,0,0,81.58,670,534,"忠義里",NULL
0,2277,78,2355,2966,0,0,79.4,1584,693,"興仁里",NULL
0,2843,70,2913,3557,0,0,81.89,2032,811,"中正里",NULL
0,4262,94,4356,5336,0,0,81.63,3003,1259,"中山里",NULL
0,1399,67,1466,1840,0,0,79.67,1137,262,"篤行里",NULL
0,2764,60,2824,3363,0,0,83.97,2124,640,"自立里",NULL
0,2174,38,2212,2673,0,0,82.75,1538,636,"自強里",NULL
0,2234,48,2282,2692,0,0,84.77,1948,286,"自治里",NULL
0,1513,45,1558,1871,0,0,83.27,1239,274,"莊敬里",NULL
0,1857,71,1928,2366,0,0,81.49,1282,575,"內壢里",NULL
0,2307,68,2375,2941,0,0,80.75,1466,841,"成功里",NULL
0,2027,51,2078,2509,0,0,82.82,1258,769,"福德里",NULL
0,2916,77,2993,3607,0,0,82.98,1701,1215,"中原里",NULL
0,1727,53,1780,2175,0,0,81.84,1065,662,"忠孝里",NULL
0,3474,95,3569,4440,0,0,80.38,2103,1371,"復興里",NULL
0,2752,75,2827,3394,0,0,83.29,1698,1054,"復華里",NULL
0,3967,94,4061,5034,0,0,80.67,2254,1713,"文化里",NULL
0,1611,48,1659,1981,0,0,83.75,964,647,"和平里",NULL
0,2830,110,2940,3522,0,0,83.48,1206,1624,"內定里",NULL
0,1410,43,1453,2343,0,0,62.01,709,701,"石頭里",NULL
0,2579,74,2653,3247,0,0,81.71,1430,1149,"中央里",NULL
0,4911,110,5021,6122,0,0,82.02,2836,2075,"新興里",NULL
0,3261,74,3335,4050,0,0,82.35,1923,1338,"振興里",NULL
0,2029,57,2086,2619,0,0,79.65,1063,966,"東興里",NULL
0,2723,58,2781,3463,0,0,80.31,1600,1123,"健行里",NULL
0,4174,93,4267,5108,0,0,83.54,2372,1802,"水尾里",NULL
0,4323,114,4437,5358,0,0,82.81,2283,2040,"忠福里",NULL
0,3365,68,3433,4231,0,0,81.14,1854,1511,"幸福里",NULL
0,3395,79,3474,4239,0,0,81.95,1753,1642,"永福里",NULL
0,897,20,917,1098,0,0,83.52,431,466,"青埔里",NULL
0,1470,48,1518,1950,0,0,77.85,826,644,"新街里",NULL
0,1598,17,1615,2063,0,0,78.28,899,699,"興南里",NULL
0,3575,84,3659,4461,0,0,82.02,1701,1874,"興國里",NULL
0,2044,60,2104,2503,0,0,84.06,857,1187,"興和里",NULL
0,815,32,847,1040,0,0,81.44,408,407,"永興里",NULL
0,670,26,696,836,0,0,83.25,311,359,"中壢里",NULL
0,729,21,750,979,0,0,76.61,345,384,"中榮里",NULL
0,821,11,832,1064,0,0,78.2,359,462,"中建里",NULL
0,1708,60,1768,2119,0,0,83.44,1025,683,"舊明里",NULL
0,2883,70,2953,3572,0,0,82.67,1456,1427,"新明里",NULL
0,3536,104,3640,4472,0,0,81.4,2062,1474,"光明里",NULL
0,2616,68,2684,3311,0,0,81.06,1324,1292,"永光里",NULL
0,2111,78,2189,2646,0,0,82.73,864,1247,"三民里",NULL
0,3254,87,3341,4126,0,0,80.97,1540,1714,"五權里",NULL
0,2581,85,2666,3281,0,0,81.26,1216,1365,"五福里",NULL
0,1609,73,1682,2006,0,0,83.85,513,1096,"芝芭里",NULL
0,982,53,1035,1285,0,0,80.54,334,648,"洽溪里",NULL
0,2760,118,2878,3519,0,0,81.78,1049,1711,"內厝里",NULL
0,2571,93,2664,3146,0,0,84.68,706,1865,"月眉里",NULL
0,2269,118,2387,2859,0,0,83.49,713,1556,"山東里",NULL
0,2021,66,2087,2500,0,0,83.48,866,1155,"過嶺里",NULL
0,2532,117,2649,3249,0,0,81.53,1250,1282,"平鎮里",NULL
0,1932,76,2008,2447,0,0,82.06,901,1031,"鎮興里",NULL
0,3029,87,3116,3835,0,0,81.25,1588,1441,"南勢里",NULL
0,1785,37,1822,2266,0,0,80.41,968,817,"金星里",NULL
0,2432,75,2507,3053,0,0,82.12,1233,1199,"平安里",NULL
0,2764,53,2817,3422,0,0,82.32,1682,1082,"平南里",NULL
0,1847,55,1902,2302,0,0,82.62,1217,630,"山峰里",NULL
0,1674,66,1740,2064,0,0,84.3,825,849,"福林里",NULL
0,3631,118,3749,4546,0,0,82.47,2323,1308,"湧光里",NULL
0,3191,112,3303,3959,0,0,83.43,2332,859,"莊敬里",NULL
0,1150,38,1188,1440,0,0,82.5,673,477,"湧豐里",NULL
0,2322,72,2394,2988,0,0,80.12,1363,959,"湧安里",NULL
0,2351,71,2422,2997,0,0,80.81,1292,1059,"宋屋里",NULL
0,2035,47,2082,2651,0,0,78.54,1247,788,"平興里",NULL
0,3329,56,3385,4133,0,0,81.9,1724,1605,"廣興里",NULL
0,2468,65,2533,3053,0,0,82.97,1161,1307,"廣達里",NULL
0,2736,86,2822,3569,0,0,79.07,1502,1234,"廣仁里",NULL
0,2690,39,2729,3312,0,0,82.4,1655,1035,"復旦里",NULL
0,2864,77,2941,3540,0,0,83.08,1508,1356,"復興里",NULL
0,2689,55,2744,3343,0,0,82.08,1551,1138,"義民里",NULL
0,3957,108,4065,4864,0,0,83.57,2056,1901,"義興里",NULL
0,3014,126,3140,3809,0,0,82.44,1834,1180,"雙連里",NULL
0,2260,65,2325,2791,0,0,83.3,970,1290,"高雙里",NULL
0,1880,33,1913,2291,0,0,83.5,981,899,"北勢里",NULL
0,1994,41,2035,2422,0,0,84.02,1123,871,"北華里",NULL
0,2743,69,2812,3473,0,0,80.97,1457,1286,"新勢里",NULL
0,1283,43,1326,1568,0,0,84.57,645,638,"北安里",NULL
0,3217,74,3291,3992,0,0,82.44,1840,1377,"新榮里",NULL
0,2403,48,2451,3200,0,0,76.59,1459,944,"新富里",NULL
0,1738,27,1765,2133,0,0,82.75,1164,574,"新英里",NULL
0,2854,71,2925,3597,0,0,81.32,1545,1309,"北興里",NULL
0,1401,33,1434,1698,0,0,84.45,805,596,"金陵里",NULL
0,2162,67,2229,2707,0,0,82.34,1098,1064,"新貴里",NULL
0,2808,90,2898,3523,0,0,82.26,1456,1352,"建安里",NULL
0,2848,63,2911,3522,0,0,82.65,2137,711,"華安里",NULL
0,1806,69,1875,2278,0,0,82.31,1271,535,"東安里",NULL
0,2468,79,2547,3133,0,0,81.3,1644,824,"新安里",NULL
0,3334,103,3437,4194,0,0,81.95,1561,1773,"東勢里",NULL
0,2508,58,2566,3125,0,0,82.11,1379,1129,"北貴里",NULL
0,2624,65,2689,3237,0,0,83.07,1384,1240,"北富里",NULL
0,2076,31,2107,2631,0,0,80.08,1574,502,"龍恩里",NULL
0,2484,93,2577,3110,0,0,82.86,1659,825,"東社里",NULL
0,955,37,992,1258,0,0,78.86,922,33,"忠貞里",NULL
0,1748,68,1816,2171,0,0,83.65,1676,72,"貿易里",NULL
0,1813,74,1887,2295,0,0,82.22,1385,428,"龍興里",NULL
0,1091,46,1137,1347,0,0,84.41,1023,68,"中正里",NULL
0,2552,87,2639,3625,0,0,72.8,1374,1178,"興仁里",NULL
0,2270,77,2347,2853,0,0,82.26,1201,1069,"福興里",NULL
0,1126,43,1169,1395,0,0,83.8,782,344,"瑞豐里",NULL
0,1743,53,1796,2191,0,0,81.97,892,851,"瑞興里",NULL
0,2451,67,2518,3146,0,0,80.04,1335,1116,"瑞泰里",NULL
0,2516,110,2626,3193,0,0,82.24,1630,886,"瑞發里",NULL
0,2567,61,2628,3204,0,0,82.02,1906,661,"瑞德里",NULL
0,2430,95,2525,3028,0,0,83.39,1833,597,"瑞祥里",NULL
0,3885,128,4013,4896,0,0,81.96,2067,1818,"廣興里",NULL
0,2510,105,2615,3081,0,0,84.88,1575,935,"廣隆里",NULL
0,2297,68,2365,2925,0,0,80.85,1274,1023,"竹園里",NULL
0,3094,112,3206,3930,0,0,81.58,2145,949,"霄裡里",NULL
0,2325,60,2385,3033,0,0,78.64,1396,929,"茄明里",NULL
0,3367,105,3472,4208,0,0,82.51,1669,1698,"茄苳里",NULL
0,2402,93,2495,3075,0,0,81.14,1282,1120,"高明里",NULL
0,1633,47,1680,2080,0,0,80.77,923,710,"高城里",NULL
0,1975,69,2044,2480,0,0,82.42,976,999,"白鷺里",NULL
0,2149,57,2206,2736,0,0,80.63,1043,1106,"大湳里",NULL
0,1328,42,1370,1722,0,0,79.56,630,698,"大發里",NULL
0,2569,64,2633,3194,0,0,82.44,1265,1304,"大仁里",NULL
0,1799,38,1837,2273,0,0,80.82,847,952,"大明里",NULL
0,2086,59,2145,2573,0,0,83.37,998,1088,"大安里",NULL
0,1157,42,1199,1492,0,0,80.36,568,589,"大竹里",NULL
0,1827,49,1876,2223,0,0,84.39,940,887,"大興里",NULL
0,1479,43,1522,1818,0,0,83.72,921,558,"大愛里",NULL
0,3224,81,3305,4106,0,0,80.49,1964,1260,"大華里",NULL
0,2513,68,2581,3222,0,0,80.11,1605,908,"大和里",NULL
0,2113,78,2191,2659,0,0,82.4,1260,853,"大昌里",NULL
0,3055,257,3312,4897,0,0,67.63,2236,819,"大信里",NULL
0,2949,95,3044,3564,0,0,85.41,2270,679,"大同里",NULL
0,1125,29,1154,1414,0,0,81.61,637,488,"大慶里",NULL
0,2788,111,2899,3462,0,0,83.74,1538,1250,"大成里",NULL
0,2461,107,2568,3163,0,0,81.19,1609,852,"大義里",NULL
0,1433,67,1500,1876,0,0,79.96,894,539,"大忠里",NULL
0,1958,71,2029,2402,0,0,84.47,1406,552,"大智里",NULL
0,1694,21,1715,2069,0,0,82.89,1043,651,"大宏里",NULL
0,1716,24,1740,2148,0,0,81.01,966,750,"大正里",NULL
0,2796,53,2849,3459,0,0,82.36,1497,1299,"大福里",NULL
0,2095,62,2157,2633,0,0,81.92,1024,1071,"大強里",NULL
0,1817,57,1874,2240,0,0,83.66,943,874,"大勇里",NULL
0,1220,25,1245,1547,0,0,80.48,659,561,"大榮里",NULL
0,1272,54,1326,1611,0,0,82.31,859,413,"大千里",NULL
0,2088,50,2138,2608,0,0,81.98,1415,673,"大漢里",NULL
0,3021,94,3115,3837,0,0,81.18,1823,1198,"仁美里",NULL
0,1199,27,1226,1494,0,0,82.06,557,642,"埔心里",NULL
0,2424,91,2515,3004,0,0,83.72,1558,866,"光華里",NULL
0,1147,52,1199,1401,0,0,85.58,1097,50,"金龍里",NULL
0,1216,39,1255,1525,0,0,82.3,931,285,"四維里",NULL
0,1098,28,1126,1429,0,0,78.8,677,421,"永平里",NULL
0,2975,100,3075,3872,0,0,79.42,1673,1302,"瑞塘里",NULL
0,1992,40,2032,2572,0,0,79,1372,620,"瑞坪里",NULL
0,2520,67,2587,3280,0,0,78.87,1494,1026,"梅溪里",NULL
0,2933,61,2994,3756,0,0,79.71,1951,982,"金溪里",NULL
0,2111,44,2155,2663,0,0,80.92,1316,795,"楊明里",NULL
0,2757,55,2812,3676,0,0,76.5,1893,864,"裕成里",NULL
0,2324,80,2404,2891,0,0,83.15,1400,924,"大同里",NULL
0,1773,27,1800,2206,0,0,81.6,1089,684,"中山里",NULL
0,2274,84,2358,2936,0,0,80.31,1296,978,"楊梅里",NULL
0,901,32,933,1164,0,0,80.15,529,372,"楊江里",NULL
0,1189,52,1241,1579,0,0,78.59,724,465,"梅新里",NULL
0,1644,39,1683,2031,0,0,82.87,919,725,"紅梅里",NULL
0,2904,99,3003,3793,0,0,79.17,1569,1335,"永寧里",NULL
0,2291,112,2403,2961,0,0,81.16,1299,992,"大平里",NULL
0,2150,99,2249,2763,0,0,81.4,1147,1003,"秀才里",NULL
0,1762,73,1835,2307,0,0,79.54,872,890,"東流里",NULL
0,2330,90,2420,3008,0,0,80.45,1249,1081,"豐野里",NULL
0,3106,154,3260,4059,0,0,80.32,1588,1518,"富岡里",NULL
0,1432,71,1503,1860,0,0,80.81,673,759,"員本里",NULL
0,2469,80,2549,3301,0,0,77.22,1347,1122,"三湖里",NULL
0,2428,126,2554,3285,0,0,77.75,1341,1087,"上湖里",NULL
0,1831,44,1875,2264,0,0,82.82,829,1002,"上田里",NULL
0,2918,111,3029,3791,0,0,79.9,1619,1299,"高山里",NULL
0,1317,35,1352,1807,0,0,74.82,869,448,"青山里",NULL
0,1696,36,1732,2133,0,0,81.2,797,899,"高榮里",NULL
0,1429,36,1465,1819,0,0,80.54,751,678,"雙榮里",NULL
0,1943,36,1979,2409,0,0,82.15,1012,931,"新榮里",NULL
0,2418,80,2498,3176,0,0,78.65,1284,1134,"水美里",NULL
0,2378,110,2488,3153,0,0,78.91,1242,1136,"瑞原里",NULL
0,1357,47,1404,1670,0,0,84.07,523,834,"興和里",NULL
0,867,24,891,1079,0,0,82.58,257,610,"福仁里",NULL
0,3091,87,3178,3827,0,0,83.04,1246,1845,"田心里",NULL
0,2801,84,2885,3497,0,0,82.5,1236,1565,"一心里",NULL
0,3297,100,3397,4160,0,0,81.66,1401,1896,"一德里",NULL
0,869,29,898,1065,0,0,84.32,284,585,"月眉里",NULL
0,726,27,753,947,0,0,79.51,234,492,"永福里",NULL
0,859,24,883,1069,0,0,82.6,261,598,"康安里",NULL
0,1213,79,1292,1583,0,0,81.62,378,835,"義和里",NULL
0,2263,97,2360,2812,0,0,83.93,784,1479,"美華里",NULL
0,1673,84,1757,2155,0,0,81.53,504,1169,"福安里",NULL
0,737,53,790,969,0,0,81.53,246,491,"復興里",NULL
0,720,14,734,918,0,0,79.96,269,451,"新峰里",NULL
0,1254,59,1313,1585,0,0,82.84,437,817,"中新里",NULL
0,1867,85,1952,2473,0,0,78.93,767,1100,"瑞興里",NULL
0,2177,84,2261,2755,0,0,82.07,1160,1017,"仁善里",NULL
0,1435,64,1499,1765,0,0,84.93,1320,115,"僑愛里",NULL
0,2124,109,2233,2710,0,0,82.4,1770,354,"仁義里",NULL
0,1934,63,1997,2514,0,0,79.44,1119,815,"仁和里",NULL
0,1839,60,1899,2291,0,0,82.89,970,869,"仁愛里",NULL
0,1715,57,1772,2186,0,0,81.06,1090,625,"仁武里",NULL
0,2351,97,2448,3044,0,0,80.42,1380,971,"仁文里",NULL
0,3292,149,3441,4243,0,0,81.1,1470,1822,"南興里",NULL
0,938,35,973,1173,0,0,82.95,542,396,"員林里",NULL
0,1518,46,1564,1978,0,0,79.07,1073,445,"光明里",NULL
0,2423,85,2508,3046,0,0,82.34,1176,1247,"瑞源里",NULL
0,2038,62,2100,2527,0,0,83.1,1498,540,"三元里",NULL
0,3682,129,3811,4695,0,0,81.17,1944,1738,"龜山村",NULL
0,4177,140,4317,5247,0,0,82.28,2313,1864,"新路村",NULL
0,3419,81,3500,4361,0,0,80.26,1919,1500,"大同村",NULL
0,3000,104,3104,3864,0,0,80.33,1588,1412,"中興村",NULL
0,1201,36,1237,1730,0,0,71.5,865,336,"新興村",NULL
0,512,21,533,679,0,0,78.5,496,16,"陸光村",NULL
0,1818,59,1877,2174,0,0,86.34,1511,307,"精忠村",NULL
0,1432,50,1482,1841,0,0,80.5,798,634,"福源村",NULL
0,2056,60,2116,2760,0,0,76.67,1063,993,"兔坑村",NULL
0,3465,84,3549,4460,0,0,79.57,1789,1676,"迴龍村",NULL
0,2129,46,2175,2735,0,0,79.52,1131,998,"龍華村",NULL
0,1231,48,1279,1556,0,0,82.2,475,756,"龍壽村",NULL
0,2404,86,2490,3174,0,0,78.45,1098,1306,"嶺頂村",NULL
0,2347,70,2417,3115,0,0,77.59,1247,1100,"新嶺村",NULL
0,1510,98,1608,1952,0,0,82.38,533,977,"舊路村",NULL
0,3746,115,3861,4820,0,0,80.1,1995,1751,"山德村",NULL
0,2932,107,3039,4143,0,0,73.35,1700,1232,"山頂村",NULL
0,2232,60,2292,2858,0,0,80.2,1154,1078,"山福村",NULL
0,3288,108,3396,4387,0,0,77.41,1965,1323,"幸福村",NULL
0,1945,34,1979,2459,0,0,80.48,1173,772,"大湖村",NULL
0,2631,42,2673,3347,0,0,79.86,1391,1240,"大華村",NULL
0,2404,112,2516,3143,0,0,80.05,1343,1061,"大崗村",NULL
0,926,44,970,1187,0,0,81.72,499,427,"公西村",NULL
0,2279,60,2339,2901,0,0,80.63,1151,1128,"文化村",NULL
0,2172,59,2231,2914,0,0,76.56,1118,1054,"樂善村",NULL
0,2205,43,2248,2762,0,0,81.39,1168,1037,"長庚村",NULL
0,1068,43,1111,1361,0,0,81.63,410,658,"大坑村",NULL
0,1046,44,1090,1308,0,0,83.33,476,570,"南上村",NULL
0,1136,35,1171,1432,0,0,81.77,579,557,"南美村",NULL
0,2483,62,2545,3073,0,0,82.82,1128,1355,"楓樹村",NULL
0,2673,99,2772,3327,0,0,83.32,933,1740,"新興村",NULL
0,2686,89,2775,3391,0,0,81.83,997,1689,"中福村",NULL
0,2401,58,2459,3031,0,0,81.13,936,1465,"新莊村",NULL
0,1812,38,1850,2202,0,0,84.01,885,927,"上竹村",NULL
0,1811,82,1893,2231,0,0,84.85,664,1147,"宏竹村",NULL
0,2378,56,2434,2927,0,0,83.16,1237,1141,"大竹村",NULL
0,937,40,977,1150,0,0,84.96,254,683,"富竹村",NULL
0,1269,56,1325,1593,0,0,83.18,1227,42,"大華村",NULL
0,2388,120,2508,2945,0,0,85.16,728,1660,"蘆竹村",NULL
0,8136,167,8303,10232,0,0,81.15,4491,3645,"南興村",NULL
0,2290,55,2345,2906,0,0,80.7,1209,1081,"南榮村",NULL
0,2051,58,2109,2707,0,0,77.91,1003,1048,"南崁村",NULL
0,2577,70,2647,3180,0,0,83.24,1303,1274,"錦興村",NULL
0,1481,45,1526,1850,0,0,82.49,644,837,"錦中村",NULL
0,1379,33,1412,1787,0,0,79.02,631,748,"長興村",NULL
0,3553,62,3615,4458,0,0,81.09,2005,1548,"五福村",NULL
0,4530,87,4617,5585,0,0,82.67,2708,1822,"羊稠村",NULL
0,3049,57,3106,3897,0,0,79.7,1752,1297,"營盤村",NULL
0,1291,39,1330,1782,0,0,74.64,761,530,"瓦窯村",NULL
0,1535,70,1605,1917,0,0,83.72,608,927,"內厝村",NULL
0,1150,55,1205,1485,0,0,81.14,460,690,"山鼻村",NULL
0,2527,110,2637,3222,0,0,81.84,912,1615,"山腳村",NULL
0,991,58,1049,1241,0,0,84.53,292,699,"外社村",NULL
0,1268,66,1334,1580,0,0,84.43,320,948,"坑子村",NULL
0,1737,102,1839,2199,0,0,83.63,650,1087,"坑口村",NULL
0,3120,137,3257,4168,0,0,78.14,1610,1510,"海湖村",NULL
0,4132,171,4303,5264,0,0,81.74,1894,2238,"大園村",NULL
0,3412,127,3539,4419,0,0,80.09,1480,1932,"田心村",NULL
0,2502,146,2648,3383,0,0,78.27,1068,1434,"溪海村",NULL
0,1104,68,1172,1428,0,0,82.07,360,744,"和平村",NULL
0,3953,169,4122,5198,0,0,79.3,1842,2111,"橫峰村",NULL
0,3003,138,3141,3798,0,0,82.7,1075,1928,"五權村",NULL
0,3500,156,3656,4440,0,0,82.34,1470,2030,"埔心村",NULL
0,1096,45,1141,1371,0,0,83.22,638,458,"大海村",NULL
0,587,29,616,721,0,0,85.44,568,19,"建華村",NULL
0,2068,112,2180,2582,0,0,84.43,970,1098,"三石村",NULL
0,3504,106,3610,4559,0,0,79.18,1648,1856,"菓林村",NULL
0,1826,69,1895,2341,0,0,80.95,944,882,"竹圍村",NULL
0,1105,59,1164,1437,0,0,81,562,543,"海口村",NULL
0,1887,113,2000,2570,0,0,77.82,918,969,"沙崙村",NULL
0,1417,12,1429,1759,0,0,81.24,632,785,"後厝村",NULL
0,1545,62,1607,2025,0,0,79.36,613,932,"圳頭村",NULL
0,1366,73,1439,1785,0,0,80.62,633,733,"內海村",NULL
0,1760,94,1854,2352,0,0,78.83,783,977,"北港村",NULL
0,1982,68,2050,2700,0,0,75.93,970,1012,"南港村",NULL
0,2814,77,2891,3600,0,0,80.31,1635,1179,"黃唐村",NULL
0,2000,82,2082,2515,0,0,82.78,1182,818,"永興村",NULL
0,3086,108,3194,3837,0,0,83.24,1714,1372,"中山村",NULL
0,1474,48,1522,1936,0,0,78.62,734,740,"烏樹林村",NULL
0,2457,98,2555,3202,0,0,79.79,1585,872,"烏林村",NULL
0,1890,34,1924,2334,0,0,82.43,1388,502,"百年村",NULL
0,460,29,489,598,0,0,81.77,447,13,"干城村",NULL
0,2230,106,2336,2920,0,0,80,1396,834,"凌雲村",NULL
0,1914,73,1987,2439,0,0,81.47,1279,635,"龍祥村",NULL
0,2473,90,2563,3218,0,0,79.65,1403,1070,"八德村",NULL
0,1770,54,1824,2361,0,0,77.26,995,775,"聖德村",NULL
0,2290,79,2369,2955,0,0,80.17,1206,1084,"上林村",NULL
0,1590,45,1635,1956,0,0,83.59,761,829,"龍潭村",NULL
0,2223,50,2273,2838,0,0,80.09,1264,959,"龍星村",NULL
0,2253,61,2314,2836,0,0,81.59,1403,850,"中正村",NULL
0,1748,52,1800,2195,0,0,82,1196,552,"上華村",NULL
0,2284,36,2320,2867,0,0,80.92,1475,809,"九龍村",NULL
0,1578,42,1620,2026,0,0,79.96,979,599,"武漢村",NULL
0,2639,86,2725,3364,0,0,81,2055,584,"東興村",NULL
0,2641,109,2750,3354,0,0,81.99,1790,851,"中興村",NULL
0,1522,39,1561,1978,0,0,78.92,1108,414,"北興村",NULL
0,2615,70,2685,3183,0,0,84.35,1919,696,"佳安村",NULL
0,985,44,1029,1301,0,0,79.09,366,619,"三坑村",NULL
0,890,29,919,1126,0,0,81.62,390,500,"大平村",NULL
0,1740,34,1774,2136,0,0,83.05,1175,565,"三林村",NULL
0,2596,34,2630,3136,0,0,83.86,1949,647,"建林村",NULL
0,2263,49,2312,2779,0,0,83.2,1662,601,"富林村",NULL
0,2042,57,2099,2552,0,0,82.25,1023,1019,"高平村",NULL
0,2286,52,2338,2889,0,0,80.93,1136,1150,"高原村",NULL
0,1055,25,1080,1294,0,0,83.46,470,585,"三和村",NULL
0,518,47,565,681,0,0,82.97,148,370,"三水村",NULL
0,1849,86,1935,2389,0,0,81,834,1015,"觀音村",NULL
0,849,58,907,1114,0,0,81.42,396,453,"白玉村",NULL
0,1033,61,1094,1319,0,0,82.94,482,551,"廣興村",NULL
0,897,34,931,1172,0,0,79.44,352,545,"大潭村",NULL
0,1224,71,1295,1605,0,0,80.69,505,719,"保生村",NULL
0,541,20,561,686,0,0,81.78,198,343,"武威村",NULL
0,567,37,604,753,0,0,80.21,214,353,"三和村",NULL
0,504,31,535,662,0,0,80.82,185,319,"新興村",NULL
0,926,64,990,1230,0,0,80.49,379,547,"坑尾村",NULL
0,1485,68,1553,1916,0,0,81.05,591,894,"金湖村",NULL
0,1498,64,1562,1928,0,0,81.02,557,941,"藍埔村",NULL
0,1441,54,1495,1824,0,0,81.96,478,963,"大同村",NULL
0,818,40,858,1050,0,0,81.71,248,570,"大堀村",NULL
0,2797,144,2941,3605,0,0,81.58,1112,1685,"崙坪村",NULL
0,1515,69,1584,1975,0,0,80.2,673,842,"富源村",NULL
0,1308,69,1377,1729,0,0,79.64,502,806,"上大村",NULL
0,2060,92,2152,2590,0,0,83.09,697,1363,"新坡村",NULL
0,1431,60,1491,1830,0,0,81.48,437,994,"廣福村",NULL
0,734,43,777,969,0,0,80.19,289,445,"塔腳村",NULL
0,1439,76,1515,1884,0,0,80.41,536,903,"保障村",NULL
0,2775,92,2867,3507,0,0,81.75,1160,1615,"草漯村",NULL
0,1233,72,1305,1695,0,0,76.99,525,708,"樹林村",NULL
0,1075,17,1092,1348,0,0,81.01,425,650,"富林村",NULL
0,1927,41,1968,2408,0,0,81.73,965,962,"新屋村",NULL
0,2387,91,2478,2957,0,0,83.8,1260,1127,"新生村",NULL
0,970,45,1015,1242,0,0,81.72,430,540,"後湖村",NULL
0,2436,69,2505,3096,0,0,80.91,1110,1326,"清華村",NULL
0,1314,81,1395,1690,0,0,82.54,527,787,"石磊村",NULL
0,922,57,979,1186,0,0,82.55,393,529,"東明村",NULL
0,1117,12,1129,1325,0,0,85.21,414,703,"社子村",NULL
0,1617,68,1685,2075,0,0,81.2,751,866,"埔頂村",NULL
0,1405,87,1492,1841,0,0,81.04,578,827,"九斗村",NULL
0,2315,63,2378,2875,0,0,82.71,966,1349,"頭洲村",NULL
0,1026,42,1068,1328,0,0,80.42,369,657,"大坡村",NULL
0,1186,50,1236,1474,0,0,83.85,437,749,"望間村",NULL
0,905,9,914,1115,0,0,81.97,435,470,"後庄村",NULL
0,679,11,690,866,0,0,79.68,258,421,"蚵間村",NULL
0,503,34,537,674,0,0,79.67,237,266,"深圳村",NULL
0,805,58,863,1050,0,0,82.19,340,465,"康榔村",NULL
0,763,65,828,1033,0,0,80.15,351,412,"笨港村",NULL
0,1796,79,1875,2237,0,0,83.82,819,977,"永安村",NULL
0,732,43,775,944,0,0,82.1,239,493,"永興村",NULL
0,514,31,545,688,0,0,79.22,200,314,"下埔村",NULL
0,657,17,674,804,0,0,83.83,261,396,"石牌村",NULL
0,1210,72,1282,1591,0,0,80.58,490,720,"下田村",NULL
0,845,5,850,1066,0,0,79.74,367,478,"赤欄村",NULL
0,1290,72,1362,1742,0,0,78.19,706,584,"三民村",NULL
0,853,46,899,1190,0,0,75.55,630,223,"澤仁村",NULL
0,324,11,335,452,0,0,74.12,300,24,"霞雲村",NULL
0,418,28,446,580,0,0,76.9,387,31,"義盛村",NULL
0,589,39,628,860,0,0,73.02,464,125,"羅浮村",NULL
0,377,24,401,532,0,0,75.38,300,77,"長興村",NULL
0,352,22,374,514,0,0,72.76,315,37,"奎輝村",NULL
0,413,17,430,639,0,0,67.29,349,64,"高義村",NULL
0,364,21,385,512,0,0,75.2,332,32,"三光村",NULL
0,676,28,704,1028,0,0,68.48,488,188,"華陵村",NULL
0,999,31,1030,1230,0,0,83.74,600,399,"鹿場里",NULL
0,202,5,207,237,0,0,87.34,80,122,"東平里",NULL
0,1222,24,1246,1516,0,0,82.19,712,510,"中興里",NULL
0,449,13,462,559,0,0,82.65,250,199,"隘口里",NULL
0,2024,76,2100,2584,0,0,81.27,1320,704,"東海里",NULL
0,4561,113,4674,5637,0,0,82.92,2877,1684,"十興里",NULL
0,4125,71,4196,4930,0,0,85.11,2586,1539,"斗崙里",NULL
0,2138,29,2167,2518,0,0,86.06,1377,761,"北崙里",NULL
0,2950,61,3011,3683,0,0,81.75,1695,1255,"新崙里",NULL
0,2789,67,2856,3509,0,0,81.39,1846,943,"竹北里",NULL
0,5421,109,5530,6802,0,0,81.3,3514,1907,"竹仁里",NULL
0,2270,38,2308,2869,0,0,80.45,1408,862,"福德里",NULL
0,3082,57,3139,3880,0,0,80.9,1871,1211,"竹義里",NULL
0,2959,78,3037,3733,0,0,81.36,1853,1106,"泰和里",NULL
0,4279,72,4351,5386,0,0,80.78,2671,1608,"新社里",NULL
0,2882,68,2950,3596,0,0,82.04,1706,1176,"新國里",NULL
0,2657,54,2711,3285,0,0,82.53,1530,1127,"聯興里",NULL
0,987,40,1027,1214,0,0,84.6,455,532,"麻園里",NULL
0,1441,34,1475,1825,0,0,80.82,728,713,"溪州里",NULL
0,717,22,739,919,0,0,80.41,363,354,"新庄里",NULL
0,1371,44,1415,1701,0,0,83.19,606,765,"白地里",NULL
0,912,18,930,1097,0,0,84.78,320,592,"新港里",NULL
0,1145,36,1181,1443,0,0,81.84,635,510,"大眉里",NULL
0,1147,33,1180,1418,0,0,83.22,478,669,"大義里",NULL
0,1091,36,1127,1342,0,0,83.98,447,644,"尚義里",NULL
0,1416,31,1447,1715,0,0,84.37,624,792,"崇義里",NULL
0,326,12,338,427,0,0,79.16,234,92,"上坪里",NULL
0,276,11,287,375,0,0,76.53,198,78,"瑞峰里",NULL
0,290,9,299,369,0,0,81.03,175,115,"軟橋里",NULL
0,1498,29,1527,1938,0,0,78.79,1079,419,"員崠里",NULL
0,5522,119,5641,6911,0,0,81.62,3996,1526,"上館里",NULL
0,2295,48,2343,2861,0,0,81.89,1668,627,"東寧里",NULL
0,1244,27,1271,1558,0,0,81.58,798,446,"中正里",NULL
0,2926,70,2996,3662,0,0,81.81,2061,865,"大鄉里",NULL
0,1481,21,1502,1789,0,0,83.96,981,500,"中山里",NULL
0,946,25,971,1155,0,0,84.07,630,316,"南華里",NULL
0,667,17,684,798,0,0,85.71,433,234,"東華里",NULL
0,2035,50,2085,2597,0,0,80.28,1431,604,"商華里",NULL
0,2676,50,2726,3330,0,0,81.86,1933,743,"鷄林里",NULL
0,2232,64,2296,2827,0,0,81.22,1551,681,"仁愛里",NULL
0,1195,22,1217,1458,0,0,83.47,759,436,"竹東里",NULL
0,1140,28,1168,1435,0,0,81.39,795,345,"忠孝里",NULL
0,1180,21,1201,1436,0,0,83.64,809,371,"榮樂里",NULL
0,4501,89,4590,5493,0,0,83.56,3285,1216,"榮華里",NULL
0,4680,105,4785,5904,0,0,81.05,3480,1200,"五豐里",NULL
0,382,12,394,509,0,0,77.41,257,125,"陸豐里",NULL
0,4018,88,4106,5008,0,0,81.99,2777,1241,"三重里",NULL
0,5298,123,5421,6782,0,0,79.93,3627,1671,"二重里",NULL
0,2890,52,2942,3578,0,0,82.22,1959,931,"頭重里",NULL
0,1183,41,1224,1480,0,0,82.7,806,377,"員山里",NULL
0,507,27,534,658,0,0,81.16,288,219,"柯湖里",NULL
0,851,18,869,1021,0,0,85.11,532,319,"新埔里",NULL
0,545,21,566,685,0,0,82.63,312,233,"新生里",NULL
0,867,24,891,1070,0,0,83.27,572,295,"新民里",NULL
0,1920,47,1967,2364,0,0,83.21,1241,679,"田新里",NULL
0,1336,50,1386,1745,0,0,79.43,809,527,"旱坑里",NULL
0,1477,58,1535,1861,0,0,82.48,889,588,"五埔里",NULL
0,2306,63,2369,2878,0,0,82.31,1256,1050,"四座里",NULL
0,1086,37,1123,1390,0,0,80.79,556,530,"照門里",NULL
0,351,15,366,446,0,0,82.06,148,203,"清水里",NULL
0,601,22,623,737,0,0,84.53,258,343,"鹿鳴里",NULL
0,488,17,505,602,0,0,83.89,193,295,"新北里",NULL
0,899,39,938,1086,0,0,86.37,438,461,"巨埔里",NULL
0,890,27,917,1115,0,0,82.24,475,415,"內立里",NULL
0,652,25,677,806,0,0,84,351,301,"寶石里",NULL
0,3099,110,3209,3946,0,0,81.32,1953,1146,"文山里",NULL
0,1341,49,1390,1711,0,0,81.24,728,613,"上寮里",NULL
0,1435,47,1482,1808,0,0,81.97,819,616,"下寮里",NULL
0,777,43,820,999,0,0,82.08,447,330,"南平里",NULL
0,510,28,538,664,0,0,81.02,233,277,"北平里",NULL
0,475,6,481,552,0,0,87.14,309,166,"東興里",NULL
0,1452,36,1488,1757,0,0,84.69,1038,414,"西安里",NULL
0,620,19,639,754,0,0,84.75,391,229,"南雄里",NULL
0,2911,64,2975,3599,0,0,82.66,1800,1111,"北斗里",NULL
0,613,8,621,746,0,0,83.24,331,282,"北山里",NULL
0,876,20,896,1097,0,0,81.68,492,384,"仁安里",NULL
0,790,35,825,1048,0,0,78.72,434,356,"南山里",NULL
0,2321,92,2413,2967,0,0,81.33,1470,851,"東安里",NULL
0,629,31,660,789,0,0,83.65,341,288,"東山里",NULL
0,991,28,1019,1217,0,0,83.73,562,429,"東光里",NULL
0,770,38,808,983,0,0,82.2,475,295,"南新里",NULL
0,462,15,477,608,0,0,78.45,234,228,"新富里",NULL
0,414,21,435,541,0,0,80.41,236,178,"玉山里",NULL
0,496,10,506,645,0,0,78.45,297,199,"金山里",NULL
0,868,16,884,1101,0,0,80.29,531,337,"錦山里",NULL
0,595,23,618,738,0,0,83.74,278,317,"大同里",NULL
0,1457,53,1510,1834,0,0,82.33,892,565,"石光里",NULL
0,791,27,818,976,0,0,83.81,439,352,"東平里",NULL
0,655,23,678,845,0,0,80.24,437,218,"上林里",NULL
0,497,28,525,620,0,0,84.68,297,200,"新力里",NULL
0,676,9,685,797,0,0,85.95,385,291,"南和里",NULL
0,1901,76,1977,2379,0,0,83.1,1067,834,"和興村",NULL
0,2382,59,2441,3060,0,0,79.77,1534,848,"東興村",NULL
0,2815,79,2894,3531,0,0,81.96,1684,1131,"德盛村",NULL
0,3138,71,3209,3858,0,0,83.18,2070,1068,"愛勢村",NULL
0,693,10,703,856,0,0,82.13,438,255,"仁勢村",NULL
0,1038,36,1074,1306,0,0,82.24,704,334,"孝勢村",NULL
0,1970,41,2011,2373,0,0,84.75,1316,654,"中勢村",NULL
0,1798,42,1840,2173,0,0,84.68,1157,641,"中正村",NULL
0,2785,76,2861,3500,0,0,81.74,1765,1020,"信勢村",NULL
0,1759,50,1809,2185,0,0,82.79,1140,619,"信義村",NULL
0,1371,30,1401,1803,0,0,77.7,858,513,"波羅村",NULL
0,2052,72,2124,2583,0,0,82.23,1308,744,"長嶺村",NULL
0,778,26,804,1005,0,0,80,427,351,"長安村",NULL
0,1914,47,1961,2353,0,0,83.34,1237,677,"湖口村",NULL
0,1745,55,1800,2161,0,0,83.29,1274,471,"湖鏡村",NULL
0,1034,33,1067,1344,0,0,79.39,720,314,"湖南村",NULL
0,3040,89,3129,3806,0,0,82.21,2480,560,"中興村",NULL
0,2630,40,2670,3374,0,0,79.13,1759,871,"鳳凰村",NULL
0,1882,51,1933,2387,0,0,80.98,1445,437,"勝利村",NULL
0,2051,50,2101,2640,0,0,79.58,1551,500,"鳳山村",NULL
0,739,2,741,889,0,0,83.35,414,325,"福興村",NULL
0,1322,50,1372,1676,0,0,81.86,783,539,"後湖村",NULL
0,1099,40,1139,1392,0,0,81.82,693,406,"青埔村",NULL
0,1775,52,1827,2256,0,0,80.98,784,991,"埔和村",NULL
0,650,23,673,805,0,0,83.6,305,345,"坡頭村",NULL
0,1671,61,1732,2095,0,0,82.67,715,956,"新豐村",NULL
0,1066,29,1095,1366,0,0,80.16,611,455,"瑞興村",NULL
0,1842,66,1908,2372,0,0,80.44,1184,658,"中崙村",NULL
0,4604,87,4691,5912,0,0,79.35,3095,1509,"重興村",NULL
0,1110,27,1137,1437,0,0,79.12,687,423,"上坑村",NULL
0,775,27,802,966,0,0,83.02,476,299,"鳳坑村",NULL
0,5738,127,5865,7242,0,0,80.99,3860,1878,"員山村",NULL
0,3389,77,3466,4392,0,0,78.92,2397,992,"松林村",NULL
0,338,12,350,424,0,0,82.55,209,129,"華龍村",NULL
0,398,15,413,484,0,0,85.33,279,119,"五龍村",NULL
0,701,18,719,855,0,0,84.09,519,182,"秀湖村",NULL
0,328,4,332,397,0,0,83.63,236,92,"永興村",NULL
0,1879,38,1917,2367,0,0,80.99,1259,620,"石潭村",NULL
0,1076,41,1117,1389,0,0,80.42,666,410,"新鳳村",NULL
0,441,18,459,551,0,0,83.3,338,103,"中坑村",NULL
0,544,12,556,664,0,0,83.73,347,197,"水坑村",NULL
0,1711,55,1766,2107,0,0,83.82,1118,593,"文林村",NULL
0,1200,32,1232,1474,0,0,83.58,766,434,"芎林村",NULL
0,2521,83,2604,3103,0,0,83.92,1538,983,"上山村",NULL
0,870,36,906,1068,0,0,84.83,544,326,"下山村",NULL
0,2563,65,2628,3248,0,0,80.91,1741,822,"橫山村",NULL
0,692,19,711,846,0,0,84.04,424,268,"田寮村",NULL
0,122,12,134,165,0,0,81.21,78,44,"南昌村",NULL
0,124,2,126,166,0,0,75.9,86,38,"豐鄉村",NULL
0,270,12,282,332,0,0,84.94,157,113,"豐田村",NULL
0,808,33,841,1068,0,0,78.75,605,203,"內灣村",NULL
0,702,19,721,865,0,0,83.35,507,195,"力行村",NULL
0,390,11,401,472,0,0,84.96,232,158,"福興村",NULL
0,917,9,926,1098,0,0,84.34,566,351,"沙坑村",NULL
0,1291,30,1321,1551,0,0,85.17,915,376,"新興村",NULL
0,1129,16,1145,1370,0,0,83.58,842,287,"大肚村",NULL
0,915,27,942,1163,0,0,81,603,312,"北埔村",NULL
0,1016,35,1051,1268,0,0,82.89,718,298,"南興村",NULL
0,387,18,405,508,0,0,79.72,262,125,"大湖村",NULL
0,1885,64,1949,2367,0,0,82.34,1203,682,"埔尾村",NULL
0,590,25,615,789,0,0,77.95,326,264,"水際村",NULL
0,305,12,317,379,0,0,83.64,209,96,"南埔村",NULL
0,538,29,567,659,0,0,86.04,388,150,"大林村",NULL
0,273,10,283,358,0,0,79.05,175,98,"南坑村",NULL
0,241,8,249,309,0,0,80.58,125,116,"外坪村",NULL
0,3032,54,3086,3753,0,0,82.23,2076,956,"雙溪村",NULL
0,730,24,754,949,0,0,79.45,442,288,"大崎村",NULL
0,613,33,646,755,0,0,85.56,362,251,"三峰村",NULL
0,855,6,861,1066,0,0,80.77,494,361,"新城村",NULL
0,515,17,532,649,0,0,81.97,277,238,"寶斗村",NULL
0,583,5,588,713,0,0,82.47,383,200,"深井村",NULL
0,509,12,521,626,0,0,83.23,364,145,"寶山村",NULL
0,450,2,452,558,0,0,81,254,196,"油田村",NULL
0,387,5,392,488,0,0,80.33,226,161,"山湖村",NULL
0,723,23,746,879,0,0,84.87,477,246,"峨眉村",NULL
0,585,26,611,724,0,0,84.39,283,302,"中盛村",NULL
0,508,20,528,622,0,0,84.89,276,232,"石井村",NULL
0,501,26,527,618,0,0,85.28,270,231,"七星村",NULL
0,927,28,955,1232,0,0,77.52,523,404,"富興村",NULL
0,709,34,743,902,0,0,82.37,329,380,"湖光村",NULL
0,765,27,792,987,0,0,80.24,593,172,"義興村",NULL
0,272,11,283,351,0,0,80.63,230,42,"嘉樂村",NULL
0,776,21,797,1044,0,0,76.34,690,86,"新樂村",NULL
0,741,11,752,967,0,0,77.77,652,89,"錦屏村",NULL
0,359,13,372,492,0,0,75.61,289,70,"梅花村",NULL
0,543,13,556,719,0,0,77.33,452,91,"玉峰村",NULL
0,763,13,776,1103,0,0,70.35,552,211,"秀巒村",NULL
0,985,8,993,1295,0,0,76.68,868,117,"大隘村",NULL
0,458,3,461,610,0,0,75.57,340,118,"花園村",NULL
0,223,2,225,289,0,0,77.85,188,35,"竹林村",NULL
0,956,17,973,1302,0,0,74.73,777,179,"桃山村",NULL
0,795,15,810,1010,0,0,80.2,543,252,"中苗里",NULL
0,798,18,816,1046,0,0,78.01,519,279,"青苗里",NULL
0,2442,50,2492,3077,0,0,80.99,1701,741,"維祥里",NULL
0,2894,83,2977,3772,0,0,78.92,1998,896,"維新里",NULL
0,1833,44,1877,2321,0,0,80.87,1277,556,"玉清里",NULL
0,2651,79,2730,3364,0,0,81.15,1895,756,"玉華里",NULL
0,698,24,722,894,0,0,80.76,447,251,"綠苗里",NULL
0,2108,48,2156,2731,0,0,78.95,1407,701,"高苗里",NULL
0,751,23,774,947,0,0,81.73,475,276,"新苗里",NULL
0,795,25,820,1050,0,0,78.1,519,276,"玉苗里",NULL
0,500,15,515,642,0,0,80.22,342,158,"大同里",NULL
0,1258,26,1284,1580,0,0,81.27,895,363,"恭敬里",NULL
0,1906,39,1945,2391,0,0,81.35,1379,527,"水源里",NULL
0,2805,81,2886,3537,0,0,81.59,1894,911,"勝利里",NULL
0,2428,47,2475,3028,0,0,81.74,1634,794,"清華里",NULL
0,1422,31,1453,1775,0,0,81.86,917,505,"上苗里",NULL
0,3493,76,3569,4340,0,0,82.24,2414,1079,"北苗里",NULL
0,2402,83,2485,3128,0,0,79.44,1602,800,"嘉盛里",NULL
0,2101,33,2134,2530,0,0,84.35,1467,634,"嘉新里",NULL
0,2600,66,2666,3325,0,0,80.18,1765,835,"福星里",NULL
0,2030,62,2092,2653,0,0,78.85,1379,651,"福安里",NULL
0,2906,55,2961,3599,0,0,82.27,2043,863,"建功里",NULL
0,3320,71,3391,4243,0,0,79.92,2314,1006,"福麗里",NULL
0,3776,98,3874,4881,0,0,79.37,2536,1240,"文山里",NULL
0,803,41,844,1110,0,0,76.04,523,280,"新川里",NULL
0,1094,46,1140,1505,0,0,75.75,715,379,"新英里",NULL
0,1341,53,1394,1778,0,0,78.4,899,442,"南勢里",NULL
0,1408,46,1454,1786,0,0,81.41,631,777,"苑東里",NULL
0,1313,40,1353,1671,0,0,80.97,584,729,"苑南里",NULL
0,694,17,711,901,0,0,78.91,314,380,"苑北里",NULL
0,1043,41,1084,1321,0,0,82.06,423,620,"西平里",NULL
0,884,50,934,1145,0,0,81.57,286,598,"苑港里",NULL
0,1332,32,1364,1689,0,0,80.76,593,739,"西勢里",NULL
0,788,38,826,1024,0,0,80.66,297,491,"海岸里",NULL
0,1653,69,1722,2164,0,0,79.57,713,940,"房裡里",NULL
0,2672,61,2733,3340,0,0,81.83,1256,1416,"客庄里",NULL
0,1466,45,1511,1809,0,0,83.53,574,892,"中正里",NULL
0,773,45,818,1011,0,0,80.91,244,529,"苑坑里",NULL
0,432,23,455,604,0,0,75.33,159,273,"水坡里",NULL
0,885,37,922,1114,0,0,82.76,407,478,"新復里",NULL
0,1146,51,1197,1501,0,0,79.75,476,670,"山腳里",NULL
0,1350,48,1398,1706,0,0,81.95,611,739,"舊社里",NULL
0,907,48,955,1233,0,0,77.45,351,556,"福田里",NULL
0,488,24,512,618,0,0,82.85,213,275,"石鎮里",NULL
0,688,37,725,893,0,0,81.19,323,365,"蕉埔里",NULL
0,545,29,574,727,0,0,78.95,204,341,"南勢里",NULL
0,1141,44,1185,1482,0,0,79.96,485,656,"泰田里",NULL
0,1146,66,1212,1539,0,0,78.75,500,646,"上館里",NULL
0,1210,47,1257,1623,0,0,77.45,503,707,"玉田里",NULL
0,1596,79,1675,2051,0,0,81.67,634,962,"社苓里",NULL
0,969,34,1003,1207,0,0,83.1,429,540,"山柑里",NULL
0,1073,45,1118,1362,0,0,82.09,447,626,"田心里",NULL
0,1009,27,1036,1259,0,0,82.29,497,512,"通東里",NULL
0,1715,53,1768,2159,0,0,81.89,882,833,"通西里",NULL
0,2920,93,3013,3797,0,0,79.35,1353,1567,"平元里",NULL
0,584,49,633,760,0,0,83.29,250,334,"圳頭里",NULL
0,1147,47,1194,1493,0,0,79.97,538,609,"梅南里",NULL
0,1980,54,2034,2591,0,0,78.5,1001,979,"通南里",NULL
0,1355,73,1428,1767,0,0,80.81,681,674,"內湖里",NULL
0,398,26,424,539,0,0,78.66,186,212,"楓樹里",NULL
0,702,32,734,943,0,0,77.84,405,297,"烏眉里",NULL
0,360,8,368,478,0,0,76.99,221,139,"福龍里",NULL
0,587,33,620,787,0,0,78.78,322,265,"福源里",NULL
0,541,21,562,702,0,0,80.06,216,325,"城北里",NULL
0,726,52,778,998,0,0,77.96,308,418,"城南里",NULL
0,652,28,680,834,0,0,81.53,279,373,"南和里",NULL
0,467,29,496,645,0,0,76.9,182,285,"福興里",NULL
0,909,51,960,1193,0,0,80.47,468,441,"坪頂里",NULL
0,1035,33,1068,1336,0,0,79.94,524,511,"五南里",NULL
0,1142,68,1210,1460,0,0,82.88,499,643,"五北里",NULL
0,1581,66,1647,2192,0,0,75.14,788,793,"通灣里",NULL
0,917,55,972,1254,0,0,77.51,331,586,"新埔里",NULL
0,535,34,569,765,0,0,74.38,262,273,"內島里",NULL
0,987,53,1040,1370,0,0,75.91,522,465,"白東里",NULL
0,579,30,609,794,0,0,76.7,263,316,"白西里",NULL
0,1537,34,1571,1909,0,0,82.29,862,675,"竹南里",NULL
0,1875,54,1929,2361,0,0,81.7,931,944,"照南里",NULL
0,1800,41,1841,2314,0,0,79.56,965,835,"正南里",NULL
0,2251,54,2305,2827,0,0,81.54,1250,1001,"新南里",NULL
0,2584,69,2653,3187,0,0,83.24,1417,1167,"大厝里",NULL
0,2152,53,2205,2684,0,0,82.15,1088,1064,"營盤里",NULL
0,1802,58,1860,2285,0,0,81.4,1080,722,"聖福里",NULL
0,2143,57,2200,2870,0,0,76.66,1195,948,"竹興里",NULL
0,3538,84,3622,4477,0,0,80.9,1993,1545,"龍鳳里",NULL
0,2319,81,2400,3055,0,0,78.56,1337,982,"山佳里",NULL
0,1669,50,1719,2135,0,0,80.52,919,750,"佳興里",NULL
0,727,30,757,957,0,0,79.1,417,310,"中港里",NULL
0,1822,54,1876,2276,0,0,82.43,1007,815,"中華里",NULL
0,945,38,983,1245,0,0,78.96,531,414,"中英里",NULL
0,1277,33,1310,1652,0,0,79.3,733,544,"中美里",NULL
0,441,5,446,545,0,0,81.83,222,219,"開元里",NULL
0,1713,82,1795,2266,0,0,79.21,833,880,"海口里",NULL
0,1165,44,1209,1439,0,0,84.02,647,518,"港墘里",NULL
0,874,9,883,1112,0,0,79.41,562,312,"公館里",NULL
0,2413,96,2509,3156,0,0,79.5,1248,1165,"大埔里",NULL
0,1711,43,1754,2145,0,0,81.77,988,723,"頂埔里",NULL
0,2035,93,2128,2690,0,0,79.11,1057,978,"崎頂里",NULL
0,738,28,766,940,0,0,81.49,354,384,"公義里",NULL
0,1520,58,1578,2080,0,0,75.87,1080,440,"流東里",NULL
0,1409,49,1458,1796,0,0,81.18,975,434,"珊湖里",NULL
0,2214,58,2272,2849,0,0,79.75,1520,694,"斗煥里",NULL
0,2736,82,2818,3485,0,0,80.86,1933,803,"新華里",NULL
0,2282,71,2353,2945,0,0,79.9,1562,720,"興隆里",NULL
0,1956,60,2016,2431,0,0,82.93,1421,535,"上埔里",NULL
0,606,21,627,803,0,0,78.08,365,241,"土牛里",NULL
0,2153,63,2216,2775,0,0,79.86,1529,624,"頭份里",NULL
0,3510,66,3576,4368,0,0,81.87,2512,998,"忠孝里",NULL
0,1205,23,1228,1565,0,0,78.47,769,436,"仁愛里",NULL
0,611,5,616,766,0,0,80.42,405,206,"信義里",NULL
0,795,23,818,974,0,0,83.98,460,335,"和平里",NULL
0,988,16,1004,1272,0,0,78.93,672,316,"上興里",NULL
0,1565,78,1643,2097,0,0,78.35,1036,529,"下興里",NULL
0,1951,43,1994,2472,0,0,80.66,1377,574,"山下里",NULL
0,4163,100,4263,5215,0,0,81.74,2774,1389,"後庄里",NULL
0,2212,44,2256,2734,0,0,82.52,1519,693,"建國里",NULL
0,2217,52,2269,2807,0,0,80.83,1574,643,"成功里",NULL
0,1954,48,2002,2513,0,0,79.67,1396,558,"蟠桃里",NULL
0,1796,51,1847,2391,0,0,77.25,1241,555,"東庄里",NULL
0,1263,33,1296,1627,0,0,79.66,896,367,"民族里",NULL
0,1284,37,1321,1665,0,0,79.34,840,444,"民權里",NULL
0,1443,54,1497,1931,0,0,77.52,977,466,"民生里",NULL
0,2139,53,2192,2748,0,0,79.77,1440,699,"田寮里",NULL
0,1037,46,1083,1322,0,0,81.92,559,478,"蘆竹里",NULL
0,1051,37,1088,1322,0,0,82.3,765,286,"尖山里",NULL
0,680,29,709,848,0,0,83.61,494,186,"廣興里",NULL
0,1855,80,1935,2468,0,0,78.4,1310,545,"尖下里",NULL
0,1502,48,1550,1946,0,0,79.65,1066,436,"濫坑里",NULL
0,1070,51,1121,1413,0,0,79.33,591,479,"南龍里",NULL
0,788,8,796,949,0,0,83.88,416,372,"中龍里",NULL
0,1104,27,1131,1416,0,0,79.87,534,570,"北龍里",NULL
0,2658,84,2742,3428,0,0,79.99,1504,1154,"大庄里",NULL
0,1627,87,1714,2225,0,0,77.03,886,741,"溪洲里",NULL
0,992,26,1018,1285,0,0,79.22,740,252,"豐富里",NULL
0,930,29,959,1188,0,0,80.72,533,397,"校椅里",NULL
0,1725,85,1810,2380,0,0,76.05,935,790,"埔頂里",NULL
0,1002,41,1043,1318,0,0,79.14,619,383,"新民里",NULL
0,511,6,517,649,0,0,79.66,265,246,"復興里",NULL
0,1013,70,1083,1383,0,0,78.31,501,512,"東明里",NULL
0,1154,61,1215,1563,0,0,77.74,589,565,"大山里",NULL
0,989,9,998,1314,0,0,75.95,410,579,"灣寶里",NULL
0,741,41,782,1017,0,0,76.89,347,394,"海寶里",NULL
0,796,48,844,1150,0,0,73.39,509,287,"外埔里",NULL
0,703,25,728,1017,0,0,71.58,329,374,"海埔里",NULL
0,558,31,589,727,0,0,81.02,279,279,"秀水里",NULL
0,811,47,858,1110,0,0,77.3,437,374,"水尾里",NULL
0,506,22,528,665,0,0,79.4,275,231,"龍津里",NULL
0,973,44,1017,1296,0,0,78.47,477,496,"龍坑里",NULL
0,616,5,621,824,0,0,75.36,316,300,"福寧里",NULL
0,813,74,887,1220,0,0,72.7,419,394,"中和里",NULL
0,907,72,979,1282,0,0,76.37,371,536,"南港里",NULL
0,1711,62,1773,2155,0,0,82.27,808,903,"老庄里",NULL
0,954,23,977,1170,0,0,83.5,405,549,"新榮里",NULL
0,667,28,695,816,0,0,85.17,323,344,"中街里",NULL
0,1283,44,1327,1627,0,0,81.56,628,655,"新厝里",NULL
0,783,46,829,1037,0,0,79.94,357,426,"豐田里",NULL
0,418,19,437,558,0,0,78.32,190,228,"西坪里",NULL
0,617,28,645,756,0,0,85.32,279,338,"苗豐里",NULL
0,1620,36,1656,2060,0,0,80.39,687,933,"上新里",NULL
0,1614,56,1670,2143,0,0,77.93,697,917,"內灣里",NULL
0,1062,49,1111,1441,0,0,77.1,640,422,"坪林里",NULL
0,504,33,537,705,0,0,76.17,274,230,"景山里",NULL
0,1350,36,1386,1711,0,0,81.01,972,378,"大湖村",NULL
0,558,18,576,694,0,0,83,429,129,"明湖村",NULL
0,933,31,964,1269,0,0,75.97,636,297,"大寮村",NULL
0,1276,41,1317,1709,0,0,77.06,891,385,"靜湖村",NULL
0,972,46,1018,1369,0,0,74.36,660,312,"富興村",NULL
0,433,30,463,643,0,0,72.01,318,115,"大南村",NULL
0,543,36,579,749,0,0,77.3,339,204,"南湖村",NULL
0,516,32,548,723,0,0,75.8,344,172,"東興村",NULL
0,388,2,390,518,0,0,75.29,264,124,"武榮村",NULL
0,1116,60,1176,1584,0,0,74.24,702,414,"義和村",NULL
0,669,42,711,929,0,0,76.53,408,261,"栗林村",NULL
0,631,29,660,845,0,0,78.11,347,284,"新開村",NULL
0,1243,30,1273,1542,0,0,82.56,751,492,"館中村",NULL
0,1688,65,1753,2148,0,0,81.61,1018,670,"館東村",NULL
0,2193,66,2259,2812,0,0,80.33,1409,784,"館南村",NULL
0,1468,59,1527,1982,0,0,77.04,853,615,"中義村",NULL
0,1318,48,1366,1763,0,0,77.48,816,502,"玉泉村",NULL
0,714,41,755,974,0,0,77.52,442,272,"大坑村",NULL
0,849,3,852,1073,0,0,79.4,587,262,"福基村",NULL
0,304,15,319,402,0,0,79.35,213,91,"福德村",NULL
0,1319,41,1360,1701,0,0,79.95,806,513,"福星村",NULL
0,1059,45,1104,1442,0,0,76.56,681,378,"石墻村",NULL
0,249,10,259,320,0,0,80.94,156,93,"開礦村",NULL
0,1408,41,1449,1782,0,0,81.31,824,584,"五穀村",NULL
0,880,14,894,1111,0,0,80.47,541,339,"玉穀村",NULL
0,1082,31,1113,1371,0,0,81.18,730,352,"鶴岡村",NULL
0,1052,38,1090,1370,0,0,79.56,680,372,"鶴山村",NULL
0,1050,39,1089,1394,0,0,78.12,692,358,"尖山村",NULL
0,888,40,928,1178,0,0,78.78,540,348,"仁安村",NULL
0,197,7,204,264,0,0,77.27,142,55,"南河村",NULL
0,252,14,266,315,0,0,84.44,170,82,"北河村",NULL
0,3286,100,3386,4191,0,0,80.79,2270,1016,"銅鑼村",NULL
0,944,48,992,1263,0,0,78.54,578,366,"樟樹村",NULL
0,976,35,1011,1278,0,0,79.11,678,298,"九湖村",NULL
0,830,25,855,1065,0,0,80.28,658,172,"福興村",NULL
0,1349,48,1397,1731,0,0,80.7,942,407,"朝陽村",NULL
0,808,41,849,1089,0,0,77.96,586,222,"竹森村",NULL
0,2150,86,2236,2836,0,0,78.84,1238,912,"中平村",NULL
0,490,4,494,622,0,0,79.42,312,178,"興隆村",NULL
0,358,22,380,500,0,0,76,213,145,"盛隆村",NULL
0,400,30,430,562,0,0,76.51,249,151,"新隆村",NULL
0,952,30,982,1264,0,0,77.69,665,287,"東村",NULL
0,523,29,552,709,0,0,77.86,377,146,"西村",NULL
0,979,38,1017,1402,0,0,72.54,733,246,"南江村",NULL
0,663,25,688,878,0,0,78.36,437,226,"田美村",NULL
0,741,32,773,990,0,0,78.08,500,241,"獅山村",NULL
0,815,40,855,1069,0,0,79.98,576,239,"南富村",NULL
0,788,39,827,1043,0,0,79.29,472,316,"員林村",NULL
0,618,31,649,893,0,0,72.68,493,125,"蓬萊村",NULL
0,649,19,668,958,0,0,69.73,587,62,"東河村",NULL
0,1957,52,2009,2444,0,0,82.2,1426,531,"頭屋村",NULL
0,1220,35,1255,1596,0,0,78.63,840,380,"獅潭村",NULL
0,506,32,538,673,0,0,79.94,362,144,"北坑村",NULL
0,728,23,751,888,0,0,84.57,452,276,"曲洞村",NULL
0,283,11,294,358,0,0,82.12,170,113,"飛鳳村",NULL
0,1442,14,1456,1848,0,0,78.79,954,488,"象山村",NULL
0,850,35,885,1114,0,0,79.44,586,264,"明德村",NULL
0,268,10,278,352,0,0,78.98,169,99,"鳴鳳村",NULL
0,3164,108,3272,3993,0,0,81.94,2183,981,"廣盛村",NULL
0,2297,82,2379,3009,0,0,79.06,1499,798,"勝興村",NULL
0,1334,35,1369,1691,0,0,80.96,894,440,"雙湖村",NULL
0,1087,35,1122,1383,0,0,81.13,718,369,"雙潭村",NULL
0,1070,45,1115,1344,0,0,82.96,759,311,"西湖村",NULL
0,318,15,333,399,0,0,83.46,229,89,"龍騰村",NULL
0,957,44,1001,1173,0,0,85.34,413,544,"鯉魚潭村",NULL
0,469,7,476,607,0,0,78.42,345,124,"高埔村",NULL
0,438,23,461,561,0,0,82.17,326,112,"下埔村",NULL
0,686,28,714,895,0,0,79.78,517,169,"五湖村",NULL
0,491,21,512,652,0,0,78.53,391,100,"四湖村",NULL
0,697,22,719,956,0,0,75.21,464,233,"三湖村",NULL
0,373,25,398,517,0,0,76.98,253,120,"龍洞村",NULL
0,414,3,417,524,0,0,79.58,290,124,"金獅村",NULL
0,849,41,890,1139,0,0,78.14,568,281,"湖東村",NULL
0,480,29,509,694,0,0,73.34,308,172,"二湖村",NULL
0,1368,45,1413,1759,0,0,80.33,1025,343,"造橋村",NULL
0,367,20,387,487,0,0,79.47,272,95,"平興村",NULL
0,747,27,774,982,0,0,78.82,508,239,"豐湖村",NULL
0,2398,87,2485,3077,0,0,80.76,1692,706,"大西村",NULL
0,430,9,439,537,0,0,81.75,291,139,"錦水村",NULL
0,400,5,405,505,0,0,80.2,288,112,"大龍村",NULL
0,1064,55,1119,1387,0,0,80.68,593,471,"朝陽村",NULL
0,555,39,594,720,0,0,82.5,315,240,"談文村",NULL
0,725,55,780,1017,0,0,76.7,377,348,"龍昇村",NULL
0,1694,62,1756,2152,0,0,81.6,1111,583,"三灣村",NULL
0,462,24,486,576,0,0,84.38,328,134,"內灣村",NULL
0,644,24,668,842,0,0,79.33,414,230,"銅鏡村",NULL
0,178,9,187,231,0,0,80.95,130,48,"頂寮村",NULL
0,406,20,426,522,0,0,81.61,245,161,"北埔村",NULL
0,481,29,510,620,0,0,82.26,312,169,"大河村",NULL
0,339,27,366,467,0,0,78.37,195,144,"大坪村",NULL
0,274,17,291,366,0,0,79.51,185,89,"永和村",NULL
0,273,18,291,389,0,0,74.81,228,45,"百壽村",NULL
0,447,33,480,634,0,0,75.71,280,167,"永興村",NULL
0,702,49,751,945,0,0,79.47,477,225,"新店村",NULL
0,465,23,488,616,0,0,79.22,313,152,"和興村",NULL
0,460,28,488,644,0,0,75.78,333,127,"豐林村",NULL
0,254,14,268,368,0,0,72.83,165,89,"新豐村",NULL
0,566,28,594,761,0,0,78.06,396,170,"竹木村",NULL
0,187,10,197,270,0,0,72.96,157,30,"八卦村",NULL
0,675,24,699,930,0,0,75.16,577,98,"錦水村",NULL
0,607,25,632,829,0,0,76.24,468,139,"清安村",NULL
0,325,8,333,421,0,0,79.1,296,29,"大興村",NULL
0,319,13,332,411,0,0,80.78,249,70,"中興村",NULL
0,283,6,289,372,0,0,77.69,245,38,"梅園村",NULL
0,465,8,473,569,0,0,83.13,352,113,"象鼻村",NULL
0,403,2,405,465,0,0,87.1,394,9,"士林村",NULL
0,1549,44,1593,1925,0,0,82.75,851,698,"豐原里",NULL
0,819,9,828,1028,0,0,80.54,324,495,"豐榮里",NULL
0,731,12,743,904,0,0,82.19,286,445,"頂街里",NULL
0,759,11,770,924,0,0,83.33,318,441,"中山里",NULL
0,667,14,681,824,0,0,82.65,301,366,"下街里",NULL
0,3697,74,3771,4547,0,0,82.93,1640,2057,"中陽里",NULL
0,1876,37,1913,2257,0,0,84.76,796,1080,"大湳里",NULL
0,2029,39,2068,2515,0,0,82.23,990,1039,"北湳里",NULL
0,3039,79,3118,3735,0,0,83.48,1114,1925,"東湳里",NULL
0,5420,112,5532,6653,0,0,83.15,2134,3286,"西湳里",NULL
0,1398,31,1429,1746,0,0,81.84,704,694,"豐西里",NULL
0,936,25,961,1140,0,0,84.3,389,547,"圳寮里",NULL
0,2205,46,2251,2739,0,0,82.18,1110,1095,"豐圳里",NULL
0,718,9,727,833,0,0,87.27,326,392,"富春里",NULL
0,667,15,682,810,0,0,84.2,336,331,"葫蘆里",NULL
0,3947,70,4017,4800,0,0,83.69,1818,2129,"西安里",NULL
0,1767,27,1794,2269,0,0,79.07,873,894,"西勢里",NULL
0,2176,46,2222,2750,0,0,80.8,1168,1008,"中興里",NULL
0,6135,127,6262,7652,0,0,81.83,2965,3170,"社皮里",NULL
0,3943,96,4039,4920,0,0,82.09,1694,2249,"三村里",NULL
0,1153,23,1176,1403,0,0,83.82,472,681,"東勢里",NULL
0,856,13,869,1044,0,0,83.24,348,508,"民生里",NULL
0,3800,73,3873,4684,0,0,82.69,1753,2047,"田心里",NULL
0,7026,201,7227,8791,0,0,82.21,2945,4081,"豐田里",NULL
0,2828,84,2912,3525,0,0,82.61,1316,1512,"鎌村里",NULL
0,1974,34,2008,2453,0,0,81.86,973,1001,"陽明里",NULL
0,6042,119,6161,7490,0,0,82.26,2859,3183,"南陽里",NULL
0,8102,140,8242,9879,0,0,83.43,3739,4363,"北陽里",NULL
0,1265,36,1301,1509,0,0,86.22,438,827,"東陽里",NULL
0,3220,68,3288,3995,0,0,82.3,1365,1855,"南村里",NULL
0,2427,63,2490,2981,0,0,83.53,1002,1425,"南田里",NULL
0,2268,68,2336,2837,0,0,82.34,847,1421,"南嵩里",NULL
0,1415,34,1449,1727,0,0,83.9,646,769,"翁明里",NULL
0,1959,58,2017,2388,0,0,84.46,783,1176,"翁子里",NULL
0,1514,41,1555,1834,0,0,84.79,602,912,"翁社里",NULL
0,2396,56,2452,2947,0,0,83.2,832,1564,"朴子里",NULL
0,2372,73,2445,2959,0,0,82.63,1068,1304,"大里里",NULL
0,5180,85,5265,6641,0,0,79.28,2431,2749,"新里里",NULL
0,3023,47,3070,3727,0,0,82.37,1519,1504,"國光里",NULL
0,2295,44,2339,2818,0,0,83,861,1434,"樹王里",NULL
0,4368,82,4450,5541,0,0,80.31,2037,2331,"祥興里",NULL
0,4219,94,4313,5380,0,0,80.17,2322,1897,"內新里",NULL
0,2857,61,2918,3599,0,0,81.08,1512,1345,"中新里",NULL
0,2119,52,2171,2634,0,0,82.42,976,1143,"東昇里",NULL
0,2799,49,2848,3374,0,0,84.41,1200,1599,"大元里",NULL
0,1782,35,1817,2157,0,0,84.24,758,1024,"西湖里",NULL
0,760,21,781,929,0,0,84.07,285,475,"夏田里",NULL
0,4363,52,4415,5485,0,0,80.49,1883,2480,"仁化里",NULL
0,3850,55,3905,4756,0,0,82.11,1792,2058,"仁德里",NULL
0,3337,78,3415,4306,0,0,79.31,1798,1539,"健民里",NULL
0,5240,114,5354,6689,0,0,80.04,2355,2885,"塗城里",NULL
0,4935,105,5040,6334,0,0,79.57,2432,2503,"東湖里",NULL
0,4681,82,4763,5725,0,0,83.2,2261,2420,"東興里",NULL
0,2647,55,2702,3304,0,0,81.78,1222,1425,"大明里",NULL
0,3464,31,3495,4108,0,0,85.08,1823,1641,"永隆里",NULL
0,2635,58,2693,3266,0,0,82.46,1278,1357,"日新里",NULL
0,3693,70,3763,4653,0,0,80.87,1835,1858,"西榮里",NULL
0,4708,71,4779,5831,0,0,81.96,2477,2231,"長榮里",NULL
0,6211,93,6304,7922,0,0,79.58,3099,3112,"金城里",NULL
0,3027,69,3096,3859,0,0,80.23,1367,1660,"立仁里",NULL
0,3247,64,3311,4064,0,0,81.47,1491,1756,"立德里",NULL
0,4934,89,5023,6144,0,0,81.75,2291,2643,"新仁里",NULL
0,7062,97,7159,8857,0,0,80.83,3381,3681,"瑞城里",NULL
0,4182,128,4310,5214,0,0,82.66,1720,2462,"太平里",NULL
0,6326,121,6447,7981,0,0,80.78,3103,3223,"長億里",NULL
0,4847,103,4950,6164,0,0,80.3,2201,2646,"中平里",NULL
0,5472,108,5580,7233,0,0,77.15,2569,2903,"中興里",NULL
0,7292,164,7456,9214,0,0,80.92,3335,3957,"東平里",NULL
0,3976,98,4074,5074,0,0,80.29,2194,1782,"建國里",NULL
0,6052,132,6184,7460,0,0,82.9,3614,2438,"坪林里",NULL
0,5899,146,6045,7388,0,0,81.82,3582,2317,"光華里",NULL
0,5033,116,5149,6253,0,0,82.34,3049,1984,"中山里",NULL
0,9819,200,10019,12535,0,0,79.93,5001,4818,"宜欣里",NULL
0,8974,172,9146,11571,0,0,79.04,4866,4108,"新坪里",NULL
0,7333,158,7491,9228,0,0,81.18,3430,3903,"新光里",NULL
0,3479,67,3546,4273,0,0,82.99,1841,1638,"新福里",NULL
0,2536,113,2649,3295,0,0,80.39,1067,1469,"頭汴里",NULL
0,875,41,916,1198,0,0,76.46,346,529,"東汴里",NULL
0,4694,93,4787,5871,0,0,81.54,2326,2368,"興隆里",NULL
0,648,22,670,822,0,0,81.51,280,368,"黃竹里",NULL
0,3720,91,3811,4724,0,0,80.67,1655,2065,"光隆里",NULL
0,2803,78,2881,3595,0,0,80.14,1243,1560,"德隆里",NULL
0,929,22,951,1190,0,0,79.92,586,343,"北興里",NULL
0,673,13,686,825,0,0,83.15,414,259,"中寧里",NULL
0,997,24,1021,1286,0,0,79.39,594,403,"東安里",NULL
0,1449,42,1491,1853,0,0,80.46,870,579,"南平里",NULL
0,1725,45,1770,2202,0,0,80.38,897,828,"延平里",NULL
0,764,30,794,954,0,0,83.23,466,298,"上新里",NULL
0,1172,36,1208,1515,0,0,79.74,691,481,"廣興里",NULL
0,2558,63,2621,3232,0,0,81.1,1531,1027,"泰昌里",NULL
0,1420,60,1480,1844,0,0,80.26,755,665,"中嵙里",NULL
0,2479,79,2558,3178,0,0,80.49,1405,1074,"福隆里",NULL
0,1042,40,1082,1426,0,0,75.88,498,544,"隆興里",NULL
0,3628,138,3766,4631,0,0,81.32,1822,1806,"新盛里",NULL
0,1133,47,1180,1448,0,0,81.49,485,648,"詒福里",NULL
0,759,32,791,975,0,0,81.13,333,426,"上城里",NULL
0,680,38,718,898,0,0,79.96,292,388,"下城里",NULL
0,1480,52,1532,1928,0,0,79.46,627,853,"慶東里",NULL
0,978,48,1026,1389,0,0,73.87,385,593,"慶福里",NULL
0,1512,41,1553,1936,0,0,80.22,889,623,"東新里",NULL
0,1375,43,1418,1760,0,0,80.57,677,698,"粵寧里",NULL
0,1330,24,1354,1647,0,0,82.21,568,762,"下新里",NULL
0,976,43,1019,1240,0,0,82.18,380,596,"興隆里",NULL
0,1349,61,1410,1750,0,0,80.57,659,690,"茂興里",NULL
0,580,24,604,755,0,0,80,240,340,"泰興里",NULL
0,555,25,580,663,0,0,87.48,248,307,"埤頭里",NULL
0,988,70,1058,1395,0,0,75.84,395,593,"明正里",NULL
0,1010,22,1032,1271,0,0,81.2,451,559,"朝陽里",NULL
0,897,23,920,1177,0,0,78.16,419,478,"大甲里",NULL
0,1304,29,1333,1659,0,0,80.35,608,696,"順天里",NULL
0,632,16,648,786,0,0,82.44,326,306,"孔門里",NULL
0,1567,31,1598,1960,0,0,81.53,712,855,"平安里",NULL
0,1565,44,1609,1966,0,0,81.84,707,858,"庄美里",NULL
0,2454,77,2531,3102,0,0,81.59,1199,1255,"新美里",NULL
0,1479,23,1502,1863,0,0,80.62,751,728,"岷山里",NULL
0,2705,87,2792,3439,0,0,81.19,1450,1255,"中山里",NULL
0,682,17,699,880,0,0,79.43,336,346,"南陽里",NULL
0,746,17,763,934,0,0,81.69,359,387,"薰風里",NULL
0,2033,64,2097,2649,0,0,79.16,1013,1020,"義和里",NULL
0,849,36,885,1106,0,0,80.02,474,375,"武陵里",NULL
0,802,37,839,1095,0,0,76.62,364,438,"文曲里",NULL
0,1228,54,1282,1560,0,0,82.18,607,621,"武曲里",NULL
0,3608,83,3691,4552,0,0,81.09,1788,1820,"文武里",NULL
0,1116,32,1148,1445,0,0,79.45,591,525,"奉化里",NULL
0,1246,32,1278,1607,0,0,79.53,464,782,"德化里",NULL
0,830,12,842,1028,0,0,81.91,369,461,"江南里",NULL
0,2616,80,2696,3376,0,0,79.86,1164,1452,"頂店里",NULL
0,952,31,983,1246,0,0,78.89,398,554,"太白里",NULL
0,2499,67,2566,3206,0,0,80.04,1106,1393,"孟春里",NULL
0,1796,83,1879,2340,0,0,80.3,670,1126,"幸福里",NULL
0,3195,77,3272,4100,0,0,79.8,1534,1661,"日南里",NULL
0,1077,53,1130,1392,0,0,81.18,507,570,"龍泉里",NULL
0,1165,40,1205,1494,0,0,80.66,587,578,"西岐里",NULL
0,955,45,1000,1242,0,0,80.52,438,517,"銅安里",NULL
0,862,21,883,1067,0,0,82.76,473,389,"福德里",NULL
0,1042,45,1087,1329,0,0,81.79,443,599,"建興里",NULL
0,954,17,971,1200,0,0,80.92,460,494,"鰲峰里",NULL
0,872,14,886,1071,0,0,82.73,452,420,"靈泉里",NULL
0,1621,27,1648,2026,0,0,81.34,655,966,"清水里",NULL
0,593,8,601,730,0,0,82.33,251,342,"文昌里",NULL
0,1442,21,1463,1778,0,0,82.28,690,752,"南寧里",NULL
0,1165,36,1201,1466,0,0,81.92,458,707,"西寧里",NULL
0,601,20,621,744,0,0,83.47,246,355,"北寧里",NULL
0,376,11,387,459,0,0,84.31,157,219,"中興里",NULL
0,1971,31,2002,2414,0,0,82.93,1077,894,"西社里",NULL
0,4257,107,4364,5359,0,0,81.43,1831,2426,"南社里",NULL
0,975,25,1000,1272,0,0,78.62,431,544,"裕嘉里",NULL
0,1138,47,1185,1484,0,0,79.85,582,556,"臨江里",NULL
0,2761,67,2828,3559,0,0,79.46,1237,1524,"秀水里",NULL
0,2122,70,2192,2769,0,0,79.16,896,1226,"武鹿里",NULL
0,1452,44,1496,1862,0,0,80.34,679,773,"海濱里",NULL
0,2831,64,2895,3598,0,0,80.46,1092,1739,"康榔里",NULL
0,1219,27,1246,1527,0,0,81.6,952,267,"中社里",NULL
0,995,53,1048,1325,0,0,79.09,576,419,"高西里",NULL
0,1057,33,1090,1305,0,0,83.52,476,581,"高南里",NULL
0,973,47,1020,1285,0,0,79.38,320,653,"高東里",NULL
0,827,28,855,1101,0,0,77.66,492,335,"高北里",NULL
0,990,26,1016,1270,0,0,80,502,488,"高美里",NULL
0,1542,50,1592,2008,0,0,79.28,532,1010,"國姓里",NULL
0,1648,55,1703,2183,0,0,78.01,667,981,"菁埔里",NULL
0,1345,55,1400,1759,0,0,79.59,573,772,"頂湳里",NULL
0,1614,34,1648,2125,0,0,77.55,635,979,"田寮里",NULL
0,4624,65,4689,5801,0,0,80.83,1947,2677,"橋頭里",NULL
0,2246,58,2304,2861,0,0,80.53,955,1291,"下湳里",NULL
0,864,31,895,1112,0,0,80.49,432,432,"東山里",NULL
0,1049,42,1091,1332,0,0,81.91,532,517,"吳厝里",NULL
0,811,42,853,1037,0,0,82.26,284,527,"楊厝里",NULL
0,918,42,960,1207,0,0,79.54,330,588,"海風里",NULL
0,1099,12,1111,1355,0,0,81.99,520,579,"居仁里",NULL
0,1774,36,1810,2198,0,0,82.35,876,898,"洛泉里",NULL
0,942,21,963,1174,0,0,82.03,366,576,"沙鹿里",NULL
0,452,8,460,547,0,0,84.1,219,233,"美仁里",NULL
0,1921,34,1955,2381,0,0,82.11,946,975,"興仁里",NULL
0,2091,47,2138,2593,0,0,82.45,958,1133,"興安里",NULL
0,3008,66,3074,3684,0,0,83.44,1470,1538,"斗抵里",NULL
0,3042,78,3120,3873,0,0,80.56,1268,1774,"鹿峰里",NULL
0,4110,95,4205,5149,0,0,81.67,1637,2473,"鹿寮里",NULL
0,4396,105,4501,5501,0,0,81.82,2202,2194,"竹林里",NULL
0,646,35,681,840,0,0,81.07,275,371,"犁分里",NULL
0,1704,43,1747,2236,0,0,78.13,920,784,"福興里",NULL
0,2542,81,2623,3324,0,0,78.91,1265,1277,"北勢里",NULL
0,980,42,1022,1254,0,0,81.5,439,541,"晉江里",NULL
0,1811,43,1854,2304,0,0,80.47,855,956,"六路里",NULL
0,1427,53,1480,1850,0,0,80,633,794,"南勢里",NULL
0,1600,43,1643,2061,0,0,79.72,792,808,"埔子里",NULL
0,1815,52,1867,2394,0,0,77.99,1041,774,"三鹿里",NULL
0,2779,70,2849,3478,0,0,81.91,1818,961,"公明里",NULL
0,1514,29,1543,1885,0,0,81.86,984,530,"清泉里",NULL
0,1587,23,1610,1984,0,0,81.15,809,778,"西勢里",NULL
0,2024,41,2065,2570,0,0,80.35,1097,927,"頂寮里",NULL
0,1656,37,1693,2015,0,0,84.02,909,747,"下寮里",NULL
0,2592,52,2644,3343,0,0,79.09,1334,1258,"中正里",NULL
0,441,3,444,566,0,0,78.45,198,243,"中和里",NULL
0,930,24,954,1148,0,0,83.1,484,446,"文化里",NULL
0,588,19,607,741,0,0,81.92,307,281,"安仁里",NULL
0,4120,100,4220,5224,0,0,80.78,2046,2074,"草湳里",NULL
0,2104,53,2157,2620,0,0,82.33,846,1258,"南簡里",NULL
0,2304,50,2354,2900,0,0,81.17,1027,1277,"福德里",NULL
0,4032,74,4106,5083,0,0,80.78,1950,2082,"大庄里",NULL
0,2922,65,2987,3735,0,0,79.97,1440,1482,"大村里",NULL
0,1426,49,1475,1804,0,0,81.76,564,862,"興農里",NULL
0,1769,24,1793,2168,0,0,82.7,784,985,"永寧里",NULL
0,1772,39,1811,2239,0,0,80.88,813,959,"永安里",NULL
0,1533,54,1587,1931,0,0,82.19,1048,485,"廣福村",NULL
0,1848,46,1894,2309,0,0,82.03,1401,447,"仁里村",NULL
0,2097,49,2146,2626,0,0,81.72,1230,867,"義里村",NULL
0,2013,47,2060,2524,0,0,81.62,1188,825,"義德村",NULL
0,2726,47,2773,3317,0,0,83.6,1409,1317,"后里村",NULL
0,1534,52,1586,1896,0,0,83.65,686,848,"厚里村",NULL
0,3280,90,3370,4093,0,0,82.34,1590,1690,"墩東村",NULL
0,1450,47,1497,1797,0,0,83.31,617,833,"墩西村",NULL
0,2115,51,2166,2599,0,0,83.34,921,1194,"墩南村",NULL
0,2300,68,2368,2835,0,0,83.53,1016,1284,"墩北村",NULL
0,1648,50,1698,2026,0,0,83.81,651,997,"中和村",NULL
0,1057,39,1096,1331,0,0,82.34,387,670,"舊社村",NULL
0,1173,42,1215,1499,0,0,81.05,459,714,"聯合村",NULL
0,1562,63,1625,2016,0,0,80.61,718,844,"太平村",NULL
0,2215,59,2274,2825,0,0,80.5,1082,1133,"眉山村",NULL
0,1251,30,1281,1543,0,0,83.02,480,771,"月眉村",NULL
0,1388,47,1435,1769,0,0,81.12,579,809,"公館村",NULL
0,989,38,1027,1268,0,0,80.99,397,592,"泰安村",NULL
0,2034,42,2076,2513,0,0,82.61,938,1096,"神岡村",NULL
0,1257,29,1286,1586,0,0,81.08,537,720,"庄前村",NULL
0,1729,57,1786,2155,0,0,82.88,697,1032,"北庄村",NULL
0,1629,57,1686,2011,0,0,83.84,574,1055,"庄後村",NULL
0,1695,44,1739,2117,0,0,82.14,897,798,"圳前村",NULL
0,1601,40,1641,1951,0,0,84.11,829,772,"圳堵村",NULL
0,2781,108,2889,3584,0,0,80.61,1151,1630,"新庄村",NULL
0,731,31,762,917,0,0,83.1,302,429,"山皮村",NULL
0,4410,90,4500,5418,0,0,83.06,1836,2574,"社口村",NULL
0,3248,98,3346,4040,0,0,82.82,1267,1981,"社南村",NULL
0,1725,52,1777,2121,0,0,83.78,575,1150,"三角村",NULL
0,2544,65,2609,3247,0,0,80.35,1219,1325,"大社村",NULL
0,2108,57,2165,2550,0,0,84.9,744,1364,"岸裡村",NULL
0,4899,158,5057,6160,0,0,82.09,1877,3022,"豐洲村",NULL
0,1880,72,1952,2276,0,0,85.76,615,1265,"神洲村",NULL
0,2063,45,2108,2498,0,0,84.39,750,1313,"溪洲村",NULL
0,1137,18,1155,1377,0,0,83.88,414,723,"潭秀村",NULL
0,1698,29,1727,2095,0,0,82.43,876,822,"潭北村",NULL
0,7077,140,7217,8852,0,0,81.53,3482,3595,"潭陽村",NULL
0,5777,133,5910,7288,0,0,81.09,3092,2685,"福仁村",NULL
0,3045,62,3107,3789,0,0,82,1702,1343,"頭家村",NULL
0,2390,46,2436,2923,0,0,83.34,1271,1119,"頭家東村",NULL
0,2967,54,3021,3822,0,0,79.04,1679,1288,"家興村",NULL
0,2228,46,2274,2797,0,0,81.3,1070,1158,"家福村",NULL
0,5271,81,5352,6508,0,0,82.24,2767,2504,"甘蔗村",NULL
0,7308,187,7495,8995,0,0,83.32,3342,3966,"東寶村",NULL
0,1457,35,1492,1770,0,0,84.29,502,955,"大富村",NULL
0,2759,51,2810,3358,0,0,83.68,1134,1625,"大豐村",NULL
0,3332,92,3424,4121,0,0,83.09,1435,1897,"栗林村",NULL
0,2792,69,2861,3368,0,0,84.95,1311,1481,"嘉仁村",NULL
0,1154,27,1181,1453,0,0,81.28,451,703,"新田村",NULL
0,2243,84,2327,2867,0,0,81.16,952,1291,"聚興村",NULL
0,3014,52,3066,3806,0,0,80.56,1486,1528,"上雅村",NULL
0,3004,53,3057,3812,0,0,80.19,1544,1460,"大雅村",NULL
0,3522,77,3599,4480,0,0,80.33,1977,1545,"文雅村",NULL
0,3059,60,3119,3824,0,0,81.56,1407,1652,"三和村",NULL
0,2954,53,3007,3708,0,0,81.09,1480,1474,"二和村",NULL
0,2475,35,2510,3098,0,0,81.02,1267,1208,"四德村",NULL
0,2440,61,2501,3069,0,0,81.49,972,1468,"西寶村",NULL
0,8003,191,8194,10169,0,0,80.58,3834,4169,"上楓村",NULL
0,4880,105,4985,6097,0,0,81.76,2279,2601,"員林村",NULL
0,4257,93,4350,5346,0,0,81.37,2474,1783,"六寶村",NULL
0,2194,59,2253,2686,0,0,83.88,924,1270,"秀山村",NULL
0,2661,82,2743,3381,0,0,81.13,1216,1445,"橫山村",NULL
0,2625,80,2705,3319,0,0,81.5,2196,429,"忠義村",NULL
0,2284,62,2346,2814,0,0,83.37,1222,1062,"新社村",NULL
0,1309,66,1375,1747,0,0,78.71,735,574,"復盛村",NULL
0,991,46,1037,1236,0,0,83.9,467,524,"中正村",NULL
0,730,27,757,911,0,0,83.1,316,414,"月湖村",NULL
0,951,36,987,1205,0,0,81.91,331,620,"崑山村",NULL
0,1519,53,1572,1948,0,0,80.7,767,752,"大南村",NULL
0,2119,75,2194,2646,0,0,82.92,820,1299,"永源村",NULL
0,640,26,666,809,0,0,82.32,549,91,"中興村",NULL
0,2035,92,2127,2596,0,0,81.93,849,1186,"協成村",NULL
0,1009,45,1054,1274,0,0,82.73,534,475,"東興村",NULL
0,692,37,729,892,0,0,81.73,288,404,"慶西村",NULL
0,457,17,474,587,0,0,80.75,297,160,"中和村",NULL
0,934,57,991,1267,0,0,78.22,449,485,"福興村",NULL
0,854,30,884,1058,0,0,83.55,404,450,"石岡村",NULL
0,982,26,1008,1160,0,0,86.9,457,525,"萬安村",NULL
0,825,29,854,1047,0,0,81.57,451,374,"九房村",NULL
0,951,47,998,1212,0,0,82.34,424,527,"金星村",NULL
0,547,13,560,679,0,0,82.47,259,288,"龍興村",NULL
0,1111,31,1142,1351,0,0,84.53,547,564,"萬興村",NULL
0,1347,47,1394,1724,0,0,80.86,635,712,"梅子村",NULL
0,726,28,754,929,0,0,81.16,403,323,"土牛村",NULL
0,1003,37,1040,1268,0,0,82.02,588,415,"德興村",NULL
0,979,19,998,1210,0,0,82.48,638,341,"和盛村",NULL
0,799,10,809,993,0,0,81.47,413,386,"永豐村",NULL
0,1220,33,1253,1531,0,0,81.84,707,513,"六分村",NULL
0,2769,69,2838,3506,0,0,80.95,1557,1212,"大同村",NULL
0,3602,112,3714,4659,0,0,79.72,1984,1618,"大東村",NULL
0,1281,51,1332,1694,0,0,78.63,698,583,"三崁村",NULL
0,2227,55,2282,2875,0,0,79.37,1216,1011,"水美村",NULL
0,1534,85,1619,2057,0,0,78.71,842,692,"鐵山村",NULL
0,797,24,821,1038,0,0,79.09,456,341,"中山村",NULL
0,1034,40,1074,1339,0,0,80.21,551,483,"馬鳴村",NULL
0,1251,57,1308,1571,0,0,83.26,527,724,"土城村",NULL
0,906,40,946,1205,0,0,78.51,434,472,"廍子村",NULL
0,855,26,881,1077,0,0,81.8,332,523,"南埔村",NULL
0,874,26,900,1114,0,0,80.79,335,539,"南庄村",NULL
0,1810,41,1851,2388,0,0,77.51,859,951,"中庄村",NULL
0,964,23,987,1200,0,0,82.25,491,473,"東安村",NULL
0,861,42,903,1157,0,0,78.05,342,519,"福興村",NULL
0,1250,49,1299,1574,0,0,82.53,619,631,"龜殼村",NULL
0,671,30,701,875,0,0,80.11,294,377,"頂安村",NULL
0,1313,46,1359,1649,0,0,82.41,638,675,"永安村",NULL
0,771,35,806,989,0,0,81.5,378,393,"福住村",NULL
0,1032,33,1065,1362,0,0,78.19,623,409,"海墘村",NULL
0,1052,58,1110,1378,0,0,80.55,445,607,"西安村",NULL
0,628,11,639,768,0,0,83.2,261,367,"松雅村",NULL
0,4745,99,4844,5828,0,0,83.12,2218,2527,"烏日村",NULL
0,1689,39,1728,2140,0,0,80.75,768,921,"湖日村",NULL
0,2690,105,2795,3362,0,0,83.14,1606,1084,"三和村",NULL
0,2074,51,2125,2523,0,0,84.23,1136,938,"榮泉村",NULL
0,1577,60,1637,1978,0,0,82.76,867,710,"學田村",NULL
0,7772,128,7900,9571,0,0,82.54,3781,3991,"九德村",NULL
0,4278,75,4353,5283,0,0,82.4,2248,2030,"仁德村",NULL
0,1721,45,1766,2072,0,0,85.23,645,1076,"前竹村",NULL
0,1168,37,1205,1473,0,0,81.81,556,612,"五光村",NULL
0,1638,46,1684,2011,0,0,83.74,693,945,"光明村",NULL
0,1324,46,1370,1672,0,0,81.94,576,748,"東園村",NULL
0,2955,60,3015,3601,0,0,83.73,1372,1583,"溪埧村",NULL
0,1247,45,1292,1532,0,0,84.33,545,702,"螺潭村",NULL
0,1115,46,1161,1406,0,0,82.57,450,665,"北里村",NULL
0,876,21,897,1081,0,0,82.98,385,491,"南里村",NULL
0,594,30,624,812,0,0,76.85,255,339,"溪尾村",NULL
0,2898,78,2976,3660,0,0,81.31,1278,1620,"王田村",NULL
0,662,19,681,798,0,0,85.34,275,387,"中和村",NULL
0,2654,69,2723,3254,0,0,83.68,1268,1386,"福山村",NULL
0,1051,29,1080,1292,0,0,83.59,525,526,"營埔村",NULL
0,1837,45,1882,2258,0,0,83.35,996,841,"社腳村",NULL
0,1800,34,1834,2306,0,0,79.53,978,822,"新興村",NULL
0,2114,43,2157,2589,0,0,83.31,1096,1018,"大東村",NULL
0,1491,24,1515,1827,0,0,82.92,826,665,"大肚村",NULL
0,676,11,687,845,0,0,81.3,338,338,"永和村",NULL
0,1046,33,1079,1329,0,0,81.19,559,487,"磺溪村",NULL
0,1197,42,1239,1476,0,0,83.94,534,663,"永順村",NULL
0,709,28,737,891,0,0,82.72,353,356,"成功村",NULL
0,1070,42,1112,1344,0,0,82.74,487,583,"山陽村",NULL
0,3919,74,3993,4877,0,0,81.87,2088,1831,"頂街村",NULL
0,3052,64,3116,3894,0,0,80.02,1462,1590,"瑞井村",NULL
0,2722,76,2798,3510,0,0,79.72,1170,1552,"蔗廍村",NULL
0,2397,48,2445,2955,0,0,82.74,1486,911,"自強村",NULL
0,1774,35,1809,2244,0,0,80.61,900,874,"竹坑村",NULL
0,1909,48,1957,2429,0,0,80.57,956,953,"龍東村",NULL
0,1327,42,1369,1643,0,0,83.32,714,613,"龍西村",NULL
0,2044,53,2097,2580,0,0,81.28,936,1108,"田中村",NULL
0,736,31,767,998,0,0,76.85,391,345,"福田村",NULL
0,1527,46,1573,1964,0,0,80.09,851,676,"麗水村",NULL
0,3318,97,3415,4266,0,0,80.05,1435,1883,"龍津村",NULL
0,1914,56,1970,2500,0,0,78.8,804,1110,"三德村",NULL
0,3034,94,3128,3867,0,0,80.89,1243,1791,"忠和村",NULL
0,3016,73,3089,3926,0,0,78.68,1381,1635,"山腳村",NULL
0,3380,88,3468,4380,0,0,79.18,1749,1631,"龍泉村",NULL
0,1641,39,1680,2086,0,0,80.54,736,905,"龍崗村",NULL
0,3576,111,3687,4659,0,0,79.14,1708,1868,"新庄村",NULL
0,1109,51,1160,1362,0,0,85.17,469,640,"南寮村",NULL
0,4492,63,4555,5651,0,0,80.61,2737,1755,"東海村",NULL
0,2520,52,2572,3238,0,0,79.43,1296,1224,"新東村",NULL
0,912,27,939,1143,0,0,82.15,401,511,"桐林村",NULL
0,5920,110,6030,7476,0,0,80.66,2996,2924,"吉峰村",NULL
0,3185,72,3257,4006,0,0,81.3,1639,1546,"甲寅村",NULL
0,1489,27,1516,1826,0,0,83.02,710,779,"本鄉村",NULL
0,1278,23,1301,1546,0,0,84.15,687,591,"中正村",NULL
0,784,16,800,942,0,0,84.93,410,374,"錦榮村",NULL
0,865,21,886,1071,0,0,82.73,437,428,"萊園村",NULL
0,3844,90,3934,4869,0,0,80.8,2097,1747,"本堂村",NULL
0,2510,64,2574,3053,0,0,84.31,1185,1325,"北柳村",NULL
0,1153,41,1194,1428,0,0,83.61,525,628,"南柳村",NULL
0,1635,41,1676,2004,0,0,83.63,650,985,"四德村",NULL
0,1931,72,2003,2384,0,0,84.02,906,1025,"五福村",NULL
0,1612,62,1674,1937,0,0,86.42,572,1040,"丁臺村",NULL
0,1335,51,1386,1662,0,0,83.39,672,663,"北勢村",NULL
0,923,26,949,1162,0,0,81.67,422,501,"南勢村",NULL
0,1908,53,1961,2403,0,0,81.61,793,1115,"萬豐村",NULL
0,1577,62,1639,2000,0,0,81.95,703,874,"舊正村",NULL
0,2297,59,2356,2875,0,0,81.95,1360,937,"坑口村",NULL
0,805,21,826,1036,0,0,79.73,336,469,"峰谷村",NULL
0,1785,62,1847,2190,0,0,84.34,676,1109,"六股村",NULL
0,1284,51,1335,1739,0,0,76.77,750,534,"南勢村",NULL
0,342,17,359,485,0,0,74.02,198,144,"天輪村",NULL
0,1257,20,1277,1639,0,0,77.91,886,371,"博愛村",NULL
0,703,22,725,947,0,0,76.56,542,161,"自由村",NULL
0,767,17,784,988,0,0,79.35,567,200,"達觀村",NULL
0,298,8,306,376,0,0,81.38,172,126,"中坑村",NULL
0,1122,27,1149,1915,0,0,60,857,265,"梨山村",NULL
0,526,4,530,783,0,0,67.69,433,93,"平等村",NULL
0,2120,75,2195,2757,0,0,79.62,1191,929,"桃源里",NULL
0,1301,22,1323,1599,0,0,82.74,647,654,"東興里",NULL
0,1210,18,1228,1528,0,0,80.37,614,596,"華北里",NULL
0,1660,43,1703,2119,0,0,80.37,988,672,"華陽里",NULL
0,830,19,849,1032,0,0,82.27,348,482,"大同里",NULL
0,1112,33,1145,1392,0,0,82.26,523,589,"永生里",NULL
0,1924,35,1959,2352,0,0,83.29,1147,777,"卦山里",NULL
0,611,14,625,760,0,0,82.24,272,339,"光復里",NULL
0,762,26,788,933,0,0,84.46,338,424,"永福里",NULL
0,671,9,680,808,0,0,84.16,287,384,"光華里",NULL
0,1173,15,1188,1429,0,0,83.14,565,608,"中正里",NULL
0,668,14,682,810,0,0,84.2,382,286,"中山里",NULL
0,1827,37,1864,2229,0,0,83.62,1092,735,"龍山里",NULL
0,1939,29,1968,2331,0,0,84.43,1188,751,"建寶里",NULL
0,1134,28,1162,1395,0,0,83.3,567,567,"光南里",NULL
0,1520,38,1558,2132,0,0,73.08,949,571,"介壽里",NULL
0,4972,100,5072,6183,0,0,82.03,2607,2365,"延平里",NULL
0,2964,40,3004,3593,0,0,83.61,1399,1565,"延和里",NULL
0,4155,75,4230,5143,0,0,82.25,2118,2037,"南興里",NULL
0,5224,91,5315,6494,0,0,81.84,2591,2633,"南瑤里",NULL
0,1213,34,1247,1478,0,0,84.37,614,599,"成功里",NULL
0,891,15,906,1063,0,0,85.23,445,446,"福安里",NULL
0,2212,52,2264,2767,0,0,81.82,1056,1156,"西安里",NULL
0,2447,52,2499,3020,0,0,82.75,1159,1288,"彰安里",NULL
0,740,11,751,909,0,0,82.62,312,428,"中央里",NULL
0,804,16,820,992,0,0,82.66,360,444,"富貴里",NULL
0,1012,22,1034,1226,0,0,84.34,493,519,"民權里",NULL
0,795,9,804,982,0,0,81.87,327,468,"萬壽里",NULL
0,1895,45,1940,2372,0,0,81.79,937,958,"西興里",NULL
0,1016,28,1044,1209,0,0,86.35,428,588,"長樂里",NULL
0,2080,37,2117,2564,0,0,82.57,1079,1001,"西勢里",NULL
0,2131,33,2164,2646,0,0,81.78,1188,943,"忠權里",NULL
0,938,16,954,1162,0,0,82.1,453,485,"忠孝里",NULL
0,2596,48,2644,3294,0,0,80.27,1319,1277,"五權里",NULL
0,2818,64,2882,3539,0,0,81.44,1438,1380,"平和里",NULL
0,3590,69,3659,4425,0,0,82.69,1834,1756,"崙平里",NULL
0,2387,46,2433,2961,0,0,82.17,1325,1062,"向陽里",NULL
0,2036,41,2077,2505,0,0,82.91,1044,992,"莿桐里",NULL
0,1191,33,1224,1501,0,0,81.55,562,629,"南美里",NULL
0,1413,43,1456,1779,0,0,81.84,691,722,"南安里",NULL
0,2249,55,2304,2867,0,0,80.36,1112,1137,"東芳里",NULL
0,2137,61,2198,2718,0,0,80.87,1035,1102,"磚窯里",NULL
0,3309,69,3378,4062,0,0,83.16,1680,1629,"新興里",NULL
0,1457,36,1493,1813,0,0,82.35,733,724,"新華里",NULL
0,1246,22,1268,1540,0,0,82.34,575,671,"興北里",NULL
0,755,19,774,944,0,0,81.99,347,408,"信義里",NULL
0,1171,15,1186,1448,0,0,81.91,593,578,"民生里",NULL
0,1169,32,1201,1452,0,0,82.71,607,562,"文化里",NULL
0,1402,36,1438,1740,0,0,82.64,688,714,"陽明里",NULL
0,2996,57,3053,3704,0,0,82.42,1560,1436,"萬安里",NULL
0,2978,57,3035,3686,0,0,82.34,1562,1416,"下廍里",NULL
0,645,29,674,810,0,0,83.21,285,360,"茄苳里",NULL
0,1748,47,1795,2198,0,0,81.67,888,860,"茄南里",NULL
0,801,26,827,1035,0,0,79.9,407,394,"寶廍里",NULL
0,1749,52,1801,2254,0,0,79.9,820,929,"古夷里",NULL
0,4518,114,4632,5675,0,0,81.62,2363,2155,"阿夷里",NULL
0,1805,49,1854,2285,0,0,81.14,945,860,"和調里",NULL
0,3186,54,3240,3972,0,0,81.57,1660,1526,"復興里",NULL
0,1707,32,1739,2150,0,0,80.88,714,993,"中庄里",NULL
0,1219,50,1269,1621,0,0,78.29,573,646,"竹中里",NULL
0,2088,58,2146,2586,0,0,82.99,967,1121,"香山里",NULL
0,2321,59,2380,2861,0,0,83.19,1094,1227,"牛埔里",NULL
0,2855,46,2901,3665,0,0,79.15,1599,1256,"台鳳里",NULL
0,1813,62,1875,2257,0,0,83.07,864,949,"國聖里",NULL
0,4766,130,4896,6015,0,0,81.4,2093,2673,"福山里",NULL
0,837,18,855,1049,0,0,81.51,353,484,"安溪里",NULL
0,779,33,812,993,0,0,81.77,285,494,"三村里",NULL
0,2214,51,2265,2732,0,0,82.91,1059,1155,"大竹里",NULL
0,641,21,662,813,0,0,81.43,258,383,"田中里",NULL
0,780,28,808,994,0,0,81.29,345,435,"快官里",NULL
0,654,16,670,804,0,0,83.33,299,355,"竹巷里",NULL
0,948,25,973,1197,0,0,81.29,401,547,"福田里",NULL
0,898,23,921,1135,0,0,81.15,355,543,"石牌里",NULL
0,2237,54,2291,2791,0,0,82.09,1168,1069,"花壇村",NULL
0,1264,29,1293,1626,0,0,79.52,590,674,"金墩村",NULL
0,1833,49,1882,2257,0,0,83.39,940,893,"中庄村",NULL
0,840,23,863,1035,0,0,83.38,300,540,"劉厝村",NULL
0,1056,42,1098,1338,0,0,82.06,413,643,"崙雅村",NULL
0,1166,22,1188,1461,0,0,81.31,581,585,"南口村",NULL
0,570,10,580,705,0,0,82.27,227,343,"中口村",NULL
0,1259,38,1297,1579,0,0,82.14,569,690,"北口村",NULL
0,3120,63,3183,3876,0,0,82.12,1628,1492,"長沙村",NULL
0,1854,60,1914,2371,0,0,80.73,965,889,"文德村",NULL
0,2905,59,2964,3691,0,0,80.3,1552,1353,"白沙村",NULL
0,996,37,1033,1304,0,0,79.22,483,513,"岩竹村",NULL
0,2239,74,2313,2924,0,0,79.1,1197,1042,"橋頭村",NULL
0,659,23,682,841,0,0,81.09,358,301,"灣雅村",NULL
0,693,32,725,947,0,0,76.56,367,326,"灣東村",NULL
0,1259,33,1292,1635,0,0,79.02,670,589,"三春村",NULL
0,1106,36,1142,1467,0,0,77.85,573,533,"永春村",NULL
0,1121,45,1166,1461,0,0,79.81,598,523,"長春村",NULL
0,1231,68,1299,1695,0,0,76.64,574,657,"舊社村",NULL
0,983,57,1040,1321,0,0,78.73,448,535,"大埔村",NULL
0,1223,59,1282,1620,0,0,79.14,578,645,"竹林村",NULL
0,446,17,463,570,0,0,81.23,208,238,"楓坑村",NULL
0,1747,52,1799,2263,0,0,79.5,785,962,"社口村",NULL
0,1737,59,1796,2171,0,0,82.73,748,989,"茄荖村",NULL
0,1191,41,1232,1531,0,0,80.47,505,686,"嘉興村",NULL
0,677,36,713,872,0,0,81.77,269,408,"芬園村",NULL
0,703,37,740,938,0,0,78.89,304,399,"進芬村",NULL
0,840,40,880,1072,0,0,82.09,271,569,"縣庄村",NULL
0,539,33,572,682,0,0,83.87,172,367,"圳墘村",NULL
0,1144,52,1196,1484,0,0,80.59,418,726,"溪頭村",NULL
0,942,74,1016,1254,0,0,81.02,318,624,"同安村",NULL
0,715,35,750,986,0,0,76.06,286,429,"中崙村",NULL
0,751,49,800,1066,0,0,75.05,245,506,"大竹村",NULL
0,900,33,933,1152,0,0,80.99,335,565,"大有里",NULL
0,451,12,463,565,0,0,81.95,161,290,"中興里",NULL
0,792,20,812,994,0,0,81.69,304,488,"洛津里",NULL
0,698,9,707,863,0,0,81.92,295,403,"順興里",NULL
0,780,30,810,981,0,0,82.57,233,547,"菜園里",NULL
0,1534,37,1571,1921,0,0,81.78,597,937,"街尾里",NULL
0,927,32,959,1180,0,0,81.27,441,486,"泰興里",NULL
0,240,16,256,322,0,0,79.5,109,131,"長興里",NULL
0,519,18,537,656,0,0,81.86,236,283,"興化里",NULL
0,589,12,601,755,0,0,79.6,232,357,"龍山里",NULL
0,881,35,916,1123,0,0,81.57,406,475,"景福里",NULL
0,435,16,451,593,0,0,76.05,157,278,"郭厝里",NULL
0,769,17,786,952,0,0,82.56,230,539,"新宮里",NULL
0,1008,39,1047,1267,0,0,82.64,369,639,"玉順里",NULL
0,2621,59,2680,3298,0,0,81.26,911,1710,"東石里",NULL
0,2883,91,2974,3659,0,0,81.28,1247,1636,"永安里",NULL
0,2636,76,2712,3322,0,0,81.64,978,1658,"埔崙里",NULL
0,4291,125,4416,5448,0,0,81.06,1730,2561,"頂厝里",NULL
0,3203,145,3348,4189,0,0,79.92,1455,1748,"東崎里",NULL
0,2458,83,2541,3173,0,0,80.08,1236,1222,"廖厝里",NULL
0,1196,59,1255,1627,0,0,77.14,497,699,"詔安里",NULL
0,2223,59,2282,2870,0,0,79.51,958,1265,"海埔里",NULL
0,1804,69,1873,2346,0,0,79.84,636,1168,"洋厝里",NULL
0,2208,69,2277,2855,0,0,79.75,1151,1057,"草中里",NULL
0,2326,73,2399,2917,0,0,82.24,922,1404,"山崙里",NULL
0,1367,60,1427,1787,0,0,79.85,714,653,"頭南里",NULL
0,1739,67,1806,2252,0,0,80.2,848,891,"頭崙里",NULL
0,2402,75,2477,3094,0,0,80.06,1274,1128,"頂番里",NULL
0,2668,89,2757,3458,0,0,79.73,1437,1231,"溝墘里",NULL
0,1545,56,1601,2078,0,0,77.05,683,862,"番婆村",NULL
0,845,29,874,1097,0,0,79.67,400,445,"大崙村",NULL
0,827,55,882,1075,0,0,82.05,289,538,"外埔村",NULL
0,982,35,1017,1228,0,0,82.82,352,630,"三汴村",NULL
0,588,25,613,741,0,0,82.73,257,331,"萬豐村",NULL
0,895,44,939,1163,0,0,80.74,311,584,"外中村",NULL
0,859,42,901,1075,0,0,83.81,399,460,"元中村",NULL
0,1702,58,1760,2164,0,0,81.33,787,915,"橋頭村",NULL
0,962,56,1018,1329,0,0,76.6,411,551,"社尾村",NULL
0,1008,40,1048,1275,0,0,82.2,252,756,"番社村",NULL
0,1671,55,1726,2089,0,0,82.62,735,936,"同安村",NULL
0,1351,40,1391,1665,0,0,83.54,622,729,"西勢村",NULL
0,1604,55,1659,2069,0,0,80.18,717,887,"秀厝村",NULL
0,817,39,856,1091,0,0,78.46,358,459,"鎮平村",NULL
0,797,37,834,1021,0,0,81.68,256,541,"三和村",NULL
0,1552,78,1630,2107,0,0,77.36,601,951,"麥厝村",NULL
0,1396,54,1450,1824,0,0,79.5,681,715,"廈粘村",NULL
0,1545,79,1624,2053,0,0,79.1,762,783,"頂粘村",NULL
0,881,39,920,1174,0,0,78.36,471,410,"福寶村",NULL
0,969,41,1010,1257,0,0,80.35,488,481,"二港村",NULL
0,2190,68,2258,2813,0,0,80.27,959,1231,"福興村",NULL
0,1673,59,1732,2164,0,0,80.04,789,884,"福南村",NULL
0,1311,40,1351,1623,0,0,83.24,547,764,"秀水村",NULL
0,1198,45,1243,1491,0,0,83.37,501,697,"安溪村",NULL
0,1651,50,1701,2057,0,0,82.69,824,827,"莊雅村",NULL
0,958,37,995,1194,0,0,83.33,490,468,"陝西村",NULL
0,1339,53,1392,1660,0,0,83.86,647,692,"金興村",NULL
0,2543,76,2619,3227,0,0,81.16,1198,1345,"安東村",NULL
0,2116,75,2191,2652,0,0,82.62,909,1207,"鶴鳴村",NULL
0,1599,53,1652,2005,0,0,82.39,614,985,"馬興村",NULL
0,893,27,920,1116,0,0,82.44,396,497,"義興村",NULL
0,2735,87,2822,3487,0,0,80.93,1293,1442,"福安村",NULL
0,1390,34,1424,1747,0,0,81.51,585,805,"埔崙村",NULL
0,1078,40,1118,1365,0,0,81.9,454,624,"曾厝村",NULL
0,1177,26,1203,1439,0,0,83.6,413,764,"金陵村",NULL
0,1511,69,1580,1896,0,0,83.33,612,899,"下崙村",NULL
0,3198,73,3271,4075,0,0,80.27,1549,1649,"竹營里",NULL
0,2825,53,2878,3515,0,0,81.88,1443,1382,"和東里",NULL
0,395,2,397,457,0,0,86.87,227,168,"和南里",NULL
0,1105,29,1134,1389,0,0,81.64,581,524,"和北里",NULL
0,2456,71,2527,3109,0,0,81.28,1305,1151,"和西里",NULL
0,1861,56,1917,2367,0,0,80.99,886,975,"四張里",NULL
0,1072,36,1108,1364,0,0,81.23,561,511,"頭前里",NULL
0,636,22,658,776,0,0,84.79,300,336,"還社里",NULL
0,1352,37,1389,1705,0,0,81.47,647,705,"面前里",NULL
0,1967,47,2014,2451,0,0,82.17,860,1107,"鎮平里",NULL
0,994,22,1016,1238,0,0,82.07,562,432,"大霞里",NULL
0,1197,41,1238,1556,0,0,79.56,589,608,"源埤里",NULL
0,1346,56,1402,1755,0,0,79.89,618,728,"南佃里",NULL
0,971,16,987,1248,0,0,79.09,427,544,"雅溝里",NULL
0,4351,114,4465,5533,0,0,80.7,2192,2159,"山犁里",NULL
0,1218,28,1246,1570,0,0,79.36,666,552,"嘉犁里",NULL
0,1294,34,1328,1670,0,0,79.52,638,656,"詔安里",NULL
0,1905,42,1947,2388,0,0,81.53,950,955,"鐵山里",NULL
0,2152,70,2222,2651,0,0,83.82,1027,1125,"柑井里",NULL
0,663,21,684,814,0,0,84.03,218,445,"竹園里",NULL
0,1796,55,1851,2288,0,0,80.9,896,900,"新庄里",NULL
0,1629,44,1673,2060,0,0,81.21,767,862,"犁盛里",NULL
0,841,29,870,1093,0,0,79.6,349,492,"中寮里",NULL
0,1966,74,2040,2575,0,0,79.22,834,1132,"中圍里",NULL
0,2210,40,2250,2720,0,0,82.72,1202,1008,"糖友里",NULL
0,1284,41,1325,1665,0,0,79.58,701,583,"塗厝里",NULL
0,670,25,695,842,0,0,82.54,326,344,"地潭里",NULL
0,943,52,995,1204,0,0,82.64,272,671,"湖內里",NULL
0,1304,43,1347,1714,0,0,78.59,642,662,"嘉寶里",NULL
0,2220,61,2281,2832,0,0,80.54,994,1226,"月眉里",NULL
0,1243,62,1305,1645,0,0,79.33,587,656,"好修里",NULL
0,1488,48,1536,1917,0,0,80.13,944,544,"線西村",NULL
0,890,44,934,1136,0,0,82.22,549,341,"頂庄村",NULL
0,1527,20,1547,1996,0,0,77.51,760,767,"寓埔村",NULL
0,917,23,940,1155,0,0,81.39,494,423,"塭仔村",NULL
0,777,34,811,1037,0,0,78.21,448,329,"溝內村",NULL
0,1269,42,1311,1676,0,0,78.22,660,609,"下犁村",NULL
0,1650,73,1723,2163,0,0,79.66,979,671,"頂犁村",NULL
0,860,34,894,1094,0,0,81.72,500,360,"德興村",NULL
0,3306,79,3385,4224,0,0,80.14,1686,1620,"新港村",NULL
0,1174,50,1224,1539,0,0,79.53,721,453,"什股村",NULL
0,991,25,1016,1239,0,0,82,452,539,"大同村",NULL
0,1289,40,1329,1621,0,0,81.99,630,659,"海尾村",NULL
0,1135,52,1187,1532,0,0,77.48,721,414,"全興村",NULL
0,1218,66,1284,1575,0,0,81.52,541,677,"溪底村",NULL
0,1662,65,1727,2196,0,0,78.64,890,772,"定興村",NULL
0,1298,44,1342,1663,0,0,80.7,695,603,"泉州村",NULL
0,927,43,970,1197,0,0,81.04,438,489,"泉厝村",NULL
0,1128,56,1184,1486,0,0,79.68,491,637,"曾家村",NULL
0,883,43,926,1145,0,0,80.87,249,634,"蚵寮村",NULL
0,777,22,799,960,0,0,83.23,358,419,"埤墘村",NULL
0,1494,49,1543,1934,0,0,79.78,793,701,"七嘉村",NULL
0,1574,45,1619,1986,0,0,81.52,821,753,"汴頭村",NULL
0,856,9,865,1077,0,0,80.32,480,376,"東和里",NULL
0,2046,60,2106,2621,0,0,80.35,1021,1025,"民生里",NULL
0,2345,33,2378,2936,0,0,80.99,1225,1120,"中正里",NULL
0,2190,40,2230,2725,0,0,81.83,1166,1024,"仁美里",NULL
0,647,13,660,819,0,0,80.59,314,333,"新興里",NULL
0,2124,52,2176,2686,0,0,81.01,1101,1023,"和平里",NULL
0,781,15,796,960,0,0,82.92,371,410,"光明里",NULL
0,583,15,598,711,0,0,84.11,283,300,"中山里",NULL
0,1381,41,1422,1753,0,0,81.12,710,671,"黎明里",NULL
0,3545,82,3627,4508,0,0,80.46,1768,1777,"惠來里",NULL
0,1832,43,1875,2261,0,0,82.93,944,888,"三義里",NULL
0,3028,67,3095,3776,0,0,81.97,1578,1450,"新生里",NULL
0,2856,69,2925,3563,0,0,82.09,1448,1408,"南平里",NULL
0,3296,95,3391,4177,0,0,81.18,1838,1458,"南興里",NULL
0,1184,58,1242,1523,0,0,81.55,471,713,"源潭里",NULL
0,1387,61,1448,1778,0,0,81.44,657,730,"大埔里",NULL
0,1065,23,1088,1279,0,0,85.07,557,508,"仁愛里",NULL
0,1465,32,1497,1829,0,0,81.85,768,697,"忠孝里",NULL
0,1627,44,1671,2068,0,0,80.8,802,825,"三條里",NULL
0,3859,90,3949,4988,0,0,79.17,2096,1763,"三和里",NULL
0,1997,61,2058,2533,0,0,81.25,974,1023,"三橋里",NULL
0,1948,46,1994,2446,0,0,81.52,1019,929,"三愛里",NULL
0,1512,31,1543,1901,0,0,81.17,807,705,"三信里",NULL
0,1600,31,1631,2007,0,0,81.27,854,746,"三多里",NULL
0,1223,42,1265,1561,0,0,81.04,593,630,"中央里",NULL
0,1664,43,1707,2092,0,0,81.6,805,859,"溝皂里",NULL
0,1978,54,2032,2510,0,0,80.96,1018,960,"大饒里",NULL
0,1577,63,1640,2006,0,0,81.75,680,897,"大明里",NULL
0,2462,64,2526,3056,0,0,82.66,1303,1159,"萬年里",NULL
0,1781,69,1850,2237,0,0,82.7,1034,747,"崙雅里",NULL
0,1761,55,1816,2259,0,0,80.39,907,854,"振興里",NULL
0,1765,73,1838,2267,0,0,81.08,781,984,"林厝里",NULL
0,1298,58,1356,1679,0,0,80.76,562,736,"出水里",NULL
0,956,32,988,1288,0,0,76.71,368,588,"湖水里",NULL
0,562,19,581,737,0,0,78.83,289,273,"大峰里",NULL
0,1412,49,1461,1824,0,0,80.1,693,719,"鎮興里",NULL
0,1592,39,1631,2034,0,0,80.19,779,813,"浮圳里",NULL
0,1303,36,1339,1682,0,0,79.61,507,796,"西東里",NULL
0,1258,48,1306,1646,0,0,79.34,573,685,"南東里",NULL
0,1133,46,1179,1507,0,0,78.23,545,588,"中東里",NULL
0,1633,36,1669,2024,0,0,82.46,770,863,"東北里",NULL
0,1649,32,1681,2066,0,0,81.36,820,829,"大村村",NULL
0,1229,47,1276,1552,0,0,82.22,556,673,"茄苳村",NULL
0,706,31,737,912,0,0,80.81,344,362,"田洋村",NULL
0,1051,41,1092,1359,0,0,80.35,503,548,"貢旗村",NULL
0,972,47,1019,1256,0,0,81.13,489,483,"加錫村",NULL
0,1090,73,1163,1449,0,0,80.26,481,609,"大崙村",NULL
0,840,29,869,1115,0,0,77.94,339,501,"新興村",NULL
0,946,30,976,1196,0,0,81.61,393,553,"南勢村",NULL
0,1684,67,1751,2156,0,0,81.22,776,908,"擺塘村",NULL
0,1707,31,1738,2111,0,0,82.33,936,771,"過溝村",NULL
0,1386,53,1439,1804,0,0,79.77,748,638,"大橋村",NULL
0,1003,34,1037,1247,0,0,83.16,506,497,"村上村",NULL
0,2019,55,2074,2518,0,0,82.37,990,1029,"美港村",NULL
0,1403,54,1457,1794,0,0,81.22,735,668,"黃厝村",NULL
0,1350,43,1393,1753,0,0,79.46,596,754,"福興村",NULL
0,1560,82,1642,2009,0,0,81.73,734,826,"平和村",NULL
0,670,10,680,815,0,0,83.44,333,337,"永東村",NULL
0,1176,34,1210,1459,0,0,82.93,581,595,"永西村",NULL
0,1445,57,1502,1841,0,0,81.59,712,733,"永南村",NULL
0,1456,41,1497,1901,0,0,78.75,689,767,"永北村",NULL
0,1283,50,1333,1645,0,0,81.03,657,626,"港西村",NULL
0,1073,36,1109,1367,0,0,81.13,497,576,"五福村",NULL
0,746,30,776,949,0,0,81.77,294,452,"湳港村",NULL
0,697,26,723,867,0,0,83.39,419,278,"新莊村",NULL
0,1631,50,1681,2053,0,0,81.88,786,845,"瑚璉村",NULL
0,1068,31,1099,1345,0,0,81.71,469,599,"五汴村",NULL
0,854,41,895,1076,0,0,83.18,438,416,"浮圳村",NULL
0,1220,61,1281,1551,0,0,82.59,495,725,"光雲村",NULL
0,1259,53,1312,1645,0,0,79.76,594,665,"東寧村",NULL
0,1195,52,1247,1518,0,0,82.15,612,583,"永興村",NULL
0,924,30,954,1176,0,0,81.12,359,565,"崙子村",NULL
0,642,40,682,846,0,0,80.61,285,357,"獨鰲村",NULL
0,556,23,579,717,0,0,80.75,283,273,"敦厚村",NULL
0,604,23,627,748,0,0,83.82,269,335,"崙美村",NULL
0,544,20,564,682,0,0,82.7,292,252,"同安村",NULL
0,721,28,749,945,0,0,79.26,371,350,"同仁村",NULL
0,635,34,669,832,0,0,80.41,342,293,"湳墘村",NULL
0,513,32,545,680,0,0,80.15,263,250,"四芳村",NULL
0,895,39,934,1143,0,0,81.71,501,394,"福興村",NULL
0,1078,12,1090,1349,0,0,80.8,370,708,"竹子村",NULL
0,979,29,1008,1221,0,0,82.56,489,490,"光平里",NULL
0,640,12,652,754,0,0,86.47,327,313,"平和里",NULL
0,1105,23,1128,1391,0,0,81.09,564,541,"太平里",NULL
0,400,8,408,491,0,0,83.1,219,181,"光華里",NULL
0,2189,54,2243,2822,0,0,79.48,1236,953,"東寮里",NULL
0,1423,49,1472,1853,0,0,79.44,786,637,"西寮里",NULL
0,1696,45,1741,2187,0,0,79.61,890,806,"大突里",NULL
0,981,43,1024,1254,0,0,81.66,404,577,"北勢里",NULL
0,1815,55,1870,2333,0,0,80.15,838,977,"汴頭里",NULL
0,1800,48,1848,2265,0,0,81.59,976,824,"大竹里",NULL
0,1482,39,1521,1919,0,0,79.26,777,705,"湖西里",NULL
0,610,33,643,769,0,0,83.62,277,333,"田中里",NULL
0,1305,65,1370,1631,0,0,84,638,667,"河東里",NULL
0,1709,63,1772,2222,0,0,79.75,811,898,"中山里",NULL
0,622,26,648,783,0,0,82.76,291,331,"中竹里",NULL
0,998,34,1032,1262,0,0,81.77,350,648,"東溪里",NULL
0,1179,43,1222,1527,0,0,80.03,596,583,"西溪里",NULL
0,2814,107,2921,3610,0,0,80.91,1320,1494,"湖東里",NULL
0,493,21,514,649,0,0,79.2,270,223,"頂庄里",NULL
0,946,45,991,1224,0,0,80.96,500,446,"忠覺里",NULL
0,563,27,590,734,0,0,80.38,258,305,"湳底里",NULL
0,980,34,1014,1264,0,0,80.22,573,407,"大庭里",NULL
0,1009,51,1060,1323,0,0,80.12,442,567,"媽厝里",NULL
0,1483,50,1533,1910,0,0,80.26,684,799,"西勢里",NULL
0,1138,45,1183,1519,0,0,77.88,547,591,"番婆里",NULL
0,1162,55,1217,1525,0,0,79.8,581,581,"埔鹽村",NULL
0,1119,53,1172,1473,0,0,79.57,560,559,"埔南村",NULL
0,916,33,949,1155,0,0,82.16,519,397,"廍子村",NULL
0,628,18,646,806,0,0,80.15,345,283,"出水村",NULL
0,1309,39,1348,1627,0,0,82.85,576,733,"南港村",NULL
0,746,38,784,931,0,0,84.21,341,405,"打廉村",NULL
0,1016,35,1051,1290,0,0,81.47,454,562,"豐澤村",NULL
0,769,40,809,1034,0,0,78.24,401,368,"崑崙村",NULL
0,572,25,597,711,0,0,83.97,315,257,"角樹村",NULL
0,908,14,922,1164,0,0,79.21,469,439,"瓦窯村",NULL
0,1030,26,1056,1334,0,0,79.16,635,395,"好修村",NULL
0,1485,67,1552,1955,0,0,79.39,744,741,"西湖村",NULL
0,971,43,1014,1252,0,0,80.99,491,480,"大有村",NULL
0,306,7,313,396,0,0,79.04,185,121,"新興村",NULL
0,795,40,835,1041,0,0,80.21,405,390,"永平村",NULL
0,610,26,636,766,0,0,83.03,306,304,"永樂村",NULL
0,949,83,1032,1307,0,0,78.96,422,527,"石埤村",NULL
0,615,29,644,834,0,0,77.22,383,232,"天盛村",NULL
0,1074,61,1135,1460,0,0,77.74,570,504,"太平村",NULL
0,1098,30,1128,1379,0,0,81.8,718,380,"新水村",NULL
0,963,42,1005,1269,0,0,79.2,561,402,"三省村",NULL
0,944,42,986,1245,0,0,79.2,599,345,"南新村",NULL
0,2092,57,2149,2635,0,0,81.56,957,1135,"東門村",NULL
0,882,34,916,1188,0,0,77.1,373,509,"埔心村",NULL
0,1162,38,1200,1437,0,0,83.51,585,577,"義民村",NULL
0,895,30,925,1131,0,0,81.79,437,458,"油車村",NULL
0,1246,37,1283,1588,0,0,80.79,571,675,"瓦北村",NULL
0,1379,48,1427,1723,0,0,82.82,637,742,"瓦中村",NULL
0,1069,42,1111,1327,0,0,83.72,465,604,"瓦南村",NULL
0,1302,56,1358,1673,0,0,81.17,494,808,"經口村",NULL
0,1400,75,1475,1769,0,0,83.38,564,836,"太平村",NULL
0,483,17,500,601,0,0,83.19,221,262,"大華村",NULL
0,811,38,849,1068,0,0,79.49,393,418,"仁里村",NULL
0,897,36,933,1150,0,0,81.13,389,508,"舊館村",NULL
0,622,29,651,790,0,0,82.41,249,373,"南館村",NULL
0,696,33,729,898,0,0,81.18,311,385,"新館村",NULL
0,1348,15,1363,1678,0,0,81.23,513,835,"芎蕉村",NULL
0,999,53,1052,1329,0,0,79.16,418,581,"羅厝村",NULL
0,677,29,706,873,0,0,80.87,319,358,"梧鳳村",NULL
0,1001,11,1012,1203,0,0,84.12,394,607,"二重村",NULL
0,603,31,634,766,0,0,82.77,278,325,"埤霞村",NULL
0,677,36,713,846,0,0,84.28,320,357,"埤腳村",NULL
0,661,35,696,870,0,0,80,270,391,"香山里",NULL
0,1176,113,1289,2143,0,0,60.15,864,312,"碧峰里",NULL
0,484,29,513,649,0,0,79.04,234,250,"東源里",NULL
0,1161,28,1189,1494,0,0,79.59,625,536,"復興里",NULL
0,1148,43,1191,1472,0,0,80.91,573,575,"平和里",NULL
0,948,38,986,1232,0,0,80.03,418,530,"頂潭里",NULL
0,1286,45,1331,1696,0,0,78.48,568,718,"中潭里",NULL
0,501,21,522,654,0,0,79.82,210,291,"龍潭里",NULL
0,2204,60,2264,2798,0,0,80.91,1157,1047,"北路里",NULL
0,1702,42,1744,2131,0,0,81.84,816,886,"西路里",NULL
0,884,15,899,1094,0,0,82.18,399,485,"東路里",NULL
0,1036,21,1057,1278,0,0,82.71,490,546,"南路里",NULL
0,1553,33,1586,1993,0,0,79.58,784,769,"中路里",NULL
0,1590,45,1635,2048,0,0,79.83,810,780,"新庄里",NULL
0,1214,39,1253,1616,0,0,77.54,458,756,"三安里",NULL
0,979,49,1028,1316,0,0,78.12,425,554,"大崙里",NULL
0,1237,63,1300,1643,0,0,79.12,595,642,"沙崙里",NULL
0,2661,70,2731,3409,0,0,80.11,1353,1308,"新民里",NULL
0,1007,41,1048,1323,0,0,79.21,403,604,"梅州里",NULL
0,1154,50,1204,1523,0,0,79.05,591,563,"三民里",NULL
0,693,29,722,888,0,0,81.31,309,384,"三光里",NULL
0,645,21,666,817,0,0,81.52,262,383,"大社里",NULL
0,2092,44,2136,2575,0,0,82.95,925,1167,"社頭村",NULL
0,3005,88,3093,3769,0,0,82.06,1244,1761,"廣興村",NULL
0,1968,52,2020,2470,0,0,81.78,925,1043,"仁雅村",NULL
0,634,15,649,803,0,0,80.82,315,319,"崙雅村",NULL
0,830,28,858,1037,0,0,82.74,397,433,"美雅村",NULL
0,846,33,879,1075,0,0,81.77,421,425,"里仁村",NULL
0,1111,35,1146,1410,0,0,81.28,445,666,"舊社村",NULL
0,741,37,778,944,0,0,82.42,317,424,"松竹村",NULL
0,973,46,1019,1242,0,0,82.05,435,538,"東興村",NULL
0,672,27,699,824,0,0,84.83,310,362,"廣福村",NULL
0,1534,60,1594,1903,0,0,83.76,641,893,"橋頭村",NULL
0,1173,36,1209,1476,0,0,81.91,463,710,"湳底村",NULL
0,1086,53,1139,1401,0,0,81.3,456,630,"新厝村",NULL
0,894,18,912,1113,0,0,81.94,379,515,"張厝村",NULL
0,765,30,795,991,0,0,80.22,343,422,"埤斗村",NULL
0,839,35,874,1062,0,0,82.3,441,398,"清水村",NULL
0,816,31,847,992,0,0,85.38,268,548,"山湖村",NULL
0,813,38,851,1021,0,0,83.35,400,413,"朝興村",NULL
0,507,28,535,685,0,0,78.1,249,258,"仁和村",NULL
0,704,28,732,892,0,0,82.06,367,337,"泰安村",NULL
0,766,31,797,947,0,0,84.16,357,409,"平和村",NULL
0,626,27,653,800,0,0,81.63,267,359,"龍井村",NULL
0,1070,50,1120,1377,0,0,81.34,461,609,"湳雅村",NULL
0,1530,64,1594,1935,0,0,82.38,681,849,"協和村",NULL
0,811,34,845,1038,0,0,81.41,278,533,"復興村",NULL
0,542,30,572,732,0,0,78.14,227,315,"十五村",NULL
0,659,33,692,877,0,0,78.91,313,346,"合和村",NULL
0,803,32,835,1033,0,0,80.83,336,467,"上豊村",NULL
0,523,17,540,650,0,0,83.08,264,259,"過圳村",NULL
0,543,30,573,669,0,0,85.65,243,300,"五伯村",NULL
0,783,22,805,979,0,0,82.23,377,406,"光化村",NULL
0,826,21,847,1026,0,0,82.55,439,387,"文化村",NULL
0,689,25,714,888,0,0,80.41,353,336,"二水村",NULL
0,396,8,404,503,0,0,80.32,225,171,"聖化村",NULL
0,708,28,736,951,0,0,77.39,302,406,"裕民村",NULL
0,667,29,696,870,0,0,80,258,409,"惠民村",NULL
0,633,24,657,786,0,0,83.59,222,411,"大園村",NULL
0,625,36,661,803,0,0,82.32,301,324,"修仁村",NULL
0,574,29,603,745,0,0,80.94,205,369,"合興村",NULL
0,499,21,520,669,0,0,77.73,251,248,"源泉村",NULL
0,483,14,497,634,0,0,78.39,232,251,"倡和村",NULL
0,1799,72,1871,2335,0,0,80.13,781,1018,"中寮里",NULL
0,1393,63,1456,1734,0,0,83.97,537,856,"大道里",NULL
0,3114,75,3189,3858,0,0,82.66,1500,1614,"西德里",NULL
0,1212,44,1256,1580,0,0,79.49,564,648,"西安里",NULL
0,1100,25,1125,1391,0,0,80.88,591,509,"光復里",NULL
0,649,12,661,802,0,0,82.42,325,324,"新政里",NULL
0,503,15,518,627,0,0,82.62,211,292,"重慶里",NULL
0,602,19,621,749,0,0,82.91,296,306,"五權里",NULL
0,1061,39,1100,1390,0,0,79.14,422,639,"七星里",NULL
0,1055,26,1081,1324,0,0,81.65,556,499,"居仁里",NULL
0,1370,33,1403,1726,0,0,81.29,608,762,"東光里",NULL
0,1713,77,1790,2303,0,0,77.72,858,855,"文昌里",NULL
0,803,30,833,1045,0,0,79.71,349,454,"中和里",NULL
0,1256,75,1331,1735,0,0,76.71,632,624,"新生里",NULL
0,1129,53,1182,1546,0,0,76.46,557,572,"大新里",NULL
0,1234,84,1318,1756,0,0,75.06,402,832,"溪厝村",NULL
0,506,33,539,676,0,0,79.73,150,356,"坑厝村",NULL
0,746,26,772,959,0,0,80.5,246,500,"瓦厝村",NULL
0,1226,44,1270,1618,0,0,78.49,550,676,"溪州村",NULL
0,1052,37,1089,1395,0,0,78.06,444,608,"尾厝村",NULL
0,1283,86,1369,1708,0,0,80.15,481,802,"東州村",NULL
0,1013,39,1052,1314,0,0,80.06,331,682,"舊眉村",NULL
0,1028,52,1080,1469,0,0,73.52,435,593,"圳寮村",NULL
0,1518,89,1607,2045,0,0,78.58,533,985,"西畔村",NULL
0,1365,68,1433,1828,0,0,78.39,560,805,"成功村",NULL
0,1372,88,1460,1904,0,0,76.68,515,857,"大庄村",NULL
0,612,28,640,801,0,0,79.9,410,202,"榮光村",NULL
0,822,58,880,1124,0,0,78.29,407,415,"柑園村",NULL
0,661,60,721,966,0,0,74.64,212,449,"潮洋村",NULL
0,514,42,556,740,0,0,75.14,194,320,"張厝村",NULL
0,671,39,710,895,0,0,79.33,255,416,"菜公村",NULL
0,898,52,950,1203,0,0,78.97,309,589,"三圳村",NULL
0,705,36,741,886,0,0,83.63,188,517,"三條村",NULL
0,946,37,983,1283,0,0,76.62,240,706,"水尾村",NULL
0,898,42,940,1231,0,0,76.36,432,466,"田尾村",NULL
0,550,20,570,680,0,0,83.82,294,256,"豐田村",NULL
0,1562,45,1607,2026,0,0,79.32,773,789,"饒平村",NULL
0,985,42,1027,1274,0,0,80.61,444,541,"北曾村",NULL
0,908,45,953,1200,0,0,79.42,379,529,"南曾村",NULL
0,753,37,790,1020,0,0,77.45,391,362,"睦宜村",NULL
0,919,35,954,1159,0,0,82.31,428,491,"新生村",NULL
0,771,39,810,1014,0,0,79.88,365,406,"北鎮村",NULL
0,489,28,517,655,0,0,78.93,223,266,"南鎮村",NULL
0,655,36,691,855,0,0,80.82,303,352,"福田村",NULL
0,793,30,823,1007,0,0,81.73,366,427,"新興村",NULL
0,940,40,980,1232,0,0,79.55,397,543,"溪畔村",NULL
0,1296,62,1358,1694,0,0,80.17,576,720,"打簾村",NULL
0,648,39,687,811,0,0,84.71,357,291,"柳鳳村",NULL
0,682,34,716,873,0,0,82.02,341,341,"陸豐村",NULL
0,1072,54,1126,1459,0,0,77.18,499,573,"海豐村",NULL
0,1182,58,1240,1554,0,0,79.79,607,575,"仁里村",NULL
0,227,6,233,294,0,0,79.25,126,101,"新厝村",NULL
0,476,29,505,636,0,0,79.4,201,275,"溪頂村",NULL
0,588,23,611,731,0,0,83.58,289,299,"正義村",NULL
0,1682,90,1772,2300,0,0,77.04,764,918,"和豊村",NULL
0,1163,65,1228,1567,0,0,78.37,532,631,"興農村",NULL
0,1180,59,1239,1589,0,0,77.97,440,740,"埤頭村",NULL
0,1517,99,1616,2148,0,0,75.23,853,664,"豊崙村",NULL
0,849,52,901,1159,0,0,77.74,396,453,"崙子村",NULL
0,1047,86,1133,1467,0,0,77.23,457,590,"永豊村",NULL
0,2270,97,2367,2963,0,0,79.89,1171,1099,"合興村",NULL
0,1204,59,1263,1635,0,0,77.25,591,613,"平原村",NULL
0,507,42,549,695,0,0,78.99,193,314,"崙腳村",NULL
0,452,26,478,598,0,0,79.93,208,244,"元埔村",NULL
0,1147,72,1219,1645,0,0,74.1,559,588,"芙朝村",NULL
0,852,50,902,1167,0,0,77.29,238,614,"新庄村",NULL
0,572,50,622,820,0,0,75.85,197,375,"陸嘉村",NULL
0,663,37,700,906,0,0,77.26,224,439,"竹圍村",NULL
0,983,51,1034,1336,0,0,77.4,321,662,"中和村",NULL
0,697,52,749,961,0,0,77.94,193,504,"庄內村",NULL
0,722,38,760,990,0,0,76.77,218,504,"大湖村",NULL
0,1610,54,1664,2077,0,0,80.12,820,790,"東和里",NULL
0,2214,67,2281,2872,0,0,79.42,1287,927,"南光里",NULL
0,990,37,1027,1328,0,0,77.33,521,469,"西平里",NULL
0,1978,105,2083,2711,0,0,76.84,1041,937,"北平里",NULL
0,1130,84,1214,1648,0,0,73.67,682,448,"中西里",NULL
0,1045,84,1129,1481,0,0,76.23,430,615,"廣興里",NULL
0,855,54,909,1192,0,0,76.26,317,538,"香田里",NULL
0,810,37,847,1083,0,0,78.21,457,353,"外竹里",NULL
0,811,56,867,1115,0,0,77.76,519,292,"興華里",NULL
0,899,36,935,1214,0,0,77.02,478,421,"東興里",NULL
0,1769,80,1849,2430,0,0,76.09,964,805,"後厝里",NULL
0,1515,72,1587,2092,0,0,75.86,811,704,"豐田里",NULL
0,974,64,1038,1403,0,0,73.98,500,474,"頂厝里",NULL
0,1180,82,1262,1669,0,0,75.61,662,518,"趙甲里",NULL
0,926,47,973,1294,0,0,75.19,512,414,"振興里",NULL
0,610,29,639,813,0,0,78.6,349,261,"萬興里",NULL
0,1162,57,1219,1566,0,0,77.84,573,589,"永興里",NULL
0,937,49,986,1265,0,0,77.94,362,575,"西庄里",NULL
0,817,57,874,1101,0,0,79.38,398,419,"梅芳里",NULL
0,2589,129,2718,3547,0,0,76.63,1540,1049,"華崙里",NULL
0,952,62,1014,1336,0,0,75.9,575,377,"萬合里",NULL
0,702,63,765,1004,0,0,76.2,373,329,"東勢里",NULL
0,634,48,682,890,0,0,76.63,333,301,"大永里",NULL
0,918,48,966,1237,0,0,78.09,452,466,"原斗里",NULL
0,758,46,804,1059,0,0,75.92,397,361,"西斗里",NULL
0,730,47,777,1021,0,0,76.1,353,377,"東華里",NULL
0,553,41,594,742,0,0,80.05,286,267,"復豐里",NULL
0,698,42,740,1024,0,0,72.27,313,385,"芳苑村",NULL
0,354,27,381,529,0,0,72.02,149,205,"芳中村",NULL
0,603,43,646,885,0,0,72.99,305,298,"仁愛村",NULL
0,411,31,442,647,0,0,68.32,223,188,"信義村",NULL
0,662,48,710,969,0,0,73.27,396,266,"後寮村",NULL
0,1352,63,1415,1873,0,0,75.55,691,661,"三合村",NULL
0,925,93,1018,1399,0,0,72.77,408,517,"永興村",NULL
0,588,74,662,1013,0,0,65.35,171,417,"新街村",NULL
0,500,45,545,748,0,0,72.86,238,262,"路上村",NULL
0,533,22,555,742,0,0,74.8,325,208,"路平村",NULL
0,692,66,758,1002,0,0,75.65,304,388,"三成村",NULL
0,459,27,486,691,0,0,70.33,210,249,"福榮村",NULL
0,383,40,423,602,0,0,70.27,190,193,"頂廍村",NULL
0,1410,98,1508,2095,0,0,71.98,436,974,"王功村",NULL
0,577,42,619,800,0,0,77.38,200,377,"博愛村",NULL
0,541,40,581,817,0,0,71.11,185,356,"和平村",NULL
0,873,84,957,1395,0,0,68.6,265,608,"興仁村",NULL
0,518,33,551,779,0,0,70.73,146,372,"民生村",NULL
0,1056,66,1122,1470,0,0,76.33,459,597,"新寶村",NULL
0,343,19,362,561,0,0,64.53,162,181,"五俊村",NULL
0,1001,49,1050,1428,0,0,73.53,507,494,"草湖村",NULL
0,1522,88,1610,2096,0,0,76.81,729,793,"建平村",NULL
0,497,23,520,720,0,0,72.22,283,214,"崙腳村",NULL
0,705,39,744,1041,0,0,71.47,350,355,"文津村",NULL
0,887,66,953,1362,0,0,69.97,325,562,"新生村",NULL
0,2087,126,2213,2917,0,0,75.87,878,1209,"漢寶村",NULL
0,887,67,954,1334,0,0,71.51,331,556,"潭墘村",NULL
0,916,80,996,1447,0,0,68.83,481,435,"山腳村",NULL
0,586,48,634,864,0,0,73.38,303,283,"西城村",NULL
0,868,41,909,1269,0,0,71.63,444,424,"東城村",NULL
0,761,31,792,1070,0,0,74.02,420,341,"大城村",NULL
0,812,41,853,1227,0,0,69.52,432,380,"上山村",NULL
0,525,7,532,757,0,0,70.28,292,233,"永和村",NULL
0,813,53,866,1241,0,0,69.78,462,351,"公館村",NULL
0,614,67,681,923,0,0,73.78,279,335,"豐美村",NULL
0,452,40,492,749,0,0,65.69,239,213,"三豐村",NULL
0,770,60,830,1196,0,0,69.4,472,298,"菜寮村",NULL
0,847,66,913,1350,0,0,67.63,513,334,"東港村",NULL
0,703,49,752,1096,0,0,68.61,414,289,"西港村",NULL
0,514,49,563,811,0,0,69.42,226,288,"頂庄村",NULL
0,679,67,746,1012,0,0,73.72,283,396,"臺西村",NULL
0,803,27,830,1105,0,0,75.11,345,458,"竹元村",NULL
0,1314,26,1340,1689,0,0,79.34,661,653,"竹塘村",NULL
0,606,30,636,815,0,0,78.04,308,298,"小西村",NULL
0,560,33,593,808,0,0,73.39,303,257,"民靖村",NULL
0,1101,66,1167,1530,0,0,76.27,342,759,"五庄村",NULL
0,508,21,529,653,0,0,81.01,173,335,"樹腳村",NULL
0,693,37,730,992,0,0,73.59,254,439,"田頭村",NULL
0,865,53,918,1181,0,0,77.73,311,554,"新廣村",NULL
0,394,33,427,563,0,0,75.84,151,243,"溪墘村",NULL
0,631,25,656,894,0,0,73.38,266,365,"竹林村",NULL
0,511,35,546,734,0,0,74.39,186,325,"土庫村",NULL
0,461,34,495,674,0,0,73.44,147,314,"內新村",NULL
0,542,35,577,788,0,0,73.22,192,350,"長安村",NULL
0,478,28,506,692,0,0,73.12,167,311,"永安村",NULL
0,749,10,759,946,0,0,80.23,347,402,"龍泉里",NULL
0,1069,20,1089,1369,0,0,79.55,545,524,"康壽里",NULL
0,654,15,669,797,0,0,83.94,380,274,"三民里",NULL
0,456,17,473,547,0,0,86.47,195,261,"仁和里",NULL
0,547,11,558,690,0,0,80.87,244,303,"南投里",NULL
0,370,6,376,445,0,0,84.49,154,216,"彰仁里",NULL
0,845,21,866,1056,0,0,82.01,415,430,"崇文里",NULL
0,3386,67,3453,4345,0,0,79.47,1926,1460,"三興里",NULL
0,2219,31,2250,2751,0,0,81.79,1187,1032,"三和里",NULL
0,1388,33,1421,1780,0,0,79.83,543,845,"嘉興里",NULL
0,2528,46,2574,3182,0,0,80.89,1285,1243,"嘉和里",NULL
0,4003,83,4086,5134,0,0,79.59,2150,1853,"平和里",NULL
0,1532,39,1571,1988,0,0,79.02,604,928,"振興里",NULL
0,650,12,662,881,0,0,75.14,292,358,"千秋里",NULL
0,2910,66,2976,3783,0,0,78.67,1625,1285,"軍功里",NULL
0,318,8,326,411,0,0,79.32,165,153,"東山里",NULL
0,1595,40,1635,1984,0,0,82.41,927,668,"營南里",NULL
0,4018,69,4087,4831,0,0,84.6,2831,1187,"營北里",NULL
0,4026,99,4125,5004,0,0,82.43,2414,1612,"內興里",NULL
0,1085,30,1115,1352,0,0,82.47,494,591,"內新里",NULL
0,503,2,505,593,0,0,85.16,358,145,"光輝里",NULL
0,1434,28,1462,1820,0,0,80.33,1208,226,"光榮里",NULL
0,1568,18,1586,1859,0,0,85.31,1375,193,"光明里",NULL
0,1226,20,1246,1485,0,0,83.91,1066,160,"光華里",NULL
0,1874,34,1908,2356,0,0,80.98,914,960,"漳興里",NULL
0,4605,117,4722,5883,0,0,80.27,2477,2128,"漳和里",NULL
0,3205,47,3252,4144,0,0,78.47,1702,1503,"平山里",NULL
0,2957,79,3036,3848,0,0,78.9,1413,1544,"新興里",NULL
0,1933,48,1981,2434,0,0,81.39,977,956,"永豐里",NULL
0,1997,51,2048,2558,0,0,80.06,979,1018,"福興里",NULL
0,923,42,965,1251,0,0,77.14,372,551,"鳳山里",NULL
0,579,27,606,756,0,0,80.16,252,327,"永興里",NULL
0,540,32,572,729,0,0,78.46,207,333,"鳳鳴里",NULL
0,1351,49,1400,1788,0,0,78.3,698,653,"福山里",NULL
0,2183,76,2259,2958,0,0,76.37,1120,1063,"東門里",NULL
0,2353,45,2398,3132,0,0,76.56,1246,1107,"西門里",NULL
0,713,13,726,939,0,0,77.32,341,372,"南門里",NULL
0,1775,31,1806,2366,0,0,76.33,1054,721,"北門里",NULL
0,2447,57,2504,3248,0,0,77.09,1407,1040,"北安里",NULL
0,1555,36,1591,2003,0,0,79.43,889,666,"泰安里",NULL
0,1667,41,1708,2248,0,0,75.98,900,767,"北梅里",NULL
0,1702,55,1757,2285,0,0,76.89,912,790,"同聲里",NULL
0,2543,72,2615,3552,0,0,73.62,1377,1166,"清新里",NULL
0,948,20,968,1191,0,0,81.28,524,424,"薰化里",NULL
0,4259,85,4344,5713,0,0,76.04,2397,1862,"大城里",NULL
0,735,17,752,978,0,0,76.89,324,411,"籃城里",NULL
0,1740,56,1796,2319,0,0,77.45,857,883,"杷城里",NULL
0,4346,115,4461,5954,0,0,74.92,2367,1979,"枇杷里",NULL
0,2211,74,2285,3140,0,0,72.77,1109,1102,"水頭里",NULL
0,719,23,742,1006,0,0,73.76,343,376,"麒麟里",NULL
0,712,31,743,991,0,0,74.97,337,375,"珠格里",NULL
0,716,17,733,916,0,0,80.02,413,303,"溪南里",NULL
0,755,29,784,1031,0,0,76.04,401,354,"桃米里",NULL
0,276,10,286,384,0,0,74.48,172,104,"成功里",NULL
0,951,28,979,1313,0,0,74.56,480,471,"南村里",NULL
0,1028,29,1057,1360,0,0,77.72,576,452,"愛蘭里",NULL
0,1200,42,1242,1649,0,0,75.32,692,508,"鐵山里",NULL
0,898,46,944,1245,0,0,75.82,450,448,"房里里",NULL
0,505,19,524,655,0,0,80,223,282,"向善里",NULL
0,606,3,609,809,0,0,75.28,322,284,"一新里",NULL
0,1121,32,1153,1549,0,0,74.44,523,598,"合成里",NULL
0,884,14,898,1225,0,0,73.31,423,461,"廣成里",NULL
0,505,15,520,669,0,0,77.73,274,231,"史港里",NULL
0,701,28,729,989,0,0,73.71,259,442,"福興里",NULL
0,1792,64,1856,2430,0,0,76.38,724,1068,"牛眠里",NULL
0,909,33,942,1206,0,0,78.11,396,513,"大湳里",NULL
0,1885,46,1931,2561,0,0,75.4,1022,863,"蜈蚣里",NULL
0,1570,39,1609,1987,0,0,80.98,848,722,"玉峰里",NULL
0,2712,58,2770,3458,0,0,80.1,1481,1231,"明正里",NULL
0,1628,38,1666,2056,0,0,81.03,894,734,"炎峰里",NULL
0,586,16,602,731,0,0,82.35,337,249,"中正里",NULL
0,1032,24,1056,1249,0,0,84.55,547,485,"和平里",NULL
0,1775,37,1812,2220,0,0,81.62,911,864,"中山里",NULL
0,4195,121,4316,5432,0,0,79.46,2246,1949,"敦和里",NULL
0,4918,86,5004,6151,0,0,81.35,2937,1981,"山腳里",NULL
0,2213,52,2265,2750,0,0,82.36,1233,980,"新厝里",NULL
0,1967,40,2007,2459,0,0,81.62,1118,849,"上林里",NULL
0,2729,72,2801,3476,0,0,80.58,1296,1433,"碧峰里",NULL
0,1436,33,1469,1757,0,0,83.61,790,646,"碧洲里",NULL
0,2151,77,2228,2790,0,0,79.86,1020,1131,"復興里",NULL
0,3906,99,4005,5116,0,0,78.28,1966,1940,"御史里",NULL
0,2629,86,2715,3395,0,0,79.97,1189,1440,"新豐里",NULL
0,2226,80,2306,2928,0,0,78.76,1212,1014,"新庄里",NULL
0,1641,49,1690,2029,0,0,83.29,726,915,"加老里",NULL
0,992,38,1030,1247,0,0,82.6,439,553,"石川里",NULL
0,1923,51,1974,2419,0,0,81.6,864,1059,"北投里",NULL
0,3447,74,3521,4483,0,0,78.54,1719,1728,"富寮里",NULL
0,1449,65,1514,1906,0,0,79.43,662,787,"北勢里",NULL
0,1450,35,1485,1872,0,0,79.33,581,869,"中原里",NULL
0,2680,50,2730,3409,0,0,80.08,1191,1489,"南埔里",NULL
0,731,9,740,937,0,0,78.98,392,339,"坪頂里",NULL
0,1267,45,1312,1685,0,0,77.86,696,571,"土城里",NULL
0,793,1,794,1031,0,0,77.01,406,387,"平林里",NULL
0,1670,69,1739,2318,0,0,75.02,795,875,"雙冬里",NULL
0,1665,27,1692,2107,0,0,80.3,830,835,"竹山里",NULL
0,564,5,569,691,0,0,82.34,278,286,"中正里",NULL
0,3258,95,3353,4397,0,0,76.26,1469,1789,"中山里",NULL
0,2450,48,2498,3186,0,0,78.41,1131,1319,"雲林里",NULL
0,1667,47,1714,2226,0,0,77,797,870,"竹圍里",NULL
0,2545,47,2592,3394,0,0,76.37,1147,1398,"桂林里",NULL
0,800,34,834,1049,0,0,79.5,346,454,"下坪里",NULL
0,817,33,850,1070,0,0,79.44,215,602,"中和里",NULL
0,1007,32,1039,1292,0,0,80.42,498,509,"中崎里",NULL
0,558,24,582,761,0,0,76.48,199,359,"秀林里",NULL
0,311,11,322,435,0,0,74.02,131,180,"大鞍里",NULL
0,3222,66,3288,4251,0,0,77.35,1574,1648,"延和里",NULL
0,2474,72,2546,3290,0,0,77.39,1053,1421,"延祥里",NULL
0,1254,61,1315,1675,0,0,78.51,454,800,"延正里",NULL
0,2029,75,2104,2717,0,0,77.44,777,1252,"延平里",NULL
0,518,24,542,671,0,0,80.77,213,305,"延山里",NULL
0,1359,51,1410,1843,0,0,76.51,547,812,"山崇里",NULL
0,742,27,769,965,0,0,79.69,313,429,"社寮里",NULL
0,993,41,1034,1344,0,0,76.93,345,648,"中央里",NULL
0,528,23,551,722,0,0,76.32,237,291,"富州里",NULL
0,478,11,489,637,0,0,76.77,200,278,"田子里",NULL
0,1116,29,1145,1460,0,0,78.42,463,653,"硘磘里",NULL
0,694,34,728,899,0,0,80.98,294,400,"德興里",NULL
0,430,17,447,582,0,0,76.8,229,201,"福興里",NULL
0,598,33,631,871,0,0,72.45,251,347,"鯉魚里",NULL
0,378,28,406,534,0,0,76.03,135,243,"坪頂里",NULL
0,534,18,552,725,0,0,76.14,210,324,"瑞竹里",NULL
0,723,35,758,1061,0,0,71.44,279,444,"桶頭里",NULL
0,721,17,738,962,0,0,76.72,404,317,"集集里",NULL
0,706,23,729,945,0,0,77.14,376,330,"和平里",NULL
0,420,11,431,564,0,0,76.42,181,239,"林尾里",NULL
0,932,56,988,1254,0,0,78.79,497,435,"田寮里",NULL
0,429,16,445,561,0,0,79.32,188,241,"隘寮里",NULL
0,350,13,363,452,0,0,80.31,154,196,"玉映里",NULL
0,724,19,743,898,0,0,82.74,401,323,"吳厝里",NULL
0,1031,32,1063,1413,0,0,75.23,479,552,"八張里",NULL
0,701,16,717,915,0,0,78.36,349,352,"永昌里",NULL
0,763,32,795,1059,0,0,75.07,368,395,"廣明里",NULL
0,313,2,315,423,0,0,74.47,180,133,"富山里",NULL
0,772,29,801,1017,0,0,78.76,344,428,"南雅村",NULL
0,2179,63,2242,2910,0,0,77.04,949,1230,"中正村",NULL
0,1574,57,1631,2042,0,0,79.87,706,868,"中山村",NULL
0,1177,47,1224,1551,0,0,78.92,504,673,"濁水村",NULL
0,789,48,837,1041,0,0,80.4,332,457,"新民村",NULL
0,782,30,812,1010,0,0,80.4,332,450,"炭寮村",NULL
0,2869,65,2934,3636,0,0,80.69,1134,1735,"新街村",NULL
0,1247,20,1267,1628,0,0,77.83,477,770,"東湖村",NULL
0,637,28,665,857,0,0,77.6,348,289,"仁和村",NULL
0,777,36,813,995,0,0,81.71,287,490,"萬丹村",NULL
0,790,42,832,1040,0,0,80,255,535,"田仔村",NULL
0,652,19,671,842,0,0,79.69,188,464,"田仔村、大坑村",NULL
0,804,31,835,1026,0,0,81.38,233,571,"大庄村",NULL
0,708,34,742,920,0,0,80.65,231,477,"大庄村、廍下村、大坑村",NULL
0,584,31,615,770,0,0,79.87,236,348,"廍下村",NULL
0,1003,26,1029,1270,0,0,81.02,373,630,"赤水村",NULL
0,722,25,747,926,0,0,80.67,195,527,"竹圍村",NULL
0,1175,46,1221,1483,0,0,82.33,445,730,"三崙村",NULL
0,1155,29,1184,1482,0,0,79.89,506,649,"松山村",NULL
0,905,24,929,1141,0,0,81.42,355,550,"松柏村",NULL
0,638,6,644,802,0,0,80.3,305,333,"崁腳村",NULL
0,707,14,721,878,0,0,82.12,276,431,"埔中村",NULL
0,626,27,653,817,0,0,79.93,245,381,"新厝村",NULL
0,1250,56,1306,1640,0,0,79.63,505,745,"新光村",NULL
0,1088,64,1152,1597,0,0,72.14,521,567,"初鄉村",NULL
0,1296,14,1310,1668,0,0,78.54,626,670,"鹿谷村",NULL
0,915,30,945,1175,0,0,80.43,438,477,"彰雅村",NULL
0,1429,49,1478,1872,0,0,78.95,754,675,"廣興村",NULL
0,750,24,774,1017,0,0,76.11,353,397,"內湖村",NULL
0,463,23,486,609,0,0,79.8,255,208,"和雅村",NULL
0,1128,34,1162,1522,0,0,76.35,535,593,"竹林村",NULL
0,687,20,707,892,0,0,79.26,372,315,"竹豐村",NULL
0,1023,48,1071,1359,0,0,78.81,445,578,"鳳凰村",NULL
0,1059,30,1089,1331,0,0,81.82,507,552,"永隆村",NULL
0,467,4,471,643,0,0,73.25,163,304,"秀峰村",NULL
0,306,13,319,437,0,0,73,99,207,"永隆村",NULL
0,527,23,550,731,0,0,75.24,211,316,"清水村",NULL
0,520,35,555,778,0,0,71.34,238,282,"瑞田村",NULL
0,619,38,657,853,0,0,77.02,210,409,"廣興村",NULL
0,391,16,407,517,0,0,78.72,151,240,"崁頂村",NULL
0,563,17,580,754,0,0,76.92,232,331,"八仙村",NULL
0,583,34,617,798,0,0,77.32,271,312,"福盛村",NULL
0,489,30,519,698,0,0,74.36,190,299,"和興村",NULL
0,1353,45,1398,1765,0,0,79.21,694,659,"永平村",NULL
0,195,6,201,273,0,0,73.63,86,109,"復興村",NULL
0,528,1,529,709,0,0,74.61,293,235,"中寮村",NULL
0,411,22,433,548,0,0,79.01,142,269,"廣福村",NULL
0,911,21,932,1147,0,0,81.26,421,490,"永福村",NULL
0,854,30,884,1113,0,0,79.42,359,495,"義和村",NULL
0,663,42,705,959,0,0,73.51,301,362,"清水村",NULL
0,322,16,338,468,0,0,72.22,158,164,"內城村",NULL
0,513,21,534,700,0,0,76.29,203,310,"龍安村",NULL
0,412,6,418,543,0,0,76.98,207,205,"爽文村",NULL
0,538,16,554,686,0,0,80.76,264,274,"龍岩村",NULL
0,336,11,347,437,0,0,79.41,171,165,"永芳村",NULL
0,405,20,425,549,0,0,77.41,198,207,"永和村",NULL
0,1346,35,1381,1909,0,0,72.34,652,694,"魚池村",NULL
0,1049,45,1094,1529,0,0,71.55,445,604,"東池村",NULL
0,750,27,777,1065,0,0,72.96,304,446,"大林村",NULL
0,828,35,863,1242,0,0,69.48,294,534,"東光村",NULL
0,691,27,718,981,0,0,73.19,292,399,"共和村",NULL
0,974,14,988,1317,0,0,75.02,433,541,"新城村",NULL
0,495,18,513,670,0,0,76.57,216,279,"大雁村",NULL
0,515,32,547,728,0,0,75.14,264,251,"五城村",NULL
0,721,27,748,1025,0,0,72.98,314,407,"中明村",NULL
0,593,8,601,807,0,0,74.47,323,270,"水社村",NULL
0,526,20,546,722,0,0,75.62,283,243,"日月村",NULL
0,660,33,693,961,0,0,72.11,311,349,"頭社村",NULL
0,526,11,537,749,0,0,71.7,268,258,"武登村",NULL
0,1195,34,1229,1640,0,0,74.94,612,583,"國姓村",NULL
0,1177,54,1231,1684,0,0,73.1,678,499,"石門村",NULL
0,535,16,551,755,0,0,72.98,238,297,"大旗村",NULL
0,1063,34,1097,1512,0,0,72.55,611,452,"長流村",NULL
0,494,29,523,703,0,0,74.4,265,229,"長福村",NULL
0,582,8,590,841,0,0,70.15,313,269,"長豐村",NULL
0,1389,73,1462,2017,0,0,72.48,707,682,"北港村",NULL
0,1389,46,1435,1852,0,0,77.48,770,619,"福龜村",NULL
0,613,17,630,866,0,0,72.75,324,289,"乾溝村",NULL
0,846,50,896,1205,0,0,74.36,455,391,"柑林村",NULL
0,542,28,570,759,0,0,75.1,258,284,"大石村",NULL
0,1187,44,1231,1615,0,0,76.22,555,632,"北山村",NULL
0,1284,79,1363,1926,0,0,70.77,716,568,"南港村",NULL
0,636,27,663,908,0,0,73.02,364,272,"水里村",NULL
0,1210,24,1234,1664,0,0,74.16,578,632,"新城村",NULL
0,567,5,572,736,0,0,77.72,277,290,"中央村",NULL
0,772,18,790,1043,0,0,75.74,425,347,"城中村",NULL
0,401,7,408,525,0,0,77.71,192,209,"農富村",NULL
0,727,19,746,1004,0,0,74.3,413,314,"北埔村",NULL
0,1047,11,1058,1379,0,0,76.72,553,494,"南光村",NULL
0,853,29,882,1078,0,0,81.82,532,321,"鉅工村",NULL
0,1043,35,1078,1398,0,0,77.11,505,538,"永豐村",NULL
0,740,31,771,1049,0,0,73.5,232,508,"民和村",NULL
0,831,27,858,1181,0,0,72.65,446,385,"頂崁村",NULL
0,267,12,279,379,0,0,73.61,142,125,"新山村",NULL
0,253,11,264,368,0,0,71.74,135,118,"郡坑村",NULL
0,835,31,866,1171,0,0,73.95,451,384,"上安村",NULL
0,242,0,242,353,0,0,68.56,91,151,"興隆村",NULL
0,250,11,261,368,0,0,70.92,103,147,"永興村",NULL
0,695,24,719,920,0,0,78.15,228,467,"玉峰村",NULL
0,376,26,402,557,0,0,72.17,208,168,"車埕村",NULL
0,476,18,494,689,0,0,71.7,273,203,"新興村",NULL
0,413,11,424,557,0,0,76.12,332,81,"雙龍村",NULL
0,592,13,605,763,0,0,79.29,496,96,"地利村",NULL
0,333,16,349,463,0,0,75.38,305,28,"潭南村",NULL
0,735,41,776,1067,0,0,72.73,586,149,"人和村",NULL
0,1106,15,1121,1496,0,0,74.93,622,484,"明德村",NULL
0,541,34,575,753,0,0,76.36,262,279,"自強村",NULL
0,385,21,406,541,0,0,75.05,209,176,"愛國村",NULL
0,425,27,452,583,0,0,77.53,239,186,"豐丘村",NULL
0,363,11,374,470,0,0,79.57,289,74,"新鄉村",NULL
0,828,44,872,1164,0,0,74.91,688,140,"羅娜村",NULL
0,946,29,975,1299,0,0,75.06,610,336,"望美村",NULL
0,976,40,1016,1403,0,0,72.42,432,544,"同富村",NULL
0,516,28,544,756,0,0,71.96,288,228,"神木村",NULL
0,593,10,603,809,0,0,74.54,403,190,"東埔村",NULL
0,472,16,488,721,0,0,67.68,419,53,"發祥村",NULL
0,934,21,955,1239,0,0,77.08,846,88,"精英村",NULL
0,782,22,804,1071,0,0,75.07,698,84,"親愛村",NULL
0,380,8,388,531,0,0,73.07,333,47,"萬豐村",NULL
0,261,10,271,327,0,0,82.87,234,27,"新生村",NULL
0,1079,36,1115,1464,0,0,76.16,816,263,"大同村",NULL
0,671,8,679,844,0,0,80.45,575,96,"春陽村",NULL
0,425,6,431,603,0,0,71.48,373,52,"法治村",NULL
0,342,23,365,545,0,0,66.97,263,79,"翠華村",NULL
0,335,13,348,478,0,0,72.8,271,64,"力行村",NULL
0,810,40,850,1120,0,0,75.89,626,184,"南豐村",NULL
0,539,4,543,710,0,0,76.48,501,38,"中正村",NULL
0,61,1,62,83,0,0,74.7,53,8,"榮興村",NULL
0,390,18,408,537,0,0,75.98,332,58,"合作村",NULL
0,737,24,761,959,0,0,79.35,671,66,"互助村",NULL
0,623,13,636,787,0,0,80.81,278,345,"信義里",NULL
0,587,14,601,720,0,0,83.47,275,312,"四維里",NULL
0,612,17,629,771,0,0,81.58,296,316,"太平里",NULL
0,762,20,782,937,0,0,83.46,317,445,"中和里",NULL
0,697,18,715,918,0,0,77.89,311,386,"光興里",NULL
0,2217,56,2273,2921,0,0,77.82,1092,1125,"鎮西里",NULL
0,2873,68,2941,3591,0,0,81.9,1528,1345,"鎮東里",NULL
0,2383,56,2439,3019,0,0,80.79,1325,1058,"三平里",NULL
0,1837,16,1853,2331,0,0,79.49,906,931,"明德里",NULL
0,1895,38,1933,2342,0,0,82.54,933,962,"鎮北里",NULL
0,1373,32,1405,1773,0,0,79.24,698,675,"公誠里",NULL
0,1179,26,1205,1472,0,0,81.86,549,630,"忠孝里",NULL
0,937,9,946,1156,0,0,81.83,426,511,"仁愛里",NULL
0,2094,54,2148,2623,0,0,81.89,983,1111,"八德里",NULL
0,1887,41,1928,2402,0,0,80.27,1142,745,"公正里",NULL
0,1547,54,1601,2020,0,0,79.26,620,927,"重光里",NULL
0,2724,45,2769,3518,0,0,78.71,1550,1174,"林頭里",NULL
0,1611,19,1630,2005,0,0,81.3,810,801,"成功里",NULL
0,2578,54,2632,3250,0,0,80.98,1433,1145,"鎮南里",NULL
0,1678,28,1706,2091,0,0,81.59,896,782,"社口里",NULL
0,894,21,915,1092,0,0,83.79,383,511,"龍潭里",NULL
0,593,28,621,747,0,0,83.13,227,366,"嘉東里",NULL
0,1401,24,1425,1748,0,0,81.52,786,615,"崙峰里",NULL
0,470,16,486,594,0,0,81.82,248,222,"溝埧里",NULL
0,1175,47,1222,1553,0,0,78.69,493,682,"江厝里",NULL
0,444,17,461,564,0,0,81.74,160,284,"三光里",NULL
0,1532,50,1582,1916,0,0,82.57,700,832,"久安里",NULL
0,3496,74,3570,4467,0,0,79.92,1729,1767,"虎溪里",NULL
0,2433,91,2524,3110,0,0,81.16,1061,1372,"保庄里",NULL
0,1214,55,1269,1566,0,0,81.03,476,738,"長平里",NULL
0,2919,102,3021,3776,0,0,80.01,1139,1780,"榴中里",NULL
0,764,26,790,964,0,0,81.95,273,491,"榴北里",NULL
0,924,31,955,1180,0,0,80.93,395,529,"榴南里",NULL
0,1340,64,1404,1720,0,0,81.63,590,750,"梅林里",NULL
0,1023,22,1045,1269,0,0,82.35,393,630,"湖山里",NULL
0,1947,79,2026,2533,0,0,79.98,771,1176,"長安里",NULL
0,1886,71,1957,2471,0,0,79.2,790,1096,"溪洲里",NULL
0,909,40,949,1142,0,0,83.1,293,616,"十三里",NULL
0,886,21,907,1131,0,0,80.19,388,498,"東仁里",NULL
0,3557,39,3596,4495,0,0,80,1776,1781,"西岐里",NULL
0,1589,42,1631,2034,0,0,80.19,729,860,"南昌里",NULL
0,1055,9,1064,1322,0,0,80.48,551,504,"北銘里",NULL
0,977,20,997,1256,0,0,79.38,434,543,"中天里",NULL
0,958,30,988,1252,0,0,78.91,330,628,"林子里",NULL
0,693,24,717,888,0,0,80.74,291,402,"石龜里",NULL
0,727,33,760,924,0,0,82.25,238,489,"石溪里",NULL
0,693,29,722,903,0,0,79.96,274,419,"靖興里",NULL
0,539,25,564,744,0,0,75.81,164,375,"新南里",NULL
0,960,42,1002,1177,0,0,85.13,366,594,"阿丹里",NULL
0,1128,58,1186,1483,0,0,79.97,468,660,"將軍里",NULL
0,1499,35,1534,1977,0,0,77.59,600,899,"舊社里",NULL
0,3417,102,3519,4350,0,0,80.9,1543,1874,"明昌里",NULL
0,696,40,736,933,0,0,78.89,291,405,"大東里",NULL
0,613,35,648,831,0,0,77.98,318,295,"埤麻里",NULL
0,718,26,744,938,0,0,79.32,308,410,"西伯里",NULL
0,1169,65,1234,1583,0,0,77.95,427,742,"新崙里",NULL
0,757,29,786,994,0,0,79.07,317,440,"東明里",NULL
0,1879,93,1972,2414,0,0,81.69,709,1170,"新光里",NULL
0,1620,83,1703,2058,0,0,82.75,617,1003,"田頭里",NULL
0,1235,38,1273,1596,0,0,79.76,336,899,"小東里",NULL
0,1794,38,1832,2264,0,0,80.92,961,833,"東仁里",NULL
0,1307,27,1334,1704,0,0,78.29,658,649,"新興里",NULL
0,2134,29,2163,2676,0,0,80.83,1115,1019,"公安里",NULL
0,1840,34,1874,2433,0,0,77.02,972,868,"德興里",NULL
0,814,24,838,1071,0,0,78.24,424,390,"中山里",NULL
0,2315,46,2361,2977,0,0,79.31,1213,1102,"西安里",NULL
0,2733,41,2774,3519,0,0,78.83,1490,1243,"立仁里",NULL
0,1081,23,1104,1366,0,0,80.82,625,456,"安慶里",NULL
0,1068,23,1091,1423,0,0,76.67,550,518,"平和里",NULL
0,1356,33,1389,1764,0,0,78.74,663,693,"興南里",NULL
0,1924,41,1965,2496,0,0,78.73,891,1033,"新吉里",NULL
0,1273,41,1314,1682,0,0,78.12,544,729,"穎川里",NULL
0,694,32,726,945,0,0,76.83,292,402,"延平里",NULL
0,525,28,553,758,0,0,72.96,383,142,"建國里",NULL
0,1843,37,1880,2359,0,0,79.69,653,1190,"埒內里",NULL
0,615,8,623,778,0,0,80.08,216,399,"堀頭里",NULL
0,1331,63,1394,1715,0,0,81.28,550,781,"安溪里",NULL
0,1203,55,1258,1589,0,0,79.17,495,708,"興中里",NULL
0,2189,70,2259,2881,0,0,78.41,856,1333,"廉使里",NULL
0,1703,59,1762,2288,0,0,77.01,795,908,"惠來里",NULL
0,1886,83,1969,2464,0,0,79.91,671,1215,"頂溪里",NULL
0,999,39,1038,1299,0,0,79.91,408,591,"中溪里",NULL
0,1014,52,1066,1307,0,0,81.56,473,541,"下溪里",NULL
0,852,35,887,1161,0,0,76.4,359,493,"東屯里",NULL
0,1073,55,1128,1515,0,0,74.46,481,592,"西屯里",NULL
0,620,42,662,870,0,0,76.09,161,459,"芳草里",NULL
0,708,37,745,979,0,0,76.1,216,492,"墾地里",NULL
0,612,4,616,781,0,0,78.87,246,366,"北溪里",NULL
0,733,28,761,1029,0,0,73.96,334,399,"三合里",NULL
0,1237,49,1286,1595,0,0,80.63,353,884,"振興里",NULL
0,1153,46,1199,1505,0,0,79.67,411,742,"大園里",NULL
0,1284,42,1326,1642,0,0,80.76,558,726,"廣福里",NULL
0,2242,60,2302,2899,0,0,79.41,1043,1199,"正興里",NULL
0,352,8,360,458,0,0,78.6,151,201,"永安里",NULL
0,553,11,564,703,0,0,80.23,232,321,"中和里",NULL
0,479,16,495,645,0,0,76.74,185,294,"福興里",NULL
0,765,18,783,990,0,0,79.09,292,473,"光華里",NULL
0,1752,37,1789,2236,0,0,80.01,659,1093,"中興里",NULL
0,2582,77,2659,3451,0,0,77.05,953,1629,"漢光里",NULL
0,1015,48,1063,1295,0,0,82.08,227,788,"新安里",NULL
0,1146,24,1170,1482,0,0,78.95,293,853,"新豐里",NULL
0,1280,89,1369,1755,0,0,78.01,406,874,"大新里",NULL
0,717,32,749,908,0,0,82.49,181,536,"埤頭里",NULL
0,855,39,894,1111,0,0,80.47,198,657,"東興里",NULL
0,1142,51,1193,1506,0,0,79.22,332,810,"鹿場里",NULL
0,637,38,675,869,0,0,77.68,280,357,"廣興里",NULL
0,736,40,776,978,0,0,79.35,223,513,"頂湳里",NULL
0,1019,47,1066,1359,0,0,78.44,286,733,"吳厝里",NULL
0,591,31,622,763,0,0,81.52,187,404,"九隆里",NULL
0,594,28,622,813,0,0,76.51,341,253,"下湳里",NULL
0,709,56,765,966,0,0,79.19,171,538,"七座里",NULL
0,994,51,1045,1390,0,0,75.18,257,737,"公館里",NULL
0,732,44,776,982,0,0,79.02,267,465,"詔安里",NULL
0,703,25,728,924,0,0,78.79,246,457,"河南里",NULL
0,1323,90,1413,1805,0,0,78.28,262,1061,"安定里",NULL
0,1108,58,1166,1422,0,0,82,288,820,"福田里",NULL
0,704,13,717,937,0,0,76.52,313,391,"忠正里",NULL
0,807,20,827,1017,0,0,81.32,384,423,"順天里",NULL
0,1027,39,1066,1400,0,0,76.14,482,545,"宮北里",NULL
0,679,21,700,921,0,0,76,332,347,"越港里",NULL
0,847,45,892,1170,0,0,76.24,346,501,"溪邊里",NULL
0,1155,46,1201,1599,0,0,75.11,481,674,"石廟里",NULL
0,965,47,1012,1333,0,0,75.92,366,599,"興新里",NULL
0,960,42,1002,1436,0,0,69.78,350,610,"奮起里",NULL
0,997,57,1054,1446,0,0,72.89,352,645,"埤腳里",NULL
0,1645,84,1729,2347,0,0,73.67,601,1044,"後埔里",NULL
0,1040,54,1094,1548,0,0,70.67,371,669,"崙內里",NULL
0,635,23,658,875,0,0,75.2,274,361,"大荖里",NULL
0,1370,46,1416,1892,0,0,74.84,390,980,"東平里",NULL
0,1337,71,1408,1817,0,0,77.49,407,930,"南平里",NULL
0,1293,60,1353,1786,0,0,75.76,453,840,"西平里",NULL
0,737,34,771,1003,0,0,76.87,168,569,"北平里",NULL
0,1060,69,1129,1486,0,0,75.98,363,697,"新庄里",NULL
0,618,30,648,823,0,0,78.74,196,422,"東陽里",NULL
0,604,32,636,783,0,0,81.23,203,401,"光民里",NULL
0,398,8,406,518,0,0,78.38,124,274,"東華里",NULL
0,811,20,831,1021,0,0,81.39,233,578,"南安里",NULL
0,318,12,330,424,0,0,77.83,126,192,"中和里",NULL
0,355,8,363,449,0,0,80.85,140,215,"義民里",NULL
0,348,10,358,436,0,0,82.11,110,238,"共榮里",NULL
0,737,11,748,947,0,0,78.99,304,433,"西勢里",NULL
0,444,14,458,548,0,0,83.58,178,266,"仁和里",NULL
0,315,8,323,408,0,0,79.17,111,204,"賜福里",NULL
0,510,11,521,668,0,0,77.99,158,352,"公館里",NULL
0,1032,27,1059,1339,0,0,79.09,364,668,"大同里",NULL
0,421,14,435,530,0,0,82.08,202,219,"仁安里",NULL
0,3760,95,3855,4869,0,0,79.17,1434,2326,"華勝里",NULL
0,994,24,1018,1339,0,0,76.03,456,538,"光復里",NULL
0,3881,87,3968,5015,0,0,79.12,1625,2256,"新街里",NULL
0,898,7,905,1195,0,0,75.73,301,597,"劉厝里",NULL
0,727,27,754,981,0,0,76.86,211,516,"後溝里",NULL
0,331,17,348,436,0,0,79.82,106,225,"新厝里",NULL
0,583,27,610,855,0,0,71.35,231,352,"府番里",NULL
0,1053,47,1100,1438,0,0,76.5,284,769,"草湖里",NULL
0,810,61,871,1216,0,0,71.63,261,549,"溝皂里",NULL
0,721,10,731,1035,0,0,70.63,195,526,"番溝里",NULL
0,412,22,434,642,0,0,67.6,113,299,"大北里",NULL
0,1192,69,1261,1652,0,0,76.33,442,750,"好收里",NULL
0,2047,84,2131,2770,0,0,76.93,618,1429,"樹腳里",NULL
0,752,41,793,1030,0,0,76.99,107,645,"扶朝里",NULL
0,411,20,431,581,0,0,74.18,95,316,"水埔里",NULL
0,1586,94,1680,2091,0,0,80.34,460,1126,"棋盤村",NULL
0,1158,61,1219,1560,0,0,78.14,331,827,"新庄村",NULL
0,2175,60,2235,2847,0,0,78.5,856,1319,"東和村",NULL
0,1079,64,1143,1449,0,0,78.88,369,710,"荷苞村",NULL
0,889,36,925,1176,0,0,78.66,288,601,"高林村",NULL
0,909,38,947,1215,0,0,77.94,346,563,"水碓村",NULL
0,757,20,777,979,0,0,79.37,287,470,"田心村",NULL
0,1543,51,1594,2051,0,0,77.72,618,925,"古坑村",NULL
0,1513,35,1548,1963,0,0,78.86,645,868,"朝陽村",NULL
0,1114,30,1144,1419,0,0,80.62,437,677,"西平村",NULL
0,516,26,542,682,0,0,79.47,168,348,"湳仔村",NULL
0,1416,73,1489,1917,0,0,77.67,528,888,"永光村",NULL
0,1474,54,1528,2017,0,0,75.76,537,937,"永昌村",NULL
0,504,15,519,660,0,0,78.64,111,393,"麻園村",NULL
0,927,39,966,1288,0,0,75,354,573,"崁腳村",NULL
0,254,16,270,326,0,0,82.82,97,157,"華南村",NULL
0,552,22,574,781,0,0,73.5,178,374,"華山村",NULL
0,859,44,903,1176,0,0,76.79,224,635,"桂林村",NULL
0,390,29,419,534,0,0,78.46,124,266,"樟湖村",NULL
0,548,23,571,692,0,0,82.51,172,376,"草嶺村",NULL
0,569,34,603,787,0,0,76.62,206,363,"北和村",NULL
0,1594,59,1653,2102,0,0,78.64,619,975,"南和村",NULL
0,807,29,836,1104,0,0,75.72,301,506,"大德村",NULL
0,715,44,759,1000,0,0,75.9,194,521,"松竹村",NULL
0,1401,61,1462,1883,0,0,77.64,467,934,"尚義村",NULL
0,1399,46,1445,1822,0,0,79.31,498,901,"嘉興村",NULL
0,1042,27,1069,1372,0,0,77.92,433,609,"豐田村",NULL
0,915,47,962,1262,0,0,76.23,286,629,"三結村",NULL
0,610,28,638,823,0,0,77.52,175,435,"吉田村",NULL
0,506,31,537,691,0,0,77.71,223,283,"豐岡村",NULL
0,847,62,909,1238,0,0,73.42,311,536,"聯美村",NULL
0,629,36,665,847,0,0,78.51,269,360,"怡然村",NULL
0,522,27,549,721,0,0,76.14,161,361,"北鎮村",NULL
0,562,34,596,804,0,0,74.13,201,361,"興安村",NULL
0,558,40,598,794,0,0,75.31,251,307,"西鎮村",NULL
0,2784,64,2848,3540,0,0,80.45,1029,1755,"莿桐村",NULL
0,731,37,768,934,0,0,82.23,163,568,"甘厝村",NULL
0,1216,51,1267,1625,0,0,77.97,266,950,"甘西村",NULL
0,1003,57,1060,1271,0,0,83.4,328,675,"興桐村",NULL
0,895,41,936,1160,0,0,80.69,198,697,"義和村",NULL
0,1427,45,1472,1767,0,0,83.31,438,989,"埔子村",NULL
0,1959,77,2036,2512,0,0,81.05,776,1183,"大美村",NULL
0,1010,49,1059,1271,0,0,83.32,424,586,"埔尾村",NULL
0,1472,59,1531,1904,0,0,80.41,526,946,"興貴村",NULL
0,867,32,899,1168,0,0,76.97,290,577,"饒平村",NULL
0,1325,59,1384,1775,0,0,77.97,476,849,"四合村",NULL
0,1204,63,1267,1587,0,0,79.84,372,832,"麻園村",NULL
0,1033,40,1073,1347,0,0,79.66,310,723,"五華村",NULL
0,1338,57,1395,1771,0,0,78.77,405,933,"六合村",NULL
0,809,29,838,1049,0,0,79.89,452,357,"林南村",NULL
0,2654,72,2726,3429,0,0,79.5,1176,1478,"林中村",NULL
0,1604,67,1671,2156,0,0,77.5,632,972,"林北村",NULL
0,455,28,483,611,0,0,79.05,215,240,"坪頂村",NULL
0,708,15,723,932,0,0,77.58,259,449,"林茂村",NULL
0,1963,53,2016,2537,0,0,79.46,773,1190,"九芎村",NULL
0,486,23,509,652,0,0,78.07,154,332,"湖本村",NULL
0,893,10,903,1115,0,0,80.99,381,512,"烏塗村",NULL
0,829,24,853,1038,0,0,82.18,392,437,"烏麻村",NULL
0,1352,74,1426,1782,0,0,80.02,452,900,"重興村",NULL
0,1077,45,1122,1435,0,0,78.19,440,637,"崙東村",NULL
0,1263,56,1319,1662,0,0,79.36,447,816,"崙西村",NULL
0,1285,75,1360,1790,0,0,75.98,343,942,"來惠村",NULL
0,1207,47,1254,1632,0,0,76.84,317,890,"三和村",NULL
0,933,34,967,1256,0,0,76.99,334,599,"湳仔村",NULL
0,1507,59,1566,2016,0,0,77.68,556,951,"田尾村",NULL
0,731,35,766,968,0,0,79.13,183,548,"定安村",NULL
0,1013,56,1069,1366,0,0,78.26,234,779,"永定村",NULL
0,663,52,715,930,0,0,76.88,153,510,"大華村",NULL
0,599,31,630,792,0,0,79.55,125,474,"義庄村",NULL
0,1121,76,1197,1537,0,0,77.88,274,847,"楊賢村",NULL
0,1462,75,1537,1973,0,0,77.9,375,1087,"港後村",NULL
0,687,39,726,934,0,0,77.73,180,507,"大義村",NULL
0,1350,53,1403,1795,0,0,78.16,439,911,"油車村",NULL
0,1045,51,1096,1432,0,0,76.54,305,740,"大庄村",NULL
0,711,50,761,1012,0,0,75.2,227,484,"庄西村",NULL
0,626,35,661,860,0,0,76.86,200,426,"大同村",NULL
0,749,50,799,1062,0,0,75.24,249,500,"復興村",NULL
0,963,43,1006,1293,0,0,77.8,461,502,"東明村",NULL
0,1065,43,1108,1435,0,0,77.21,448,617,"西榮村",NULL
0,1689,71,1760,2270,0,0,77.53,757,932,"南陽村",NULL
0,1517,51,1568,2058,0,0,76.19,447,1070,"崙前村",NULL
0,1538,68,1606,2056,0,0,78.11,548,990,"羅厝村",NULL
0,982,64,1046,1378,0,0,75.91,296,686,"港尾村",NULL
0,1527,60,1587,2059,0,0,77.08,592,935,"阿勸村",NULL
0,681,12,693,922,0,0,75.16,465,216,"五魁村",NULL
0,1229,76,1305,1778,0,0,73.4,485,744,"大有村",NULL
0,1382,56,1438,2080,0,0,69.13,530,852,"豐榮村",NULL
0,1054,54,1108,1504,0,0,73.67,452,602,"草湖村",NULL
0,854,49,903,1216,0,0,74.26,329,525,"舊庄村",NULL
0,985,36,1021,1296,0,0,78.78,308,677,"水尾村",NULL
0,636,39,675,851,0,0,79.32,242,394,"枋南村",NULL
0,2454,77,2531,3435,0,0,73.68,1419,1035,"麥豐村",NULL
0,1852,65,1917,2632,0,0,72.83,1002,850,"麥津村",NULL
0,891,39,930,1375,0,0,67.64,373,518,"瓦磘村",NULL
0,1230,58,1288,1843,0,0,69.89,572,658,"興華村",NULL
0,986,24,1010,1477,0,0,68.38,553,433,"海豐村",NULL
0,1456,50,1506,2155,0,0,69.88,959,497,"後安村",NULL
0,1494,80,1574,2285,0,0,68.88,646,848,"三盛村",NULL
0,1233,68,1301,1870,0,0,69.57,715,518,"崙後村",NULL
0,1798,91,1889,2611,0,0,72.35,835,963,"橋頭村",NULL
0,533,31,564,794,0,0,71.03,206,327,"新吉村",NULL
0,1582,46,1628,2274,0,0,71.59,619,963,"施厝村",NULL
0,948,58,1006,1483,0,0,67.84,408,540,"雷厝村",NULL
0,822,49,871,1297,0,0,67.15,284,538,"月眉村",NULL
0,347,21,368,494,0,0,74.49,161,186,"復興村",NULL
0,1142,75,1217,1794,0,0,67.84,435,707,"嘉隆村",NULL
0,1069,36,1105,1457,0,0,75.84,537,532,"東南村",NULL
0,831,30,861,1209,0,0,71.22,396,435,"東北村",NULL
0,670,63,733,1017,0,0,72.07,242,428,"龍潭村",NULL
0,390,29,419,604,0,0,69.37,166,224,"程海村",NULL
0,642,39,681,951,0,0,71.61,244,398,"昌南村",NULL
0,582,54,636,934,0,0,68.09,217,365,"安南村",NULL
0,1376,83,1459,2195,0,0,66.47,657,719,"同安村",NULL
0,841,28,869,1311,0,0,66.29,406,435,"四美村",NULL
0,780,37,817,1268,0,0,64.43,334,446,"新坤村",NULL
0,1330,74,1404,1898,0,0,73.97,590,740,"中民村",NULL
0,977,50,1027,1407,0,0,72.99,497,480,"埔姜村",NULL
0,1031,44,1075,1444,0,0,74.45,446,585,"中勝村",NULL
0,969,74,1043,1416,0,0,73.66,332,637,"馬鳴村",NULL
0,912,59,971,1311,0,0,74.07,320,592,"新湖村",NULL
0,642,43,685,969,0,0,70.69,213,429,"有才村",NULL
0,584,33,617,814,0,0,75.8,227,357,"田洋村",NULL
0,887,49,936,1286,0,0,72.78,419,468,"龍岩村",NULL
0,684,44,728,989,0,0,73.61,201,483,"潮厝村",NULL
0,898,31,929,1257,0,0,73.91,574,324,"臺西村",NULL
0,718,5,723,1056,0,0,68.47,422,296,"海南村",NULL
0,661,34,695,1070,0,0,64.95,366,295,"海北村",NULL
0,1221,63,1284,1985,0,0,64.69,697,524,"海口村",NULL
0,546,52,598,928,0,0,64.44,228,318,"山寮村",NULL
0,900,53,953,1550,0,0,61.48,323,577,"溪頂村",NULL
0,1184,98,1282,1983,0,0,64.65,452,732,"牛厝村",NULL
0,390,26,416,653,0,0,63.71,175,215,"泉州村",NULL
0,331,2,333,504,0,0,66.07,99,232,"五榔村",NULL
0,453,24,477,699,0,0,68.24,212,241,"光華村",NULL
0,1204,84,1288,1946,0,0,66.19,577,627,"五港村",NULL
0,1071,27,1098,1571,0,0,69.89,616,455,"富琦村",NULL
0,942,48,990,1472,0,0,67.26,511,431,"永豐村",NULL
0,2003,143,2146,3286,0,0,65.31,1031,972,"和豐村",NULL
0,1334,96,1430,2069,0,0,69.12,756,578,"蚊港村",NULL
0,2243,115,2358,3203,0,0,73.62,864,1379,"長南村",NULL
0,1175,49,1224,1681,0,0,72.81,391,784,"長北村",NULL
0,1021,46,1067,1513,0,0,70.52,362,659,"子茂村",NULL
0,604,10,614,814,0,0,75.43,207,397,"後湖村",NULL
0,702,53,755,1061,0,0,71.16,356,346,"山內村",NULL
0,854,5,859,1221,0,0,70.35,258,596,"合和村",NULL
0,691,32,723,1067,0,0,67.76,326,365,"五塊村",NULL
0,542,41,583,926,0,0,62.96,146,396,"潭西村",NULL
0,447,27,474,692,0,0,68.5,233,214,"潭東村",NULL
0,607,46,653,883,0,0,73.95,212,395,"客厝村",NULL
0,291,27,318,464,0,0,68.53,51,240,"卓運村",NULL
0,791,43,834,1248,0,0,66.83,255,536,"頂寮村",NULL
0,1037,64,1101,1533,0,0,71.82,395,642,"下寮村",NULL
0,722,65,787,1107,0,0,71.09,165,557,"龍岩村",NULL
0,623,49,672,927,0,0,72.49,179,444,"西莊村",NULL
0,892,53,945,1348,0,0,70.1,294,598,"鹿北村",NULL
0,675,54,729,1049,0,0,69.49,200,475,"鹿南村",NULL
0,1132,74,1206,1660,0,0,72.65,328,804,"瓦窯村",NULL
0,464,36,500,672,0,0,74.4,129,335,"內寮村",NULL
0,605,51,656,935,0,0,70.16,213,392,"崙仔村",NULL
0,517,37,554,739,0,0,74.97,198,319,"新吉村",NULL
0,1233,25,1258,1765,0,0,71.27,487,746,"四湖村",NULL
0,1531,84,1615,2136,0,0,75.61,680,851,"湖西村",NULL
0,474,36,510,717,0,0,71.13,162,312,"新庄村",NULL
0,709,42,751,1086,0,0,69.15,243,466,"溪底村",NULL
0,692,55,747,1119,0,0,66.76,296,396,"鹿場村",NULL
0,617,42,659,978,0,0,67.38,208,409,"蔡厝村",NULL
0,558,18,576,884,0,0,65.16,181,377,"湖寮村",NULL
0,727,61,788,1228,0,0,64.17,318,409,"施湖村",NULL
0,682,65,747,1152,0,0,64.84,299,383,"羊調村",NULL
0,532,38,570,969,0,0,58.82,188,344,"內湖村",NULL
0,390,27,417,654,0,0,63.76,174,216,"飛東村",NULL
0,563,5,568,995,0,0,57.09,308,255,"飛沙村",NULL
0,230,23,253,423,0,0,59.81,111,119,"三姓村",NULL
0,1113,56,1169,1822,0,0,64.16,497,616,"崙北村",NULL
0,531,44,575,928,0,0,61.96,228,303,"崙南村",NULL
0,491,24,515,816,0,0,63.11,290,201,"廣溝村",NULL
0,612,35,647,1050,0,0,61.62,165,447,"箔子村",NULL
0,703,45,748,1175,0,0,63.66,155,548,"箔東村",NULL
0,810,70,880,1301,0,0,67.64,333,477,"林厝村",NULL
0,609,69,678,1096,0,0,61.86,280,329,"林東村",NULL
0,493,45,538,852,0,0,63.15,270,223,"溪尾村",NULL
0,757,35,792,1082,0,0,73.2,319,438,"口湖村",NULL
0,912,44,956,1306,0,0,73.2,437,475,"湖東村",NULL
0,439,27,466,706,0,0,66.01,195,244,"頂湖村",NULL
0,487,26,513,682,0,0,75.22,174,313,"埔南村",NULL
0,519,43,562,934,0,0,60.17,155,364,"埔北村",NULL
0,694,41,735,1018,0,0,72.2,203,491,"謝厝村",NULL
0,977,75,1052,1467,0,0,71.71,257,720,"蚵寮村",NULL
0,1281,71,1352,2116,0,0,63.89,411,870,"下崙村",NULL
0,1055,57,1112,1767,0,0,62.93,346,709,"崙中村",NULL
0,982,46,1028,1564,0,0,65.73,344,638,"崙東村",NULL
0,381,23,404,580,0,0,69.66,111,270,"青蚶村",NULL
0,1070,11,1081,1517,0,0,71.26,426,644,"港東村",NULL
0,532,24,556,817,0,0,68.05,286,246,"港西村",NULL
0,1256,46,1302,1696,0,0,76.77,223,1033,"臺子村",NULL
0,717,34,751,1045,0,0,71.87,297,420,"成龍村",NULL
0,1328,74,1402,1880,0,0,74.57,479,849,"梧南村",NULL
0,929,57,986,1325,0,0,74.42,165,764,"梧北村",NULL
0,680,60,740,1060,0,0,69.81,236,444,"水井村",NULL
0,569,24,593,805,0,0,73.66,132,437,"後厝村",NULL
0,711,48,759,1072,0,0,70.8,195,516,"湖口村",NULL
0,491,17,508,753,0,0,67.46,170,321,"過港村",NULL
0,1673,60,1733,2318,0,0,74.76,569,1104,"水北村",NULL
0,1438,52,1490,1941,0,0,76.76,413,1025,"水南村",NULL
0,540,34,574,770,0,0,74.55,139,401,"萬興村",NULL
0,502,31,533,752,0,0,70.88,144,358,"尖山村",NULL
0,720,39,759,1081,0,0,70.21,227,493,"大溝村",NULL
0,650,37,687,933,0,0,73.63,129,521,"順興村",NULL
0,786,50,836,1174,0,0,71.21,181,605,"大山村",NULL
0,506,41,547,804,0,0,68.03,134,372,"後寮村",NULL
0,733,46,779,1076,0,0,72.4,183,550,"春埔村",NULL
0,476,35,511,763,0,0,66.97,167,309,"西井村",NULL
0,461,33,494,693,0,0,71.28,94,367,"車港村",NULL
0,797,62,859,1227,0,0,70.01,199,598,"蘇秦村",NULL
0,452,35,487,761,0,0,63.99,197,255,"灣東村",NULL
0,676,47,723,1075,0,0,67.26,255,421,"灣西村",NULL
0,753,52,805,1065,0,0,75.59,186,567,"蕃薯村",NULL
0,622,41,663,916,0,0,72.38,124,498,"山腳村",NULL
0,893,9,902,1230,0,0,73.33,288,605,"松北村",NULL
0,476,3,479,611,0,0,78.4,126,350,"松中村",NULL
0,556,37,593,802,0,0,73.94,98,458,"松西村",NULL
0,563,33,596,867,0,0,68.74,105,458,"舊埔村",NULL
0,514,48,562,847,0,0,66.35,124,390,"塭底村",NULL
0,740,44,784,1082,0,0,72.46,148,592,"海埔村",NULL
0,917,32,949,1254,0,0,75.68,199,718,"土厝村",NULL
0,578,39,617,842,0,0,73.28,170,408,"溪墘村",NULL
0,1347,31,1378,1791,0,0,76.94,649,698,"太保里",NULL
0,380,17,397,498,0,0,79.72,119,261,"後庄里",NULL
0,1115,12,1127,1402,0,0,80.39,321,794,"前潭里",NULL
0,1174,31,1205,1528,0,0,78.86,427,747,"後潭里",NULL
0,857,31,888,1100,0,0,80.73,352,505,"梅埔里",NULL
0,680,24,704,870,0,0,80.92,214,466,"春珠里",NULL
0,634,27,661,825,0,0,80.12,309,325,"崙頂里",NULL
0,928,38,966,1193,0,0,80.97,378,550,"安仁里",NULL
0,686,24,710,911,0,0,77.94,229,457,"東勢里",NULL
0,917,36,953,1206,0,0,79.02,245,672,"新埤里",NULL
0,1400,39,1439,1836,0,0,78.38,505,895,"舊埤里",NULL
0,548,26,574,721,0,0,79.61,200,348,"田尾里",NULL
0,439,20,459,568,0,0,80.81,143,296,"港尾里",NULL
0,1691,33,1724,2137,0,0,80.67,605,1086,"過溝里",NULL
0,2319,56,2375,2964,0,0,80.13,945,1374,"麻寮里",NULL
0,1401,53,1454,1746,0,0,83.28,464,937,"南新里",NULL
0,1796,45,1841,2268,0,0,81.17,606,1190,"北新里",NULL
0,548,20,568,725,0,0,78.34,209,339,"埤鄉里",NULL
0,1409,30,1439,1827,0,0,78.76,623,786,"安福里",NULL
0,1445,35,1480,1855,0,0,79.78,636,809,"平和里",NULL
0,847,23,870,1114,0,0,78.1,221,626,"內厝里",NULL
0,397,6,403,492,0,0,81.91,142,255,"開元里",NULL
0,549,13,562,725,0,0,77.52,203,346,"順天里",NULL
0,566,9,575,719,0,0,79.97,211,355,"中正里",NULL
0,599,20,619,766,0,0,80.81,190,409,"博厚里",NULL
0,1486,35,1521,1853,0,0,82.08,591,895,"文化里",NULL
0,1896,41,1937,2444,0,0,79.26,657,1239,"永和里",NULL
0,2954,56,3010,3783,0,0,79.57,1227,1727,"竹圍里",NULL
0,497,29,526,681,0,0,77.24,170,327,"新寮里",NULL
0,515,13,528,685,0,0,77.08,146,369,"雙溪里",NULL
0,624,22,646,827,0,0,78.11,217,407,"溪口里",NULL
0,877,14,891,1077,0,0,82.73,211,666,"德興里",NULL
0,476,25,501,637,0,0,78.65,167,309,"仁和里",NULL
0,1990,78,2068,2654,0,0,77.92,698,1292,"大鄉里",NULL
0,1358,51,1409,1810,0,0,77.85,479,879,"大葛里",NULL
0,457,21,478,598,0,0,79.93,150,307,"佳禾里",NULL
0,733,24,757,1000,0,0,75.7,250,483,"竹村里",NULL
0,697,49,746,972,0,0,76.75,156,541,"崁前里",NULL
0,592,31,623,841,0,0,74.08,155,437,"崁後里",NULL
0,230,3,233,291,0,0,80.07,94,136,"順安里",NULL
0,574,35,609,803,0,0,75.84,158,416,"德家里",NULL
0,473,3,476,616,0,0,77.27,157,316,"新庄里",NULL
0,847,45,892,1135,0,0,78.59,160,687,"梅華里",NULL
0,1014,62,1076,1445,0,0,74.46,194,820,"松華里",NULL
0,423,13,436,565,0,0,77.17,76,347,"南竹里",NULL
0,510,31,541,728,0,0,74.31,209,301,"岱江里",NULL
0,312,11,323,444,0,0,72.75,127,185,"九龍里",NULL
0,1257,31,1288,1759,0,0,73.22,557,700,"岑海里",NULL
0,892,26,918,1213,0,0,75.68,373,519,"興中里",NULL
0,1359,44,1403,1819,0,0,77.13,538,821,"光復里",NULL
0,711,15,726,979,0,0,74.16,226,485,"見龍里",NULL
0,549,19,568,795,0,0,71.45,262,287,"新厝里",NULL
0,596,27,623,837,0,0,74.43,240,356,"龍江里",NULL
0,982,44,1026,1382,0,0,74.24,399,583,"西安里",NULL
0,1155,57,1212,1622,0,0,74.72,385,770,"中安里",NULL
0,1136,54,1190,1553,0,0,76.63,359,777,"東安里",NULL
0,425,11,436,568,0,0,76.76,143,282,"樹林里",NULL
0,561,22,583,769,0,0,75.81,205,356,"貴舍里",NULL
0,824,30,854,1179,0,0,72.43,371,453,"永安里",NULL
0,1436,55,1491,1961,0,0,76.03,595,841,"東港里",NULL
0,249,9,258,342,0,0,75.44,110,139,"江山里",NULL
0,291,25,316,446,0,0,70.85,168,123,"菜舖里",NULL
0,246,14,260,351,0,0,74.07,97,149,"考試里",NULL
0,592,8,600,824,0,0,72.82,295,297,"振寮里",NULL
0,750,21,771,1048,0,0,73.57,247,503,"新岑里",NULL
0,914,21,935,1246,0,0,75.04,353,561,"新民里",NULL
0,1851,42,1893,2444,0,0,77.45,786,1065,"復興里",NULL
0,774,33,807,1118,0,0,72.18,308,466,"好美里",NULL
0,391,15,406,493,0,0,82.35,173,218,"東林里",NULL
0,1585,30,1615,1986,0,0,81.32,690,895,"西林里",NULL
0,766,21,787,1013,0,0,77.69,367,399,"吉林里",NULL
0,3865,93,3958,5013,0,0,78.95,1787,2078,"平林里",NULL
0,904,6,910,1151,0,0,79.06,362,542,"明華里",NULL
0,1089,27,1116,1398,0,0,79.83,441,648,"明和里",NULL
0,527,21,548,690,0,0,79.42,123,404,"排路里",NULL
0,561,40,601,819,0,0,73.38,142,419,"西結里",NULL
0,482,30,512,681,0,0,75.18,173,309,"湖北里",NULL
0,226,6,232,314,0,0,73.89,137,89,"大糖里",NULL
0,1350,56,1406,1770,0,0,79.44,634,716,"大美里",NULL
0,1102,60,1162,1486,0,0,78.2,432,670,"過溪里",NULL
0,1134,52,1186,1514,0,0,78.34,460,674,"中坑里",NULL
0,628,30,658,848,0,0,77.59,242,386,"上林里",NULL
0,1143,70,1213,1529,0,0,79.33,291,852,"中林里",NULL
0,1498,36,1534,1915,0,0,80.1,665,833,"三和里",NULL
0,750,41,791,984,0,0,80.39,232,518,"溝背里",NULL
0,528,20,548,677,0,0,80.95,247,281,"義和里",NULL
0,565,19,584,730,0,0,80,249,316,"內林里",NULL
0,658,5,663,863,0,0,76.83,283,375,"三角里",NULL
0,600,14,614,768,0,0,79.95,224,376,"三村里",NULL
0,1603,53,1656,2071,0,0,79.96,672,931,"東榮村",NULL
0,1310,28,1338,1637,0,0,81.73,590,720,"中樂村",NULL
0,2358,75,2433,2995,0,0,81.24,859,1499,"西安村",NULL
0,1627,30,1657,2044,0,0,81.07,594,1033,"寮頂村",NULL
0,1069,34,1103,1357,0,0,81.28,283,786,"福權村",NULL
0,1378,57,1435,1806,0,0,79.46,593,785,"東湖村",NULL
0,1018,36,1054,1366,0,0,77.16,397,621,"頂崙村",NULL
0,1295,57,1352,1684,0,0,80.29,261,1034,"菁埔村",NULL
0,580,26,606,755,0,0,80.26,207,373,"中和村",NULL
0,566,18,584,738,0,0,79.13,197,369,"平和村",NULL
0,614,26,640,776,0,0,82.47,170,444,"西昌村",NULL
0,1456,71,1527,1902,0,0,80.28,566,890,"豊收村",NULL
0,688,27,715,864,0,0,82.75,235,453,"三興村",NULL
0,406,28,434,572,0,0,75.87,117,289,"東興村",NULL
0,730,23,753,926,0,0,81.32,300,430,"鎮北村",NULL
0,2767,64,2831,3565,0,0,79.41,1044,1723,"北斗村",NULL
0,1328,40,1368,1680,0,0,81.43,623,705,"雙福村",NULL
0,3417,67,3484,4318,0,0,80.69,1522,1895,"福樂村",NULL
0,1658,52,1710,2148,0,0,79.61,682,976,"大崎村",NULL
0,1705,52,1757,2215,0,0,79.32,616,1089,"秀林村",NULL
0,1202,56,1258,1640,0,0,76.71,460,742,"松山村",NULL
0,1362,39,1401,1744,0,0,80.33,563,799,"興中村",NULL
0,1712,47,1759,2231,0,0,78.84,693,1019,"興南村",NULL
0,1996,49,2045,2602,0,0,78.59,898,1098,"金興村",NULL
0,1392,41,1433,1758,0,0,81.51,537,855,"福興村",NULL
0,1590,50,1640,2006,0,0,81.75,672,918,"文隆村",NULL
0,2729,97,2826,3492,0,0,80.93,966,1763,"山中村",NULL
0,973,28,1001,1243,0,0,80.53,253,720,"中央村",NULL
0,1099,42,1141,1420,0,0,80.35,358,741,"溪東村",NULL
0,550,24,574,735,0,0,78.1,169,381,"溪西村",NULL
0,526,8,534,699,0,0,76.39,165,361,"溪北村",NULL
0,617,5,622,821,0,0,75.76,153,464,"柴林村",NULL
0,634,38,672,880,0,0,76.36,131,503,"林腳村",NULL
0,935,45,980,1235,0,0,79.35,229,706,"美南村",NULL
0,689,38,727,946,0,0,76.85,208,481,"美北村",NULL
0,734,40,774,997,0,0,77.63,186,548,"本厝村",NULL
0,834,40,874,1101,0,0,79.38,186,648,"游東村",NULL
0,558,34,592,783,0,0,75.61,112,446,"游西村",NULL
0,954,45,999,1273,0,0,78.48,272,682,"柳溝村",NULL
0,800,17,817,1015,0,0,80.49,205,595,"疊溪村",NULL
0,521,34,555,743,0,0,74.7,148,373,"妙崙村",NULL
0,713,8,721,888,0,0,81.19,184,529,"坪頂村",NULL
0,1433,32,1465,1757,0,0,83.38,528,905,"宮前村",NULL
0,1270,39,1309,1682,0,0,77.82,416,854,"宮後村",NULL
0,1127,18,1145,1440,0,0,79.51,339,788,"大興村",NULL
0,1172,40,1212,1529,0,0,79.27,433,739,"福德村",NULL
0,891,32,923,1188,0,0,77.69,203,688,"古民村",NULL
0,1140,46,1186,1527,0,0,77.67,259,881,"中庄村",NULL
0,1265,16,1281,1628,0,0,78.69,295,970,"大潭村",NULL
0,703,34,737,974,0,0,75.67,261,442,"西庄村",NULL
0,1316,37,1353,1719,0,0,78.71,376,940,"月眉村",NULL
0,1098,40,1138,1437,0,0,79.19,319,779,"月潭村",NULL
0,1102,57,1159,1437,0,0,80.65,306,796,"溪北村",NULL
0,725,30,755,950,0,0,79.47,237,488,"菜公村",NULL
0,759,30,789,998,0,0,79.06,252,507,"中洋村",NULL
0,795,20,815,975,0,0,83.59,245,550,"三間村",NULL
0,799,50,849,1131,0,0,75.07,244,555,"安和村",NULL
0,865,43,908,1162,0,0,78.14,226,639,"潭大村",NULL
0,823,50,873,1119,0,0,78.02,226,597,"南港村",NULL
0,487,8,495,606,0,0,81.68,121,366,"板頭村",NULL
0,647,31,678,857,0,0,79.11,180,467,"共和村",NULL
0,456,25,481,602,0,0,79.9,98,358,"埤子村",NULL
0,724,30,754,938,0,0,80.38,96,628,"南崙村",NULL
0,411,25,436,601,0,0,72.55,83,328,"北崙村",NULL
0,382,22,404,507,0,0,79.68,111,271,"海瀛村",NULL
0,953,29,982,1284,0,0,76.48,386,567,"蒜頭村",NULL
0,651,31,682,945,0,0,72.17,212,439,"蒜東村",NULL
0,664,28,692,900,0,0,76.89,218,446,"蒜南村",NULL
0,237,8,245,305,0,0,80.33,155,82,"工廠村",NULL
0,882,43,925,1239,0,0,74.66,277,605,"灣南村",NULL
0,895,44,939,1306,0,0,71.9,347,548,"灣北村",NULL
0,655,29,684,914,0,0,74.84,174,481,"雙涵村",NULL
0,532,21,553,740,0,0,74.73,103,429,"塗師村",NULL
0,561,25,586,787,0,0,74.46,156,405,"三義村",NULL
0,1088,36,1124,1428,0,0,78.71,225,863,"正義村",NULL
0,443,13,456,628,0,0,72.61,144,299,"溪厝村",NULL
0,577,23,600,777,0,0,77.22,99,478,"港美村",NULL
0,775,40,815,1096,0,0,74.36,209,566,"豐美村",NULL
0,659,29,688,921,0,0,74.7,187,472,"六斗村",NULL
0,774,25,799,1014,0,0,78.8,205,569,"崙陽村",NULL
0,1075,41,1116,1460,0,0,76.44,306,769,"蘇厝村",NULL
0,513,29,542,735,0,0,73.74,128,385,"竹本村",NULL
0,386,27,413,558,0,0,74.01,88,298,"永賢村",NULL
0,522,34,556,766,0,0,72.58,119,403,"魚寮村",NULL
0,656,41,697,980,0,0,71.12,247,409,"潭墘村",NULL
0,626,33,659,893,0,0,73.8,231,395,"六腳村",NULL
0,407,36,443,629,0,0,70.43,102,305,"六南村",NULL
0,567,51,618,796,0,0,77.64,129,438,"崩山村",NULL
0,609,32,641,842,0,0,76.13,128,481,"古林村",NULL
0,428,21,449,624,0,0,71.96,128,300,"更寮村",NULL
0,1292,45,1337,1827,0,0,73.18,457,835,"東石村",NULL
0,704,30,734,1003,0,0,73.18,300,404,"猿樹村",NULL
0,1180,59,1239,1636,0,0,75.73,528,652,"塭港村",NULL
0,1027,40,1067,1481,0,0,72.05,391,636,"型厝村",NULL
0,868,45,913,1261,0,0,72.4,369,499,"三家村",NULL
0,528,18,546,728,0,0,75,224,304,"永屯村",NULL
0,318,19,337,456,0,0,73.9,102,216,"海埔村",NULL
0,693,37,730,988,0,0,73.89,331,362,"龍港村",NULL
0,791,55,846,1157,0,0,73.12,228,563,"副瀨村",NULL
0,627,35,662,878,0,0,75.4,181,446,"下揖村",NULL
0,284,14,298,435,0,0,68.51,72,212,"頂揖村",NULL
0,717,47,764,1104,0,0,69.2,314,403,"溪下村",NULL
0,257,10,267,388,0,0,68.81,125,132,"港口村",NULL
0,1004,21,1025,1376,0,0,74.49,352,652,"鰲鼓村",NULL
0,1014,46,1060,1325,0,0,80,364,650,"港墘村",NULL
0,685,37,722,917,0,0,78.74,243,442,"蔦松村",NULL
0,546,19,565,788,0,0,71.7,181,365,"圍潭村",NULL
0,668,43,711,961,0,0,73.99,256,412,"洲仔村",NULL
0,556,28,584,820,0,0,71.22,206,350,"東崙村",NULL
0,797,39,836,1139,0,0,73.4,294,503,"西崙村",NULL
0,732,38,770,1008,0,0,76.39,263,469,"塭仔村",NULL
0,908,32,940,1316,0,0,71.43,362,546,"網寮村",NULL
0,597,17,614,816,0,0,75.25,267,330,"掌潭村",NULL
0,585,37,622,804,0,0,77.36,207,378,"岸腳村",NULL
0,1193,42,1235,1543,0,0,80.04,421,772,"義竹村",NULL
0,961,47,1008,1317,0,0,76.54,390,571,"六桂村",NULL
0,700,33,733,903,0,0,81.17,294,406,"仁里村",NULL
0,533,23,556,739,0,0,75.24,203,330,"傳芳村",NULL
0,982,52,1034,1308,0,0,79.05,342,640,"頭竹村",NULL
0,317,9,326,437,0,0,74.6,104,213,"五厝村",NULL
0,363,21,384,482,0,0,79.67,165,198,"中平村",NULL
0,587,40,627,802,0,0,78.18,274,313,"埤前村",NULL
0,333,13,346,449,0,0,77.06,107,226,"平溪村",NULL
0,357,20,377,491,0,0,76.78,138,219,"後鎮村",NULL
0,433,16,449,598,0,0,75.08,125,308,"北華村",NULL
0,1135,54,1189,1547,0,0,76.86,387,748,"新店村",NULL
0,637,18,655,867,0,0,75.55,266,371,"東過村",NULL
0,600,29,629,890,0,0,70.67,176,424,"西過村",NULL
0,638,25,663,874,0,0,75.86,151,487,"官和村",NULL
0,377,12,389,536,0,0,72.57,124,253,"官順村",NULL
0,419,21,440,577,0,0,76.26,176,243,"新富村",NULL
0,643,38,681,855,0,0,79.65,202,441,"東光村",NULL
0,338,19,357,480,0,0,74.38,94,244,"東榮村",NULL
0,468,27,495,680,0,0,72.79,168,300,"龍蛟村",NULL
0,560,31,591,748,0,0,79.01,120,440,"溪洲村",NULL
0,361,23,384,511,0,0,75.15,102,259,"後寮村",NULL
0,503,23,526,659,0,0,79.82,128,375,"鹿東村",NULL
0,997,49,1046,1346,0,0,77.71,366,631,"鹿草村",NULL
0,853,44,897,1151,0,0,77.93,335,518,"西井村",NULL
0,327,12,339,445,0,0,76.18,140,187,"豊稠村",NULL
0,831,45,876,1154,0,0,75.91,217,614,"重寮村",NULL
0,377,18,395,508,0,0,77.76,119,258,"施家村",NULL
0,657,44,701,901,0,0,77.8,146,511,"下潭村",NULL
0,827,40,867,1141,0,0,75.99,208,619,"光潭村",NULL
0,761,60,821,1098,0,0,74.77,304,457,"碧潭村",NULL
0,635,38,673,930,0,0,72.37,276,359,"松竹村",NULL
0,663,39,702,943,0,0,74.44,180,483,"竹山村",NULL
0,996,34,1030,1299,0,0,79.29,343,653,"後堀村",NULL
0,1142,66,1208,1538,0,0,78.54,341,801,"三角村",NULL
0,430,26,456,569,0,0,80.14,170,260,"下麻村",NULL
0,2477,65,2542,3153,0,0,80.62,1034,1443,"水上村",NULL
0,1699,48,1747,2124,0,0,82.25,762,937,"水頭村",NULL
0,1141,44,1185,1497,0,0,79.16,447,694,"粗溪村",NULL
0,1279,41,1320,1639,0,0,80.54,526,753,"下寮村",NULL
0,1448,41,1489,1836,0,0,81.1,765,683,"三和村",NULL
0,501,18,519,654,0,0,79.36,344,157,"回歸村",NULL
0,1208,24,1232,1479,0,0,83.3,349,859,"大堀村",NULL
0,1469,58,1527,1945,0,0,78.51,505,964,"大崙村",NULL
0,650,23,673,843,0,0,79.83,221,429,"塗溝村",NULL
0,1457,66,1523,1844,0,0,82.59,446,1011,"龍德村",NULL
0,858,24,882,1109,0,0,79.53,288,570,"溪洲村",NULL
0,517,23,540,678,0,0,79.65,270,247,"三鎮村",NULL
0,424,21,445,527,0,0,84.44,246,178,"靖和村",NULL
0,997,42,1039,1294,0,0,80.29,413,584,"南和村",NULL
0,1710,54,1764,2242,0,0,78.68,1124,586,"柳新村",NULL
0,1347,46,1393,1782,0,0,78.17,515,832,"柳林村",NULL
0,1470,44,1514,1862,0,0,81.31,473,997,"柳鄉村",NULL
0,743,41,784,993,0,0,78.95,281,462,"內溪村",NULL
0,2812,73,2885,3709,0,0,77.78,1106,1706,"寬士村",NULL
0,2274,43,2317,2942,0,0,78.76,969,1305,"民生村",NULL
0,630,5,635,761,0,0,83.44,255,375,"義興村",NULL
0,1394,52,1446,1856,0,0,77.91,694,700,"中庄村",NULL
0,1414,58,1472,1872,0,0,78.63,707,707,"忠和村",NULL
0,634,26,660,817,0,0,80.78,230,404,"南鄉村",NULL
0,765,39,804,1033,0,0,77.83,247,518,"三界村",NULL
0,970,43,1013,1305,0,0,77.62,284,686,"國姓村",NULL
0,1264,46,1310,1637,0,0,80.02,498,766,"中埔村",NULL
0,648,29,677,861,0,0,78.63,247,401,"塩舘村",NULL
0,565,18,583,749,0,0,77.84,296,269,"龍門村",NULL
0,681,28,709,890,0,0,79.66,145,536,"裕民村",NULL
0,1073,35,1108,1381,0,0,80.23,376,697,"金蘭村",NULL
0,2029,74,2103,2647,0,0,79.45,726,1303,"富收村",NULL
0,2043,59,2102,2714,0,0,77.45,785,1258,"和睦村",NULL
0,4340,102,4442,5636,0,0,78.81,1944,2396,"和美村",NULL
0,3747,121,3868,5020,0,0,77.05,1519,2228,"和興村",NULL
0,1309,46,1355,1701,0,0,79.66,520,789,"隆興村",NULL
0,1051,37,1088,1360,0,0,80,343,708,"義仁村",NULL
0,1537,55,1592,2088,0,0,76.25,610,927,"社口村",NULL
0,814,31,845,1093,0,0,77.31,354,460,"灣潭村",NULL
0,914,35,949,1202,0,0,78.95,392,522,"石硦村",NULL
0,733,23,756,945,0,0,80,242,491,"頂埔村",NULL
0,1428,65,1493,1972,0,0,75.71,429,999,"同仁村",NULL
0,584,22,606,737,0,0,82.23,208,376,"深坑村",NULL
0,476,13,489,632,0,0,77.37,161,315,"三層村",NULL
0,559,24,583,732,0,0,79.64,239,320,"瑞豐村",NULL
0,822,35,857,1115,0,0,76.86,273,549,"沄水村",NULL
0,266,4,270,335,0,0,80.6,126,140,"東興村",NULL
0,254,15,269,329,0,0,81.76,118,136,"中崙村",NULL
0,1782,53,1835,2315,0,0,79.27,685,1097,"竹崎村",NULL
0,1470,45,1515,1910,0,0,79.32,524,946,"和平村",NULL
0,571,29,600,775,0,0,77.42,197,374,"坑頭村",NULL
0,685,33,718,884,0,0,81.22,171,514,"沙坑村",NULL
0,1036,47,1083,1313,0,0,82.48,345,691,"獅埜村",NULL
0,450,21,471,558,0,0,84.41,167,283,"義和村",NULL
0,790,28,818,1056,0,0,77.46,267,523,"義仁村",NULL
0,3662,102,3764,4789,0,0,78.6,1543,2119,"灣橋村",NULL
0,981,30,1011,1281,0,0,78.92,345,636,"鹿滿村",NULL
0,1010,35,1045,1334,0,0,78.34,431,579,"紫雲村",NULL
0,1239,40,1279,1601,0,0,79.89,447,792,"內埔村",NULL
0,1273,54,1327,1754,0,0,75.66,489,784,"昇平村",NULL
0,807,30,837,1064,0,0,78.67,298,509,"桃源村",NULL
0,546,26,572,779,0,0,73.43,246,300,"白杞村",NULL
0,706,25,731,930,0,0,78.6,335,371,"塘興村",NULL
0,431,14,445,562,0,0,79.18,193,238,"義隆村",NULL
0,185,2,187,240,0,0,77.92,56,129,"龍山村",NULL
0,1122,39,1161,1481,0,0,78.39,376,746,"灣橋村",NULL
0,564,40,604,762,0,0,79.27,164,400,"文峯村",NULL
0,353,23,376,478,0,0,78.66,143,210,"金獅村",NULL
0,1412,69,1481,1893,0,0,78.24,475,937,"復金村",NULL
0,733,30,763,1025,0,0,74.44,301,432,"緞繻村",NULL
0,194,10,204,298,0,0,68.46,57,137,"仁壽村",NULL
0,597,19,616,825,0,0,74.67,248,349,"中和村",NULL
0,569,4,573,763,0,0,75.1,242,327,"光華村",NULL
0,1778,69,1847,2344,0,0,78.8,662,1116,"梅東村",NULL
0,788,21,809,1028,0,0,78.7,345,443,"梅南村",NULL
0,3007,100,3107,3875,0,0,80.18,1065,1942,"梅北村",NULL
0,470,2,472,583,0,0,80.96,199,271,"過山村",NULL
0,385,17,402,512,0,0,78.52,124,261,"圳南村",NULL
0,518,18,536,679,0,0,78.94,238,280,"圳北村",NULL
0,460,11,471,565,0,0,83.36,184,276,"双溪村",NULL
0,1305,47,1352,1710,0,0,79.06,499,806,"大南村",NULL
0,693,31,724,948,0,0,76.37,279,414,"安靖村",NULL
0,385,25,410,521,0,0,78.69,137,248,"永興村",NULL
0,343,12,355,452,0,0,78.54,110,233,"半天村",NULL
0,352,14,366,496,0,0,73.79,145,207,"太平村",NULL
0,319,3,322,393,0,0,81.93,165,154,"太興村",NULL
0,359,10,369,475,0,0,77.68,94,265,"龍眼村",NULL
0,214,3,217,293,0,0,74.06,89,125,"碧湖村",NULL
0,544,18,562,760,0,0,73.95,157,387,"瑞峯村",NULL
0,559,29,588,736,0,0,79.89,256,303,"瑞里村",NULL
0,758,30,788,1055,0,0,74.69,305,453,"太和村",NULL
0,824,36,860,1047,0,0,82.14,330,494,"江西村",NULL
0,301,13,314,414,0,0,75.85,120,181,"內甕村",NULL
0,661,2,663,810,0,0,81.85,226,435,"新福村",NULL
0,1287,54,1341,1666,0,0,80.49,479,808,"下坑村",NULL
0,630,22,652,832,0,0,78.37,231,399,"番路村",NULL
0,587,39,626,803,0,0,77.96,223,364,"民和村",NULL
0,661,21,682,825,0,0,82.67,213,448,"觸口村",NULL
0,593,23,616,836,0,0,73.68,242,351,"大湖村",NULL
0,721,11,732,959,0,0,76.33,268,453,"公田村",NULL
0,410,14,424,550,0,0,77.09,197,213,"公興村",NULL
0,300,8,308,405,0,0,76.05,159,141,"草山村",NULL
0,651,25,676,999,0,0,67.67,328,323,"大埔村",NULL
0,324,9,333,479,0,0,69.52,171,153,"和平村",NULL
0,216,3,219,313,0,0,69.97,130,86,"永樂村",NULL
0,444,18,462,711,0,0,64.98,268,176,"茄苳村",NULL
0,249,5,254,377,0,0,67.37,174,75,"西興村",NULL
0,238,6,244,353,0,0,69.12,116,122,"中山村",NULL
0,134,4,138,194,0,0,71.13,79,55,"中正村",NULL
0,144,2,146,232,0,0,62.93,100,44,"香林村",NULL
0,208,11,219,321,0,0,68.22,103,105,"十字村",NULL
0,206,12,218,293,0,0,74.4,80,126,"豐山村",NULL
0,239,0,239,328,0,0,72.87,183,56,"來吉村",NULL
0,569,24,593,760,0,0,78.03,409,160,"樂野村",NULL
0,608,6,614,846,0,0,72.58,537,71,"達邦村",NULL
0,195,8,203,270,0,0,75.19,157,38,"里佳村",NULL
0,343,9,352,483,0,0,72.88,279,64,"山美村",NULL
0,211,9,220,301,0,0,73.09,181,30,"新美村",NULL
0,232,7,239,327,0,0,73.09,138,94,"茶山村",NULL
0,3484,47,3531,4470,0,0,78.99,1779,1705,"忠政里",NULL
0,1918,43,1961,2423,0,0,80.93,881,1037,"民權里",NULL
0,2087,55,2142,2688,0,0,79.69,882,1205,"三仙里",NULL
0,650,28,678,863,0,0,78.56,230,420,"好平里",NULL
0,960,34,994,1269,0,0,78.33,336,624,"延平里",NULL
0,756,17,773,968,0,0,79.86,329,427,"永生里",NULL
0,2398,68,2466,3181,0,0,77.52,1022,1376,"大宏里",NULL
0,5008,114,5122,6403,0,0,79.99,2299,2709,"王公里",NULL
0,846,16,862,1085,0,0,79.45,358,488,"中營里",NULL
0,1105,39,1144,1434,0,0,79.78,327,778,"土庫里",NULL
0,356,3,359,451,0,0,79.6,153,203,"興安里",NULL
0,1877,48,1925,2382,0,0,80.81,832,1045,"南興里",NULL
0,1193,28,1221,1526,0,0,80.01,624,569,"興業里",NULL
0,2358,70,2428,3082,0,0,78.78,917,1441,"民生里",NULL
0,2704,43,2747,3442,0,0,79.81,1290,1414,"新北里",NULL
0,2236,36,2272,2786,0,0,81.55,987,1249,"新南里",NULL
0,3021,86,3107,3967,0,0,78.32,1166,1855,"民榮里",NULL
0,1266,36,1302,1616,0,0,80.57,442,824,"埤寮里",NULL
0,973,40,1013,1278,0,0,79.26,295,678,"護鎮里",NULL
0,1148,53,1201,1484,0,0,80.93,286,862,"太南里",NULL
0,1272,47,1319,1589,0,0,83.01,345,927,"太北里",NULL
0,2378,57,2435,3131,0,0,77.77,1059,1319,"南紙里",NULL
0,1139,40,1179,1497,0,0,78.76,346,793,"嘉芳里",NULL
0,268,17,285,367,0,0,77.66,61,207,"舊埔里",NULL
0,334,19,353,441,0,0,80.05,106,228,"角帶里",NULL
0,589,24,613,741,0,0,82.73,160,429,"鐵線里",NULL
0,728,44,772,1009,0,0,76.51,186,542,"五興里",NULL
0,475,18,493,593,0,0,83.14,79,396,"姑爺里",NULL
0,1082,22,1104,1400,0,0,78.86,315,767,"水秀里",NULL
0,471,17,488,622,0,0,78.46,156,315,"福得里",NULL
0,295,15,310,382,0,0,81.15,96,199,"三生里",NULL
0,438,9,447,551,0,0,81.13,136,302,"武廟里",NULL
0,428,6,434,534,0,0,81.27,210,218,"中境里",NULL
0,312,9,321,397,0,0,80.86,107,205,"水仙里",NULL
0,610,18,628,791,0,0,79.39,239,371,"水正里",NULL
0,2443,70,2513,3254,0,0,77.23,883,1560,"橋南里",NULL
0,617,15,632,766,0,0,82.51,101,516,"舊營里",NULL
0,719,43,762,982,0,0,77.6,131,588,"汫水里",NULL
0,2551,69,2620,3285,0,0,79.76,978,1573,"岸內里",NULL
0,555,19,574,772,0,0,74.35,158,397,"義稠里",NULL
0,597,31,628,780,0,0,80.51,140,457,"下中里",NULL
0,1265,53,1318,1635,0,0,80.61,343,922,"歡雅里",NULL
0,374,21,395,498,0,0,79.32,66,308,"大莊里",NULL
0,236,11,247,290,0,0,85.17,53,183,"桐寮里",NULL
0,505,32,537,687,0,0,78.17,129,376,"後宅里",NULL
0,338,20,358,475,0,0,75.37,93,245,"孫厝里",NULL
0,620,23,643,784,0,0,82.02,127,493,"竹埔里",NULL
0,312,21,333,431,0,0,77.26,61,251,"下林里",NULL
0,220,13,233,281,0,0,82.92,47,173,"田寮里",NULL
0,300,7,307,375,0,0,81.87,70,230,"大豐里",NULL
0,315,15,330,420,0,0,78.57,98,217,"飯店里",NULL
0,419,15,434,552,0,0,78.62,99,320,"河南里",NULL
0,737,36,773,947,0,0,81.63,192,545,"南港里",NULL
0,1369,48,1417,1813,0,0,78.16,481,888,"白河里",NULL
0,2189,45,2234,2818,0,0,79.28,747,1442,"永安里",NULL
0,1113,38,1151,1476,0,0,77.98,306,807,"外角里",NULL
0,1200,52,1252,1574,0,0,79.54,380,820,"庄內里",NULL
0,644,44,688,866,0,0,79.45,215,429,"秀祐里",NULL
0,992,42,1034,1371,0,0,75.42,318,674,"河東里",NULL
0,334,22,356,462,0,0,77.06,109,225,"虎山里",NULL
0,437,22,459,640,0,0,71.72,107,330,"大林里",NULL
0,336,29,365,458,0,0,79.69,92,244,"崁頭里",NULL
0,449,14,463,650,0,0,71.23,107,342,"六溪里",NULL
0,906,22,928,1249,0,0,74.3,314,592,"關嶺里",NULL
0,1295,92,1387,1924,0,0,72.09,649,646,"仙草里",NULL
0,918,34,952,1235,0,0,77.09,304,614,"玉豐里",NULL
0,1051,52,1103,1396,0,0,79.01,328,723,"大竹里",NULL
0,678,30,708,882,0,0,80.27,166,512,"詔安里",NULL
0,527,16,543,683,0,0,79.5,141,386,"廣安里",NULL
0,667,35,702,890,0,0,78.88,208,459,"蓮潭里",NULL
0,718,24,742,952,0,0,77.94,220,498,"竹門里",NULL
0,591,8,599,785,0,0,76.31,248,343,"崎內里",NULL
0,957,51,1008,1270,0,0,79.37,271,686,"昇安里",NULL
0,545,29,574,708,0,0,81.07,127,418,"汴頭里",NULL
0,589,27,616,791,0,0,77.88,144,445,"內角里",NULL
0,682,20,702,918,0,0,76.47,274,408,"草店里",NULL
0,470,25,495,662,0,0,74.77,106,364,"甘宅里",NULL
0,1205,17,1222,1541,0,0,79.3,381,824,"士林村",NULL
0,1459,50,1509,1807,0,0,83.51,502,957,"光福村",NULL
0,554,17,571,712,0,0,80.2,185,369,"中埕村",NULL
0,1956,76,2032,2540,0,0,80,634,1322,"東昇村",NULL
0,1011,42,1053,1276,0,0,82.52,360,651,"八翁村",NULL
0,618,21,639,794,0,0,80.48,228,390,"人和村",NULL
0,1175,58,1233,1508,0,0,81.76,337,838,"太康村",NULL
0,1389,74,1463,1776,0,0,82.38,490,899,"重溪村",NULL
0,1064,46,1110,1416,0,0,78.39,349,715,"篤農村",NULL
0,519,22,541,672,0,0,80.51,169,350,"大農村",NULL
0,1055,50,1105,1396,0,0,79.15,268,787,"神農村",NULL
0,955,39,994,1251,0,0,79.46,237,718,"果毅村",NULL
0,1243,47,1290,1689,0,0,76.38,443,800,"旭山村",NULL
0,1208,33,1241,1515,0,0,81.91,470,738,"後壁村",NULL
0,1012,37,1049,1304,0,0,80.44,265,747,"侯伯村",NULL
0,957,48,1005,1271,0,0,79.07,316,641,"嘉苳村",NULL
0,1017,39,1056,1324,0,0,79.76,272,745,"土溝村",NULL
0,911,47,958,1179,0,0,81.26,223,688,"嘉田村",NULL
0,980,41,1021,1280,0,0,79.77,240,740,"嘉民村",NULL
0,621,20,641,815,0,0,78.65,185,436,"菁豊村",NULL
0,401,12,413,483,0,0,85.51,90,311,"崁頂村",NULL
0,356,28,384,555,0,0,69.19,94,262,"後廍村",NULL
0,584,41,625,791,0,0,79.01,184,400,"墨林村",NULL
0,338,19,357,450,0,0,79.33,105,233,"菁寮村",NULL
0,865,52,917,1141,0,0,80.37,165,700,"新嘉村",NULL
0,430,25,455,552,0,0,82.43,100,330,"頂長村",NULL
0,790,45,835,1060,0,0,78.77,205,585,"平安村",NULL
0,456,22,478,575,0,0,83.13,103,353,"仕安村",NULL
0,1180,35,1215,1448,0,0,83.91,220,960,"竹新村",NULL
0,1203,38,1241,1530,0,0,81.11,291,912,"新東村",NULL
0,935,31,966,1215,0,0,79.51,364,571,"頂安村",NULL
0,1026,32,1058,1337,0,0,79.13,350,676,"長安村",NULL
0,913,19,932,1166,0,0,79.93,311,602,"福安村",NULL
0,620,27,647,817,0,0,79.19,151,469,"烏樹村",NULL
0,1038,47,1085,1485,0,0,73.06,409,629,"東山村",NULL
0,1764,71,1835,2334,0,0,78.62,671,1093,"東中村",NULL
0,1077,71,1148,1552,0,0,73.97,337,740,"東正村",NULL
0,678,37,715,928,0,0,77.05,186,492,"三榮村",NULL
0,788,53,841,1162,0,0,72.38,288,500,"大客村",NULL
0,995,66,1061,1361,0,0,77.96,365,630,"科里村",NULL
0,681,36,717,906,0,0,79.14,173,508,"東河村",NULL
0,1473,46,1519,1896,0,0,80.12,414,1059,"聖賢村",NULL
0,370,20,390,511,0,0,76.32,110,260,"南溪村",NULL
0,317,14,331,472,0,0,70.13,73,244,"水雲村",NULL
0,288,25,313,410,0,0,76.34,77,211,"林安村",NULL
0,1527,99,1626,2306,0,0,70.51,608,919,"東原村",NULL
0,514,28,542,790,0,0,68.61,170,344,"嶺南村",NULL
0,782,47,829,1151,0,0,72.02,312,470,"南勢村",NULL
0,787,36,823,1130,0,0,72.83,323,464,"青山村",NULL
0,664,47,711,965,0,0,73.68,308,356,"高原村",NULL
0,546,6,552,645,0,0,85.58,116,430,"穀興里",NULL
0,483,12,495,586,0,0,84.47,119,364,"保安里",NULL
0,1712,32,1744,2080,0,0,83.85,556,1156,"東角里",NULL
0,1888,47,1935,2327,0,0,83.15,482,1406,"晉江里",NULL
0,1164,21,1185,1424,0,0,83.22,357,807,"巷口里",NULL
0,1550,32,1582,1898,0,0,83.35,475,1075,"中興里",NULL
0,1092,31,1123,1322,0,0,84.95,243,849,"興農里",NULL
0,835,17,852,1009,0,0,84.44,186,649,"新建里",NULL
0,2393,54,2447,2931,0,0,83.49,537,1856,"油車里",NULL
0,940,29,969,1161,0,0,83.46,111,829,"北勢里",NULL
0,2045,51,2096,2511,0,0,83.47,538,1507,"大埕里",NULL
0,526,20,546,660,0,0,82.73,168,358,"總榮里",NULL
0,607,14,621,735,0,0,84.49,89,518,"龍泉里",NULL
0,1809,39,1848,2256,0,0,81.91,602,1207,"南勢里",NULL
0,1288,48,1336,1562,0,0,85.53,212,1076,"寮廍里",NULL
0,783,15,798,944,0,0,84.53,148,635,"小埤里",NULL
0,1106,28,1134,1325,0,0,85.58,210,896,"埤頭里",NULL
0,457,10,467,524,0,0,89.12,79,378,"大山里",NULL
0,793,33,826,972,0,0,84.98,169,624,"海埔里",NULL
0,418,21,439,528,0,0,83.14,61,357,"莊禮里",NULL
0,902,26,928,1101,0,0,84.29,152,750,"港尾里",NULL
0,856,15,871,1045,0,0,83.35,145,711,"麻口里",NULL
0,492,13,505,629,0,0,80.29,123,369,"安東里",NULL
0,550,15,565,674,0,0,83.83,104,446,"安業里",NULL
0,614,27,641,746,0,0,85.92,85,529,"安西里",NULL
0,779,16,795,927,0,0,85.76,143,636,"謝安里",NULL
0,716,6,722,846,0,0,85.34,85,631,"中民里",NULL
0,703,11,714,833,0,0,85.71,117,586,"安正里",NULL
0,942,24,966,1123,0,0,86.02,156,786,"磚井里",NULL
0,755,26,781,970,0,0,80.52,284,471,"下營村",NULL
0,2006,53,2059,2619,0,0,78.62,782,1224,"仁里村",NULL
0,852,37,889,1146,0,0,77.57,337,515,"宅內村",NULL
0,1209,15,1224,1534,0,0,79.79,490,719,"後街村",NULL
0,1690,50,1740,2180,0,0,79.82,612,1078,"新興村",NULL
0,1657,49,1706,2134,0,0,79.94,630,1027,"營前村",NULL
0,640,28,668,804,0,0,83.08,184,456,"大屯村",NULL
0,599,20,619,761,0,0,81.34,228,371,"大埤村",NULL
0,984,35,1019,1218,0,0,83.66,230,754,"茅港村",NULL
0,910,32,942,1140,0,0,82.63,196,714,"中營村",NULL
0,1509,34,1543,1857,0,0,83.09,359,1150,"開化村",NULL
0,715,20,735,891,0,0,82.49,134,581,"西連村",NULL
0,1021,32,1053,1328,0,0,79.29,271,750,"賀建村",NULL
0,945,13,958,1185,0,0,80.84,189,756,"甲中村",NULL
0,986,47,1033,1254,0,0,82.38,170,816,"紅厝村",NULL
0,2233,59,2292,2805,0,0,81.71,749,1484,"六甲村",NULL
0,1952,71,2023,2536,0,0,79.77,582,1370,"甲東村",NULL
0,1040,21,1061,1323,0,0,80.2,298,742,"甲南村",NULL
0,818,12,830,1041,0,0,79.73,208,610,"龍湖村",NULL
0,721,22,743,883,0,0,84.14,166,555,"七甲村",NULL
0,2339,60,2399,2940,0,0,81.6,691,1648,"二甲村",NULL
0,1565,30,1595,1942,0,0,82.13,508,1057,"水林村",NULL
0,1254,43,1297,1580,0,0,82.09,373,881,"中社村",NULL
0,841,42,883,1093,0,0,80.79,263,578,"龜港村",NULL
0,483,15,498,597,0,0,83.42,159,324,"菁埔村",NULL
0,641,37,678,840,0,0,80.71,180,461,"王爺村",NULL
0,548,28,576,736,0,0,78.26,175,373,"大丘村",NULL
0,1546,61,1607,1938,0,0,82.92,457,1089,"官田村",NULL
0,1993,48,2041,2448,0,0,83.37,372,1621,"二鎮村",NULL
0,805,33,838,995,0,0,84.22,137,668,"湖山村",NULL
0,241,2,243,317,0,0,76.66,91,150,"嘉南村",NULL
0,392,18,410,482,0,0,85.06,114,278,"大崎村",NULL
0,1482,48,1530,1835,0,0,83.38,640,842,"隆田村",NULL
0,2354,64,2418,2903,0,0,83.29,1106,1248,"隆本村",NULL
0,869,28,897,1120,0,0,80.09,229,640,"南廍村",NULL
0,1200,62,1262,1392,0,0,90.66,66,1134,"東庄村",NULL
0,614,22,636,699,0,0,90.99,15,599,"西庄村",NULL
0,489,16,505,600,0,0,84.17,145,344,"拔林村",NULL
0,1746,76,1822,2197,0,0,82.93,496,1250,"渡頭村",NULL
0,736,32,768,923,0,0,83.21,116,620,"社子村",NULL
0,874,39,913,1123,0,0,81.3,238,636,"石湖村",NULL
0,629,26,655,791,0,0,82.81,153,476,"石林村",NULL
0,1200,49,1249,1526,0,0,81.85,363,837,"石城村",NULL
0,878,37,915,1104,0,0,82.88,314,564,"內江村",NULL
0,708,18,726,846,0,0,85.82,254,454,"大內村",NULL
0,529,42,571,702,0,0,81.34,137,392,"內郭村",NULL
0,838,34,872,1070,0,0,81.5,268,570,"頭社村",NULL
0,705,27,732,917,0,0,79.83,314,391,"環湖村",NULL
0,709,39,748,945,0,0,79.15,242,467,"二溪村",NULL
0,529,25,554,647,0,0,85.63,163,366,"曲溪村",NULL
0,1449,25,1474,1782,0,0,82.72,533,916,"東寧里",NULL
0,2208,48,2256,2781,0,0,81.12,771,1437,"忠仁里",NULL
0,3774,91,3865,4760,0,0,81.2,1262,2512,"鎮山里",NULL
0,4719,97,4816,5967,0,0,80.71,1578,3141,"建南里",NULL
0,7130,121,7251,9003,0,0,80.54,2650,4480,"安西里",NULL
0,2633,42,2675,3316,0,0,80.67,1006,1627,"六安里",NULL
0,1543,38,1581,1917,0,0,82.47,440,1103,"佳化里",NULL
0,680,29,709,849,0,0,83.51,193,487,"禮化里",NULL
0,1072,37,1109,1335,0,0,83.07,285,787,"興化里",NULL
0,558,15,573,701,0,0,81.74,203,355,"營頂里",NULL
0,290,18,308,398,0,0,77.39,100,190,"溪洲里",NULL
0,1064,28,1092,1361,0,0,80.24,300,764,"海澄里",NULL
0,564,7,571,687,0,0,83.11,169,395,"漳洲里",NULL
0,669,17,686,850,0,0,80.71,243,426,"頂廍里",NULL
0,758,32,790,973,0,0,81.19,195,563,"嘉福里",NULL
0,842,37,879,1096,0,0,80.2,214,628,"通興里",NULL
0,668,22,690,828,0,0,83.33,133,535,"蚶寮里",NULL
0,828,29,857,981,0,0,87.36,231,597,"龍安里",NULL
0,1004,48,1052,1292,0,0,81.42,233,771,"民安里",NULL
0,1214,44,1258,1538,0,0,81.79,269,945,"子龍里",NULL
0,715,15,730,879,0,0,83.05,168,547,"三協里",NULL
0,1005,23,1028,1268,0,0,81.07,301,704,"一秀里",NULL
0,1043,6,1049,1306,0,0,80.32,237,806,"西明里",NULL
0,412,4,416,513,0,0,81.09,139,273,"宜民里",NULL
0,718,14,732,927,0,0,78.96,218,500,"煥昌里",NULL
0,477,13,490,602,0,0,81.4,191,286,"慈生里",NULL
0,2877,50,2927,3594,0,0,81.44,886,1991,"仁得里",NULL
0,1156,11,1167,1482,0,0,78.74,422,734,"新生里",NULL
0,1073,35,1108,1382,0,0,80.17,336,737,"百福里",NULL
0,1178,25,1203,1497,0,0,80.36,354,824,"新榮里",NULL
0,433,16,449,560,0,0,80.18,109,324,"文化里",NULL
0,418,12,430,536,0,0,80.22,120,298,"大安里",NULL
0,683,35,718,881,0,0,81.5,166,517,"美豐里",NULL
0,284,3,287,339,0,0,84.66,54,230,"美和里",NULL
0,515,15,530,651,0,0,81.41,95,420,"達明里",NULL
0,270,6,276,333,0,0,82.88,76,194,"光明里",NULL
0,344,8,352,431,0,0,81.67,105,239,"民吉里",NULL
0,349,23,372,482,0,0,77.18,71,278,"西進里",NULL
0,264,4,268,337,0,0,79.53,76,188,"白渚里",NULL
0,704,17,721,902,0,0,79.93,145,559,"光華里",NULL
0,335,8,343,440,0,0,77.95,77,258,"頭港里",NULL
0,843,28,871,1093,0,0,79.69,174,669,"宅港里",NULL
0,377,16,393,479,0,0,82.05,53,324,"平東里",NULL
0,533,19,552,686,0,0,80.47,82,451,"平西里",NULL
0,533,10,543,675,0,0,80.44,166,367,"頂洲里",NULL
0,335,20,355,490,0,0,72.45,113,222,"紅茄里",NULL
0,354,18,372,452,0,0,82.3,80,274,"新芳里",NULL
0,2264,49,2313,2794,0,0,82.78,671,1593,"西港村",NULL
0,2895,61,2956,3635,0,0,81.32,982,1913,"慶安村",NULL
0,1596,30,1626,1952,0,0,83.3,364,1232,"南海村",NULL
0,1113,32,1145,1389,0,0,82.43,331,782,"港東村",NULL
0,1258,43,1301,1555,0,0,83.67,305,953,"檨林村",NULL
0,1076,38,1114,1354,0,0,82.27,269,807,"後營村",NULL
0,1031,39,1070,1324,0,0,80.82,296,735,"營西村",NULL
0,680,26,706,823,0,0,85.78,187,493,"金砂村",NULL
0,963,31,994,1184,0,0,83.95,242,721,"劉厝村",NULL
0,963,37,1000,1187,0,0,84.25,216,747,"竹林村",NULL
0,698,32,730,881,0,0,82.86,178,520,"永樂村",NULL
0,325,6,331,397,0,0,83.38,60,265,"新復村",NULL
0,576,20,596,751,0,0,79.36,255,321,"永樂村、南海村、新復村",NULL
0,452,5,457,559,0,0,81.75,121,331,"後港村",NULL
0,535,22,557,725,0,0,76.83,167,368,"大潭村",NULL
0,408,11,419,508,0,0,82.48,84,324,"城內村",NULL
0,670,23,693,854,0,0,81.15,168,502,"篤加村",NULL
0,759,20,779,944,0,0,82.52,198,561,"頂山村",NULL
0,475,14,489,616,0,0,79.38,182,293,"西寮村",NULL
0,347,10,357,443,0,0,80.59,136,211,"鹽埕村",NULL
0,588,25,613,789,0,0,77.69,212,376,"中寮村",NULL
0,1356,53,1409,1721,0,0,81.87,308,1048,"龍山村",NULL
0,283,3,286,348,0,0,82.18,110,173,"溪南村",NULL
0,682,22,704,883,0,0,79.73,137,545,"七股村",NULL
0,672,24,696,854,0,0,81.5,200,472,"玉成村",NULL
0,1086,32,1118,1408,0,0,79.4,339,747,"大埕村",NULL
0,748,30,778,959,0,0,81.13,190,558,"大寮村",NULL
0,494,16,510,620,0,0,82.26,101,393,"看坪村",NULL
0,830,26,856,1036,0,0,82.63,221,609,"樹林村",NULL
0,470,19,489,576,0,0,84.9,125,345,"竹港村",NULL
0,597,18,615,735,0,0,83.67,165,432,"竹橋村",NULL
0,831,37,868,1051,0,0,82.59,226,605,"義合村",NULL
0,546,15,561,682,0,0,82.26,144,402,"康榔村",NULL
0,678,41,719,923,0,0,77.9,246,432,"永吉村",NULL
0,1177,86,1263,1651,0,0,76.5,501,676,"三股村",NULL
0,1012,38,1050,1332,0,0,78.83,299,713,"十份村",NULL
0,760,31,791,962,0,0,82.22,246,514,"長榮村",NULL
0,1032,31,1063,1349,0,0,78.8,322,710,"西華村",NULL
0,806,7,813,1035,0,0,78.55,198,608,"西和村",NULL
0,1168,38,1206,1496,0,0,80.61,396,772,"忠興村",NULL
0,729,28,757,908,0,0,83.37,170,559,"嘉昌村",NULL
0,817,34,851,1043,0,0,81.59,216,601,"保源村",NULL
0,819,29,848,1074,0,0,78.96,241,578,"苓和村",NULL
0,570,23,593,764,0,0,77.62,118,452,"仁和村",NULL
0,520,22,542,631,0,0,85.9,111,409,"北埔村",NULL
0,531,19,550,713,0,0,77.14,129,402,"將富村",NULL
0,485,8,493,609,0,0,80.95,133,352,"將貴村",NULL
0,315,12,327,435,0,0,75.17,103,212,"三吉村",NULL
0,675,36,711,897,0,0,79.26,108,567,"玉山村",NULL
0,523,35,558,696,0,0,80.17,135,388,"廣山村",NULL
0,1099,21,1120,1463,0,0,76.56,268,831,"長沙村",NULL
0,943,27,970,1286,0,0,75.43,193,750,"平沙村",NULL
0,1539,53,1592,2056,0,0,77.43,404,1135,"鯤鯓村",NULL
0,762,23,785,1018,0,0,77.11,172,590,"鯤溟村",NULL
0,728,17,745,919,0,0,81.07,286,442,"北門村",NULL
0,397,13,410,528,0,0,77.65,235,162,"永隆村",NULL
0,317,8,325,395,0,0,82.28,110,207,"永華村",NULL
0,589,30,619,794,0,0,77.96,143,446,"玉港村",NULL
0,1032,29,1061,1334,0,0,79.54,395,637,"保吉村",NULL
0,583,19,602,774,0,0,77.78,213,370,"東壁村",NULL
0,588,9,597,774,0,0,77.13,162,426,"鯤江村",NULL
0,436,15,451,603,0,0,74.79,154,282,"雙春村",NULL
0,764,36,800,1069,0,0,74.84,221,543,"錦湖村",NULL
0,488,15,503,680,0,0,73.97,193,295,"慈安村",NULL
0,882,20,902,1168,0,0,77.23,245,637,"三光村",NULL
0,518,30,548,718,0,0,76.32,112,406,"中樞村",NULL
0,541,26,567,709,0,0,79.97,151,390,"仁里村",NULL
0,1305,42,1347,1645,0,0,81.88,613,692,"武安里",NULL
0,3023,45,3068,3831,0,0,80.08,1341,1682,"東榮里",NULL
0,1153,26,1179,1653,0,0,71.32,608,545,"護國里",NULL
0,3001,72,3073,3801,0,0,80.85,1169,1832,"太平里",NULL
0,352,7,359,436,0,0,82.34,155,197,"中央里",NULL
0,473,13,486,607,0,0,80.07,211,262,"觀音里",NULL
0,360,11,371,443,0,0,83.75,146,214,"竹林里",NULL
0,801,20,821,983,0,0,83.52,313,488,"清水里",NULL
0,2382,63,2445,3017,0,0,81.04,1016,1366,"協興里",NULL
0,1394,28,1422,1696,0,0,83.84,507,887,"唪口里",NULL
0,944,10,954,1175,0,0,81.19,367,577,"北勢里",NULL
0,1938,57,1995,2466,0,0,80.9,860,1078,"豐榮里",NULL
0,1658,41,1699,2040,0,0,83.28,730,928,"全興里",NULL
0,1405,61,1466,1753,0,0,83.63,471,934,"崙頂里",NULL
0,1661,69,1730,2135,0,0,81.03,692,969,"知義里",NULL
0,1052,28,1080,1325,0,0,81.51,412,640,"山腳里",NULL
0,353,29,382,481,0,0,79.42,120,233,"大坑里",NULL
0,1612,56,1668,2061,0,0,80.93,687,925,"那拔里",NULL
0,625,22,647,845,0,0,76.57,232,393,"羊林里",NULL
0,792,43,835,1041,0,0,80.21,174,618,"礁坑里",NULL
0,771,8,779,938,0,0,83.05,267,504,"東關里",NULL
0,2220,62,2282,2759,0,0,82.71,882,1338,"坐駕里",NULL
0,3357,64,3421,4201,0,0,81.43,1342,2015,"光文里",NULL
0,1683,34,1717,2155,0,0,79.68,611,1072,"文昌里",NULL
0,992,33,1025,1263,0,0,81.16,239,753,"南關里",NULL
0,528,23,551,682,0,0,80.79,204,324,"西關里",NULL
0,357,4,361,439,0,0,82.23,129,228,"北關里",NULL
0,901,34,935,1215,0,0,76.95,265,636,"文正里",NULL
0,968,46,1014,1247,0,0,81.32,154,814,"胡家里",NULL
0,1514,39,1553,1893,0,0,82.04,626,888,"胡厝里",NULL
0,720,37,757,895,0,0,84.58,196,524,"什乃里",NULL
0,1308,26,1334,1595,0,0,83.64,426,882,"溪美里",NULL
0,532,22,554,679,0,0,81.59,145,387,"六分里",NULL
0,829,16,845,1057,0,0,79.94,211,618,"六德里",NULL
0,1414,48,1462,1762,0,0,82.97,379,1035,"田寮里",NULL
0,710,25,735,866,0,0,84.87,209,501,"東隆里",NULL
0,795,32,827,984,0,0,84.04,202,593,"東昌里",NULL
0,1092,52,1144,1379,0,0,82.96,357,735,"牛庄里",NULL
0,1138,49,1187,1388,0,0,85.52,268,870,"嘉北里",NULL
0,806,23,829,1028,0,0,80.64,199,607,"嘉南里",NULL
0,2222,70,2292,2810,0,0,81.57,761,1461,"小新里",NULL
0,2012,41,2053,2490,0,0,82.45,705,1307,"新市村",NULL
0,4322,92,4414,5344,0,0,82.6,1586,2736,"新和村",NULL
0,1586,58,1644,1959,0,0,83.92,393,1193,"社內村",NULL
0,530,17,547,648,0,0,84.41,141,389,"大洲村",NULL
0,705,16,721,889,0,0,81.1,244,461,"豊華村",NULL
0,953,38,991,1162,0,0,85.28,288,665,"三舍村",NULL
0,1958,64,2022,2418,0,0,83.62,766,1192,"大營村",NULL
0,2742,72,2814,3395,0,0,82.89,734,2008,"大社村",NULL
0,1240,44,1284,1526,0,0,84.14,412,828,"潭頂村",NULL
0,2339,84,2423,2929,0,0,82.72,768,1571,"港墘村",NULL
0,1826,46,1872,2261,0,0,82.8,649,1177,"永就村",NULL
0,1616,57,1673,2062,0,0,81.13,487,1129,"蘇林村",NULL
0,1423,68,1491,1799,0,0,82.88,417,1006,"蘇厝村",NULL
0,1102,35,1137,1355,0,0,83.91,342,760,"安定村",NULL
0,919,51,970,1138,0,0,85.24,237,682,"安加村",NULL
0,636,18,654,765,0,0,85.49,250,386,"保西村",NULL
0,1180,49,1229,1486,0,0,82.71,406,774,"港尾村",NULL
0,800,42,842,1020,0,0,82.55,207,593,"中榮村",NULL
0,1760,51,1811,2208,0,0,82.02,619,1141,"港口村",NULL
0,1758,59,1817,2206,0,0,82.37,599,1159,"港南村",NULL
0,511,15,526,634,0,0,82.97,202,309,"大同村",NULL
0,1147,41,1188,1388,0,0,85.59,311,836,"六嘉村",NULL
0,577,23,600,695,0,0,86.33,198,379,"中沙村",NULL
0,1453,58,1511,1848,0,0,81.76,416,1037,"新吉村",NULL
0,1758,76,1834,2229,0,0,82.28,653,1105,"海寮村",NULL
0,764,21,785,915,0,0,85.79,183,581,"管寮村",NULL
0,430,19,449,506,0,0,88.74,147,283,"南安村",NULL
0,1427,44,1471,1773,0,0,82.97,470,957,"明和村",NULL
0,1273,59,1332,1551,0,0,85.88,432,841,"南洲村",NULL
0,644,28,672,866,0,0,77.6,219,425,"山上村",NULL
0,580,23,603,757,0,0,79.66,173,407,"新莊村",NULL
0,427,28,455,572,0,0,79.55,154,273,"玉峰村",NULL
0,277,13,290,359,0,0,80.78,129,148,"平陽村",NULL
0,304,8,312,379,0,0,82.32,95,209,"豐德村",NULL
0,718,20,738,912,0,0,80.92,415,303,"玉井村",NULL
0,3177,115,3292,4103,0,0,80.23,1569,1608,"玉田村",NULL
0,989,41,1030,1275,0,0,80.78,412,577,"中正村",NULL
0,1051,42,1093,1405,0,0,77.79,471,580,"竹圍村",NULL
0,385,26,411,505,0,0,81.39,196,189,"沙田村",NULL
0,367,12,379,511,0,0,74.17,164,203,"三埔村",NULL
0,611,30,641,771,0,0,83.14,276,335,"三和村",NULL
0,1221,44,1265,1574,0,0,80.37,531,690,"望明村",NULL
0,559,17,576,694,0,0,83,277,282,"層林村",NULL
0,776,38,814,1002,0,0,81.24,353,423,"豐里村",NULL
0,1420,55,1475,1903,0,0,77.51,801,619,"楠西村",NULL
0,936,50,986,1272,0,0,77.52,489,447,"灣丘村",NULL
0,621,20,641,837,0,0,76.58,361,260,"密枝村",NULL
0,766,46,812,1058,0,0,76.75,406,360,"照興村",NULL
0,785,24,809,1008,0,0,80.26,422,363,"鹿田村",NULL
0,569,18,587,719,0,0,81.64,276,293,"龜丹村",NULL
0,1739,48,1787,2255,0,0,79.25,968,771,"東勢村",NULL
0,1092,30,1122,1376,0,0,81.54,488,604,"南化村",NULL
0,616,17,633,795,0,0,79.62,305,311,"小崙村",NULL
0,488,21,509,656,0,0,77.59,241,247,"東和村",NULL
0,398,15,413,502,0,0,82.27,182,216,"中坑村",NULL
0,485,14,499,595,0,0,83.87,193,292,"北平村",NULL
0,610,18,628,796,0,0,78.89,278,332,"西埔村",NULL
0,915,36,951,1199,0,0,79.32,515,400,"北寮村",NULL
0,667,31,698,893,0,0,78.16,305,362,"玉山村",NULL
0,378,3,381,549,0,0,69.4,177,201,"關山村",NULL
0,323,10,333,422,0,0,78.91,137,186,"光和村",NULL
0,536,23,559,693,0,0,80.66,168,368,"榮和村",NULL
0,418,13,431,523,0,0,82.41,152,266,"左鎮村",NULL
0,664,19,683,864,0,0,79.05,292,372,"中正村",NULL
0,304,5,309,379,0,0,81.53,115,189,"睦光村",NULL
0,347,32,379,469,0,0,80.81,158,189,"內庄村",NULL
0,318,22,340,443,0,0,76.75,99,219,"岡林村",NULL
0,242,6,248,320,0,0,77.5,94,148,"草山村",NULL
0,188,9,197,234,0,0,84.19,69,119,"二寮村",NULL
0,416,17,433,554,0,0,78.16,109,307,"澄山村",NULL
0,3373,83,3456,4102,0,0,84.25,956,2417,"太子村",NULL
0,1902,35,1937,2255,0,0,85.9,449,1453,"土庫村",NULL
0,1554,40,1594,1929,0,0,82.63,472,1082,"一甲村",NULL
0,3590,69,3659,4547,0,0,80.47,1387,2203,"仁德村",NULL
0,5619,129,5748,6930,0,0,82.94,2115,3504,"仁義村",NULL
0,2149,46,2195,2645,0,0,82.99,824,1325,"新田村",NULL
0,5268,133,5401,6564,0,0,82.28,1892,3376,"後壁村",NULL
0,3274,124,3398,4113,0,0,82.62,1061,2213,"上崙村",NULL
0,1111,13,1124,1320,0,0,85.15,421,690,"田厝村",NULL
0,579,15,594,706,0,0,84.14,189,390,"三甲村",NULL
0,1784,57,1841,2228,0,0,82.63,606,1178,"保安村",NULL
0,2965,83,3048,3694,0,0,82.51,1596,1369,"成功村",NULL
0,889,40,929,1134,0,0,81.92,836,53,"仁和村",NULL
0,1655,50,1705,2066,0,0,82.53,1277,378,"仁愛村",NULL
0,1625,35,1660,2047,0,0,81.09,645,980,"二行村",NULL
0,1558,60,1618,1981,0,0,81.68,538,1020,"大甲村",NULL
0,1044,46,1090,1260,0,0,86.51,291,753,"中洲村",NULL
0,1114,41,1155,1403,0,0,82.32,403,711,"中生村",NULL
0,3917,90,4007,4810,0,0,83.31,1420,2497,"南保村",NULL
0,2322,51,2373,2880,0,0,82.4,834,1488,"南興村",NULL
0,2408,88,2496,3110,0,0,80.26,763,1645,"六甲村",NULL
0,1678,21,1699,2069,0,0,82.12,650,1028,"歸南村",NULL
0,2412,56,2468,3004,0,0,82.16,907,1505,"後市村",NULL
0,1931,27,1958,2378,0,0,82.34,738,1193,"文化村",NULL
0,2183,51,2234,2750,0,0,81.24,798,1385,"辜厝村",NULL
0,1723,42,1765,2112,0,0,83.57,542,1181,"新厝村",NULL
0,2255,41,2296,2789,0,0,82.32,733,1522,"許厝村",NULL
0,1145,29,1174,1388,0,0,84.58,322,823,"看西村",NULL
0,1048,41,1089,1324,0,0,82.25,364,684,"看東村",NULL
0,1639,44,1683,1991,0,0,84.53,525,1114,"崙頂村",NULL
0,485,10,495,608,0,0,81.41,150,335,"沙崙村",NULL
0,1391,50,1441,1694,0,0,85.06,366,1025,"大潭村",NULL
0,895,34,929,1200,0,0,77.42,314,581,"武東村",NULL
0,1605,32,1637,1984,0,0,82.51,650,955,"歸仁村",NULL
0,1702,48,1750,2098,0,0,83.41,567,1135,"八甲村",NULL
0,1828,42,1870,2193,0,0,85.27,591,1237,"七甲村",NULL
0,1535,42,1577,1877,0,0,84.02,477,1058,"媽廟村",NULL
0,1100,25,1125,1341,0,0,83.89,300,800,"西埔村",NULL
0,1766,56,1822,2236,0,0,81.48,492,1274,"大廟村",NULL
0,1586,34,1620,1955,0,0,82.86,594,992,"關廟村",NULL
0,1527,37,1564,1877,0,0,83.32,516,1011,"山西村",NULL
0,2724,105,2829,3398,0,0,83.25,1012,1712,"香洋村",NULL
0,1984,65,2049,2477,0,0,82.72,638,1346,"北勢村",NULL
0,701,26,727,877,0,0,82.9,240,461,"新埔村",NULL
0,591,26,617,752,0,0,82.05,159,432,"新光村",NULL
0,2208,42,2250,2734,0,0,82.3,825,1383,"五甲村",NULL
0,2377,70,2447,2995,0,0,81.7,812,1565,"東勢村",NULL
0,1576,43,1619,1915,0,0,84.54,523,1053,"松腳村",NULL
0,1173,39,1212,1472,0,0,82.34,387,786,"南花村",NULL
0,1697,68,1765,2127,0,0,82.98,543,1154,"北花村",NULL
0,1237,40,1277,1545,0,0,82.65,395,842,"深坑村",NULL
0,987,43,1030,1217,0,0,84.63,278,709,"布袋村",NULL
0,630,25,655,753,0,0,86.99,180,450,"田中村",NULL
0,628,25,653,775,0,0,84.26,199,429,"龜洞村",NULL
0,1212,47,1259,1536,0,0,81.97,368,844,"埤頭村",NULL
0,317,17,334,397,0,0,84.13,106,211,"下湖村",NULL
0,924,51,975,1153,0,0,84.56,328,596,"崎頂村",NULL
0,538,28,566,702,0,0,80.63,191,347,"土崎村",NULL
0,132,9,141,199,0,0,70.85,44,88,"中坑村",NULL
0,245,14,259,308,0,0,84.09,104,141,"楠坑村",NULL
0,222,14,236,270,0,0,87.41,88,134,"牛埔村",NULL
0,231,18,249,305,0,0,81.64,91,140,"大坪村",NULL
0,348,16,364,429,0,0,84.85,176,172,"龍船村",NULL
0,296,23,319,381,0,0,83.73,130,166,"石曹村",NULL
0,3334,65,3399,4245,0,0,80.07,1515,1819,"五王里",NULL
0,2336,49,2385,2980,0,0,80.03,1039,1297,"三合里",NULL
0,2884,46,2930,3663,0,0,79.99,1431,1453,"六合里",NULL
0,3475,63,3538,4341,0,0,81.5,1428,2047,"網寮里",NULL
0,4732,69,4801,5995,0,0,80.08,2204,2528,"二王里",NULL
0,4731,107,4838,6136,0,0,78.85,1834,2897,"永康里",NULL
0,4615,103,4718,5788,0,0,81.51,1634,2981,"埔園里",NULL
0,4640,95,4735,5809,0,0,81.51,1798,2842,"正強里",NULL
0,3481,63,3544,4372,0,0,81.06,1510,1971,"大橋里",NULL
0,1754,30,1784,2178,0,0,81.91,750,1004,"東橋里",NULL
0,1995,52,2047,2568,0,0,79.71,924,1071,"西橋里",NULL
0,3018,54,3072,3868,0,0,79.42,1376,1642,"安康里",NULL
0,1246,35,1281,1550,0,0,82.65,444,802,"蔦松里",NULL
0,867,25,892,1063,0,0,83.91,299,568,"三民里",NULL
0,5052,82,5134,6430,0,0,79.84,1861,3191,"鹽行里",NULL
0,3642,73,3715,4439,0,0,83.69,1311,2331,"鹽洲里",NULL
0,1849,33,1882,2258,0,0,83.35,753,1096,"甲頂里",NULL
0,2822,59,2881,3466,0,0,83.12,1036,1786,"尚頂里",NULL
0,5190,110,5300,6532,0,0,81.14,1792,3398,"龍潭里",NULL
0,1534,30,1564,1879,0,0,83.24,418,1116,"王行里",NULL
0,1374,32,1406,1712,0,0,82.13,470,904,"烏竹里",NULL
0,3419,77,3496,4226,0,0,82.73,1221,2198,"西勢里",NULL
0,1004,29,1033,1290,0,0,80.08,255,749,"新樹里",NULL
0,2472,68,2540,3025,0,0,83.97,756,1716,"大灣里",NULL
0,2672,56,2728,3224,0,0,84.62,854,1818,"東灣里",NULL
0,4440,81,4521,5404,0,0,83.66,1572,2868,"西灣里",NULL
0,2878,80,2958,3541,0,0,83.54,793,2085,"南灣里",NULL
0,4400,50,4450,5381,0,0,82.7,1625,2775,"崑山里",NULL
0,4665,103,4768,5808,0,0,82.09,1641,3024,"北灣里",NULL
0,1344,48,1392,1754,0,0,79.36,1008,336,"復興里",NULL
0,876,31,907,1128,0,0,80.41,767,109,"光復里",NULL
0,1462,31,1493,1906,0,0,78.33,1224,238,"建國里",NULL
0,1748,31,1779,2148,0,0,82.82,999,749,"復國里",NULL
0,8089,139,8228,10334,0,0,79.62,4429,3660,"復華里",NULL
0,1362,25,1387,1693,0,0,81.93,1024,338,"神洲里",NULL
0,1660,20,1680,2087,0,0,80.5,1269,391,"成功里",NULL
0,1690,24,1714,2098,0,0,81.7,883,807,"中華里",NULL
0,2278,48,2326,2780,0,0,83.67,1223,1055,"中興里",NULL
0,4209,77,4286,5382,0,0,79.64,2169,2040,"勝利里",NULL
0,1034,26,1060,1278,0,0,82.94,545,489,"鳳崗里",NULL
0,659,10,669,855,0,0,78.25,346,313,"縣衙里",NULL
0,1820,41,1861,2319,0,0,80.25,850,970,"曹公里",NULL
0,4000,66,4066,5045,0,0,80.59,1782,2218,"鎮西里",NULL
0,3149,84,3233,3957,0,0,81.7,1339,1810,"北門里",NULL
0,3507,56,3563,4389,0,0,81.18,1416,2091,"鎮北里",NULL
0,1971,34,2005,2429,0,0,82.54,792,1179,"武松里",NULL
0,2397,63,2460,3045,0,0,80.79,1074,1323,"忠誠里",NULL
0,2467,48,2515,3013,0,0,83.47,1132,1335,"文英里",NULL
0,4125,84,4209,5062,0,0,83.15,2224,1901,"文華里",NULL
0,4312,77,4389,5321,0,0,82.48,1688,2624,"文山里",NULL
0,4455,61,4516,5535,0,0,81.59,2297,2158,"文德里",NULL
0,1914,17,1931,2325,0,0,83.05,861,1053,"文衡里",NULL
0,4684,81,4765,5865,0,0,81.24,2396,2288,"文福里",NULL
0,634,14,648,791,0,0,81.92,247,387,"成功里",NULL
0,394,5,399,483,0,0,82.61,199,195,"縣口里",NULL
0,1051,19,1070,1309,0,0,81.74,435,616,"光明里",NULL
0,1382,26,1408,1681,0,0,83.76,651,731,"和德里",NULL
0,4047,73,4120,4883,0,0,84.37,1893,2154,"和興里",NULL
0,852,24,876,1068,0,0,82.02,362,490,"南興里",NULL
0,915,7,922,1097,0,0,84.05,416,499,"三民里",NULL
0,988,25,1013,1407,0,0,72,413,575,"新興里",NULL
0,3078,51,3129,3759,0,0,83.24,1518,1560,"興仁里",NULL
0,668,13,681,802,0,0,84.91,294,374,"興中里",NULL
0,3061,54,3115,3731,0,0,83.49,1581,1480,"協和里",NULL
0,3348,59,3407,4170,0,0,81.7,1709,1639,"忠義里",NULL
0,4364,84,4448,5428,0,0,81.95,2210,2154,"忠孝里",NULL
0,2637,61,2698,3274,0,0,82.41,1474,1163,"中和里",NULL
0,739,19,758,947,0,0,80.04,705,34,"誠正里",NULL
0,937,14,951,1141,0,0,83.35,698,239,"誠義里",NULL
0,1170,20,1190,1446,0,0,82.3,727,443,"生明里",NULL
0,1623,44,1667,2094,0,0,79.61,740,883,"鎮東里",NULL
0,4017,97,4114,4885,0,0,84.22,2117,1900,"瑞竹里",NULL
0,3210,55,3265,3886,0,0,84.02,1804,1406,"瑞興里",NULL
0,3881,75,3956,4787,0,0,82.64,2328,1553,"東門里",NULL
0,1670,37,1707,2051,0,0,83.23,1053,617,"誠德里",NULL
0,1349,17,1366,1667,0,0,81.94,946,403,"誠信里",NULL
0,1771,43,1814,2232,0,0,81.27,1026,745,"誠智里",NULL
0,3295,64,3359,4034,0,0,83.27,1489,1806,"鳳東里",NULL
0,3737,63,3800,4610,0,0,82.43,1994,1743,"埤頂里",NULL
0,550,14,564,692,0,0,81.5,508,42,"美齡里",NULL
0,904,19,923,1169,0,0,78.96,624,280,"中正里",NULL
0,3069,37,3106,3769,0,0,82.41,2323,746,"海光里",NULL
0,1886,40,1926,2323,0,0,82.91,1794,92,"海風里",NULL
0,3243,56,3299,3984,0,0,82.81,1471,1772,"國泰里",NULL
0,2944,36,2980,3666,0,0,81.29,1297,1647,"國光里",NULL
0,2179,40,2219,2705,0,0,82.03,754,1425,"國隆里",NULL
0,1791,22,1813,2210,0,0,82.04,866,925,"國富里",NULL
0,1719,30,1749,2143,0,0,81.61,687,1032,"武慶里",NULL
0,3130,61,3191,3905,0,0,81.72,1306,1824,"武漢里",NULL
0,1942,21,1963,2388,0,0,82.2,726,1216,"新甲里",NULL
0,1555,34,1589,1952,0,0,81.4,577,978,"新武里",NULL
0,2203,37,2240,2728,0,0,82.11,1014,1189,"新泰里",NULL
0,2753,52,2805,3358,0,0,83.53,1190,1563,"新樂里",NULL
0,3200,37,3237,3866,0,0,83.73,1297,1903,"新強里",NULL
0,2556,26,2582,3099,0,0,83.32,1091,1465,"海洋里",NULL
0,2920,44,2964,3656,0,0,81.07,1128,1792,"新富里",NULL
0,4940,118,5058,6166,0,0,82.03,1672,3268,"老爺里",NULL
0,2663,50,2713,3434,0,0,79,986,1677,"中民里",NULL
0,1598,33,1631,2002,0,0,81.47,747,851,"中崙里",NULL
0,3173,55,3228,3988,0,0,80.94,1366,1807,"中榮里",NULL
0,2654,69,2723,3332,0,0,81.72,1137,1517,"過埤里",NULL
0,6646,132,6778,8339,0,0,81.28,2395,4251,"正義里",NULL
0,2547,73,2620,3218,0,0,81.42,851,1696,"一甲里",NULL
0,2965,46,3011,3651,0,0,82.47,1104,1861,"二甲里",NULL
0,2155,50,2205,2719,0,0,81.1,781,1374,"龍成里",NULL
0,3131,83,3214,3957,0,0,81.22,1163,1968,"鎮南里",NULL
0,1505,45,1550,2073,0,0,74.77,571,934,"富甲里",NULL
0,3672,74,3746,4575,0,0,81.88,1529,2143,"善美里",NULL
0,1555,35,1590,1974,0,0,80.55,652,903,"富榮里",NULL
0,600,11,611,753,0,0,81.14,218,382,"南和里",NULL
0,4535,85,4620,5620,0,0,82.21,1592,2943,"南成里",NULL
0,2745,64,2809,3460,0,0,81.18,1036,1709,"天興里",NULL
0,2912,61,2973,3653,0,0,81.39,1011,1901,"大德里",NULL
0,2467,56,2523,3051,0,0,82.69,972,1495,"五福里",NULL
0,4290,89,4379,5315,0,0,82.39,1581,2709,"福興里",NULL
0,2063,33,2096,2569,0,0,81.59,699,1364,"福祥里",NULL
0,2286,40,2326,2848,0,0,81.67,835,1451,"福誠里",NULL
0,2124,66,2190,2619,0,0,83.62,772,1352,"仁愛村",NULL
0,2404,47,2451,2995,0,0,81.84,987,1417,"林園村",NULL
0,1638,49,1687,2056,0,0,82.05,653,985,"文賢村",NULL
0,1942,67,2009,2511,0,0,80.01,835,1107,"東林村",NULL
0,2633,100,2733,3369,0,0,81.12,883,1750,"溪州村",NULL
0,1402,29,1431,1851,0,0,77.31,432,970,"五福村",NULL
0,1893,75,1968,2426,0,0,81.12,766,1127,"潭頭村",NULL
0,2030,95,2125,2599,0,0,81.76,824,1206,"中厝村",NULL
0,1363,59,1422,1755,0,0,81.03,729,634,"林內村",NULL
0,2476,62,2538,3068,0,0,82.72,964,1512,"王公村",NULL
0,2272,72,2344,2881,0,0,81.36,836,1436,"廣應村",NULL
0,916,42,958,1202,0,0,79.7,308,608,"林家村",NULL
0,1309,59,1368,1662,0,0,82.31,483,826,"龔厝村",NULL
0,1536,39,1575,1963,0,0,80.23,538,998,"中門村",NULL
0,2811,55,2866,3572,0,0,80.24,956,1855,"頂厝村",NULL
0,1302,40,1342,1653,0,0,81.19,407,895,"港埔村",NULL
0,1105,25,1130,1362,0,0,82.97,333,772,"港嘴村",NULL
0,2227,69,2296,2817,0,0,81.51,693,1534,"西溪村",NULL
0,1317,48,1365,1700,0,0,80.29,328,989,"中芸村",NULL
0,1325,37,1362,1675,0,0,81.31,381,944,"鳳芸村",NULL
0,699,27,726,908,0,0,79.96,215,484,"東汕村",NULL
0,568,20,588,757,0,0,77.68,138,430,"西汕村",NULL
0,1605,72,1677,2148,0,0,78.07,381,1224,"中汕村",NULL
0,1044,42,1086,1470,0,0,73.88,491,553,"北汕村",NULL
0,1610,47,1657,2023,0,0,81.91,488,1122,"義和村",NULL
0,1153,43,1196,1418,0,0,84.34,356,797,"溪寮村",NULL
0,1302,16,1318,1527,0,0,86.31,438,864,"江山村",NULL
0,6694,129,6823,8390,0,0,81.32,2499,4195,"中庄村",NULL
0,4022,95,4117,5172,0,0,79.6,1578,2444,"後庄村",NULL
0,1614,36,1650,1990,0,0,82.91,629,985,"前庄村",NULL
0,4566,113,4679,5589,0,0,83.72,2871,1695,"中興村",NULL
0,1563,39,1602,1929,0,0,83.05,1328,235,"忠義村",NULL
0,1576,54,1630,1995,0,0,81.7,1469,107,"光武村",NULL
0,2849,88,2937,3519,0,0,83.46,2698,151,"復興村",NULL
0,2359,61,2420,2849,0,0,84.94,554,1805,"翁園村",NULL
0,2496,90,2586,3067,0,0,84.32,711,1785,"琉球村",NULL
0,4813,130,4943,5994,0,0,82.47,1816,2997,"永芳村",NULL
0,4579,110,4689,5738,0,0,81.72,2226,2353,"山頂村",NULL
0,3632,87,3719,4678,0,0,79.5,1624,2008,"會社村",NULL
0,3172,62,3234,3954,0,0,81.79,1021,2151,"三隆村",NULL
0,1700,51,1751,2098,0,0,83.46,442,1258,"上寮村",NULL
0,4342,100,4442,5553,0,0,79.99,1492,2850,"大寮村",NULL
0,1044,50,1094,1355,0,0,80.74,285,759,"拷潭村",NULL
0,2946,73,3019,3862,0,0,78.17,1098,1848,"內坑村",NULL
0,1088,51,1139,1429,0,0,79.71,307,781,"新厝村",NULL
0,1409,52,1461,1799,0,0,81.21,478,931,"過溪村",NULL
0,2037,79,2116,2573,0,0,82.24,567,1470,"潮寮村",NULL
0,980,37,1017,1246,0,0,81.62,364,616,"會結村",NULL
0,2361,82,2443,3027,0,0,80.71,673,1688,"昭明村",NULL
0,1411,48,1459,1803,0,0,80.92,454,957,"義仁村",NULL
0,1720,41,1761,2129,0,0,82.71,730,990,"竹寮村",NULL
0,3293,73,3366,4182,0,0,80.49,1488,1805,"九曲村",NULL
0,3170,108,3278,3932,0,0,83.37,1451,1719,"久堂村",NULL
0,1743,65,1808,2166,0,0,83.47,547,1196,"水安村",NULL
0,1843,64,1907,2279,0,0,83.68,528,1315,"水寮村",NULL
0,1281,24,1305,1526,0,0,85.52,290,991,"井腳村",NULL
0,963,36,999,1222,0,0,81.75,334,629,"小坪村",NULL
0,1321,49,1370,1582,0,0,86.6,270,1051,"龍目村",NULL
0,1843,41,1884,2258,0,0,83.44,587,1256,"大樹村",NULL
0,2548,84,2632,3217,0,0,81.82,827,1721,"檨腳村",NULL
0,879,38,917,1087,0,0,84.36,197,682,"興山村",NULL
0,790,24,814,955,0,0,85.24,217,573,"和山村",NULL
0,767,37,804,976,0,0,82.38,203,564,"姑山村",NULL
0,630,32,662,822,0,0,80.54,194,436,"三和村",NULL
0,1098,30,1128,1338,0,0,84.3,288,810,"大坑村",NULL
0,1346,47,1393,1675,0,0,83.16,463,883,"溪埔村",NULL
0,1567,49,1616,1920,0,0,84.17,752,815,"興田村",NULL
0,488,21,509,614,0,0,82.9,113,375,"統嶺村",NULL
0,725,46,771,944,0,0,81.67,266,459,"嘉誠村",NULL
0,1609,66,1675,1982,0,0,84.51,615,994,"保社村",NULL
0,3354,64,3418,4089,0,0,83.59,1155,2199,"大社村",NULL
0,2065,71,2136,2530,0,0,84.43,716,1349,"保安村",NULL
0,2011,73,2084,2506,0,0,83.16,728,1283,"三奶村",NULL
0,3708,119,3827,4584,0,0,83.49,1329,2379,"觀音村",NULL
0,2808,89,2897,3571,0,0,81.13,1049,1759,"神農村",NULL
0,2175,73,2248,2680,0,0,83.88,794,1381,"中里村",NULL
0,1185,42,1227,1471,0,0,83.41,339,846,"翠屏村",NULL
0,3438,94,3532,4244,0,0,83.22,1158,2280,"仁武村",NULL
0,4231,128,4359,5244,0,0,83.12,1486,2745,"文武村",NULL
0,1748,45,1793,2167,0,0,82.74,498,1250,"後安村",NULL
0,1815,42,1857,2190,0,0,84.79,439,1376,"竹後村",NULL
0,1039,35,1074,1362,0,0,78.85,384,655,"中華村",NULL
0,5416,99,5515,6699,0,0,82.33,2112,3304,"八卦村",NULL
0,1828,50,1878,2305,0,0,81.48,625,1203,"五和村",NULL
0,1421,51,1472,1727,0,0,85.23,455,966,"高楠村",NULL
0,1557,40,1597,1915,0,0,83.39,534,1023,"大灣村",NULL
0,2037,42,2079,2457,0,0,84.62,737,1300,"赤山村",NULL
0,1645,27,1672,2004,0,0,83.43,605,1040,"仁和村",NULL
0,2469,65,2534,3155,0,0,80.32,801,1668,"灣內村",NULL
0,1089,17,1106,1307,0,0,84.62,446,643,"仁慈村",NULL
0,1873,60,1933,2397,0,0,80.64,822,1051,"考潭村",NULL
0,2313,75,2388,2912,0,0,82.01,947,1366,"烏林村",NULL
0,475,20,495,600,0,0,82.5,148,327,"仁福村",NULL
0,6156,113,6269,7724,0,0,81.16,2639,3517,"鳥松村",NULL
0,2299,61,2360,2832,0,0,83.33,940,1359,"夢裡村",NULL
0,6243,84,6327,7637,0,0,82.85,2773,3470,"大華村",NULL
0,2413,56,2469,2944,0,0,83.87,781,1632,"濫埔村",NULL
0,4598,120,4718,5702,0,0,82.74,1630,2968,"仁美村",NULL
0,2589,64,2653,3235,0,0,82.01,1070,1519,"華美村",NULL
0,562,21,583,697,0,0,83.64,198,364,"大竹村",NULL
0,3005,69,3074,3784,0,0,81.24,1309,1696,"岡山里",NULL
0,973,25,998,1235,0,0,80.81,389,584,"平安里",NULL
0,2521,49,2570,3124,0,0,82.27,1227,1294,"壽天里",NULL
0,939,36,975,1198,0,0,81.39,360,579,"維仁里",NULL
0,1099,43,1142,1339,0,0,85.29,450,649,"灣裡里",NULL
0,1028,40,1068,1250,0,0,85.44,238,790,"大遼里",NULL
0,2438,45,2483,3047,0,0,81.49,1177,1261,"後紅里",NULL
0,2440,44,2484,2980,0,0,83.36,1078,1362,"碧紅里",NULL
0,2487,61,2548,3045,0,0,83.68,1236,1251,"程香里",NULL
0,3597,63,3660,4432,0,0,82.58,1587,2010,"竹圍里",NULL
0,3003,87,3090,3728,0,0,82.89,1203,1800,"臺上里",NULL
0,482,37,519,596,0,0,87.08,128,354,"為隨里",NULL
0,1967,74,2041,2443,0,0,83.54,877,1090,"前峰里",NULL
0,1585,30,1615,1934,0,0,83.51,769,816,"壽峰里",NULL
0,2678,62,2740,3273,0,0,83.72,1267,1411,"仁壽里",NULL
0,2600,56,2656,3216,0,0,82.59,1395,1205,"協和里",NULL
0,1166,47,1213,1449,0,0,83.71,398,768,"本洲里",NULL
0,3777,87,3864,4735,0,0,81.61,2029,1748,"後協里",NULL
0,1580,48,1628,1959,0,0,83.1,949,631,"協榮里",NULL
0,1082,43,1125,1326,0,0,84.84,298,784,"劉厝里",NULL
0,1035,27,1062,1229,0,0,86.41,465,570,"白米里",NULL
0,1013,39,1052,1246,0,0,84.43,259,754,"石潭里",NULL
0,826,33,859,1003,0,0,85.64,348,478,"福興里",NULL
0,2541,110,2651,3191,0,0,83.08,737,1804,"嘉興里",NULL
0,1331,52,1383,1633,0,0,84.69,465,866,"嘉峰里",NULL
0,622,31,653,747,0,0,87.42,183,439,"潭底里",NULL
0,1105,63,1168,1352,0,0,86.39,199,906,"華崗里",NULL
0,632,4,636,772,0,0,82.38,136,496,"三和里",NULL
0,714,35,749,892,0,0,83.97,331,383,"大莊里",NULL
0,331,5,336,427,0,0,78.69,202,129,"忠孝里",NULL
0,743,16,759,924,0,0,82.14,626,117,"和平里",NULL
0,1748,26,1774,2129,0,0,83.33,1261,487,"信義里",NULL
0,1095,32,1127,1346,0,0,83.73,1060,35,"仁愛里",NULL
0,981,21,1002,1172,0,0,85.49,939,42,"四維里",NULL
0,357,8,365,445,0,0,82.02,348,9,"復興里",NULL
0,1448,41,1489,1757,0,0,84.75,529,919,"橋頭村",NULL
0,923,21,944,1121,0,0,84.21,327,596,"橋南村",NULL
0,1709,66,1775,2132,0,0,83.26,544,1165,"仕隆村",NULL
0,1756,51,1807,2194,0,0,82.36,644,1112,"仕豐村",NULL
0,2729,76,2805,3277,0,0,85.6,906,1823,"仕和村",NULL
0,1073,52,1125,1290,0,0,87.21,380,693,"新莊村",NULL
0,1599,67,1666,1962,0,0,84.91,536,1063,"甲北村",NULL
0,1734,71,1805,2138,0,0,84.42,632,1102,"甲南村",NULL
0,875,31,906,1053,0,0,86.04,288,587,"頂鹽村",NULL
0,2218,60,2278,2750,0,0,82.84,908,1310,"白樹村",NULL
0,915,44,959,1118,0,0,85.78,223,692,"芋寮村",NULL
0,619,20,639,740,0,0,86.35,141,478,"三德村",NULL
0,1224,33,1257,1489,0,0,84.42,329,895,"西林村",NULL
0,1755,71,1826,2163,0,0,84.42,474,1281,"東林村",NULL
0,916,15,931,1096,0,0,84.95,280,636,"德松村",NULL
0,1218,48,1266,1488,0,0,85.08,353,865,"筆秀村",NULL
0,511,32,543,655,0,0,82.9,126,385,"中崎村",NULL
0,356,9,365,440,0,0,82.95,132,224,"金山村",NULL
0,860,47,907,1119,0,0,81.05,239,621,"尖山村",NULL
0,1799,93,1892,2236,0,0,84.62,631,1168,"東燕村",NULL
0,2413,106,2519,3053,0,0,82.51,969,1444,"西燕村",NULL
0,2150,89,2239,2713,0,0,82.53,992,1158,"南燕村",NULL
0,1428,67,1495,1793,0,0,83.38,480,948,"瓊林村",NULL
0,2796,212,3008,3938,0,0,76.38,1332,1464,"安招村",NULL
0,1786,69,1855,2236,0,0,82.96,643,1143,"角宿村",NULL
0,1897,62,1959,2296,0,0,85.32,834,1063,"鳳雄村",NULL
0,1404,57,1461,1796,0,0,81.35,522,882,"橫山村",NULL
0,1841,93,1934,2412,0,0,80.18,740,1101,"深水村",NULL
0,286,16,302,368,0,0,82.07,121,165,"鹿埔村",NULL
0,475,44,519,672,0,0,77.23,162,313,"古亭村",NULL
0,755,32,787,965,0,0,81.55,308,447,"崇德村",NULL
0,292,28,320,416,0,0,76.92,128,164,"三和村",NULL
0,720,7,727,888,0,0,81.87,227,493,"西德村",NULL
0,1026,59,1085,1335,0,0,81.27,307,719,"南安村",NULL
0,336,2,338,421,0,0,80.29,67,269,"大同村",NULL
0,303,23,326,430,0,0,75.81,101,202,"田寮村",NULL
0,683,49,732,886,0,0,82.62,176,507,"七星村",NULL
0,1027,73,1100,1315,0,0,83.65,302,725,"新興村",NULL
0,3338,89,3427,4197,0,0,81.65,1234,2104,"阿蓮村",NULL
0,2175,71,2246,2706,0,0,83,937,1238,"南蓮村",NULL
0,2058,87,2145,2569,0,0,83.5,741,1317,"清蓮村",NULL
0,1627,89,1716,2057,0,0,83.42,477,1150,"和蓮村",NULL
0,1042,51,1093,1346,0,0,81.2,415,627,"青旗村",NULL
0,1024,60,1084,1295,0,0,83.71,250,774,"石安村",NULL
0,1531,74,1605,1941,0,0,82.69,371,1160,"中路村",NULL
0,886,46,932,1119,0,0,83.29,308,578,"峰山村",NULL
0,1456,74,1530,1849,0,0,82.75,609,847,"港後村",NULL
0,565,37,602,733,0,0,82.13,206,359,"崗山村",NULL
0,1258,61,1319,1588,0,0,83.06,505,753,"復安村",NULL
0,784,42,826,987,0,0,83.69,212,572,"玉庫村",NULL
0,1371,62,1433,1710,0,0,83.8,530,841,"竹園村",NULL
0,2000,97,2097,2515,0,0,83.38,837,1163,"下坑村",NULL
0,2374,114,2488,2943,0,0,84.54,1190,1184,"甲南村",NULL
0,1572,63,1635,1964,0,0,83.25,604,968,"甲北村",NULL
0,1240,64,1304,1580,0,0,82.53,453,787,"社東村",NULL
0,693,41,734,890,0,0,82.47,289,404,"社中村",NULL
0,1771,89,1860,2217,0,0,83.9,742,1029,"社西村",NULL
0,2799,101,2900,3537,0,0,81.99,1171,1628,"社南村",NULL
0,2327,55,2382,2859,0,0,83.32,1029,1298,"竹東村",NULL
0,2146,54,2200,2677,0,0,82.18,954,1192,"竹南村",NULL
0,1755,65,1820,2144,0,0,84.89,793,962,"竹西村",NULL
0,1785,65,1850,2176,0,0,85.02,793,992,"文南村",NULL
0,2122,99,2221,2727,0,0,81.44,863,1259,"文北村",NULL
0,1975,86,2061,2603,0,0,79.18,743,1232,"竹滬村",NULL
0,908,48,956,1171,0,0,81.64,315,593,"頂寮村",NULL
0,936,58,994,1196,0,0,83.11,409,527,"新達村",NULL
0,759,31,790,933,0,0,84.67,285,474,"後鄉村",NULL
0,912,35,947,1118,0,0,84.7,360,552,"北嶺村",NULL
0,699,50,749,882,0,0,84.92,239,460,"三爺村",NULL
0,1249,44,1293,1550,0,0,83.42,518,731,"鴨寮村",NULL
0,2110,74,2184,2564,0,0,85.18,917,1193,"大湖村",NULL
0,834,34,868,1063,0,0,81.66,336,498,"田尾村",NULL
0,2214,50,2264,2760,0,0,82.03,904,1310,"湖內村",NULL
0,1535,46,1581,1968,0,0,80.34,796,739,"湖東村",NULL
0,1397,54,1451,1754,0,0,82.73,411,986,"海埔村",NULL
0,950,50,1000,1171,0,0,85.4,326,624,"海山村",NULL
0,862,39,901,1080,0,0,83.43,229,633,"劉家村",NULL
0,655,26,681,835,0,0,81.56,220,435,"太爺村",NULL
0,1363,32,1395,1679,0,0,83.09,511,852,"公館村",NULL
0,1502,53,1555,1879,0,0,82.76,478,1024,"葉厝村",NULL
0,968,39,1007,1196,0,0,84.2,266,702,"文賢村",NULL
0,714,12,726,917,0,0,79.17,259,455,"中賢村",NULL
0,866,34,900,1115,0,0,80.72,294,572,"葉厝村",NULL
0,792,4,796,991,0,0,80.32,237,555,"逸賢村",NULL
0,612,23,635,751,0,0,84.55,209,403,"忠興村",NULL
0,879,8,887,1042,0,0,85.12,227,652,"福德村",NULL
0,716,19,735,900,0,0,81.67,285,431,"萬福村",NULL
0,1239,50,1289,1604,0,0,80.36,494,745,"白雲村",NULL
0,2238,63,2301,2844,0,0,80.91,823,1415,"嘉賜村",NULL
0,1142,38,1180,1452,0,0,81.27,462,680,"嘉安村",NULL
0,1484,53,1537,1878,0,0,81.84,490,994,"嘉樂村",NULL
0,923,43,966,1190,0,0,81.18,322,601,"嘉泰村",NULL
0,758,23,781,987,0,0,79.13,270,488,"嘉福村",NULL
0,960,32,992,1215,0,0,81.65,319,641,"和協村",NULL
0,981,36,1017,1298,0,0,78.35,365,616,"嘉定村",NULL
0,2336,43,2379,2975,0,0,79.97,822,1514,"保定村",NULL
0,946,33,979,1197,0,0,81.79,401,545,"大定村",NULL
0,815,39,854,1064,0,0,80.26,308,507,"光定村",NULL
0,1001,36,1037,1261,0,0,82.24,308,693,"吉定村",NULL
0,2707,75,2782,3628,0,0,76.68,1113,1594,"崎漏村",NULL
0,1151,61,1212,1497,0,0,80.96,578,573,"永安村",NULL
0,1356,34,1390,1721,0,0,80.77,624,732,"永華村",NULL
0,1861,59,1920,2384,0,0,80.54,758,1103,"新港村",NULL
0,284,9,293,385,0,0,76.1,87,197,"鹽田村",NULL
0,1617,60,1677,2040,0,0,82.21,775,842,"保寧村",NULL
0,2117,94,2211,2634,0,0,83.94,807,1310,"維新村",NULL
0,1188,60,1248,1516,0,0,82.32,505,683,"舊港村",NULL
0,1415,66,1481,1813,0,0,81.69,561,854,"文安村",NULL
0,1545,75,1620,1917,0,0,84.51,630,915,"鹽埕村",NULL
0,788,50,838,998,0,0,83.97,333,455,"過港村",NULL
0,886,32,918,1083,0,0,84.76,377,509,"光和村",NULL
0,1477,40,1517,1842,0,0,82.36,642,835,"彌靖村",NULL
0,489,21,510,597,0,0,85.43,227,262,"彌仁村",NULL
0,591,22,613,728,0,0,84.2,298,293,"彌壽村",NULL
0,1270,47,1317,1552,0,0,84.86,617,653,"彌陀村",NULL
0,634,35,669,846,0,0,79.08,315,319,"海尾村",NULL
0,832,49,881,1010,0,0,87.23,360,472,"漯底村",NULL
0,1611,54,1665,2014,0,0,82.67,697,914,"南寮村",NULL
0,1605,50,1655,2002,0,0,82.67,481,1124,"梓信村",NULL
0,1605,52,1657,2026,0,0,81.79,547,1058,"梓義村",NULL
0,1842,61,1903,2273,0,0,83.72,614,1228,"梓和村",NULL
0,941,42,983,1124,0,0,87.46,285,656,"梓平村",NULL
0,875,23,898,1055,0,0,85.12,303,572,"中崙村",NULL
0,760,42,802,935,0,0,85.78,234,526,"同安村",NULL
0,2720,97,2817,3450,0,0,81.65,925,1795,"大舍村",NULL
0,1499,67,1566,1881,0,0,83.25,525,974,"赤崁村",NULL
0,1849,66,1915,2347,0,0,81.59,603,1246,"赤東村",NULL
0,529,19,548,687,0,0,79.77,242,287,"赤西村",NULL
0,1825,52,1877,2335,0,0,80.39,601,1224,"禮蚵村",NULL
0,1894,52,1946,2433,0,0,79.98,731,1163,"智蚵村",NULL
0,1307,51,1358,1707,0,0,79.55,572,735,"信蚵村",NULL
0,1726,66,1792,2190,0,0,81.83,680,1046,"茄苳村",NULL
0,2015,65,2080,2475,0,0,84.04,824,1191,"典寶村",NULL
0,1752,67,1819,2322,0,0,78.34,775,977,"太平里",NULL
0,1886,44,1930,2449,0,0,78.81,909,977,"大德里",NULL
0,688,19,707,884,0,0,79.98,309,379,"湄洲里",NULL
0,453,12,465,573,0,0,81.15,221,232,"鼓山里",NULL
0,609,12,621,774,0,0,80.23,244,365,"新山里",NULL
0,563,16,579,760,0,0,76.18,210,353,"和平里",NULL
0,431,3,434,561,0,0,77.36,185,246,"竹峰里",NULL
0,1468,54,1522,1953,0,0,77.93,591,877,"瑞吉里",NULL
0,2344,48,2392,3055,0,0,78.3,955,1389,"永和里",NULL
0,1411,71,1482,1910,0,0,77.59,565,846,"三協里",NULL
0,1354,55,1409,1864,0,0,75.59,622,732,"圓富里",NULL
0,1123,48,1171,1533,0,0,76.39,574,549,"中正里",NULL
0,1061,29,1090,1477,0,0,73.8,452,609,"大林里",NULL
0,819,35,854,1003,0,0,85.14,243,576,"上洲里",NULL
0,705,22,727,897,0,0,81.05,172,533,"鯤洲里",NULL
0,1031,56,1087,1338,0,0,81.24,276,755,"大山里",NULL
0,748,42,790,930,0,0,84.95,187,561,"中洲里",NULL
0,1086,41,1127,1372,0,0,82.14,383,703,"南洲里",NULL
0,697,17,714,870,0,0,82.07,228,469,"新光里",NULL
0,1797,76,1873,2361,0,0,79.33,642,1155,"南勝里",NULL
0,1448,50,1498,1915,0,0,78.22,548,900,"東平里",NULL
0,490,27,517,659,0,0,78.45,193,297,"東昌里",NULL
0,296,7,303,378,0,0,80.16,176,120,"糖廠里",NULL
0,510,20,530,644,0,0,82.3,259,251,"廣福里",NULL
0,156,14,170,205,0,0,82.93,50,106,"中寮里",NULL
0,1368,58,1426,1849,0,0,77.12,594,774,"中圳里",NULL
0,996,43,1039,1364,0,0,76.17,379,617,"東門里",NULL
0,1148,36,1184,1496,0,0,79.14,579,569,"泰安里",NULL
0,1711,60,1771,2261,0,0,78.33,864,847,"合和里",NULL
0,1665,60,1725,2209,0,0,78.09,747,918,"瀰濃里",NULL
0,1933,45,1978,2542,0,0,77.81,816,1117,"福安里",NULL
0,1863,81,1944,2509,0,0,77.48,815,1048,"祿興里",NULL
0,1513,63,1576,2039,0,0,77.29,742,771,"中壇里",NULL
0,1151,37,1188,1492,0,0,79.62,644,507,"德興里",NULL
0,1278,48,1326,1720,0,0,77.09,562,716,"清水里",NULL
0,1065,44,1109,1410,0,0,78.65,513,552,"吉和里",NULL
0,1501,69,1570,2001,0,0,78.46,622,879,"吉洋里",NULL
0,1287,50,1337,1716,0,0,77.91,480,807,"吉東里",NULL
0,1671,30,1701,2191,0,0,77.64,728,943,"龍山里",NULL
0,1851,31,1882,2397,0,0,78.51,666,1185,"獅山里",NULL
0,1208,63,1271,1608,0,0,79.04,568,640,"龍肚里",NULL
0,1079,43,1122,1416,0,0,79.24,404,675,"廣德里",NULL
0,912,34,946,1221,0,0,77.48,336,576,"興隆里",NULL
0,1230,67,1297,1733,0,0,74.84,468,762,"廣林里",NULL
0,766,51,817,1140,0,0,71.67,314,452,"六龜村",NULL
0,847,34,881,1154,0,0,76.34,378,469,"義寶村",NULL
0,1007,63,1070,1604,0,0,66.71,369,638,"文武村",NULL
0,980,49,1029,1400,0,0,73.5,499,481,"中興村",NULL
0,610,36,646,914,0,0,70.68,223,387,"興龍村",NULL
0,595,26,621,821,0,0,75.64,265,330,"新威村",NULL
0,498,42,540,746,0,0,72.39,181,317,"新興村",NULL
0,455,27,482,632,0,0,76.27,175,280,"新寮村",NULL
0,251,19,270,353,0,0,76.49,104,147,"大津村",NULL
0,824,83,907,1377,0,0,65.87,217,607,"新發村",NULL
0,960,66,1026,1574,0,0,65.18,332,628,"荖濃村",NULL
0,774,33,807,1111,0,0,72.64,337,437,"寶來村",NULL
0,457,14,471,617,0,0,76.34,223,234,"東安村",NULL
0,842,31,873,1084,0,0,80.54,514,328,"西安村",NULL
0,627,36,663,836,0,0,79.31,347,280,"和安村",NULL
0,1212,50,1262,1622,0,0,77.81,632,580,"大田村",NULL
0,554,24,578,724,0,0,79.83,243,311,"寶隆村",NULL
0,527,37,564,736,0,0,76.63,255,272,"關山村",NULL
0,826,37,863,1168,0,0,73.89,384,442,"小林村",NULL
0,540,25,565,763,0,0,74.05,199,341,"杉林村",NULL
0,518,31,549,783,0,0,70.11,193,325,"木梓村",NULL
0,1325,80,1405,1898,0,0,74.03,461,864,"集來村",NULL
0,1251,88,1339,1776,0,0,75.39,668,583,"新庄村",NULL
0,1046,48,1094,1520,0,0,71.97,564,482,"上平村",NULL
0,1228,58,1286,1769,0,0,72.7,604,624,"月眉村",NULL
0,944,45,989,1323,0,0,74.75,384,560,"月美村",NULL
0,568,22,590,794,0,0,74.31,184,384,"金竹村",NULL
0,720,39,759,1029,0,0,73.76,335,385,"溝坪村",NULL
0,338,25,363,489,0,0,74.23,161,177,"永興村",NULL
0,368,19,387,477,0,0,81.13,166,202,"永吉村",NULL
0,740,45,785,1044,0,0,75.19,307,433,"永富村",NULL
0,1380,58,1438,1779,0,0,80.83,585,795,"觀亭村",NULL
0,459,30,489,598,0,0,81.77,218,241,"中埔村",NULL
0,264,18,282,366,0,0,77.05,102,162,"瑞山村",NULL
0,320,11,331,406,0,0,81.53,125,195,"內南村",NULL
0,597,47,644,787,0,0,81.83,262,335,"內東村",NULL
0,481,27,508,642,0,0,79.13,212,269,"光興村",NULL
0,367,21,388,502,0,0,77.29,135,232,"東埔村",NULL
0,898,34,932,1148,0,0,81.18,460,438,"內豊村",NULL
0,761,28,789,997,0,0,79.14,414,347,"內門村",NULL
0,382,17,399,509,0,0,78.39,156,226,"石坑村",NULL
0,512,24,536,688,0,0,77.91,228,284,"三平村",NULL
0,524,20,544,697,0,0,78.05,185,339,"木柵村",NULL
0,460,31,491,636,0,0,77.2,122,338,"內興村",NULL
0,412,11,423,536,0,0,78.92,364,48,"茂林村",NULL
0,225,6,231,292,0,0,79.11,209,16,"萬山村",NULL
0,310,8,318,429,0,0,74.13,289,21,"多納村",NULL
0,343,20,363,546,0,0,66.48,299,44,"寶山村",NULL
0,355,19,374,549,0,0,68.12,315,40,"建山村",NULL
0,344,10,354,518,0,0,68.34,290,54,"高中村",NULL
0,517,15,532,759,0,0,70.09,452,65,"桃源村",NULL
0,173,1,174,235,0,0,74.04,157,16,"勤和村",NULL
0,159,4,163,257,0,0,63.42,121,38,"復興村",NULL
0,171,1,172,248,0,0,69.35,126,45,"梅蘭村",NULL
0,189,2,191,242,0,0,78.93,169,20,"梅山村",NULL
0,351,17,368,529,0,0,69.57,252,99,"民族村",NULL
0,401,13,414,592,0,0,69.93,365,36,"民權村",NULL
0,776,7,783,1105,0,0,70.86,694,82,"民生村",NULL
0,1254,11,1265,1515,0,0,83.5,462,792,"大同里、端正里、武廟里",NULL
0,1183,22,1205,1517,0,0,79.43,515,668,"民權里、光榮里",NULL
0,839,13,852,1083,0,0,78.67,514,325,"泰安里、文明里",NULL
0,2180,56,2236,2844,0,0,78.62,882,1298,"維新里",NULL
0,1182,20,1202,1462,0,0,82.22,377,805,"大埔里、必信里",NULL
0,690,20,710,860,0,0,82.56,223,467,"崇禮里、崇智里",NULL
0,696,19,715,874,0,0,81.81,257,439,"平和里",NULL
0,891,11,902,1081,0,0,83.44,354,537,"扶風里、安樂里",NULL
0,1031,17,1048,1293,0,0,81.05,340,691,"勝豐里、金泉里",NULL
0,1181,30,1211,1570,0,0,77.13,524,657,"橋南里",NULL
0,731,9,740,914,0,0,80.96,299,432,"橋北里",NULL
0,7181,96,7277,8791,0,0,82.78,3907,3274,"大連里",NULL
0,3138,49,3187,3950,0,0,80.68,1597,1541,"豐田里",NULL
0,1984,24,2008,2456,0,0,81.76,948,1036,"豐榮里",NULL
0,3005,30,3035,3718,0,0,81.63,1534,1471,"豐源里",NULL
0,1620,19,1639,2075,0,0,78.99,799,821,"長春里",NULL
0,681,14,695,816,0,0,85.17,229,452,"慶春里、楠樹里",NULL
0,5046,109,5155,6592,0,0,78.2,2603,2443,"瑞光里",NULL
0,813,18,831,989,0,0,84.02,183,630,"湖南里",NULL
0,1139,20,1159,1392,0,0,83.26,285,854,"湖西里",NULL
0,878,28,906,1113,0,0,81.4,245,633,"歸心里",NULL
0,2341,33,2374,2944,0,0,80.64,1140,1201,"清溪里",NULL
0,5535,92,5627,6914,0,0,81.39,2902,2633,"大武里",NULL
0,1121,26,1147,1378,0,0,83.24,940,181,"凌雲里",NULL
0,1019,21,1040,1291,0,0,80.56,770,249,"永順里、永昌里",NULL
0,1146,27,1173,1419,0,0,82.66,1070,76,"鵬程里",NULL
0,1646,37,1683,2003,0,0,84.02,560,1086,"安鎮里",NULL
0,913,28,941,1166,0,0,80.7,387,526,"永光里",NULL
0,1577,49,1626,1999,0,0,81.34,540,1037,"長安里",NULL
0,2203,49,2252,2770,0,0,81.3,767,1436,"前進里",NULL
0,888,35,923,1088,0,0,84.83,223,665,"大洲里",NULL
0,1877,22,1899,2296,0,0,82.71,794,1083,"新興里",NULL
0,1200,21,1221,1482,0,0,82.39,391,809,"公館里",NULL
0,3788,82,3870,4764,0,0,81.23,1687,2101,"新生里",NULL
0,426,6,432,530,0,0,81.51,98,328,"頂宅里",NULL
0,867,15,882,1027,0,0,85.88,308,559,"頂柳里",NULL
0,1261,25,1286,1565,0,0,82.17,397,864,"大湖里",NULL
0,1877,54,1931,2389,0,0,80.83,752,1125,"龍華里",NULL
0,1108,41,1149,1370,0,0,83.87,295,813,"玉成里",NULL
0,1288,23,1311,1684,0,0,77.85,459,829,"建國里、擇仁里",NULL
0,622,12,634,775,0,0,81.81,229,393,"萬年里",NULL
0,2397,52,2449,3024,0,0,80.99,784,1613,"厚生里",NULL
0,1341,29,1370,1720,0,0,79.65,772,569,"義勇里、一心里",NULL
0,580,14,594,789,0,0,75.29,222,358,"光華里",NULL
0,5220,81,5301,6658,0,0,79.62,2289,2931,"永安里",NULL
0,6006,87,6093,7451,0,0,81.77,3428,2578,"崇蘭里",NULL
0,6196,102,6298,7914,0,0,79.58,3822,2374,"潭墘里",NULL
0,1757,32,1789,2319,0,0,77.15,982,775,"永城里",NULL
0,1275,25,1300,1593,0,0,81.61,895,380,"空翔里",NULL
0,563,23,586,715,0,0,81.96,537,26,"大鵬里",NULL
0,1490,22,1512,1858,0,0,81.38,657,833,"廣興里",NULL
0,3443,58,3501,4654,0,0,75.23,2030,1413,"勝利里",NULL
0,1679,31,1710,2099,0,0,81.47,863,816,"斯文里",NULL
0,3953,67,4020,4871,0,0,82.53,2127,1826,"華山里",NULL
0,2214,31,2245,2809,0,0,79.92,1141,1073,"溝美里",NULL
0,1016,22,1038,1256,0,0,82.64,374,642,"三山里",NULL
0,699,14,713,856,0,0,83.29,208,491,"海豐里",NULL
0,802,23,825,1009,0,0,81.76,294,508,"仁義里",NULL
0,4434,79,4513,5642,0,0,79.99,2497,1937,"北興里",NULL
0,1976,37,2013,2412,0,0,83.46,879,1097,"北勢里",NULL
0,2768,40,2808,3457,0,0,81.23,1520,1248,"中正里",NULL
0,752,12,764,960,0,0,79.58,397,355,"興樂里",NULL
0,1421,26,1447,1778,0,0,81.38,709,712,"明正里、太平里",NULL
0,1160,38,1198,1472,0,0,81.39,318,842,"信和里",NULL
0,726,18,744,954,0,0,77.99,213,513,"和興里",NULL
0,1810,24,1834,2257,0,0,81.26,852,958,"仁愛里",NULL
0,490,7,497,607,0,0,81.88,238,252,"潮州里",NULL
0,3060,61,3121,4048,0,0,77.1,1403,1657,"光華里",NULL
0,588,11,599,712,0,0,84.13,191,397,"同榮里",NULL
0,911,7,918,1155,0,0,79.48,348,563,"新生里",NULL
0,1122,22,1144,1456,0,0,78.57,448,674,"新榮里",NULL
0,647,23,670,808,0,0,82.92,170,477,"彭城里",NULL
0,3534,47,3581,4497,0,0,79.63,1651,1883,"三星里",NULL
0,4308,70,4378,5598,0,0,78.21,1878,2430,"三共里",NULL
0,1446,15,1461,1868,0,0,78.21,593,853,"三和里",NULL
0,947,21,968,1197,0,0,80.87,305,642,"五魁里",NULL
0,1411,12,1423,1797,0,0,79.19,470,941,"蓬萊里",NULL
0,1531,37,1568,2042,0,0,76.79,606,925,"八爺里",NULL
0,4067,92,4159,5287,0,0,78.66,1792,2275,"永春里",NULL
0,1086,11,1097,1428,0,0,76.82,533,553,"富春里",NULL
0,1033,10,1043,1325,0,0,78.72,364,669,"光春里",NULL
0,652,15,667,866,0,0,77.02,224,428,"興美里",NULL
0,426,19,445,593,0,0,75.04,198,228,"檨子里",NULL
0,1154,38,1192,1576,0,0,75.63,327,827,"九塊里",NULL
0,1241,40,1281,1563,0,0,81.96,457,784,"泗林里",NULL
0,1475,46,1521,1921,0,0,79.18,456,1019,"四春里",NULL
0,1183,50,1233,1596,0,0,77.26,399,784,"崙東里",NULL
0,1867,35,1902,2333,0,0,81.53,677,1190,"新勝里",NULL
0,465,12,477,579,0,0,82.38,147,318,"頂新里",NULL
0,349,6,355,447,0,0,79.42,121,228,"頂中里",NULL
0,595,12,607,777,0,0,78.12,213,382,"東和里",NULL
0,436,12,448,575,0,0,77.91,161,275,"興台里",NULL
0,4584,90,4674,5924,0,0,78.9,1715,2869,"興東里",NULL
0,596,13,609,733,0,0,83.08,183,413,"興農里",NULL
0,632,11,643,790,0,0,81.39,272,360,"中興里",NULL
0,1471,35,1506,1880,0,0,80.11,529,942,"朝安里",NULL
0,685,20,705,882,0,0,79.93,246,439,"八德里",NULL
0,1055,25,1080,1368,0,0,78.95,371,684,"東隆里",NULL
0,579,12,591,743,0,0,79.54,192,387,"豐漁里",NULL
0,996,40,1036,1342,0,0,77.2,264,732,"盛漁里",NULL
0,1521,34,1555,1949,0,0,79.78,477,1044,"興漁里",NULL
0,2026,35,2061,2613,0,0,78.87,593,1433,"鎮海里",NULL
0,1231,36,1267,1630,0,0,77.73,394,837,"嘉蓮里",NULL
0,1340,30,1370,1795,0,0,76.32,489,851,"南平里",NULL
0,2975,86,3061,3910,0,0,78.29,1075,1900,"船頭里",NULL
0,1439,39,1478,1826,0,0,80.94,349,1090,"下廍里",NULL
0,1253,36,1289,1618,0,0,79.67,458,795,"大潭里",NULL
0,697,33,730,910,0,0,80.22,172,525,"興和里",NULL
0,584,11,595,763,0,0,77.98,436,148,"共和里",NULL
0,236,14,250,316,0,0,79.11,194,42,"大鵬里",NULL
0,707,20,727,993,0,0,73.21,377,330,"城南里",NULL
0,1437,46,1483,2054,0,0,72.2,646,791,"城北里",NULL
0,852,11,863,1178,0,0,73.26,428,424,"城西里",NULL
0,2434,65,2499,3520,0,0,70.99,1180,1254,"山腳里",NULL
0,1818,59,1877,2686,0,0,69.88,890,928,"網紗里",NULL
0,527,27,554,807,0,0,68.65,218,309,"仁壽里",NULL
0,314,20,334,479,0,0,69.73,86,228,"茄湖里",NULL
0,293,16,309,467,0,0,66.17,104,189,"頭溝里",NULL
0,612,38,650,920,0,0,70.65,225,387,"四溝里",NULL
0,504,17,521,725,0,0,71.86,214,290,"德和里",NULL
0,662,34,696,994,0,0,70.02,284,378,"龍水里",NULL
0,1046,47,1093,1530,0,0,71.44,337,709,"山海里",NULL
0,1220,69,1289,1875,0,0,68.75,575,645,"大光里",NULL
0,850,51,901,1372,0,0,65.67,309,541,"水泉里",NULL
0,900,36,936,1378,0,0,67.92,431,469,"南灣里",NULL
0,900,16,916,1257,0,0,72.87,402,498,"墾丁里",NULL
0,714,12,726,1041,0,0,69.74,233,481,"鵝鑾里",NULL
0,1155,31,1186,1455,0,0,81.51,463,692,"香社村",NULL
0,1413,73,1486,1821,0,0,81.6,507,906,"新庄村",NULL
0,1459,57,1516,1859,0,0,81.55,711,748,"新鐘村",NULL
0,436,12,448,521,0,0,85.99,218,218,"水仙村",NULL
0,890,41,931,1124,0,0,82.83,377,513,"興全村",NULL
0,648,17,665,828,0,0,80.31,207,441,"興安村",NULL
0,288,11,299,371,0,0,80.59,128,160,"甘棠村",NULL
0,614,24,638,769,0,0,82.96,262,352,"萬惠村",NULL
0,2657,58,2715,3324,0,0,81.68,1099,1558,"萬全村",NULL
0,381,11,392,495,0,0,79.19,151,230,"萬後村",NULL
0,456,10,466,562,0,0,82.92,195,261,"萬安村",NULL
0,1022,26,1048,1255,0,0,83.51,423,599,"萬生村",NULL
0,1619,46,1665,2041,0,0,81.58,665,954,"寶厝村",NULL
0,1391,17,1408,1741,0,0,80.87,505,886,"四維村",NULL
0,1176,48,1224,1508,0,0,81.17,401,775,"竹林村",NULL
0,1121,35,1156,1381,0,0,83.71,424,697,"水泉村",NULL
0,758,19,777,902,0,0,86.14,203,555,"田厝村",NULL
0,1336,26,1362,1664,0,0,81.85,484,852,"崙頂村",NULL
0,1291,51,1342,1616,0,0,83.04,338,953,"廈北村",NULL
0,1088,28,1116,1397,0,0,79.89,364,724,"廈南村",NULL
0,798,30,828,1005,0,0,82.39,283,515,"後村村",NULL
0,1007,37,1044,1258,0,0,82.99,281,726,"灣內村",NULL
0,565,13,578,667,0,0,86.66,166,399,"上村村",NULL
0,887,31,918,1108,0,0,82.85,244,643,"加興村",NULL
0,980,29,1009,1209,0,0,83.46,428,552,"社口村",NULL
0,785,8,793,928,0,0,85.45,321,464,"磚寮村",NULL
0,1452,32,1484,1808,0,0,82.08,505,947,"社皮村",NULL
0,1184,30,1214,1463,0,0,82.98,352,832,"社中村",NULL
0,1200,18,1218,1465,0,0,83.14,415,785,"社上村",NULL
0,1621,36,1657,2017,0,0,82.15,569,1052,"廣安村",NULL
0,1747,43,1790,2257,0,0,79.31,728,1019,"進興村",NULL
0,2190,59,2249,2812,0,0,79.98,1011,1179,"新潭村",NULL
0,1223,28,1251,1532,0,0,81.66,447,776,"潭頭村",NULL
0,1515,35,1550,1899,0,0,81.62,646,869,"香楊村",NULL
0,786,21,807,992,0,0,81.35,360,426,"長興村",NULL
0,1165,30,1195,1453,0,0,82.24,425,740,"崙上村",NULL
0,863,21,884,1077,0,0,82.08,296,567,"德榮村",NULL
0,618,15,633,782,0,0,80.95,173,445,"德和村",NULL
0,1121,23,1144,1459,0,0,78.41,425,696,"復興村",NULL
0,715,19,734,872,0,0,84.17,248,467,"德成村",NULL
0,865,21,886,1115,0,0,79.46,262,603,"德協村",NULL
0,975,23,998,1321,0,0,75.55,332,643,"繁榮村",NULL
0,1302,41,1343,1699,0,0,79.05,401,901,"繁昌村",NULL
0,849,24,873,1090,0,0,80.09,354,495,"繁隆村",NULL
0,1751,45,1796,2243,0,0,80.07,522,1229,"繁華村",NULL
0,441,10,451,576,0,0,78.3,374,67,"榮華村",NULL
0,1487,29,1516,1816,0,0,83.48,521,966,"新田村",NULL
0,688,7,695,835,0,0,83.23,229,459,"麟頂村",NULL
0,1307,19,1326,1604,0,0,82.67,446,861,"麟蹄村",NULL
0,1825,24,1849,2243,0,0,82.43,639,1186,"麟趾村",NULL
0,935,20,955,1116,0,0,85.57,315,620,"田中村",NULL
0,689,19,708,837,0,0,84.59,232,457,"田心村",NULL
0,558,7,565,689,0,0,82,189,369,"田道村",NULL
0,1298,32,1330,1568,0,0,84.82,320,978,"九清村",NULL
0,1027,31,1058,1266,0,0,83.57,280,747,"九塊村",NULL
0,1134,38,1172,1407,0,0,83.3,302,832,"九明村",NULL
0,831,28,859,1033,0,0,83.16,261,570,"大坵村",NULL
0,1009,32,1041,1228,0,0,84.77,332,677,"玉水村",NULL
0,1151,34,1185,1467,0,0,80.78,368,783,"玉泉村",NULL
0,2919,49,2968,3605,0,0,82.33,928,1991,"東寧村",NULL
0,1103,38,1141,1382,0,0,82.56,268,835,"三塊村",NULL
0,1024,21,1045,1250,0,0,83.6,291,733,"耆老村",NULL
0,1427,26,1453,1688,0,0,86.08,344,1083,"後庄村",NULL
0,1082,18,1100,1303,0,0,84.42,354,728,"洽興村",NULL
0,1752,20,1772,2178,0,0,81.36,540,1212,"玉田村",NULL
0,1125,32,1157,1383,0,0,83.66,261,864,"塔樓村",NULL
0,1164,8,1172,1384,0,0,84.68,263,901,"潮厝村",NULL
0,946,15,961,1141,0,0,84.22,389,557,"大平村",NULL
0,644,12,656,803,0,0,81.69,206,438,"永春村",NULL
0,981,22,1003,1223,0,0,82.01,316,665,"春林村",NULL
0,1388,40,1428,1739,0,0,82.12,500,888,"過江村",NULL
0,984,22,1006,1212,0,0,83,288,696,"鐵店村",NULL
0,1318,38,1356,1586,0,0,85.5,342,976,"茄苳村",NULL
0,1846,52,1898,2312,0,0,82.09,476,1370,"載興村",NULL
0,1543,52,1595,1985,0,0,80.35,746,797,"土庫村",NULL
0,1390,60,1450,1755,0,0,82.62,492,898,"三廍村",NULL
0,624,19,643,820,0,0,78.41,200,424,"中和村",NULL
0,371,19,390,456,0,0,85.53,131,240,"瀰力村",NULL
0,1354,14,1368,1737,0,0,78.76,735,619,"鹽北村",NULL
0,1704,60,1764,2286,0,0,77.17,843,861,"鹽中村",NULL
0,1234,38,1272,1634,0,0,77.85,669,565,"鹽南村",NULL
0,708,36,744,917,0,0,81.13,445,263,"仕絨村",NULL
0,1994,87,2081,2698,0,0,77.13,773,1221,"高朗村",NULL
0,1316,65,1381,1866,0,0,74.01,555,761,"振興村",NULL
0,661,21,682,877,0,0,77.77,333,328,"久愛村",NULL
0,2275,13,2288,2886,0,0,79.28,664,1611,"新圍村",NULL
0,2312,54,2366,2995,0,0,79,974,1338,"新二村",NULL
0,777,21,798,979,0,0,81.51,312,465,"彭厝村",NULL
0,1148,42,1190,1476,0,0,80.62,412,736,"洛陽村",NULL
0,454,16,470,567,0,0,82.89,129,325,"永隆村",NULL
0,1660,40,1700,2178,0,0,78.05,467,1193,"高樹村",NULL
0,1056,40,1096,1377,0,0,79.59,259,797,"長榮村",NULL
0,643,22,665,837,0,0,79.45,118,525,"東興村",NULL
0,472,13,485,611,0,0,79.38,157,315,"東振村",NULL
0,779,38,817,1013,0,0,80.65,263,516,"源泉村",NULL
0,891,37,928,1170,0,0,79.32,212,679,"建興村",NULL
0,508,23,531,686,0,0,77.41,179,329,"大埔村",NULL
0,622,31,653,815,0,0,80.12,127,495,"菜寮村",NULL
0,539,23,562,706,0,0,79.6,221,318,"司馬村",NULL
0,972,40,1012,1321,0,0,76.61,327,645,"舊寮村",NULL
0,1121,40,1161,1584,0,0,73.3,371,750,"新豐村",NULL
0,1411,69,1480,1979,0,0,74.79,455,956,"泰山村",NULL
0,947,39,986,1253,0,0,78.69,310,637,"南華村",NULL
0,754,28,782,966,0,0,80.95,183,571,"廣福村",NULL
0,805,40,845,1061,0,0,79.64,236,569,"廣興村",NULL
0,795,27,822,1032,0,0,79.65,226,569,"舊庄村",NULL
0,864,32,896,1121,0,0,79.93,276,588,"田子村",NULL
0,1047,44,1091,1350,0,0,80.81,399,648,"鹽樹村",NULL
0,1142,29,1171,1477,0,0,79.28,331,811,"新南村",NULL
0,995,12,1007,1263,0,0,79.73,281,714,"萬巒村",NULL
0,610,11,621,790,0,0,78.61,164,446,"萬全村",NULL
0,1166,7,1173,1444,0,0,81.23,355,811,"萬和村",NULL
0,738,18,756,905,0,0,83.54,205,533,"鹿寮村",NULL
0,420,5,425,529,0,0,80.34,111,309,"硫黃村",NULL
0,919,30,949,1229,0,0,77.22,315,604,"泗溝村",NULL
0,901,27,928,1144,0,0,81.12,312,589,"五溝村",NULL
0,1225,18,1243,1554,0,0,79.99,406,819,"成德村",NULL
0,1221,43,1264,1693,0,0,74.66,441,780,"赤山村",NULL
0,1492,43,1535,1938,0,0,79.21,467,1025,"萬金村",NULL
0,1206,41,1247,1593,0,0,78.28,377,829,"佳佐村",NULL
0,1207,32,1239,1510,0,0,82.05,545,662,"佳和村",NULL
0,863,26,889,1157,0,0,76.84,237,626,"新厝村",NULL
0,952,34,986,1261,0,0,78.19,351,601,"新置村",NULL
0,2594,33,2627,3326,0,0,78.98,1000,1594,"內埔村",NULL
0,2106,46,2152,2742,0,0,78.48,845,1261,"內田村",NULL
0,1092,12,1104,1315,0,0,83.95,335,757,"興南村",NULL
0,456,17,473,591,0,0,80.03,128,328,"義亭村",NULL
0,1648,46,1694,2102,0,0,80.59,617,1031,"美和村",NULL
0,1583,28,1611,1961,0,0,82.15,624,959,"和興村",NULL
0,3213,55,3268,4097,0,0,79.77,1229,1984,"東寧村",NULL
0,1903,42,1945,2474,0,0,78.62,664,1239,"豐田村",NULL
0,1334,24,1358,1634,0,0,83.11,475,859,"振豐村",NULL
0,1536,24,1560,1912,0,0,81.59,444,1092,"富田村",NULL
0,1246,27,1273,1587,0,0,80.21,377,869,"竹圍村",NULL
0,2227,55,2282,2891,0,0,78.93,605,1622,"東勢村",NULL
0,732,23,755,924,0,0,81.71,214,518,"東片村",NULL
0,871,24,895,1103,0,0,81.14,262,609,"上樹村",NULL
0,1750,77,1827,2407,0,0,75.9,527,1223,"老埤村",NULL
0,1143,34,1177,1475,0,0,79.8,316,827,"中林村",NULL
0,1893,59,1952,2543,0,0,76.76,886,1007,"龍泉村",NULL
0,2013,54,2067,2663,0,0,77.62,1232,781,"龍潭村",NULL
0,910,74,984,1600,0,0,61.5,542,368,"建興村",NULL
0,1417,35,1452,1803,0,0,80.53,569,848,"大新村",NULL
0,1814,44,1858,2292,0,0,81.06,616,1198,"黎明村",NULL
0,902,29,931,1227,0,0,75.88,385,517,"隘寮村",NULL
0,662,7,669,862,0,0,77.61,308,354,"水門村",NULL
0,1172,10,1182,1458,0,0,81.07,435,737,"竹田村",NULL
0,685,18,703,862,0,0,81.55,173,512,"竹南村",NULL
0,561,7,568,687,0,0,82.68,195,366,"糶糴村",NULL
0,501,9,510,614,0,0,83.06,141,360,"履豐村",NULL
0,1077,28,1105,1335,0,0,82.77,364,713,"頭崙村",NULL
0,781,21,802,966,0,0,83.02,271,510,"二崙村",NULL
0,500,8,508,611,0,0,83.14,160,340,"美崙村",NULL
0,397,2,399,469,0,0,85.07,97,300,"南勢村",NULL
0,2028,39,2067,2563,0,0,80.65,685,1343,"西勢村",NULL
0,362,8,370,440,0,0,84.09,85,277,"福田村",NULL
0,498,8,506,606,0,0,83.5,184,314,"永豐村",NULL
0,558,9,567,681,0,0,83.26,148,410,"六巷村",NULL
0,798,29,827,1085,0,0,76.22,298,500,"泗洲村",NULL
0,903,28,931,1154,0,0,80.68,314,589,"大湖村",NULL
0,819,20,839,1022,0,0,82.09,387,432,"鳳明村",NULL
0,1481,41,1522,1969,0,0,77.3,644,837,"新埤村",NULL
0,887,36,923,1193,0,0,77.37,338,549,"建功村",NULL
0,787,23,810,1001,0,0,80.92,330,457,"打鐵村",NULL
0,571,17,588,759,0,0,77.47,233,338,"南豐村",NULL
0,1264,54,1318,1719,0,0,76.67,586,678,"萬隆村",NULL
0,952,47,999,1368,0,0,73.03,350,602,"餉潭村",NULL
0,809,35,844,1105,0,0,76.38,366,443,"箕湖村",NULL
0,905,12,917,1236,0,0,74.19,467,438,"枋寮村",NULL
0,626,17,643,873,0,0,73.65,379,247,"新龍村",NULL
0,756,21,777,984,0,0,78.96,270,486,"保生村",NULL
0,510,21,531,675,0,0,78.67,188,322,"中寮村",NULL
0,1390,45,1435,1827,0,0,78.54,580,810,"安樂村",NULL
0,2825,96,2921,3884,0,0,75.21,1060,1765,"隆山村",NULL
0,1610,39,1649,2093,0,0,78.79,597,1013,"天時村",NULL
0,1311,21,1332,1650,0,0,80.73,476,835,"地利村",NULL
0,1674,37,1711,2216,0,0,77.21,676,998,"人和村",NULL
0,489,21,510,756,0,0,67.46,130,359,"內寮村",NULL
0,620,43,663,994,0,0,66.7,300,320,"新開村",NULL
0,2178,34,2212,2821,0,0,78.41,918,1260,"東海村",NULL
0,484,15,499,634,0,0,78.71,204,280,"大庄村",NULL
0,685,22,707,964,0,0,73.34,292,393,"太源村",NULL
0,321,26,347,450,0,0,77.11,147,174,"玉泉村",NULL
0,1314,50,1364,1624,0,0,83.99,419,895,"瓦窯村",NULL
0,1890,37,1927,2394,0,0,80.49,658,1232,"仙吉村",NULL
0,1600,54,1654,2026,0,0,81.64,462,1138,"田洋村",NULL
0,595,29,624,764,0,0,81.68,196,399,"港墘村",NULL
0,652,8,660,809,0,0,81.58,214,438,"內庄村",NULL
0,1776,53,1829,2229,0,0,82.05,662,1114,"新東村",NULL
0,1611,46,1657,2040,0,0,81.23,602,1009,"新園村",NULL
0,1747,59,1806,2182,0,0,82.77,662,1085,"港西村",NULL
0,2246,81,2327,2929,0,0,79.45,791,1455,"五房村",NULL
0,1013,35,1048,1268,0,0,82.65,243,770,"烏龍村",NULL
0,1728,41,1769,2172,0,0,81.45,411,1317,"興龍村",NULL
0,1373,38,1411,1721,0,0,81.99,267,1106,"中洲村",NULL
0,1118,36,1154,1424,0,0,81.04,250,868,"南龍村",NULL
0,3148,79,3227,4102,0,0,78.67,750,2398,"鹽埔村",NULL
0,1715,40,1755,2225,0,0,78.88,423,1292,"共和村",NULL
0,1637,48,1685,2075,0,0,81.2,658,979,"崁頂村",NULL
0,1262,34,1296,1681,0,0,77.1,491,771,"園寮村",NULL
0,936,27,963,1155,0,0,83.38,304,632,"力社村",NULL
0,878,22,900,1137,0,0,79.16,268,610,"圍內村",NULL
0,729,26,755,924,0,0,81.71,235,494,"洲子村",NULL
0,1179,37,1216,1486,0,0,81.83,318,861,"北勢村",NULL
0,638,20,658,817,0,0,80.54,231,407,"越溪村",NULL
0,1356,56,1412,1776,0,0,79.5,326,1030,"港東村",NULL
0,1157,32,1189,1482,0,0,80.23,358,799,"林邊村",NULL
0,1247,39,1286,1650,0,0,77.94,422,825,"光林村",NULL
0,663,24,687,825,0,0,83.27,254,409,"中林村",NULL
0,1256,31,1287,1576,0,0,81.66,418,838,"仁和村",NULL
0,2608,60,2668,3270,0,0,81.59,815,1793,"永樂村",NULL
0,697,22,719,925,0,0,77.73,252,445,"田厝村",NULL
0,949,31,980,1353,0,0,72.43,362,587,"崎峰村",NULL
0,1410,43,1453,1938,0,0,74.97,501,909,"水利村",NULL
0,2243,66,2309,2906,0,0,79.46,1153,1090,"竹林村",NULL
0,888,32,920,1147,0,0,80.21,254,634,"鎮安村",NULL
0,1403,34,1437,1777,0,0,80.87,531,872,"溪洲村",NULL
0,774,18,792,986,0,0,80.32,300,474,"溪南村",NULL
0,415,10,425,537,0,0,79.14,161,254,"仁里村",NULL
0,624,7,631,784,0,0,80.48,388,236,"溪北村",NULL
0,814,36,850,1056,0,0,80.49,338,476,"七塊村",NULL
0,796,11,807,1009,0,0,79.98,266,530,"萬華村",NULL
0,808,10,818,1021,0,0,80.12,320,488,"米崙村",NULL
0,875,26,901,1138,0,0,79.17,173,702,"壽元村",NULL
0,743,25,768,955,0,0,80.42,233,510,"同安村",NULL
0,467,19,486,590,0,0,82.37,137,330,"南安村",NULL
0,1147,39,1186,1513,0,0,78.39,417,730,"佳冬村",NULL
0,1227,30,1257,1603,0,0,78.42,497,730,"六根村",NULL
0,702,18,720,923,0,0,78.01,221,481,"賴家村",NULL
0,1280,25,1305,1683,0,0,77.54,418,862,"萬建村",NULL
0,1490,73,1563,1959,0,0,79.79,406,1084,"石光村",NULL
0,1642,59,1701,2227,0,0,76.38,523,1119,"玉光村",NULL
0,880,34,914,1126,0,0,81.17,274,606,"昌隆村",NULL
0,635,22,657,850,0,0,77.29,197,438,"豐隆村",NULL
0,947,38,985,1196,0,0,82.36,277,670,"大同村",NULL
0,821,28,849,1042,0,0,81.48,232,589,"羌園村",NULL
0,875,30,905,1131,0,0,80.02,350,525,"燄溫村",NULL
0,1724,63,1787,2297,0,0,77.8,834,890,"塭豐村",NULL
0,1274,41,1315,2001,0,0,65.72,616,658,"本福村",NULL
0,700,29,729,1124,0,0,64.86,379,321,"中福村",NULL
0,526,22,548,916,0,0,59.83,350,176,"漁福村",NULL
0,847,45,892,1519,0,0,58.72,517,330,"大福村",NULL
0,614,32,646,1181,0,0,54.7,301,313,"南福村",NULL
0,592,33,625,1054,0,0,59.3,278,314,"天福村",NULL
0,809,46,855,1499,0,0,57.04,418,391,"上福村",NULL
0,473,15,488,792,0,0,61.62,258,215,"杉福村",NULL
0,974,39,1013,1395,0,0,72.62,372,602,"福興村",NULL
0,442,15,457,588,0,0,77.72,122,320,"福安村",NULL
0,498,4,502,737,0,0,68.11,193,305,"田中村",NULL
0,531,21,552,777,0,0,71.04,211,320,"海口村",NULL
0,301,13,314,433,0,0,72.52,127,174,"統埔村",NULL
0,625,32,657,987,0,0,66.57,246,379,"溫泉村",NULL
0,871,54,925,1364,0,0,67.82,285,586,"保力村",NULL
0,320,9,329,424,0,0,77.59,96,224,"新街村",NULL
0,299,9,308,463,0,0,66.52,112,187,"埔墘村",NULL
0,333,14,347,509,0,0,68.17,142,191,"射寮村",NULL
0,308,31,339,494,0,0,68.62,122,186,"後灣村",NULL
0,962,51,1013,1460,0,0,69.38,419,543,"滿州村",NULL
0,904,40,944,1365,0,0,69.16,414,490,"永靖村",NULL
0,799,35,834,1186,0,0,70.32,281,518,"港口村",NULL
0,315,17,332,500,0,0,66.4,79,236,"響林村",NULL
0,246,8,254,382,0,0,66.49,82,164,"里德村",NULL
0,794,56,850,1333,0,0,63.77,454,340,"長樂村",NULL
0,165,8,173,272,0,0,63.6,61,104,"九棚村",NULL
0,229,1,230,357,0,0,64.43,98,131,"港仔村",NULL
0,1408,60,1468,1828,0,0,80.31,600,808,"加祿村",NULL
0,740,25,765,1061,0,0,72.1,365,375,"枋山村",NULL
0,663,43,706,1076,0,0,65.61,243,420,"楓港村",NULL
0,659,8,667,1005,0,0,66.37,233,426,"善餘村",NULL
0,944,22,966,1238,0,0,78.03,820,124,"三地村",NULL
0,200,3,203,268,0,0,75.75,178,22,"達來村",NULL
0,341,26,367,501,0,0,73.25,254,87,"德文村",NULL
0,342,14,356,473,0,0,75.26,300,42,"大社村",NULL
0,410,9,419,575,0,0,72.87,335,75,"賽嘉村",NULL
0,360,7,367,495,0,0,74.14,294,66,"口社村",NULL
0,216,1,217,298,0,0,72.82,185,31,"馬兒村",NULL
0,275,9,284,373,0,0,76.14,223,52,"安坡村",NULL
0,449,18,467,622,0,0,75.08,413,36,"青山村",NULL
0,427,14,441,559,0,0,78.89,376,51,"青葉村",NULL
0,789,26,815,1032,0,0,78.97,660,129,"霧臺村",NULL
0,94,8,102,123,0,0,82.93,80,14,"吉露村",NULL
0,150,3,153,201,0,0,76.12,138,12,"阿禮村",NULL
0,285,12,297,394,0,0,75.38,218,67,"大武村",NULL
0,219,3,222,292,0,0,76.03,197,22,"佳暮村",NULL
0,250,1,251,335,0,0,74.93,152,98,"好茶村",NULL
0,219,1,220,305,0,0,72.13,169,50,"瑪家村",NULL
0,600,11,611,743,0,0,82.23,529,71,"北葉村",NULL
0,675,23,698,933,0,0,74.81,593,82,"涼山村",NULL
0,581,10,591,769,0,0,76.85,469,112,"佳義村",NULL
0,246,14,260,351,0,0,74.07,210,36,"排灣村",NULL
0,1283,29,1312,1695,0,0,77.4,1109,174,"三和村",NULL
0,564,14,578,691,0,0,83.65,519,45,"佳平村",NULL
0,613,26,639,825,0,0,77.45,562,51,"武潭村",NULL
0,362,5,367,464,0,0,79.09,230,132,"平和村",NULL
0,254,3,257,333,0,0,77.18,235,19,"佳興村",NULL
0,402,17,419,574,0,0,73,387,15,"泰武村",NULL
0,512,10,522,657,0,0,79.45,484,28,"萬安村",NULL
0,629,14,643,824,0,0,78.03,581,48,"來義村",NULL
0,389,5,394,505,0,0,78.02,362,27,"義林村",NULL
0,511,2,513,632,0,0,81.17,470,41,"丹林村",NULL
0,732,23,755,1020,0,0,74.02,638,94,"古樓村",NULL
0,603,25,628,810,0,0,77.53,571,32,"文樂村",NULL
0,686,6,692,836,0,0,82.78,659,27,"望嘉村",NULL
0,860,35,895,1155,0,0,77.49,800,60,"南和村",NULL
0,506,30,536,772,0,0,69.43,458,48,"春日村",NULL
0,437,20,457,624,0,0,73.24,399,38,"古華村",NULL
0,222,9,231,312,0,0,74.04,214,8,"士文村",NULL
0,464,26,490,671,0,0,73.03,419,45,"歸崇村",NULL
0,615,38,653,839,0,0,77.83,554,61,"七佳村",NULL
0,323,6,329,426,0,0,77.23,309,14,"力里村",NULL
0,425,9,434,656,0,0,66.16,365,60,"楓林村",NULL
0,475,23,498,739,0,0,67.39,434,41,"丹路村",NULL
0,453,3,456,649,0,0,70.26,432,21,"草埔村",NULL
0,144,6,150,243,0,0,61.73,137,7,"內文村",NULL
0,166,0,166,250,0,0,66.4,151,15,"竹坑村",NULL
0,230,8,238,382,0,0,62.3,215,15,"獅子村",NULL
0,392,3,395,534,0,0,73.97,371,21,"內獅村",NULL
0,237,6,243,335,0,0,72.54,230,7,"南世村",NULL
0,893,36,929,1332,0,0,69.74,774,119,"石門村",NULL
0,437,31,468,674,0,0,69.44,393,44,"牡丹村",NULL
0,258,8,266,396,0,0,67.17,206,52,"東源村",NULL
0,242,4,246,387,0,0,63.57,178,64,"旭海村",NULL
0,338,8,346,484,0,0,71.49,316,22,"高士村",NULL
0,307,27,334,543,0,0,61.51,272,35,"四林村",NULL
0,731,9,740,1016,0,0,72.83,473,258,"文化里",NULL
0,1131,13,1144,1471,0,0,77.77,608,523,"民族里",NULL
0,1212,19,1231,1664,0,0,73.98,732,480,"自強里",NULL
0,3588,59,3647,4892,0,0,74.55,2156,1432,"民生里",NULL
0,656,22,678,964,0,0,70.33,411,245,"寶桑里",NULL
0,871,9,880,1196,0,0,73.58,546,325,"民權里",NULL
0,482,17,499,729,0,0,68.45,354,128,"四維里",NULL
0,1173,16,1189,1668,0,0,71.28,645,528,"中華里",NULL
0,545,13,558,743,0,0,75.1,305,240,"仁愛里",NULL
0,448,16,464,581,0,0,79.86,251,197,"強國里",NULL
0,545,6,551,773,0,0,71.28,316,229,"大同里",NULL
0,575,13,588,846,0,0,69.5,285,290,"成功里",NULL
0,917,29,946,1371,0,0,69,548,369,"建國里",NULL
0,658,9,667,907,0,0,73.54,318,340,"中正里",NULL
0,724,12,736,951,0,0,77.39,368,356,"中山里",NULL
0,566,3,569,743,0,0,76.58,273,293,"興國里",NULL
0,301,5,306,442,0,0,69.23,130,171,"鐵花里",NULL
0,2242,46,2288,3042,0,0,75.21,1416,826,"東海里",NULL
0,459,19,478,692,0,0,69.08,266,193,"復國里",NULL
0,356,8,364,504,0,0,72.22,224,132,"復興里",NULL
0,818,20,838,1191,0,0,70.36,446,372,"新興里",NULL
0,3782,65,3847,5451,0,0,70.57,2441,1341,"新生里",NULL
0,1976,41,2017,2690,0,0,74.98,1240,736,"中心里",NULL
0,2092,34,2126,2796,0,0,76.04,1404,688,"馬蘭里",NULL
0,1302,19,1321,1841,0,0,71.75,882,420,"光明里",NULL
0,1573,49,1622,2383,0,0,68.07,1078,495,"豐年里",NULL
0,914,24,938,1326,0,0,70.74,525,389,"豐樂里",NULL
0,1057,23,1080,1453,0,0,74.33,593,464,"永樂里",NULL
0,838,19,857,1211,0,0,70.77,414,424,"康樂里",NULL
0,4608,86,4694,6567,0,0,71.48,3058,1550,"豐榮里",NULL
0,3007,77,3084,4445,0,0,69.38,1950,1057,"豐谷里",NULL
0,1352,54,1406,2068,0,0,67.99,660,692,"豐里里",NULL
0,696,23,719,1015,0,0,70.84,276,420,"豐原里",NULL
0,989,50,1039,1537,0,0,67.6,664,325,"富岡里",NULL
0,551,16,567,866,0,0,65.47,340,211,"富豐里",NULL
0,1432,51,1483,2260,0,0,65.62,1023,409,"南榮里",NULL
0,751,20,771,1231,0,0,62.63,502,249,"岩灣里",NULL
0,1613,10,1623,2085,0,0,77.84,776,837,"卑南里",NULL
0,1609,36,1645,2367,0,0,69.5,1111,498,"南王里",NULL
0,1328,39,1367,1865,0,0,73.3,664,664,"豐田里",NULL
0,988,32,1020,1503,0,0,67.86,624,364,"新園里",NULL
0,879,30,909,1330,0,0,68.35,544,335,"建和里",NULL
0,648,23,671,914,0,0,73.41,318,330,"建興里",NULL
0,864,22,886,1288,0,0,68.79,570,294,"建業里",NULL
0,834,14,848,1163,0,0,72.91,521,313,"知本里",NULL
0,964,40,1004,1511,0,0,66.45,782,182,"建農里",NULL
0,1045,44,1089,2097,0,0,51.93,847,198,"信義里",NULL
0,406,13,419,854,0,0,49.06,323,83,"和平里",NULL
0,979,32,1011,1611,0,0,62.76,636,343,"忠仁里",NULL
0,1004,22,1026,1501,0,0,68.35,720,284,"忠仁里、忠智里",NULL
0,773,14,787,1132,0,0,69.52,528,245,"忠智里",NULL
0,1520,54,1574,2792,0,0,56.38,1211,309,"三民里",NULL
0,834,29,863,1692,0,0,51,609,225,"三仙里",NULL
0,618,14,632,1169,0,0,54.06,458,160,"忠孝里",NULL
0,400,13,413,753,0,0,54.85,344,56,"博愛里",NULL
0,1205,26,1231,1788,0,0,68.85,851,354,"里壟里",NULL
0,626,16,642,868,0,0,73.96,367,259,"中福里",NULL
0,571,22,593,941,0,0,63.02,359,212,"新福里",NULL
0,728,19,747,1101,0,0,67.85,501,227,"豐泉里",NULL
0,466,28,494,757,0,0,65.26,257,209,"月眉里",NULL
0,1145,32,1177,1830,0,0,64.32,769,376,"德高里",NULL
0,319,15,334,597,0,0,55.95,246,73,"電光里",NULL
0,1509,51,1560,2187,0,0,71.33,756,753,"賓朗村",NULL
0,712,21,733,1026,0,0,71.44,270,442,"美農村",NULL
0,931,14,945,1381,0,0,68.43,502,429,"初鹿村",NULL
0,806,31,837,1287,0,0,65.03,412,394,"明峰村",NULL
0,321,17,338,560,0,0,60.36,186,135,"嘉豐村",NULL
0,2144,71,2215,3178,0,0,69.7,1479,665,"太平村",NULL
0,685,19,704,1020,0,0,69.02,507,178,"泰安村",NULL
0,668,20,688,959,0,0,71.74,525,143,"利嘉村",NULL
0,708,25,733,1108,0,0,66.16,635,73,"東興村",NULL
0,777,27,804,1118,0,0,71.91,294,483,"溫泉村",NULL
0,360,12,372,582,0,0,63.92,213,147,"富山村",NULL
0,243,7,250,356,0,0,70.22,101,142,"富源村",NULL
0,275,10,285,470,0,0,60.64,158,117,"利吉村",NULL
0,708,13,721,1156,0,0,62.37,452,256,"鹿野村",NULL
0,725,30,755,1116,0,0,67.65,310,415,"龍田村",NULL
0,867,20,887,1421,0,0,62.42,596,271,"永安村",NULL
0,606,19,625,999,0,0,62.56,387,219,"瑞隆村",NULL
0,598,12,610,924,0,0,66.02,415,183,"瑞源村",NULL
0,410,14,424,731,0,0,58,267,143,"瑞和村",NULL
0,672,27,699,1024,0,0,68.26,240,432,"瑞豐村",NULL
0,1328,35,1363,2014,0,0,67.68,761,567,"福原村",NULL
0,860,24,884,1450,0,0,60.97,541,319,"福文村",NULL
0,449,15,464,736,0,0,63.04,257,192,"慶豐村",NULL
0,202,8,210,388,0,0,54.12,143,59,"大坡村",NULL
0,464,18,482,822,0,0,58.64,310,154,"大埔村",NULL
0,513,22,535,868,0,0,61.64,308,205,"新興村",NULL
0,254,12,266,410,0,0,64.88,127,127,"錦園村",NULL
0,216,4,220,369,0,0,59.62,66,150,"萬安村",NULL
0,283,12,295,454,0,0,64.98,185,98,"富興村",NULL
0,220,11,231,426,0,0,54.23,179,41,"振興村",NULL
0,1352,56,1408,2351,0,0,59.89,867,485,"都蘭村",NULL
0,629,27,656,1071,0,0,61.25,382,247,"興昌村",NULL
0,356,10,366,597,0,0,61.31,244,112,"隆昌村",NULL
0,586,12,598,1082,0,0,55.27,497,89,"東河村",NULL
0,816,27,843,1504,0,0,56.05,630,186,"泰源村",NULL
0,939,33,972,1755,0,0,55.38,704,235,"北源村",NULL
0,150,4,154,261,0,0,59,105,45,"尚德村",NULL
0,808,18,826,1598,0,0,51.69,610,198,"寧埔村",NULL
0,599,10,609,1119,0,0,54.42,395,204,"竹湖村",NULL
0,1190,51,1241,2190,0,0,56.67,831,359,"長濱村",NULL
0,310,16,326,664,0,0,49.1,193,117,"忠勇村",NULL
0,680,19,699,1250,0,0,55.92,525,155,"三間村",NULL
0,139,4,143,277,0,0,51.62,104,35,"三間村、樟原村",NULL
0,437,15,452,740,0,0,61.08,324,113,"樟原村",NULL
0,795,28,823,1239,0,0,66.42,397,398,"美和村",NULL
0,424,11,435,637,0,0,68.29,199,225,"三和村",NULL
0,470,20,490,709,0,0,69.11,169,301,"華源村",NULL
0,381,12,393,590,0,0,66.61,218,163,"北里村",NULL
0,1136,23,1159,1707,0,0,67.9,699,437,"大王村",NULL
0,1038,35,1073,1517,0,0,70.73,601,437,"泰和村",NULL
0,512,23,535,878,0,0,60.93,315,197,"香蘭村",NULL
0,1074,33,1107,1684,0,0,65.74,965,109,"金崙村",NULL
0,569,10,579,964,0,0,60.06,504,65,"多良村",NULL
0,397,11,408,642,0,0,63.55,260,137,"南興村",NULL
0,1032,25,1057,1817,0,0,58.17,564,468,"尚武村",NULL
0,887,19,906,1539,0,0,58.87,618,269,"大武村",NULL
0,719,19,738,1144,0,0,64.51,667,52,"大鳥村",NULL
0,479,20,499,873,0,0,57.16,444,35,"大竹村",NULL
0,495,9,504,817,0,0,61.69,438,57,"南寮村",NULL
0,500,6,506,911,0,0,55.54,428,72,"中寮村",NULL
0,352,11,363,629,0,0,57.71,325,27,"公館村",NULL
0,297,16,313,496,0,0,63.1,283,14,"加拿村",NULL
0,365,14,379,572,0,0,66.26,333,32,"崁頂村",NULL
0,544,15,559,910,0,0,61.43,487,57,"海端村",NULL
0,441,12,453,726,0,0,62.4,408,33,"廣原村",NULL
0,184,8,192,263,0,0,73,175,9,"霧鹿村",NULL
0,176,4,180,253,0,0,71.15,144,32,"利稻村",NULL
0,573,18,591,870,0,0,67.93,453,120,"桃源村",NULL
0,257,9,266,412,0,0,64.56,222,35,"紅葉村",NULL
0,184,2,186,270,0,0,68.89,168,16,"永康村",NULL
0,358,12,370,580,0,0,63.79,330,28,"武陵村",NULL
0,359,10,369,594,0,0,62.12,315,44,"鸞山村",NULL
0,669,17,686,990,0,0,69.29,624,45,"嘉蘭村",NULL
0,354,0,354,481,0,0,73.6,328,26,"正興村",NULL
0,288,9,297,392,0,0,75.77,253,35,"新興村",NULL
0,210,4,214,287,0,0,74.56,207,3,"賓茂村",NULL
0,216,3,219,296,0,0,73.99,204,12,"歷坵村",NULL
0,409,15,424,662,0,0,64.05,352,57,"安朔村",NULL
0,148,0,148,236,0,0,62.71,137,11,"南田村",NULL
0,227,3,230,380,0,0,60.53,180,47,"森永村",NULL
0,231,12,243,361,0,0,67.31,204,27,"新化村",NULL
0,378,13,391,596,0,0,65.6,352,26,"台板村",NULL
0,477,2,479,807,0,0,59.36,457,20,"土板村",NULL
0,293,26,319,590,0,0,54.07,247,46,"椰油村",NULL
0,333,42,375,699,0,0,53.65,280,53,"紅頭村",NULL
0,353,32,385,755,0,0,50.99,271,82,"東清村",NULL
0,212,9,221,446,0,0,49.55,107,105,"朗島村",NULL
0,1099,16,1115,1429,0,0,78.03,810,289,"民德里",NULL
0,2360,34,2394,3040,0,0,78.75,1949,411,"民勤里",NULL
0,1700,90,1790,2650,0,0,67.55,1504,196,"民意里",NULL
0,603,11,614,840,0,0,73.1,389,214,"民心里",NULL
0,1467,35,1502,1974,0,0,76.09,1158,309,"民享里",NULL
0,1902,42,1944,2560,0,0,75.94,1468,434,"民孝里",NULL
0,1458,34,1492,1971,0,0,75.7,1022,436,"民運里",NULL
0,2178,21,2199,2854,0,0,77.05,1591,587,"民政里",NULL
0,1042,15,1057,1373,0,0,76.98,738,304,"民立里",NULL
0,450,6,456,611,0,0,74.63,333,117,"民樂里",NULL
0,504,10,514,665,0,0,77.29,295,209,"民有里",NULL
0,455,9,464,604,0,0,76.82,319,136,"民主里",NULL
0,293,5,298,382,0,0,78.01,223,70,"民治里",NULL
0,416,7,423,568,0,0,74.47,249,167,"民族里",NULL
0,1052,9,1061,1395,0,0,76.06,646,406,"民生里",NULL
0,360,2,362,473,0,0,76.53,269,91,"民權里",NULL
0,521,7,528,680,0,0,77.65,314,207,"主商里",NULL
0,724,16,740,986,0,0,75.05,474,250,"主勤里",NULL
0,477,2,479,633,0,0,75.67,269,208,"主工里",NULL
0,514,12,526,713,0,0,73.77,306,208,"主信里",NULL
0,793,14,807,1085,0,0,74.38,475,318,"主睦里、主義里",NULL
0,610,8,618,856,0,0,72.2,402,208,"主計里",NULL
0,2178,44,2222,2974,0,0,74.71,1309,869,"主和里",NULL
0,1283,30,1313,1701,0,0,77.19,799,484,"主學里",NULL
0,2189,21,2210,2918,0,0,75.74,1427,762,"主農里",NULL
0,1759,27,1786,2345,0,0,76.16,1134,625,"主安里",NULL
0,3353,51,3404,4555,0,0,74.73,2279,1074,"主權里",NULL
0,1821,22,1843,2452,0,0,75.16,1115,706,"主力里",NULL
0,2316,30,2346,3055,0,0,76.79,1454,862,"國風里",NULL
0,1184,12,1196,1737,0,0,68.85,718,466,"國威里",NULL
0,783,5,788,1054,0,0,74.76,536,247,"國治里",NULL
0,429,5,434,533,0,0,81.43,281,148,"國安里",NULL
0,945,26,971,1290,0,0,75.27,619,326,"國光里",NULL
0,614,19,633,826,0,0,76.63,404,210,"國防里",NULL
0,1519,18,1537,2033,0,0,75.6,939,580,"國華里",NULL
0,1346,22,1368,1839,0,0,74.39,836,510,"國魂里",NULL
0,1570,22,1592,2230,0,0,71.39,948,622,"國聯里",NULL
0,1900,27,1927,2723,0,0,70.77,1337,563,"國盛里",NULL
0,1034,19,1053,1343,0,0,78.41,659,375,"國強里",NULL
0,3501,52,3553,4661,0,0,76.23,2271,1230,"國富里",NULL
0,2581,44,2625,3551,0,0,73.92,1721,860,"國裕里",NULL
0,716,13,729,931,0,0,78.3,472,244,"國慶里",NULL
0,2280,32,2312,3127,0,0,73.94,1659,621,"國興里",NULL
0,909,29,938,1339,0,0,70.05,589,320,"國福里",NULL
0,998,35,1033,1414,0,0,73.06,621,377,"新城村",NULL
0,646,14,660,917,0,0,71.97,247,399,"順安村",NULL
0,1681,57,1738,2383,0,0,72.93,1119,562,"康樂村",NULL
0,1761,52,1813,2543,0,0,71.29,1442,319,"大漢村",NULL
0,2230,30,2260,3138,0,0,72.02,1575,655,"北埔村",NULL
0,500,10,510,727,0,0,70.15,353,147,"佳林村",NULL
0,2518,58,2576,3453,0,0,74.6,1996,522,"嘉里村",NULL
0,937,40,977,1349,0,0,72.42,782,155,"嘉新村",NULL
0,750,48,798,1097,0,0,72.74,632,118,"和平村",NULL
0,819,36,855,1187,0,0,72.03,729,90,"崇德村",NULL
0,1025,28,1053,1506,0,0,69.92,797,228,"富世村",NULL
0,1017,35,1052,1502,0,0,70.04,866,151,"秀林村",NULL
0,964,41,1005,1460,0,0,68.84,783,181,"景美村",NULL
0,553,20,573,782,0,0,73.27,498,55,"佳民村",NULL
0,606,17,623,826,0,0,75.42,550,56,"水源村",NULL
0,761,16,777,995,0,0,78.09,711,50,"銅門村",NULL
0,641,25,666,881,0,0,75.6,569,72,"文蘭村",NULL
0,2477,48,2525,3409,0,0,74.07,1655,822,"永安村",NULL
0,2189,40,2229,3078,0,0,72.42,1418,771,"太昌村",NULL
0,3744,75,3819,5075,0,0,75.25,2396,1348,"慶豐村",NULL
0,2728,48,2776,3793,0,0,73.19,1822,906,"吉安村",NULL
0,1692,53,1745,2354,0,0,74.13,1017,675,"福興村",NULL
0,1097,42,1139,1508,0,0,75.53,595,502,"南華村",NULL
0,745,20,765,1120,0,0,68.3,607,138,"干城村",NULL
0,1782,53,1835,2534,0,0,72.42,1214,568,"永興村",NULL
0,1870,54,1924,2598,0,0,74.06,1238,632,"稻香村",NULL
0,2284,46,2330,3148,0,0,74.02,1649,635,"南昌村",NULL
0,2527,40,2567,3388,0,0,75.77,1721,806,"宜昌村",NULL
0,4624,91,4715,6107,0,0,77.21,2972,1652,"北昌村",NULL
0,2840,43,2883,3732,0,0,77.25,1774,1066,"勝安村",NULL
0,3903,66,3969,5272,0,0,75.28,2687,1216,"仁里村",NULL
0,3262,64,3326,4486,0,0,74.14,2471,791,"東昌村",NULL
0,1235,34,1269,1818,0,0,69.8,827,408,"仁安村",NULL
0,2677,63,2740,3882,0,0,70.58,1876,801,"仁和村",NULL
0,790,20,810,1072,0,0,75.56,690,100,"光華村",NULL
0,753,37,790,1105,0,0,71.49,505,248,"溪口村",NULL
0,237,6,243,340,0,0,71.47,144,93,"樹湖村",NULL
0,1313,51,1364,1920,0,0,71.04,784,529,"豐山村",NULL
0,892,34,926,1319,0,0,70.2,577,315,"豐裡村",NULL
0,561,19,580,841,0,0,68.97,371,190,"豐坪村",NULL
0,1137,35,1172,1581,0,0,74.13,755,382,"壽豐村",NULL
0,467,18,485,619,0,0,78.35,331,136,"共和村",NULL
0,563,4,567,753,0,0,75.3,446,117,"光榮村",NULL
0,599,19,618,865,0,0,71.45,366,233,"池南村",NULL
0,948,25,973,1331,0,0,73.1,577,371,"平和村",NULL
0,1468,52,1520,2084,0,0,73.26,905,563,"志學村",NULL
0,300,5,305,407,0,0,74.94,235,65,"志學村、池南村",NULL
0,191,10,201,287,0,0,70.03,142,49,"米棧村",NULL
0,559,10,569,803,0,0,70.86,454,105,"月眉村",NULL
0,380,9,389,574,0,0,67.77,271,109,"鹽寮村",NULL
0,584,25,609,901,0,0,67.59,415,169,"水璉村",NULL
0,845,15,860,1185,0,0,72.57,545,300,"鳳仁里",NULL
0,461,14,475,627,0,0,75.76,341,120,"鳳義里",NULL
0,518,8,526,696,0,0,75.57,357,161,"鳳禮里",NULL
0,846,6,852,1148,0,0,74.22,634,212,"鳳智里",NULL
0,915,36,951,1436,0,0,66.23,726,189,"鳳信里",NULL
0,359,19,378,578,0,0,65.4,278,81,"山興里",NULL
0,908,37,945,1382,0,0,68.38,566,342,"大榮里",NULL
0,412,16,428,633,0,0,67.61,213,199,"北林里",NULL
0,437,12,449,673,0,0,66.72,267,170,"南平里",NULL
0,631,31,662,876,0,0,75.57,460,171,"林榮里",NULL
0,753,34,787,1143,0,0,68.85,467,286,"長橋里",NULL
0,140,2,142,192,0,0,73.96,108,32,"森榮里",NULL
0,915,23,938,1346,0,0,69.69,570,345,"大華村",NULL
0,655,5,660,889,0,0,74.24,417,238,"大安村",NULL
0,654,29,683,1059,0,0,64.49,514,140,"大馬村",NULL
0,634,26,660,979,0,0,67.42,462,172,"大平村",NULL
0,719,21,740,1051,0,0,70.41,495,224,"大同村",NULL
0,662,15,677,1152,0,0,58.77,596,66,"東富村",NULL
0,652,25,677,1067,0,0,63.45,498,154,"西富村",NULL
0,544,12,556,883,0,0,62.97,454,90,"南富村",NULL
0,566,17,583,903,0,0,64.56,489,77,"北富村",NULL
0,371,8,379,517,0,0,73.31,302,69,"大進村",NULL
0,532,31,563,854,0,0,65.93,371,161,"大全村",NULL
0,294,18,312,513,0,0,60.82,223,71,"大興村",NULL
0,242,11,253,386,0,0,65.54,134,108,"大富村",NULL
0,362,11,373,567,0,0,65.78,219,143,"大豐村",NULL
0,380,16,396,783,0,0,50.57,326,54,"靜浦村",NULL
0,474,23,497,835,0,0,59.52,342,132,"港口村",NULL
0,1138,41,1179,2024,0,0,58.25,911,227,"豐濱村",NULL
0,398,9,407,673,0,0,60.48,355,43,"新社村",NULL
0,196,11,207,346,0,0,59.83,175,21,"磯崎村",NULL
0,688,33,721,1041,0,0,69.26,630,58,"西林村",NULL
0,329,11,340,511,0,0,66.54,306,23,"見晴村",NULL
0,462,12,474,705,0,0,67.23,384,78,"萬榮村",NULL
0,385,13,398,598,0,0,66.56,348,37,"明利村",NULL
0,620,16,636,1008,0,0,63.1,549,71,"馬遠村",NULL
0,646,14,660,1076,0,0,61.34,597,49,"紅葉村",NULL
0,1357,30,1387,1997,0,0,69.45,891,466,"瑞穗村",NULL
0,1239,30,1269,1851,0,0,68.56,777,462,"瑞美村",NULL
0,378,9,387,558,0,0,69.35,264,114,"瑞良村",NULL
0,654,29,683,1051,0,0,64.99,430,224,"瑞祥村",NULL
0,369,8,377,607,0,0,62.11,251,118,"瑞北村",NULL
0,613,26,639,1004,0,0,63.65,461,152,"舞鶴村",NULL
0,501,20,521,898,0,0,58.02,435,66,"鶴岡村",NULL
0,194,5,199,361,0,0,55.12,173,21,"奇美村",NULL
0,559,32,591,907,0,0,65.16,393,166,"富源村",NULL
0,555,39,594,1037,0,0,57.28,476,79,"富民村",NULL
0,403,17,420,704,0,0,59.66,188,215,"富興村",NULL
0,3193,73,3266,4666,0,0,70,2124,1069,"中城里",NULL
0,970,10,980,1352,0,0,72.49,599,371,"國武里",NULL
0,1266,27,1293,1854,0,0,69.74,880,386,"啟模里",NULL
0,1116,84,1200,2626,0,0,45.7,830,286,"泰昌里",NULL
0,793,23,816,1216,0,0,67.11,598,195,"永昌里",NULL
0,832,36,868,1331,0,0,65.21,555,277,"源城里",NULL
0,402,28,430,828,0,0,51.93,338,64,"長良里",NULL
0,709,34,743,1179,0,0,63.02,607,102,"樂合里",NULL
0,331,8,339,572,0,0,59.27,242,89,"東豐里",NULL
0,1034,27,1061,1766,0,0,60.08,726,308,"觀音里",NULL
0,908,55,963,1765,0,0,54.56,696,212,"松浦里",NULL
0,549,34,583,1019,0,0,57.21,400,149,"春日里",NULL
0,458,14,472,803,0,0,58.78,414,44,"德武里",NULL
0,650,35,685,1044,0,0,65.61,342,308,"三民里",NULL
0,740,32,772,1202,0,0,64.23,465,275,"大禹里",NULL
0,348,3,351,566,0,0,62.01,251,97,"吳江村",NULL
0,707,29,736,1299,0,0,56.66,492,215,"東里村",NULL
0,412,24,436,763,0,0,57.14,280,132,"萬寧村",NULL
0,398,18,416,706,0,0,58.92,336,62,"新興村",NULL
0,712,23,735,1099,0,0,66.88,567,145,"竹田村",NULL
0,273,16,289,467,0,0,61.88,195,78,"羅山村",NULL
0,527,23,550,861,0,0,63.88,353,174,"石牌村",NULL
0,259,3,262,423,0,0,61.94,161,98,"明里村",NULL
0,1019,3,1022,1583,0,0,64.56,633,386,"富里村",NULL
0,299,0,299,526,0,0,56.84,205,94,"永豐村",NULL
0,405,33,438,719,0,0,60.92,325,80,"豐南村",NULL
0,349,15,364,568,0,0,64.08,244,105,"富南村",NULL
0,402,19,421,649,0,0,64.87,253,149,"學田村",NULL
0,311,7,318,501,0,0,63.47,291,20,"崙山村",NULL
0,583,20,603,986,0,0,61.16,528,55,"立山村",NULL
0,429,16,445,655,0,0,67.94,385,44,"太平村",NULL
0,387,8,395,654,0,0,60.4,354,33,"卓溪村",NULL
0,620,10,630,980,0,0,64.29,590,30,"卓清村",NULL
0,573,11,584,973,0,0,60.02,528,45,"古風村",NULL
0,230,5,235,313,0,0,75.08,213,17,"新復里",NULL
0,234,3,237,319,0,0,74.29,145,89,"復興里",NULL
0,389,11,400,533,0,0,75.05,203,186,"長安里",NULL
0,358,8,366,492,0,0,74.39,146,212,"中央里",NULL
0,615,7,622,859,0,0,72.41,266,349,"啟明里",NULL
0,716,12,728,990,0,0,73.54,319,397,"重慶里",NULL
0,531,10,541,715,0,0,75.66,328,203,"中興里",NULL
0,1296,15,1311,1847,0,0,70.98,692,604,"光復里",NULL
0,834,13,847,1181,0,0,71.72,562,272,"光明里",NULL
0,1704,31,1735,2366,0,0,73.33,1079,625,"光榮里",NULL
0,3140,77,3217,4619,0,0,69.65,1729,1411,"朝陽里",NULL
0,1596,32,1628,2269,0,0,71.75,806,790,"陽明里",NULL
0,827,22,849,1138,0,0,74.6,441,386,"重光里",NULL
0,2003,38,2041,2850,0,0,71.61,1148,855,"西衛里",NULL
0,1446,40,1486,2001,0,0,74.26,826,620,"西文里",NULL
0,1457,16,1473,2014,0,0,73.14,777,680,"東文里",NULL
0,876,19,895,1227,0,0,72.94,450,426,"案山里",NULL
0,493,8,501,695,0,0,72.09,407,86,"光華里",NULL
0,404,4,408,574,0,0,71.08,195,209,"前寮里",NULL
0,1088,14,1102,1499,0,0,73.52,668,420,"石泉里",NULL
0,214,5,219,316,0,0,69.3,110,104,"菜園里",NULL
0,975,25,1000,1391,0,0,71.89,558,417,"東衛里",NULL
0,312,3,315,445,0,0,70.79,136,176,"安宅里",NULL
0,418,14,432,591,0,0,73.1,174,244,"興仁里",NULL
0,552,19,571,816,0,0,69.98,184,368,"烏崁里",NULL
0,284,12,296,391,0,0,75.7,100,184,"鐵線里",NULL
0,1317,36,1353,2045,0,0,66.16,449,868,"鎖港里",NULL
0,913,34,947,1405,0,0,67.4,323,590,"山水里",NULL
0,125,5,130,176,0,0,73.86,82,43,"五德里",NULL
0,228,8,236,335,0,0,70.45,103,125,"井垵里",NULL
0,631,7,638,1071,0,0,59.57,373,258,"時裡里",NULL
0,757,24,781,1248,0,0,62.58,270,487,"風櫃里",NULL
0,235,9,244,619,0,0,39.42,129,106,"虎井里",NULL
0,82,1,83,204,0,0,40.69,52,30,"桶盤里",NULL
0,563,20,583,852,0,0,68.43,266,297,"湖西村",NULL
0,213,5,218,307,0,0,71.01,106,107,"湖東村",NULL
0,126,4,130,206,0,0,63.11,59,67,"青螺村",NULL
0,170,1,171,242,0,0,70.66,85,85,"白坑村",NULL
0,390,11,401,604,0,0,66.39,120,270,"南寮村",NULL
0,208,3,211,277,0,0,76.17,78,130,"北寮村",NULL
0,358,20,378,553,0,0,68.35,118,240,"紅羅村",NULL
0,286,15,301,453,0,0,66.45,132,154,"西溪村",NULL
0,296,10,306,426,0,0,71.83,122,174,"成功村",NULL
0,72,3,75,113,0,0,66.37,33,39,"東石村",NULL
0,498,19,517,719,0,0,71.91,134,364,"沙港村",NULL
0,100,1,101,169,0,0,59.76,45,55,"中西村",NULL
0,184,8,192,298,0,0,64.43,90,94,"鼎灣村",NULL
0,172,2,174,232,0,0,75,67,105,"潭邊村",NULL
0,125,0,125,175,0,0,71.43,70,55,"許家村",NULL
0,132,7,139,193,0,0,72.02,78,54,"城北村",NULL
0,70,5,75,114,0,0,65.79,41,29,"太武村",NULL
0,436,15,451,635,0,0,71.02,235,201,"隘門村",NULL
0,555,23,578,876,0,0,65.98,195,360,"林投村",NULL
0,340,18,358,537,0,0,66.67,122,218,"尖山村",NULL
0,1033,28,1061,1547,0,0,68.58,423,610,"龍門村",NULL
0,406,14,420,640,0,0,65.63,141,265,"果葉村",NULL
0,295,12,307,449,0,0,68.37,136,159,"中屯村",NULL
0,364,8,372,537,0,0,69.27,159,205,"講美村",NULL
0,55,3,58,92,0,0,63.04,32,23,"城前村",NULL
0,78,0,78,109,0,0,71.56,51,27,"鎮海村",NULL
0,155,2,157,245,0,0,64.08,86,69,"港子村",NULL
0,121,5,126,214,0,0,58.88,54,67,"岐頭村",NULL
0,105,2,107,146,0,0,73.29,54,51,"小赤村",NULL
0,856,27,883,1344,0,0,65.7,432,424,"赤崁村",NULL
0,166,3,169,282,0,0,59.93,72,94,"瓦硐村",NULL
0,392,13,405,642,0,0,63.08,158,234,"後寮村",NULL
0,421,9,430,683,0,0,62.96,206,215,"通梁村",NULL
0,609,15,624,1214,0,0,51.4,132,477,"吉貝村",NULL
0,445,4,449,986,0,0,45.54,341,104,"鳥嶼村",NULL
0,120,1,121,213,0,0,56.81,87,33,"員貝村",NULL
0,92,4,96,180,0,0,53.33,30,62,"大倉村",NULL
0,148,8,156,254,0,0,61.42,85,63,"橫礁村",NULL
0,223,17,240,394,0,0,60.91,95,128,"合界村",NULL
0,441,18,459,769,0,0,59.69,158,283,"竹灣村",NULL
0,143,2,145,266,0,0,54.51,131,12,"小門村",NULL
0,353,11,364,605,0,0,60.17,162,191,"大池村",NULL
0,85,1,86,126,0,0,68.25,32,53,"二崁村",NULL
0,326,12,338,512,0,0,66.02,174,152,"池東村",NULL
0,119,4,123,202,0,0,60.89,50,69,"池西村",NULL
0,330,14,344,595,0,0,57.82,95,235,"赤馬村",NULL
0,715,21,736,1193,0,0,61.69,243,472,"內垵村",NULL
0,1038,19,1057,1775,0,0,59.55,737,301,"外垵村",NULL
0,222,10,232,424,0,0,54.72,114,108,"東安村",NULL
0,157,6,163,314,0,0,51.91,94,63,"西安村",NULL
0,83,9,92,224,0,0,41.07,35,48,"中社村",NULL
0,135,11,146,288,0,0,50.69,62,73,"水垵村",NULL
0,476,39,515,1162,0,0,44.32,96,380,"將軍村",NULL
0,96,3,99,274,0,0,36.13,21,75,"東吉村",NULL
0,105,6,111,320,0,0,34.69,29,76,"東坪村",NULL
0,50,0,50,166,0,0,30.12,18,32,"西坪村",NULL
0,101,8,109,222,0,0,49.1,85,16,"花嶼村",NULL
0,98,6,104,220,0,0,47.27,76,22,"東湖村",NULL
0,218,14,232,413,0,0,56.17,162,56,"西湖村",NULL
0,202,14,216,450,0,0,48,162,40,"中和村",NULL
0,134,7,141,264,0,0,53.41,93,41,"平和村",NULL
0,107,4,111,248,0,0,44.76,68,39,"海豐村",NULL
0,409,22,431,807,0,0,53.41,329,80,"南港村",NULL
0,470,12,482,570,0,0,84.56,190,280,"長潭里",NULL
0,2423,40,2463,3242,0,0,75.97,1413,1010,"砂子里",NULL
0,1156,40,1196,1545,0,0,77.41,388,768,"八斗里",NULL
0,991,38,1029,1350,0,0,76.22,484,507,"碧砂里",NULL
0,2917,45,2962,4014,0,0,73.79,1908,1009,"新富里",NULL
0,2473,34,2507,3414,0,0,73.43,1648,825,"新豐里",NULL
0,1158,28,1186,1525,0,0,77.77,616,542,"平寮里",NULL
0,1431,47,1478,1961,0,0,75.37,694,737,"社寮里",NULL
0,751,19,770,1087,0,0,70.84,567,184,"和憲里",NULL
0,987,25,1012,1392,0,0,72.7,679,308,"海濱里",NULL
0,911,32,943,1249,0,0,75.5,570,341,"正濱里",NULL
0,1447,46,1493,2087,0,0,71.54,870,577,"中正里",NULL
0,1085,26,1111,1469,0,0,75.63,724,361,"中濱里",NULL
0,1766,44,1810,2275,0,0,79.56,1298,468,"建國里",NULL
0,1577,49,1626,2110,0,0,77.06,1076,501,"砂灣里",NULL
0,1186,25,1211,1516,0,0,79.88,742,444,"真砂里",NULL
0,1913,30,1943,2464,0,0,78.86,1298,615,"正砂里",NULL
0,1070,8,1078,1331,0,0,80.99,686,384,"中砂里",NULL
0,973,28,1001,1305,0,0,76.7,597,376,"入船里",NULL
0,1141,19,1160,1471,0,0,78.86,725,416,"正船里",NULL
0,1013,34,1047,1338,0,0,78.25,649,364,"中船里",NULL
0,1000,23,1023,1277,0,0,80.11,519,481,"港通里",NULL
0,896,24,920,1187,0,0,77.51,525,371,"義重里",NULL
0,1125,34,1159,1475,0,0,78.58,646,479,"正義里",NULL
0,831,10,841,1050,0,0,80.1,469,362,"信義里",NULL
0,649,13,662,818,0,0,80.93,370,279,"德義里",NULL
0,941,16,957,1158,0,0,82.64,571,370,"仁壽里",NULL
0,971,16,987,1202,0,0,82.11,644,327,"仁義里",NULL
0,778,14,792,996,0,0,79.52,540,238,"義昭里",NULL
0,1911,57,1968,2376,0,0,82.83,1237,674,"義幸里",NULL
0,679,12,691,833,0,0,82.95,381,298,"義民里",NULL
0,1010,15,1025,1259,0,0,81.41,657,353,"義和里",NULL
0,546,6,552,684,0,0,80.7,348,198,"智慧里",NULL
0,1325,14,1339,1733,0,0,77.26,682,643,"智誠里",NULL
0,1167,21,1188,1478,0,0,80.38,742,425,"禮儀里",NULL
0,1216,33,1249,1555,0,0,80.32,827,389,"禮東里",NULL
0,1846,20,1866,2350,0,0,79.4,1227,619,"信綠里",NULL
0,2655,41,2696,3408,0,0,79.11,1844,811,"東信里",NULL
0,1442,35,1477,1840,0,0,80.27,956,486,"東光里",NULL
0,2560,56,2616,3373,0,0,77.56,1778,782,"東明里",NULL
0,2117,34,2151,2696,0,0,79.78,1403,714,"東安里",NULL
0,2980,52,3032,3803,0,0,79.73,1966,1014,"孝賢里",NULL
0,2922,55,2977,3981,0,0,74.78,1852,1070,"孝德里",NULL
0,1796,44,1840,2491,0,0,73.87,1084,712,"孝深里",NULL
0,665,19,684,915,0,0,74.75,407,258,"孝岡里",NULL
0,1318,33,1351,1757,0,0,76.89,700,618,"林泉里",NULL
0,755,18,773,955,0,0,80.94,400,355,"花崗里",NULL
0,1232,22,1254,1544,0,0,81.22,678,554,"虹橋里",NULL
0,1405,29,1434,1754,0,0,81.76,820,585,"水錦里",NULL
0,1759,42,1801,2258,0,0,79.76,997,762,"智仁里",NULL
0,856,16,872,1091,0,0,79.93,443,413,"和明里",NULL
0,777,8,785,1013,0,0,77.49,400,377,"忠勇里",NULL
0,847,18,865,1080,0,0,80.09,433,414,"玉田里",NULL
0,778,24,802,1014,0,0,79.09,377,401,"仁德里",NULL
0,1377,25,1402,1734,0,0,80.85,748,629,"博愛里",NULL
0,654,14,668,875,0,0,76.34,300,354,"福仁里",NULL
0,796,26,822,1037,0,0,79.27,372,424,"誠仁里",NULL
0,2194,40,2234,2870,0,0,77.84,1121,1073,"吉仁里",NULL
0,661,17,678,882,0,0,76.87,316,345,"育仁里",NULL
0,1055,30,1085,1390,0,0,78.06,538,517,"英仁里",NULL
0,631,4,635,864,0,0,73.5,303,328,"龍門里",NULL
0,1012,28,1040,1372,0,0,75.8,551,461,"德厚里",NULL
0,778,18,796,975,0,0,81.64,370,408,"曲水里",NULL
0,738,19,757,954,0,0,79.35,386,352,"崇文里",NULL
0,793,30,823,1041,0,0,79.06,397,396,"文安里",NULL
0,569,7,576,712,0,0,80.9,358,211,"兆連里",NULL
0,897,26,923,1185,0,0,77.89,507,390,"獅球里",NULL
0,891,37,928,1197,0,0,77.53,446,445,"書院里",NULL
0,2253,65,2318,2871,0,0,80.74,1594,659,"朝棟里",NULL
0,1806,26,1832,2298,0,0,79.72,1025,781,"光華里",NULL
0,590,23,613,770,0,0,79.61,347,243,"明德里",NULL
0,542,14,556,669,0,0,83.11,297,245,"同風里",NULL
0,706,4,710,858,0,0,82.75,289,417,"文昌里",NULL
0,589,12,601,722,0,0,83.24,296,293,"新店里",NULL
0,599,18,617,788,0,0,78.3,274,325,"新建里",NULL
0,872,29,901,1121,0,0,80.37,440,432,"安民里",NULL
0,770,27,797,991,0,0,80.42,394,376,"安平里",NULL
0,856,16,872,1117,0,0,78.07,409,447,"中山里",NULL
0,735,7,742,985,0,0,75.33,402,333,"民治里",NULL
0,1004,37,1041,1312,0,0,79.34,591,413,"中興里",NULL
0,611,12,623,837,0,0,74.43,393,218,"仁正里",NULL
0,1104,26,1130,1452,0,0,77.82,567,537,"健民里",NULL
0,921,32,953,1238,0,0,76.98,549,372,"通化里",NULL
0,1074,38,1112,1495,0,0,74.38,619,455,"居仁里",NULL
0,1529,54,1583,2024,0,0,78.21,871,658,"通明里",NULL
0,494,16,510,674,0,0,75.67,324,170,"和平里",NULL
0,561,21,582,758,0,0,76.78,276,285,"仙洞里",NULL
0,699,23,722,960,0,0,75.21,363,336,"太白里",NULL
0,1283,27,1310,1659,0,0,78.96,703,580,"協和里",NULL
0,779,24,803,1132,0,0,70.94,451,328,"文化里",NULL
0,2497,61,2558,3175,0,0,80.57,1461,1036,"德安里",NULL
0,3897,71,3968,4799,0,0,82.68,2465,1432,"德和里",NULL
0,3511,66,3577,4639,0,0,77.11,2226,1285,"中和里",NULL
0,3645,69,3714,4963,0,0,74.83,2190,1455,"和慶里",NULL
0,1240,41,1281,1669,0,0,76.75,643,597,"西康里",NULL
0,725,29,754,998,0,0,75.55,403,322,"西定里",NULL
0,777,18,795,996,0,0,79.82,413,364,"西華里",NULL
0,646,15,661,852,0,0,77.58,359,287,"西榮里",NULL
0,1059,49,1108,1467,0,0,75.53,590,469,"新西里",NULL
0,1027,33,1060,1353,0,0,78.34,608,419,"西川里",NULL
0,929,34,963,1243,0,0,77.47,520,409,"定國里",NULL
0,1015,28,1043,1306,0,0,79.86,519,496,"定邦里",NULL
0,767,22,789,1034,0,0,76.31,366,401,"慈仁里",NULL
0,1716,68,1784,2302,0,0,77.5,971,745,"干城里",NULL
0,1499,43,1542,2003,0,0,76.98,758,741,"永康里",NULL
0,721,12,733,912,0,0,80.37,374,347,"安和里",NULL
0,513,18,531,653,0,0,81.32,250,263,"樂一里",NULL
0,2515,69,2584,3312,0,0,78.02,1206,1309,"嘉仁里",NULL
0,4070,70,4140,5191,0,0,79.75,2573,1497,"三民里",NULL
0,3425,65,3490,4193,0,0,83.23,2136,1289,"四維里",NULL
0,2718,53,2771,3484,0,0,79.54,1738,980,"五福里",NULL
0,2750,59,2809,3558,0,0,78.95,1743,1007,"六合里",NULL
0,2240,62,2302,2865,0,0,80.35,1307,933,"七賢里",NULL
0,2174,26,2200,2644,0,0,83.21,1508,666,"長樂里",NULL
0,2102,43,2145,2841,0,0,75.5,1285,817,"鶯歌里",NULL
0,1989,31,2020,2505,0,0,80.64,1262,727,"鶯安里",NULL
0,2633,47,2680,3519,0,0,76.16,1615,1018,"興寮里",NULL
0,2545,61,2606,3346,0,0,77.88,1519,1026,"外寮里",NULL
0,2360,35,2395,3098,0,0,77.31,1363,997,"新崙里",NULL
0,2616,58,2674,3393,0,0,78.81,1655,961,"武崙里",NULL
0,1000,23,1023,1315,0,0,77.79,585,415,"中崙里",NULL
0,2611,68,2679,3577,0,0,74.9,1571,1040,"內寮里",NULL
0,1070,25,1095,1375,0,0,79.64,604,466,"八西里",NULL
0,479,18,497,637,0,0,78.02,255,224,"八中里",NULL
0,542,15,557,713,0,0,78.12,307,235,"八堵里",NULL
0,448,15,463,625,0,0,74.08,227,221,"八南里",NULL
0,2529,52,2581,3309,0,0,78,1632,897,"過港里",NULL
0,1782,40,1822,2257,0,0,80.73,1037,745,"暖暖里",NULL
0,1759,34,1793,2274,0,0,78.85,1082,677,"暖同里",NULL
0,284,11,295,397,0,0,74.31,159,125,"暖東里",NULL
0,2825,51,2876,3654,0,0,78.71,1658,1167,"暖西里",NULL
0,1739,48,1787,2282,0,0,78.31,1205,534,"碇內里",NULL
0,1808,36,1844,2319,0,0,79.52,1331,477,"碇和里",NULL
0,2581,42,2623,3452,0,0,75.98,1712,869,"碇祥里",NULL
0,3373,63,3436,4438,0,0,77.42,2173,1200,"碇安里",NULL
0,2931,66,2997,3749,0,0,79.94,1769,1162,"長興里",NULL
0,1702,41,1743,2215,0,0,78.69,946,756,"正光里",NULL
0,1589,32,1621,1985,0,0,81.66,911,678,"正明里",NULL
0,2881,65,2946,3626,0,0,81.25,1826,1055,"富民里",NULL
0,1616,36,1652,2049,0,0,80.62,990,626,"永平里",NULL
0,1583,35,1618,2055,0,0,78.73,964,619,"永安里",NULL
0,1239,21,1260,1541,0,0,81.77,674,565,"八德里",NULL
0,730,9,739,934,0,0,79.12,404,326,"自強里",NULL
0,2593,51,2644,3298,0,0,80.17,1493,1100,"泰安里",NULL
0,1077,36,1113,1431,0,0,77.78,601,476,"六堵里",NULL
0,2647,45,2692,3539,0,0,76.07,1497,1150,"堵南里",NULL
0,2270,46,2316,3095,0,0,74.83,1195,1075,"堵北里",NULL
0,3627,66,3693,4673,0,0,79.03,1933,1694,"百福里",NULL
0,2622,63,2685,3429,0,0,78.3,1432,1190,"實踐里",NULL
0,346,3,349,453,0,0,77.04,152,194,"瑪南里",NULL
0,220,15,235,307,0,0,76.55,119,101,"瑪東里",NULL
0,277,12,289,360,0,0,80.28,113,164,"瑪西里",NULL
0,1095,23,1118,1380,0,0,81.01,621,474,"友一里",NULL
0,352,19,371,445,0,0,83.37,153,199,"友二里",NULL
0,731,18,749,1207,0,0,62.05,404,327,"育賢里",NULL
0,1375,32,1407,1773,0,0,79.36,1080,295,"親仁里",NULL
0,568,18,586,715,0,0,81.96,237,331,"東門里",NULL
0,577,10,587,758,0,0,77.44,246,331,"成功里",NULL
0,345,8,353,467,0,0,75.59,170,175,"榮光里",NULL
0,377,10,387,505,0,0,76.63,175,202,"中正里",NULL
0,1336,23,1359,1722,0,0,78.92,949,387,"錦華里",NULL
0,2876,48,2924,3536,0,0,82.69,1704,1172,"文華里",NULL
0,3076,53,3129,3833,0,0,81.63,1757,1319,"復中里",NULL
0,2896,58,2954,3582,0,0,82.47,1710,1186,"復興里",NULL
0,3219,69,3288,3927,0,0,83.73,1688,1531,"三民里",NULL
0,2060,42,2102,2610,0,0,80.54,1186,874,"東園里",NULL
0,1811,41,1852,2256,0,0,82.09,1106,705,"公園里",NULL
0,1736,38,1774,2157,0,0,82.24,896,840,"建華里",NULL
0,2344,42,2386,2903,0,0,82.19,1457,887,"東山里",NULL
0,3266,59,3325,4107,0,0,80.96,2163,1103,"綠水里",NULL
0,857,11,868,1063,0,0,81.66,412,445,"東勢里",NULL
0,1474,52,1526,1844,0,0,82.75,746,728,"光復里",NULL
0,1195,18,1213,1493,0,0,81.25,536,659,"前溪里",NULL
0,736,30,766,955,0,0,80.21,347,389,"水源里",NULL
0,1150,56,1206,1478,0,0,81.6,446,704,"前溪里",NULL
0,1250,44,1294,1579,0,0,81.95,571,679,"水源里",NULL
0,1369,63,1432,1751,0,0,81.78,761,608,"千甲里",NULL
0,2010,53,2063,2551,0,0,80.87,1361,649,"豐功里",NULL
0,99,4,103,168,0,0,61.31,90,9,"偉功里",NULL
0,2509,65,2574,3008,0,0,85.57,2200,309,"武功里",NULL
0,2624,79,2703,3235,0,0,83.55,2078,546,"軍功里",NULL
0,679,19,698,857,0,0,81.45,559,120,"立功里",NULL
0,2023,38,2061,2471,0,0,83.41,1721,302,"建功里",NULL
0,2563,34,2597,3273,0,0,79.35,1844,719,"光明里",NULL
0,2269,47,2316,2772,0,0,83.55,1448,821,"龍山里",NULL
0,4295,77,4372,5103,0,0,85.68,2929,1366,"科園里",NULL
0,1803,36,1839,2247,0,0,81.84,907,896,"埔頂里",NULL
0,3252,72,3324,4015,0,0,82.79,2085,1167,"新莊里",NULL
0,2941,92,3033,3688,0,0,82.24,1996,945,"關東里",NULL
0,3464,93,3557,4372,0,0,81.36,2457,1007,"金山里",NULL
0,2719,55,2774,3316,0,0,83.66,1771,948,"仙水里",NULL
0,702,20,722,871,0,0,82.89,436,266,"仙宮里",NULL
0,468,5,473,601,0,0,78.7,200,268,"關帝里",NULL
0,541,11,552,701,0,0,78.74,230,311,"南門里",NULL
0,729,9,738,911,0,0,81.01,283,446,"南市里",NULL
0,1004,30,1034,1292,0,0,80.03,454,550,"福德里",NULL
0,3469,65,3534,4490,0,0,78.71,1871,1598,"振興里",NULL
0,2457,48,2505,3078,0,0,81.38,1172,1285,"新興里",NULL
0,637,20,657,858,0,0,76.57,283,354,"寺前里",NULL
0,656,17,673,806,0,0,83.5,240,416,"竹蓮里",NULL
0,586,25,611,766,0,0,79.77,351,235,"下竹里",NULL
0,2381,50,2431,2996,0,0,81.14,1179,1202,"頂竹里",NULL
0,1182,34,1216,1506,0,0,80.74,571,611,"南大里",NULL
0,2583,79,2662,3275,0,0,81.28,1340,1243,"新光里",NULL
0,2426,43,2469,3028,0,0,81.54,1287,1139,"光鎮里",NULL
0,3865,85,3950,4945,0,0,79.88,2110,1755,"高峰里",NULL
0,2329,34,2363,2914,0,0,81.09,1231,1098,"湖濱里",NULL
0,2871,48,2919,3492,0,0,83.59,1739,1132,"柴橋里",NULL
0,2521,50,2571,3271,0,0,78.6,1614,907,"明湖里",NULL
0,408,14,422,521,0,0,81,188,220,"西門里",NULL
0,647,12,659,808,0,0,81.56,273,374,"潛園里",NULL
0,412,17,429,523,0,0,82.03,136,276,"中央里",NULL
0,410,13,423,550,0,0,76.91,193,217,"石坊里",NULL
0,606,15,621,761,0,0,81.6,237,369,"仁德里",NULL
0,925,32,957,1154,0,0,82.93,364,561,"崇禮里",NULL
0,1003,21,1024,1238,0,0,82.71,440,563,"興南里",NULL
0,2711,50,2761,3389,0,0,81.47,1439,1272,"育英里",NULL
0,983,28,1011,1304,0,0,77.53,574,409,"台溪里",NULL
0,3595,170,3765,4730,0,0,79.6,2203,1392,"曲溪里",NULL
0,1975,49,2024,2534,0,0,79.87,861,1114,"西雅里",NULL
0,2282,63,2345,2939,0,0,79.79,1291,991,"客雅里",NULL
0,2742,61,2803,3404,0,0,82.34,1015,1727,"南勢里",NULL
0,1260,36,1296,1521,0,0,85.21,1218,42,"大鵬里",NULL
0,663,19,682,838,0,0,81.38,405,258,"大同里",NULL
0,540,7,547,664,0,0,82.38,212,328,"中山里",NULL
0,454,13,467,588,0,0,79.42,171,283,"中興里",NULL
0,1038,19,1057,1312,0,0,80.56,496,542,"新民里",NULL
0,919,24,943,1167,0,0,80.81,386,533,"長和里",NULL
0,729,10,739,924,0,0,79.98,269,460,"北門里",NULL
0,3090,77,3167,4014,0,0,78.9,1412,1678,"民富里",NULL
0,3234,65,3299,4046,0,0,81.54,1549,1685,"磐石里",NULL
0,2910,65,2975,3658,0,0,81.33,1290,1620,"新雅里",NULL
0,2582,53,2635,3177,0,0,82.94,1275,1307,"文雅里",NULL
0,2103,47,2150,2663,0,0,80.74,1113,990,"水田里",NULL
0,1634,29,1663,2021,0,0,82.29,844,790,"光田里",NULL
0,2267,50,2317,3024,0,0,76.62,1317,950,"光華里",NULL
0,2973,43,3016,3664,0,0,82.31,1650,1323,"金華里",NULL
0,2011,40,2051,2531,0,0,81.04,1187,824,"湳雅里",NULL
0,1123,26,1149,1352,0,0,84.99,557,566,"金雅里",NULL
0,3608,45,3653,4374,0,0,83.52,2275,1333,"湳中里",NULL
0,3793,85,3878,4702,0,0,82.48,2021,1772,"舊社里",NULL
0,3443,59,3502,4280,0,0,81.82,2113,1330,"金竹里",NULL
0,1310,25,1335,1585,0,0,84.23,1165,145,"武陵里",NULL
0,2365,48,2413,2954,0,0,81.69,1308,1057,"福林里",NULL
0,2950,50,3000,3683,0,0,81.46,1533,1417,"境福里",NULL
0,2393,71,2464,2936,0,0,83.92,1517,876,"士林里",NULL
0,677,21,698,882,0,0,79.14,244,433,"古賢里",NULL
0,2834,82,2916,3809,0,0,76.56,1385,1449,"南寮里",NULL
0,1367,44,1411,1765,0,0,79.94,633,734,"康樂里",NULL
0,1140,24,1164,1477,0,0,78.81,488,652,"中寮里",NULL
0,1297,33,1330,1682,0,0,79.07,598,699,"海濱里",NULL
0,943,27,970,1195,0,0,81.17,359,584,"港北里",NULL
0,420,3,423,555,0,0,76.22,207,213,"舊港里",NULL
0,2396,55,2451,3025,0,0,81.02,1306,1090,"頂埔里",NULL
0,2131,42,2173,2701,0,0,80.45,1123,1008,"頂福里",NULL
0,1939,35,1974,2393,0,0,82.49,943,996,"中埔里",NULL
0,1959,48,2007,2435,0,0,82.42,993,966,"牛埔里",NULL
0,1925,60,1985,2442,0,0,81.29,780,1145,"埔前里",NULL
0,1441,46,1487,1842,0,0,80.73,431,1010,"樹下里",NULL
0,1254,49,1303,1603,0,0,81.29,434,820,"浸水里",NULL
0,1654,41,1695,2035,0,0,83.29,826,828,"虎林里",NULL
0,3675,93,3768,4764,0,0,79.09,1615,2060,"虎山里",NULL
0,1458,45,1503,1875,0,0,80.16,586,872,"港南里",NULL
0,1856,42,1898,2315,0,0,81.99,1141,715,"東香里",NULL
0,1611,56,1667,2054,0,0,81.16,830,781,"香村里",NULL
0,2150,70,2220,2778,0,0,79.91,997,1153,"香山里",NULL
0,1661,37,1698,2037,0,0,83.36,683,978,"大庄里",NULL
0,794,46,840,1009,0,0,83.25,351,443,"美山里",NULL
0,1326,45,1371,1724,0,0,79.52,622,704,"朝山里",NULL
0,1481,60,1541,1932,0,0,79.76,712,769,"海山里",NULL
0,930,20,950,1173,0,0,80.99,395,535,"鹽水里",NULL
0,2715,72,2787,3512,0,0,79.36,1360,1355,"內湖里",NULL
0,611,30,641,794,0,0,80.73,204,407,"南港里",NULL
0,1052,25,1077,1350,0,0,79.78,596,456,"中隘里",NULL
0,474,8,482,631,0,0,76.39,242,232,"南隘里",NULL
0,588,21,609,732,0,0,83.2,289,299,"大湖里",NULL
0,611,32,643,815,0,0,78.9,270,341,"茄苳里",NULL
0,1588,29,1617,1972,0,0,82,738,850,"綠川里",NULL
0,1385,29,1414,1779,0,0,79.48,629,756,"繼光里",NULL
0,1325,25,1350,1710,0,0,78.95,605,720,"公園里",NULL
0,1898,46,1944,2460,0,0,79.02,956,942,"光復里",NULL
0,1895,36,1931,2414,0,0,79.99,846,1049,"大墩里",NULL
0,1429,40,1469,1875,0,0,78.35,667,762,"柳川里",NULL
0,1586,23,1609,2034,0,0,79.11,751,835,"大誠里",NULL
0,1426,39,1465,1868,0,0,78.43,676,750,"中華里",NULL
0,2567,41,2608,3384,0,0,77.07,1177,1390,"新庄里",NULL
0,2726,48,2774,3404,0,0,81.49,1093,1633,"振興里",NULL
0,2673,62,2735,3380,0,0,80.92,991,1682,"東橋里",NULL
0,2358,56,2414,2939,0,0,82.14,997,1361,"東興里",NULL
0,1511,42,1553,1911,0,0,81.27,695,816,"泉源里",NULL
0,1894,41,1935,2457,0,0,78.75,770,1124,"干城里",NULL
0,1831,44,1875,2354,0,0,79.65,798,1033,"旱溪里",NULL
0,1482,38,1520,1894,0,0,80.25,573,909,"樂成里",NULL
0,3891,67,3958,4728,0,0,83.71,1400,2491,"東門里",NULL
0,2198,56,2254,2744,0,0,82.14,925,1273,"十甲里",NULL
0,3167,67,3234,3928,0,0,82.33,1400,1767,"東英里",NULL
0,2698,41,2739,3338,0,0,82.06,1408,1290,"東南里",NULL
0,2259,40,2299,2868,0,0,80.16,1198,1061,"東勢里",NULL
0,2046,44,2090,2577,0,0,81.1,1213,833,"合作里",NULL
0,2494,69,2563,3207,0,0,79.92,1862,632,"富仁里",NULL
0,1326,27,1353,1685,0,0,80.3,981,345,"富臺里",NULL
0,4405,78,4483,5336,0,0,84.01,1713,2692,"東信里",NULL
0,1492,28,1520,2087,0,0,72.83,946,546,"三民里",NULL
0,1320,26,1346,1766,0,0,76.22,717,603,"平和里",NULL
0,1500,22,1522,1952,0,0,77.97,981,519,"利民里",NULL
0,3345,50,3395,4209,0,0,80.66,1683,1662,"公民里",NULL
0,1409,26,1435,1782,0,0,80.53,762,647,"廣民里",NULL
0,1855,28,1883,2274,0,0,82.81,1041,814,"東昇里",NULL
0,1710,21,1731,2104,0,0,82.27,986,724,"民生里",NULL
0,3883,58,3941,4891,0,0,80.58,1929,1954,"昇平里",NULL
0,2509,47,2556,3124,0,0,81.82,1205,1304,"藍興里",NULL
0,3746,72,3818,4721,0,0,80.87,1780,1966,"公館里",NULL
0,1677,35,1712,2170,0,0,78.89,719,958,"和龍里",NULL
0,1947,40,1987,2460,0,0,80.77,1011,936,"民龍里",NULL
0,1939,34,1973,2502,0,0,78.86,886,1053,"安龍里",NULL
0,4300,81,4381,5423,0,0,80.79,2321,1979,"吉龍里",NULL
0,2335,41,2376,3032,0,0,78.36,1074,1261,"後龍里",NULL
0,2584,52,2636,3224,0,0,81.76,1190,1394,"中興里",NULL
0,3641,45,3686,4567,0,0,80.71,1715,1926,"忠明里",NULL
0,3746,41,3787,4613,0,0,82.09,1974,1772,"公正里",NULL
0,2913,47,2960,3724,0,0,79.48,1541,1372,"公平里",NULL
0,2574,43,2617,3260,0,0,80.28,1371,1203,"公德里",NULL
0,2195,47,2242,2731,0,0,82.09,1003,1192,"公益里",NULL
0,3625,71,3696,4559,0,0,81.07,1829,1796,"土庫里",NULL
0,4091,57,4148,5122,0,0,80.98,2048,2043,"忠誠里",NULL
0,2307,36,2343,2846,0,0,82.33,1178,1129,"大忠里",NULL
0,2211,40,2251,2816,0,0,79.94,1189,1022,"吉龍里",NULL
0,1746,38,1784,2238,0,0,79.71,874,872,"長春里",NULL
0,2094,31,2125,2546,0,0,83.46,1006,1088,"長榮里",NULL
0,2715,57,2772,3379,0,0,82.04,1248,1467,"城隍里",NULL
0,2864,57,2921,3575,0,0,81.71,1285,1579,"國光里",NULL
0,2574,37,2611,3224,0,0,80.99,1256,1318,"南門里",NULL
0,1998,36,2034,2508,0,0,81.1,1030,968,"德義里",NULL
0,2143,45,2188,2698,0,0,81.1,994,1149,"積善里",NULL
0,1762,36,1798,2184,0,0,82.33,849,913,"江川里",NULL
0,2329,30,2359,3236,0,0,72.9,1254,1075,"新榮里",NULL
0,2779,59,2838,3425,0,0,82.86,1358,1421,"福興里",NULL
0,3450,80,3530,4367,0,0,80.83,1649,1801,"福平里",NULL
0,2497,55,2552,3232,0,0,78.96,1358,1139,"福順里",NULL
0,1814,31,1845,2319,0,0,79.56,878,936,"和平里",NULL
0,2435,48,2483,2997,0,0,82.85,1068,1367,"平和里",NULL
0,3145,45,3190,3979,0,0,80.17,1829,1316,"南和里",NULL
0,3491,68,3559,4363,0,0,81.57,1897,1594,"永興里",NULL
0,2398,57,2455,3086,0,0,79.55,1161,1237,"永和里",NULL
0,5427,86,5513,6742,0,0,81.77,2814,2613,"樹義里",NULL
0,3035,51,3086,3743,0,0,82.45,1620,1415,"工學里",NULL
0,3795,61,3856,4842,0,0,79.64,2083,1712,"樹德里",NULL
0,2391,44,2435,2991,0,0,81.41,1238,1153,"西川里",NULL
0,2656,52,2708,3300,0,0,82.06,1254,1402,"崇倫里",NULL
0,1294,23,1317,1647,0,0,79.96,555,739,"中正里",NULL
0,1265,35,1300,1687,0,0,77.06,478,787,"六合里",NULL
0,1432,30,1462,1903,0,0,76.83,626,806,"光大里",NULL
0,2103,53,2156,2698,0,0,79.91,1337,766,"文莊里",NULL
0,1718,57,1775,2256,0,0,78.68,762,956,"大湖里",NULL
0,994,21,1015,1311,0,0,77.42,438,556,"五常里",NULL
0,1423,24,1447,1865,0,0,77.59,690,733,"錦平里",NULL
0,1504,33,1537,2000,0,0,76.85,913,591,"新興里",NULL
0,1718,21,1739,2259,0,0,76.98,884,834,"新北里",NULL
0,2318,53,2371,2970,0,0,79.83,1916,402,"樂英里",NULL
0,2381,42,2423,2987,0,0,81.12,1273,1108,"錦村里",NULL
0,3117,63,3180,4019,0,0,79.12,1667,1450,"建成里",NULL
0,2599,49,2648,3317,0,0,79.83,1428,1171,"建德里",NULL
0,2117,45,2162,2692,0,0,80.31,1214,903,"錦洲里",NULL
0,2254,40,2294,2976,0,0,77.08,1390,864,"錦祥里",NULL
0,1370,28,1398,1775,0,0,78.76,763,607,"金華里",NULL
0,3185,61,3246,4211,0,0,77.08,1801,1384,"金龍里",NULL
0,1284,27,1311,1736,0,0,75.52,690,594,"邱厝里",NULL
0,4061,71,4132,5212,0,0,79.28,2180,1881,"建興里",NULL
0,2609,45,2654,3323,0,0,79.87,1457,1152,"頂厝里",NULL
0,2194,62,2256,2844,0,0,79.32,1197,997,"崇德里",NULL
0,2478,48,2526,3618,0,0,69.82,1510,968,"賴厝里",NULL
0,1863,38,1901,2391,0,0,79.51,996,867,"賴福里",NULL
0,2407,50,2457,3028,0,0,81.14,1425,982,"賴興里",NULL
0,2744,58,2802,3556,0,0,78.8,1547,1197,"賴旺里",NULL
0,2594,31,2625,3257,0,0,80.6,1502,1092,"賴明里",NULL
0,1811,36,1847,2286,0,0,80.8,1055,756,"梅川里",NULL
0,2969,70,3039,3847,0,0,79,1463,1506,"賴村里",NULL
0,2530,64,2594,3274,0,0,79.23,1460,1070,"育德里",NULL
0,3062,61,3123,3810,0,0,81.97,1616,1446,"淡溝里",NULL
0,4472,107,4579,5665,0,0,80.83,2180,2292,"健行里",NULL
0,3487,53,3540,4272,0,0,82.87,1836,1651,"明德里",NULL
0,2063,36,2099,2641,0,0,79.48,1115,948,"明新里",NULL
0,3850,49,3899,4966,0,0,78.51,2124,1726,"長青里",NULL
0,2300,27,2327,2923,0,0,79.61,1466,834,"立人里",NULL
0,1976,49,2025,2469,0,0,82.02,977,999,"中達里",NULL
0,3015,45,3060,3709,0,0,82.5,1492,1523,"西安里",NULL
0,2307,21,2328,2911,0,0,79.97,1324,983,"至善里",NULL
0,3799,57,3856,4722,0,0,81.66,2537,1262,"西平里",NULL
0,2918,66,2984,3616,0,0,82.52,1353,1565,"西墩里",NULL
0,1868,29,1897,2280,0,0,83.2,874,994,"潮洋里",NULL
0,783,6,789,944,0,0,83.58,226,557,"龍潭里",NULL
0,4187,60,4247,5107,0,0,83.16,2493,1694,"惠來里",NULL
0,2527,54,2581,3248,0,0,79.46,1548,979,"上石里",NULL
0,2217,22,2239,2760,0,0,81.12,1243,974,"上安里",NULL
0,2895,45,2940,3562,0,0,82.54,1661,1234,"上德里",NULL
0,3029,54,3083,3855,0,0,79.97,1681,1348,"逢甲里",NULL
0,3307,78,3385,4120,0,0,82.16,1953,1354,"逢福里",NULL
0,2039,36,2075,2594,0,0,79.99,1050,989,"何厝里",NULL
0,2513,37,2550,3161,0,0,80.67,1284,1229,"何明里",NULL
0,2691,45,2736,3337,0,0,81.99,1543,1148,"何南里",NULL
0,4269,75,4344,5382,0,0,80.71,2347,1922,"何成里",NULL
0,3096,57,3153,4228,0,0,74.57,1496,1600,"何安里",NULL
0,3826,54,3880,4868,0,0,79.7,1950,1876,"何仁里",NULL
0,2382,32,2414,2927,0,0,82.47,1319,1063,"何德里",NULL
0,2873,43,2916,3561,0,0,81.89,1496,1377,"何福里",NULL
0,3901,50,3951,4883,0,0,80.91,2209,1692,"何源里",NULL
0,2681,58,2739,3340,0,0,82.01,1222,1459,"大河里",NULL
0,795,30,825,986,0,0,83.67,683,112,"大石里",NULL
1,1541,27,1568,1870,0,0,83.85,824,717,"建民里",NULL
2,1581,32,1613,1963,0,0,82.17,693,888,"建民里",NULL
3,1505,33,1538,1822,0,0,84.41,648,857,"文林里",NULL
4,1506,26,1532,1818,0,0,84.27,722,784,"文林里",NULL
5,1168,21,1189,1427,0,0,83.32,543,625,"石牌里",NULL
6,1170,28,1198,1407,0,0,85.15,542,628,"石牌里",NULL
7,1174,19,1193,1451,0,0,82.22,550,624,"石牌里",NULL
8,1531,35,1566,1845,0,0,84.88,762,769,"福興里",NULL
9,1570,37,1607,1916,0,0,83.87,722,848,"福興里",NULL
10,1353,17,1370,1592,0,0,86.06,747,606,"福興里",NULL
11,1482,27,1509,1885,0,0,80.05,696,786,"榮光里",NULL
12,1656,30,1686,1955,0,0,86.24,810,846,"榮光里",NULL
13,1541,23,1564,1863,0,0,83.95,929,612,"榮光里",NULL
14,1187,21,1208,1500,0,0,80.53,705,482,"榮華里",NULL
15,1243,17,1260,1597,0,0,78.9,703,540,"榮華里",NULL
16,1285,22,1307,1569,0,0,83.3,663,622,"榮華里",NULL
17,1181,14,1195,1417,0,0,84.33,654,527,"榮華里",NULL
18,1509,34,1543,1881,0,0,82.03,837,672,"裕民里",NULL
19,1470,17,1487,1782,0,0,83.45,765,705,"裕民里",NULL
20,1467,41,1508,1784,0,0,84.53,773,694,"裕民里",NULL
21,1438,24,1462,1736,0,0,84.22,853,585,"振華里",NULL
22,1498,34,1532,1834,0,0,83.53,819,679,"振華里",NULL
23,1150,21,1171,1417,0,0,82.64,638,512,"振華里",NULL
24,1180,24,1204,1454,0,0,82.81,584,596,"振華里",NULL
25,1313,40,1353,1664,0,0,81.31,624,689,"永和里",NULL
26,1273,20,1293,1586,0,0,81.53,678,595,"永和里",NULL
27,1548,41,1589,1955,0,0,81.28,822,726,"永和里",NULL
28,1100,9,1109,1401,0,0,79.16,618,482,"永和里",NULL
29,1432,24,1456,1777,0,0,81.94,893,539,"永欣里",NULL
30,1432,16,1448,1774,0,0,81.62,969,463,"永欣里",NULL
31,1403,30,1433,1768,0,0,81.05,794,609,"永欣里",NULL
32,1509,29,1538,1847,0,0,83.27,781,728,"永明里",NULL
33,1406,28,1434,1730,0,0,82.89,813,593,"永明里",NULL
34,1514,27,1541,1814,0,0,84.95,862,652,"東華里",NULL
35,1546,20,1566,1818,0,0,86.14,906,640,"東華里",NULL
36,1365,19,1384,1661,0,0,83.32,772,593,"吉利里",NULL
37,1446,28,1474,1794,0,0,82.16,813,633,"吉利里",NULL
38,1428,27,1455,1737,0,0,83.77,875,553,"吉利里",NULL
39,1587,18,1605,1897,0,0,84.61,714,873,"吉慶里",NULL
40,1772,35,1807,2146,0,0,84.2,879,893,"吉慶里",NULL
41,1579,35,1614,1941,0,0,83.15,778,801,"尊賢里",NULL
42,1557,34,1591,1907,0,0,83.43,670,887,"尊賢里",NULL
43,1163,29,1192,1445,0,0,82.49,561,602,"立賢里",NULL
44,1072,20,1092,1266,0,0,86.26,530,542,"立賢里",NULL
45,1156,24,1180,1455,0,0,81.1,570,586,"立賢里",NULL
46,1520,10,1530,1789,0,0,85.52,814,706,"立農里",NULL
47,1481,18,1499,1768,0,0,84.79,687,794,"立農里",NULL
48,1274,29,1303,1536,0,0,84.83,610,664,"立農里",NULL
49,1384,22,1406,1653,0,0,85.06,692,692,"立農里",NULL
50,1541,29,1570,1899,0,0,82.68,706,835,"八仙里",NULL
51,1647,39,1686,2047,0,0,82.36,787,860,"八仙里",NULL
52,1189,25,1214,1459,0,0,83.21,354,835,"洲美里",NULL
53,1361,40,1401,1701,0,0,82.36,652,709,"奇岩里",NULL
54,1460,30,1490,1781,0,0,83.66,818,642,"奇岩里",NULL
55,1492,37,1529,1836,0,0,83.28,784,708,"奇岩里",NULL
56,1850,35,1885,2348,0,0,80.28,917,933,"奇岩里",NULL
57,1521,39,1560,2382,0,0,65.49,634,887,"清江里",NULL
58,1475,38,1513,1849,0,0,81.83,665,810,"清江里",NULL
59,1645,36,1681,2013,0,0,83.51,749,896,"清江里",NULL
60,1053,22,1075,1268,0,0,84.78,622,431,"清江里",NULL
61,1231,30,1261,1522,0,0,82.85,540,691,"中央里",NULL
62,1208,30,1238,1516,0,0,81.66,518,690,"中央里",NULL
63,1226,21,1247,1572,0,0,79.33,546,680,"中央里",NULL
64,1192,22,1214,1475,0,0,82.31,554,638,"中央里",NULL
65,1308,31,1339,1579,0,0,84.8,628,680,"長安里",NULL
66,1204,30,1234,1500,0,0,82.27,587,617,"長安里",NULL
67,1202,27,1229,1555,0,0,79.04,595,607,"長安里",NULL
68,1232,39,1271,1505,0,0,84.45,524,708,"大同里",NULL
69,1247,23,1270,1554,0,0,81.72,523,724,"大同里",NULL
70,1452,18,1470,1758,0,0,83.62,778,674,"大同里",NULL
71,1367,12,1379,1671,0,0,82.53,631,736,"溫泉里",NULL
72,1333,17,1350,1686,0,0,80.07,739,594,"溫泉里",NULL
73,1448,12,1460,1771,0,0,82.44,808,640,"溫泉里",NULL
74,1015,21,1036,1321,0,0,78.43,782,233,"林泉里",NULL
75,1091,26,1117,1454,0,0,76.82,600,491,"林泉里",NULL
76,1080,29,1109,1433,0,0,77.39,615,465,"中心里",NULL
77,1297,29,1326,1651,0,0,80.31,705,592,"中心里",NULL
78,1325,25,1350,1734,0,0,77.85,668,657,"中心里",NULL
79,1270,28,1298,1553,0,0,83.58,590,680,"中庸里",NULL
80,1521,33,1554,1881,0,0,82.62,744,777,"中庸里",NULL
81,1384,18,1402,1704,0,0,82.28,787,597,"開明里",NULL
82,1412,31,1443,1759,0,0,82.04,826,586,"開明里",NULL
83,1369,34,1403,1720,0,0,81.57,683,686,"開明里",NULL
84,1367,23,1390,1689,0,0,82.3,775,592,"中和里",NULL
85,961,31,992,1189,0,0,83.43,497,464,"中和里",NULL
86,982,22,1004,1196,0,0,83.95,588,394,"中和里",NULL
87,1212,27,1239,1482,0,0,83.6,707,505,"智仁里",NULL
88,1394,30,1424,1682,0,0,84.66,788,606,"智仁里",NULL
89,1350,22,1372,1645,0,0,83.4,790,560,"智仁里",NULL
90,1140,17,1157,1424,0,0,81.25,625,515,"秀山里",NULL
91,1173,32,1205,1473,0,0,81.81,673,500,"秀山里",NULL
92,1440,22,1462,1710,0,0,85.5,1109,331,"文化里",NULL
93,1396,18,1414,1652,0,0,85.59,900,496,"文化里",NULL
94,1432,25,1457,1751,0,0,83.21,798,634,"豐年里",NULL
95,1283,32,1315,1597,0,0,82.34,655,628,"豐年里",NULL
96,1566,47,1613,1981,0,0,81.42,912,654,"稻香里",NULL
97,1479,22,1501,1937,0,0,77.49,856,623,"稻香里",NULL
98,1622,44,1666,1944,0,0,85.7,779,843,"桃源里",NULL
99,1797,25,1822,2226,0,0,81.85,780,1017,"桃源里",NULL
100,1442,35,1477,1787,0,0,82.65,532,910,"一德里",NULL
101,1534,38,1572,1940,0,0,81.03,680,854,"一德里",NULL
102,1099,39,1138,1370,0,0,83.07,545,554,"一德里",NULL
103,1473,38,1511,1825,0,0,82.79,758,715,"關渡里",NULL
104,1266,31,1297,1599,0,0,81.11,605,661,"關渡里",NULL
105,1489,29,1518,1821,0,0,83.36,787,702,"關渡里",NULL
106,1342,24,1366,1654,0,0,82.59,636,706,"關渡里",NULL
107,942,66,1008,1267,0,0,79.56,572,370,"關渡里",NULL
108,332,9,341,414,0,0,82.37,164,168,"泉源里",NULL
109,1242,31,1273,1543,0,0,82.5,534,708,"泉源里",NULL
110,582,21,603,718,0,0,83.98,255,327,"湖山里",NULL
111,771,26,797,989,0,0,80.59,437,334,"湖山里",NULL
112,762,32,794,990,0,0,80.2,250,512,"大屯里",NULL
113,592,19,611,746,0,0,81.9,270,322,"湖田里",NULL
114,1518,26,1544,1866,0,0,82.74,635,883,"仁勇里",NULL
115,1362,18,1380,1654,0,0,83.43,672,690,"仁勇里",NULL
116,948,31,979,1201,0,0,81.52,492,456,"義信里",NULL
117,1166,33,1199,1469,0,0,81.62,565,601,"義信里",NULL
118,899,17,916,1134,0,0,80.78,722,177,"福林里",NULL
119,570,1,571,735,0,0,77.69,332,238,"福林里",NULL
120,1141,22,1163,1397,0,0,83.25,569,572,"福林里",NULL
121,1198,20,1218,1495,0,0,81.47,590,608,"福德里",NULL
122,1098,27,1125,1400,0,0,80.36,573,525,"福德里",NULL
123,720,6,726,1515,0,0,47.92,388,332,"福德里",NULL
124,1530,39,1569,1902,0,0,82.49,959,571,"福志里",NULL
125,1528,31,1559,1869,0,0,83.41,837,691,"福志里",NULL
126,1665,25,1690,2034,0,0,83.09,786,879,"福志里",NULL
127,1438,17,1455,1752,0,0,83.05,716,722,"舊佳里",NULL
128,1384,24,1408,1656,0,0,85.02,646,738,"舊佳里",NULL
129,1533,37,1570,1913,0,0,82.07,752,781,"舊佳里",NULL
130,1200,10,1210,1450,0,0,83.45,573,627,"福佳里",NULL
131,1291,32,1323,1595,0,0,82.95,617,674,"福佳里",NULL
132,1264,15,1279,1520,0,0,84.14,628,636,"福佳里",NULL
133,1241,18,1259,1482,0,0,84.95,619,622,"福佳里",NULL
134,1360,26,1386,1699,0,0,81.58,608,752,"後港里",NULL
135,1293,20,1313,1604,0,0,81.86,523,770,"後港里",NULL
136,1323,25,1348,1636,0,0,82.4,594,729,"後港里",NULL
137,1152,17,1169,1411,0,0,82.85,512,640,"後港里",NULL
138,1132,23,1155,1391,0,0,83.03,447,685,"福中里",NULL
139,1199,23,1222,1458,0,0,83.81,515,684,"福中里",NULL
140,1291,31,1322,1589,0,0,83.2,547,744,"福中里",NULL
141,1408,24,1432,1747,0,0,81.97,606,802,"前港里",NULL
142,1485,19,1504,1782,0,0,84.4,633,852,"前港里",NULL
143,1475,32,1507,1824,0,0,82.62,641,834,"百齡里",NULL
144,1565,47,1612,1908,0,0,84.49,710,855,"百齡里",NULL
145,1698,29,1727,2056,0,0,84,769,929,"百齡里",NULL
146,1107,19,1126,1386,0,0,81.24,533,574,"承德里",NULL
147,1311,30,1341,1601,0,0,83.76,616,695,"承德里",NULL
148,1221,27,1248,1483,0,0,84.15,681,540,"承德里",NULL
149,1423,34,1457,1830,0,0,79.62,698,725,"福華里",NULL
150,1443,42,1485,1835,0,0,80.93,767,676,"福華里",NULL
151,1553,32,1585,1887,0,0,84,719,834,"福華里",NULL
152,1014,27,1041,1261,0,0,82.55,511,503,"明勝里",NULL
153,1110,38,1148,1385,0,0,82.89,514,596,"明勝里",NULL
154,1125,17,1142,1405,0,0,81.28,473,652,"明勝里",NULL
155,1141,26,1167,1446,0,0,80.71,407,734,"福順里",NULL
156,1073,25,1098,1345,0,0,81.64,442,631,"福順里",NULL
157,1295,34,1329,1594,0,0,83.38,510,785,"福順里",NULL
158,1352,38,1390,1707,0,0,81.43,551,801,"富光里",NULL
159,1251,34,1285,1560,0,0,82.37,510,741,"富光里",NULL
160,1280,16,1296,1605,0,0,80.75,523,757,"富光里",NULL
161,1642,35,1677,1989,0,0,84.31,651,991,"葫蘆里",NULL
162,1581,39,1620,1944,0,0,83.33,652,929,"葫蘆里",NULL
163,1571,29,1600,1877,0,0,85.24,1038,533,"葫蘆里",NULL
164,1368,26,1394,1677,0,0,83.12,556,812,"葫東里",NULL
165,1160,23,1183,1456,0,0,81.25,440,720,"葫東里",NULL
166,1309,31,1340,1590,0,0,84.28,476,833,"社子里",NULL
167,1416,29,1445,1772,0,0,81.55,653,763,"社子里",NULL
168,1432,39,1471,1742,0,0,84.44,542,890,"社子里",NULL
169,1463,41,1504,1762,0,0,85.36,593,870,"社新里",NULL
170,1359,44,1403,1703,0,0,82.38,508,851,"社新里",NULL
171,1290,25,1315,1605,0,0,81.93,507,783,"社新里",NULL
172,1283,33,1316,1635,0,0,80.49,533,750,"社新里",NULL
173,1445,22,1467,1734,0,0,84.6,560,885,"社園里",NULL
174,1665,35,1700,2011,0,0,84.54,637,1028,"社園里",NULL
175,1573,29,1602,1926,0,0,83.18,583,990,"社園里",NULL
176,1554,40,1594,1912,0,0,83.37,544,1010,"永倫里",NULL
177,1610,36,1646,1982,0,0,83.05,689,921,"永倫里",NULL
178,1609,45,1654,1992,0,0,83.03,578,1031,"永倫里",NULL
179,1103,24,1127,1346,0,0,83.73,263,840,"福安里",NULL
180,1044,18,1062,1284,0,0,82.71,220,824,"福安里",NULL
181,1109,32,1141,1344,0,0,84.9,286,823,"福安里",NULL
182,1138,41,1179,1415,0,0,83.32,321,817,"富洲里",NULL
183,1098,41,1139,1357,0,0,83.94,322,776,"富洲里",NULL
184,1405,26,1431,1687,0,0,84.83,450,955,"富洲里",NULL
185,1189,26,1215,1581,0,0,76.85,725,464,"岩山里",NULL
186,1262,15,1277,1538,0,0,83.03,802,460,"岩山里",NULL
187,1538,26,1564,1884,0,0,83.01,907,631,"名山里",NULL
188,1476,38,1514,1851,0,0,81.79,871,605,"名山里",NULL
189,1649,21,1670,1985,0,0,84.13,865,784,"名山里",NULL
190,1301,16,1317,1609,0,0,81.85,689,612,"德行里",NULL
191,1374,23,1397,1706,0,0,81.89,639,735,"德行里",NULL
192,1123,10,1133,1378,0,0,82.22,548,575,"德華里",NULL
193,1288,32,1320,1594,0,0,82.81,610,678,"德華里",NULL
194,1306,23,1329,1616,0,0,82.24,595,711,"德華里",NULL
195,1051,20,1071,1330,0,0,80.53,567,484,"聖山里",NULL
196,1197,15,1212,1462,0,0,82.9,630,567,"聖山里",NULL
197,1217,25,1242,1467,0,0,84.66,990,227,"聖山里",NULL
198,1314,14,1328,1552,0,0,85.57,1069,245,"忠誠里",NULL
199,1242,19,1261,1467,0,0,85.96,826,416,"忠誠里",NULL
200,1290,13,1303,1584,0,0,82.26,754,536,"忠誠里",NULL
201,1549,23,1572,1893,0,0,83.04,799,750,"芝山里",NULL
202,1664,23,1687,2000,0,0,84.35,953,711,"芝山里",NULL
203,1497,24,1521,1843,0,0,82.53,844,653,"芝山里",NULL
204,1074,18,1092,1295,0,0,84.32,733,341,"東山里",NULL
205,1170,27,1197,1418,0,0,84.41,766,404,"東山里",NULL
206,1116,20,1136,1346,0,0,84.4,681,435,"東山里",NULL
207,1209,14,1223,1480,0,0,82.64,663,546,"三玉里",NULL
208,1290,23,1313,1583,0,0,82.94,663,627,"三玉里",NULL
209,1224,11,1235,1513,0,0,81.63,597,627,"三玉里",NULL
210,1353,29,1382,1738,0,0,79.52,725,628,"蘭雅里",NULL
211,1214,26,1240,1540,0,0,80.52,632,582,"蘭雅里",NULL
212,1355,21,1376,1692,0,0,81.32,723,632,"蘭雅里",NULL
213,1445,22,1467,1806,0,0,81.23,741,704,"蘭雅里",NULL
214,1331,27,1358,1660,0,0,81.81,655,676,"蘭興里",NULL
215,1300,20,1320,1574,0,0,83.86,667,633,"蘭興里",NULL
216,1415,23,1438,1731,0,0,83.07,718,697,"蘭興里",NULL
217,1411,23,1434,1697,0,0,84.5,767,644,"天福里",NULL
218,1434,23,1457,1759,0,0,82.83,766,668,"天福里",NULL
219,1214,16,1230,1546,0,0,79.56,741,473,"天福里",NULL
220,1165,23,1188,1458,0,0,81.48,621,544,"天祿里",NULL
221,1222,19,1241,1444,0,0,85.94,652,570,"天祿里",NULL
222,1031,20,1051,1298,0,0,80.97,492,539,"天祿里",NULL
223,1536,18,1554,1866,0,0,83.28,785,751,"天壽里",NULL
224,1514,26,1540,1917,0,0,80.33,866,648,"天壽里",NULL
225,1191,20,1211,1463,0,0,82.78,664,527,"天和里",NULL
226,1224,22,1246,1504,0,0,82.85,700,524,"天和里",NULL
227,1190,17,1207,1538,0,0,78.48,713,477,"天和里",NULL
228,1162,21,1183,1446,0,0,81.81,620,542,"天和里",NULL
229,1439,24,1463,1810,0,0,80.83,808,631,"天山里",NULL
230,1429,24,1453,1797,0,0,80.86,811,618,"天山里",NULL
231,1527,17,1544,1966,0,0,78.54,817,710,"天山里",NULL
232,1378,18,1396,1728,0,0,80.79,763,615,"天玉里",NULL
233,1272,23,1295,1575,0,0,82.22,696,576,"天玉里",NULL
234,1388,18,1406,1734,0,0,81.08,787,601,"天玉里",NULL
235,1311,24,1335,1667,0,0,80.08,741,570,"天玉里",NULL
236,1352,21,1373,1676,0,0,81.92,722,630,"天母里",NULL
237,1391,34,1425,1805,0,0,78.95,817,574,"天母里",NULL
238,1317,22,1339,1640,0,0,81.65,772,545,"天母里",NULL
239,916,14,930,1144,0,0,81.29,354,562,"永福里",NULL
240,982,32,1014,1247,0,0,81.32,338,644,"公館里",NULL
241,1395,39,1434,1757,0,0,81.62,592,803,"新安里",NULL
242,760,3,763,957,0,0,79.73,293,467,"陽明里",NULL
243,770,20,790,1041,0,0,75.89,427,343,"陽明里",NULL
244,630,20,650,826,0,0,78.69,400,230,"陽明里",NULL
245,1107,32,1139,1386,0,0,82.18,466,641,"菁山里",NULL
246,990,27,1017,1197,0,0,84.96,259,731,"平等里",NULL
247,990,35,1025,1251,0,0,81.93,379,611,"溪山里",NULL
248,1063,20,1083,1307,0,0,82.86,820,243,"翠山里",NULL
249,1009,18,1027,1255,0,0,81.83,780,229,"翠山里",NULL
250,1107,31,1138,1405,0,0,81,649,458,"臨溪里",NULL
251,816,9,825,1061,0,0,77.76,464,352,"臨溪里",NULL
252,1115,25,1140,1458,0,0,78.19,581,534,"正守里",NULL
253,829,25,854,1022,0,0,83.56,390,439,"正守里",NULL
254,1501,21,1522,2045,0,0,74.43,852,649,"正義里",NULL
255,1269,36,1305,1663,0,0,78.47,701,568,"正義里",NULL
256,746,13,759,959,0,0,79.14,393,353,"正得里",NULL
257,1247,22,1269,1703,0,0,74.52,712,535,"正得里",NULL
258,1452,21,1473,1865,0,0,78.98,714,738,"民安里",NULL
259,1791,14,1805,2295,0,0,78.65,823,968,"民安里",NULL
260,1391,37,1428,1904,0,0,75,800,591,"康樂里",NULL
261,1310,17,1327,1689,0,0,78.57,732,578,"中山里",NULL
262,1096,20,1116,1498,0,0,74.5,591,505,"中山里",NULL
263,1059,16,1075,1378,0,0,78.01,535,524,"中山里",NULL
264,1024,28,1052,1412,0,0,74.5,507,517,"聚盛里",NULL
265,1038,31,1069,1439,0,0,74.29,544,494,"聚盛里",NULL
266,1146,42,1188,1426,0,0,83.31,494,652,"集英里",NULL
267,1601,25,1626,2053,0,0,79.2,678,923,"集英里",NULL
268,1044,17,1061,1344,0,0,78.94,508,536,"集英里",NULL
269,1059,24,1083,1412,0,0,76.7,555,504,"聚葉里",NULL
270,1353,22,1375,1723,0,0,79.8,677,676,"聚葉里",NULL
271,1066,37,1103,1421,0,0,77.62,513,553,"恆安里",NULL
272,975,14,989,1304,0,0,75.84,543,432,"恆安里",NULL
273,1250,24,1274,1658,0,0,76.84,707,543,"晴光里",NULL
274,1339,53,1392,1851,0,0,75.2,719,620,"晴光里",NULL
275,1424,19,1443,1838,0,0,78.51,677,747,"圓山里",NULL
276,930,29,959,1212,0,0,79.13,449,481,"圓山里",NULL
277,1689,28,1717,2112,0,0,81.3,906,783,"新庄里",NULL
278,1566,23,1589,1921,0,0,82.72,678,888,"新庄里",NULL
279,1219,24,1243,1517,0,0,81.94,1073,146,"劍潭里",NULL
280,1357,30,1387,1660,0,0,83.55,1138,219,"劍潭里",NULL
281,1124,14,1138,1381,0,0,82.4,700,424,"大直里",NULL
282,1503,23,1526,1796,0,0,84.97,938,565,"大直里",NULL
283,1304,18,1322,1565,0,0,84.47,759,545,"大直里",NULL
284,1173,23,1196,1446,0,0,82.71,704,469,"大直里",NULL
285,1228,25,1253,1555,0,0,80.58,720,508,"大直里",NULL
286,2055,41,2096,2438,0,0,85.97,1153,902,"成功里",NULL
287,1466,26,1492,1790,0,0,83.35,851,615,"永安里",NULL
288,1313,13,1326,1551,0,0,85.49,679,634,"永安里",NULL
289,1157,14,1171,1417,0,0,82.64,648,509,"永安里",NULL
290,1542,27,1569,1885,0,0,83.24,904,638,"永安里",NULL
291,814,5,819,970,0,0,84.43,263,551,"大佳里",NULL
292,1593,34,1627,1943,0,0,83.74,699,894,"新喜里",NULL
293,1619,21,1640,2086,0,0,78.62,791,828,"新喜里",NULL
294,1713,38,1751,2202,0,0,79.52,691,1022,"新福里",NULL
295,1517,25,1542,1990,0,0,77.49,729,788,"新福里",NULL
296,1464,24,1488,1792,0,0,83.04,692,772,"松江里",NULL
297,1490,28,1518,1901,0,0,79.85,694,796,"松江里",NULL
298,1083,29,1112,1379,0,0,80.64,557,526,"松江里",NULL
299,1018,26,1044,1271,0,0,82.14,481,537,"新生里",NULL
300,1105,16,1121,1366,0,0,82.06,524,581,"新生里",NULL
301,1096,25,1121,1399,0,0,80.13,455,641,"新生里",NULL
302,1284,39,1323,1648,0,0,80.28,582,702,"中庄里",NULL
303,1089,36,1125,1422,0,0,79.11,498,591,"中庄里",NULL
304,1215,33,1248,1533,0,0,81.41,560,655,"中庄里",NULL
305,1356,27,1383,1699,0,0,81.4,659,697,"行政里",NULL
306,1154,18,1172,1443,0,0,81.22,547,607,"行政里",NULL
307,1202,21,1223,2435,0,0,50.23,636,566,"行政里",NULL
308,1646,25,1671,2024,0,0,82.56,767,879,"行仁里",NULL
309,1229,30,1259,1523,0,0,82.67,564,665,"行仁里",NULL
310,1454,38,1492,1794,0,0,83.17,679,775,"行仁里",NULL
311,1098,25,1123,1323,0,0,84.88,549,549,"行仁里",NULL
312,1381,23,1404,1675,0,0,83.82,656,725,"行孝里",NULL
313,1418,23,1441,1758,0,0,81.97,676,742,"行孝里",NULL
314,1641,22,1663,2000,0,0,83.15,843,798,"下埤里",NULL
315,1648,34,1682,2063,0,0,81.53,856,792,"下埤里",NULL
316,1597,39,1636,1982,0,0,82.54,756,841,"下埤里",NULL
317,1547,21,1568,1882,0,0,83.32,832,715,"江寧里",NULL
318,1276,27,1303,1564,0,0,83.31,645,631,"江寧里",NULL
319,1592,39,1631,2040,0,0,79.95,859,733,"江寧里",NULL
320,1224,24,1248,1507,0,0,82.81,593,631,"江山里",NULL
321,1395,19,1414,1731,0,0,81.69,640,755,"江山里",NULL
322,1338,21,1359,1657,0,0,82.02,644,694,"江山里",NULL
323,1147,27,1174,1451,0,0,80.91,583,564,"江山里",NULL
324,1786,29,1815,2217,0,0,81.87,872,914,"中吉里",NULL
325,1571,31,1602,1958,0,0,81.82,641,930,"中吉里",NULL
326,1490,22,1512,1899,0,0,79.62,676,814,"中原里",NULL
327,1532,31,1563,1966,0,0,79.5,769,763,"中原里",NULL
328,1533,25,1558,1973,0,0,78.97,815,718,"興亞里",NULL
329,1685,34,1719,2187,0,0,78.6,810,875,"興亞里",NULL
330,1172,22,1194,1499,0,0,79.65,644,528,"中央里",NULL
331,1134,20,1154,1413,0,0,81.67,601,533,"中央里",NULL
332,1300,36,1336,1665,0,0,80.24,665,635,"朱馥里",NULL
333,1320,33,1353,1674,0,0,80.82,741,579,"朱馥里",NULL
334,1384,44,1428,1705,0,0,83.75,770,614,"朱馥里",NULL
335,1178,21,1199,1458,0,0,82.24,764,414,"龍洲里",NULL
336,1085,15,1100,1310,0,0,83.97,868,217,"龍洲里",NULL
337,1309,15,1324,1575,0,0,84.06,1053,256,"龍洲里",NULL
338,1390,23,1413,1750,0,0,80.74,574,816,"朱園里",NULL
339,1489,28,1517,1880,0,0,80.69,863,626,"朱園里",NULL
340,1267,32,1299,1590,0,0,81.7,765,502,"埤頭里",NULL
341,1401,34,1435,1778,0,0,80.71,754,647,"埤頭里",NULL
342,1077,18,1095,1364,0,0,80.28,595,482,"朱崙里",NULL
343,955,21,976,1201,0,0,81.27,397,558,"朱崙里",NULL
344,1499,20,1519,1846,0,0,82.29,620,879,"力行里",NULL
345,1174,32,1206,1555,0,0,77.56,597,577,"力行里",NULL
346,1162,24,1186,1483,0,0,79.97,610,552,"力行里",NULL
347,1342,33,1375,1702,0,0,80.79,835,507,"復華里",NULL
348,1210,33,1243,1531,0,0,81.19,713,497,"復華里",NULL
349,1165,14,1179,1389,0,0,84.88,822,343,"北安里",NULL
350,806,19,825,974,0,0,84.7,524,282,"北安里",NULL
351,1902,32,1934,2336,0,0,82.79,1091,811,"金泰里",NULL
352,1460,36,1496,1780,0,0,84.04,804,656,"金泰里",NULL
353,1303,30,1333,1673,0,0,79.68,593,710,"玉泉里",NULL
354,895,23,918,1250,0,0,73.44,522,373,"玉泉里",NULL
355,1100,21,1121,1409,0,0,79.56,469,631,"建明里",NULL
356,1132,32,1164,1439,0,0,80.89,427,705,"建明里",NULL
357,1449,45,1494,1878,0,0,79.55,618,831,"建功里",NULL
358,1586,47,1633,2037,0,0,80.17,714,872,"建功里",NULL
359,1205,21,1226,1527,0,0,80.29,508,697,"建泰里",NULL
360,1216,24,1240,1514,0,0,81.9,467,749,"建泰里",NULL
361,1206,32,1238,1557,0,0,79.51,512,694,"永樂里",NULL
362,1080,17,1097,1329,0,0,82.54,424,656,"永樂里",NULL
363,1068,28,1096,1379,0,0,79.48,454,614,"永樂里",NULL
364,1314,36,1350,1683,0,0,80.21,594,720,"朝陽里",NULL
365,1223,31,1254,1613,0,0,77.74,525,698,"朝陽里",NULL
366,1104,13,1117,1370,0,0,81.53,511,593,"星明里",NULL
367,999,13,1012,1254,0,0,80.7,464,535,"星明里",NULL
368,1055,30,1085,1361,0,0,79.72,449,606,"星明里",NULL
369,1152,17,1169,1399,0,0,83.56,506,646,"光能里",NULL
370,1068,12,1080,1329,0,0,81.26,425,643,"光能里",NULL
371,1225,34,1259,1514,0,0,83.16,495,730,"光能里",NULL
372,1054,17,1071,1293,0,0,82.83,384,670,"大有里",NULL
373,1151,30,1181,1448,0,0,81.56,525,626,"大有里",NULL
374,1069,25,1094,1319,0,0,82.94,410,659,"大有里",NULL
375,1280,26,1306,1655,0,0,78.91,561,719,"延平里",NULL
376,1230,24,1254,1602,0,0,78.28,591,639,"延平里",NULL
377,1461,33,1494,1821,0,0,82.04,601,860,"雙連里",NULL
378,1577,15,1592,1917,0,0,83.05,625,952,"雙連里",NULL
379,1573,23,1596,1973,0,0,80.89,613,960,"雙連里",NULL
380,1545,37,1582,1971,0,0,80.26,725,820,"雙連里",NULL
381,1290,30,1320,1623,0,0,81.33,576,714,"南芳里",NULL
382,1381,36,1417,1746,0,0,81.16,570,811,"南芳里",NULL
383,1409,27,1436,1760,0,0,81.59,735,674,"民權里",NULL
384,1370,43,1413,1715,0,0,82.39,600,770,"民權里",NULL
385,1379,27,1406,1734,0,0,81.08,755,624,"民權里",NULL
386,967,18,985,1204,0,0,81.81,418,549,"景星里",NULL
387,939,27,966,1195,0,0,80.84,368,571,"景星里",NULL
388,1152,23,1175,1432,0,0,82.05,435,717,"隆和里",NULL
389,1027,24,1051,1288,0,0,81.6,420,607,"隆和里",NULL
390,986,17,1003,1272,0,0,78.85,443,543,"蓬萊里",NULL
391,961,19,980,1240,0,0,79.03,393,568,"蓬萊里",NULL
392,1096,22,1118,1378,0,0,81.13,458,638,"蓬萊里",NULL
393,1043,15,1058,1293,0,0,81.83,331,712,"國順里",NULL
394,1095,28,1123,1378,0,0,81.49,452,643,"國順里",NULL
395,1195,28,1223,1486,0,0,82.3,477,718,"國慶里",NULL
396,1337,23,1360,1677,0,0,81.1,603,734,"國慶里",NULL
397,1075,34,1109,1316,0,0,84.27,390,685,"揚雅里",NULL
398,1126,33,1159,1733,0,0,66.88,510,616,"揚雅里",NULL
399,1168,50,1218,1571,0,0,77.53,455,713,"斯文里",NULL
400,1377,9,1386,1670,0,0,82.99,522,855,"斯文里",NULL
401,1037,32,1069,1285,0,0,83.19,491,546,"斯文里",NULL
402,1493,48,1541,1863,0,0,82.72,563,930,"鄰江里",NULL
403,1323,40,1363,1700,0,0,80.18,528,795,"鄰江里",NULL
404,1427,28,1455,1740,0,0,83.62,572,855,"鄰江里",NULL
405,1266,23,1289,1576,0,0,81.79,523,743,"至聖里",NULL
406,1308,23,1331,1653,0,0,80.52,557,751,"至聖里",NULL
407,1313,15,1328,1588,0,0,83.63,566,747,"至聖里",NULL
408,1233,26,1259,1546,0,0,81.44,497,736,"至聖里",NULL
409,1330,18,1348,1679,0,0,80.29,520,810,"老師里",NULL
410,1216,39,1255,1528,0,0,82.13,541,675,"老師里",NULL
411,1342,25,1367,1629,0,0,83.92,538,804,"老師里",NULL
412,1306,30,1336,1650,0,0,80.97,632,674,"重慶里",NULL
413,1232,24,1256,1500,0,0,83.73,536,696,"重慶里",NULL
414,1277,28,1305,1553,0,0,84.03,599,678,"重慶里",NULL
415,1372,22,1394,1694,0,0,82.29,520,852,"保安里",NULL
416,1621,46,1667,1993,0,0,83.64,656,965,"保安里",NULL
417,1255,16,1271,1540,0,0,82.53,716,539,"莊敬里",NULL
418,1317,26,1343,1615,0,0,83.16,767,550,"莊敬里",NULL
419,1341,35,1376,1676,0,0,82.1,816,525,"莊敬里",NULL
420,1488,24,1512,1854,0,0,81.55,881,607,"東榮里",NULL
421,1272,29,1301,1605,0,0,81.06,753,519,"東榮里",NULL
422,1547,17,1564,1868,0,0,83.73,839,708,"東榮里",NULL
423,1262,19,1281,1592,0,0,80.46,773,489,"東榮里",NULL
424,1467,21,1488,1816,0,0,81.94,840,627,"三民里",NULL
425,1562,17,1579,2010,0,0,78.56,1080,482,"三民里",NULL
426,1513,28,1541,1860,0,0,82.85,876,637,"三民里",NULL
427,1362,16,1378,1688,0,0,81.64,734,628,"新益里",NULL
428,1703,22,1725,2111,0,0,81.71,933,770,"新益里",NULL
429,1190,18,1208,1512,0,0,79.89,803,387,"富錦里",NULL
430,1436,18,1454,1719,0,0,84.58,856,580,"富錦里",NULL
431,816,9,825,1027,0,0,80.33,482,334,"富錦里",NULL
432,1612,30,1642,2010,0,0,81.69,891,721,"新東里",NULL
433,1607,31,1638,2024,0,0,80.93,904,703,"新東里",NULL
434,1497,18,1515,1870,0,0,81.02,920,577,"富泰里",NULL
435,1456,16,1472,1861,0,0,79.1,1005,451,"富泰里",NULL
436,1369,28,1397,1741,0,0,80.24,756,613,"介壽里",NULL
437,1497,21,1518,1904,0,0,79.73,804,693,"介壽里",NULL
438,1355,12,1367,1739,0,0,78.61,852,503,"精忠里",NULL
439,1495,15,1510,1899,0,0,79.52,929,566,"精忠里",NULL
440,1564,25,1589,2014,0,0,78.9,868,696,"東光里",NULL
441,1511,25,1536,1936,0,0,79.34,905,606,"東光里",NULL
442,1712,23,1735,2156,0,0,80.47,1106,606,"東光里",NULL
443,1143,11,1154,1446,0,0,79.81,737,406,"龍田里",NULL
444,997,15,1012,1235,0,0,81.94,594,403,"龍田里",NULL
445,1565,2,1567,1938,0,0,80.86,1418,147,"龍田里",NULL
446,1831,20,1851,2167,0,0,85.42,1314,517,"龍田里",NULL
447,1741,27,1768,2161,0,0,81.81,967,774,"東昌里",NULL
448,1435,27,1462,1776,0,0,82.32,795,640,"東勢里",NULL
449,1390,26,1416,1740,0,0,81.38,747,643,"東勢里",NULL
450,1271,21,1292,1556,0,0,83.03,855,416,"中華里",NULL
451,1296,13,1309,1592,0,0,82.22,831,465,"中華里",NULL
452,1348,15,1363,1716,0,0,79.43,728,620,"中華里",NULL
453,1354,18,1372,1701,0,0,80.66,757,597,"民有里",NULL
454,1357,20,1377,1779,0,0,77.4,810,547,"民有里",NULL
455,1497,22,1519,1864,0,0,81.49,718,779,"民有里",NULL
456,1385,21,1406,1774,0,0,79.26,728,657,"民有里",NULL
457,1571,31,1602,1913,0,0,83.74,964,607,"民福里",NULL
458,1549,19,1568,1854,0,0,84.57,1023,526,"民福里",NULL
459,1306,30,1336,1694,0,0,78.87,859,447,"民福里",NULL
460,1688,29,1717,2045,0,0,83.96,770,918,"慈祐里",NULL
461,1092,18,1110,2028,0,0,54.73,486,606,"慈祐里",NULL
462,1223,17,1240,1531,0,0,80.99,554,669,"慈祐里",NULL
463,1475,21,1496,1807,0,0,82.79,796,679,"安平里",NULL
464,1395,19,1414,1730,0,0,81.73,646,749,"安平里",NULL
465,1450,37,1487,1822,0,0,81.61,732,718,"安平里",NULL
466,1293,41,1334,1606,0,0,83.06,603,690,"安平里",NULL
467,1316,20,1336,1628,0,0,82.06,1062,254,"鵬程里",NULL
468,1270,30,1300,1564,0,0,83.12,800,470,"鵬程里",NULL
469,1257,23,1280,1611,0,0,79.45,790,467,"鵬程里",NULL
470,1475,16,1491,1792,0,0,83.2,1315,160,"自強里",NULL
471,1664,28,1692,2030,0,0,83.35,1170,494,"自強里",NULL
472,1477,23,1500,1805,0,0,83.1,1166,311,"自強里",NULL
473,1428,33,1461,1764,0,0,82.82,705,723,"吉祥里",NULL
474,1341,13,1354,1640,0,0,82.56,879,462,"吉祥里",NULL
475,1186,16,1202,1518,0,0,79.18,664,522,"吉祥里",NULL
476,1418,24,1442,1746,0,0,82.59,886,532,"吉祥里",NULL
477,1565,31,1596,1917,0,0,83.26,818,747,"新聚里",NULL
478,1597,31,1628,2012,0,0,80.91,899,698,"新聚里",NULL
479,1601,34,1635,2027,0,0,80.66,889,712,"新聚里",NULL
480,1453,25,1478,1768,0,0,83.6,955,498,"復盛里",NULL
481,1391,35,1426,1730,0,0,82.43,812,579,"復盛里",NULL
482,1466,34,1500,1819,0,0,82.46,823,643,"復盛里",NULL
483,1308,25,1333,1622,0,0,82.18,637,671,"中正里",NULL
484,1186,22,1208,1529,0,0,79.01,664,522,"中正里",NULL
485,1226,16,1242,1551,0,0,80.08,605,621,"中正里",NULL
486,1361,18,1379,1738,0,0,79.34,721,640,"中正里",NULL
487,1212,24,1236,1529,0,0,80.84,647,565,"中崙里",NULL
488,1268,23,1291,1545,0,0,83.56,683,585,"中崙里",NULL
489,1071,17,1088,1326,0,0,82.05,543,528,"美仁里",NULL
490,1018,13,1031,1258,0,0,81.96,556,462,"美仁里",NULL
491,1254,27,1281,1581,0,0,81.02,719,535,"吉仁里",NULL
492,1258,21,1279,1557,0,0,82.15,756,502,"吉仁里",NULL
493,1391,32,1423,1758,0,0,80.94,803,588,"敦化里",NULL
494,1586,21,1607,1938,0,0,82.92,794,792,"敦化里",NULL
495,1529,28,1557,1856,0,0,83.89,793,736,"敦化里",NULL
496,1068,17,1085,1306,0,0,83.08,632,436,"復源里",NULL
497,939,19,958,1186,0,0,80.78,583,356,"復源里",NULL
498,1173,17,1190,1468,0,0,81.06,728,445,"復建里",NULL
499,1271,24,1295,1597,0,0,81.09,747,524,"復建里",NULL
500,1259,27,1286,1547,0,0,83.13,621,638,"復勢里",NULL
501,1451,22,1473,1772,0,0,83.13,817,634,"復勢里",NULL
502,1169,23,1192,1477,0,0,80.7,645,524,"復勢里",NULL
503,1656,25,1681,2109,0,0,79.71,948,708,"福成里",NULL
504,1280,26,1306,1604,0,0,81.42,647,633,"松基里",NULL
505,1199,15,1214,1509,0,0,80.45,662,537,"松基里",NULL
506,1675,19,1694,2671,0,0,63.42,1347,328,"西村里",NULL
507,1663,29,1692,2060,0,0,82.14,1299,364,"西村里",NULL
508,1617,32,1649,2001,0,0,82.41,1125,492,"正和里",NULL
509,1568,19,1587,1986,0,0,79.91,1058,510,"正和里",NULL
510,932,21,953,1163,0,0,81.94,638,294,"興隆里",NULL
511,1058,12,1070,1394,0,0,76.76,686,372,"興隆里",NULL
512,953,19,972,1258,0,0,77.27,592,361,"中興里",NULL
513,1002,10,1012,1328,0,0,76.2,598,404,"中興里",NULL
514,1314,29,1343,1668,0,0,80.52,927,387,"新仁里",NULL
515,1067,19,1086,1399,0,0,77.63,728,339,"新仁里",NULL
516,1296,34,1330,1706,0,0,77.96,893,403,"興雅里",NULL
517,1601,26,1627,1988,0,0,81.84,868,733,"興雅里",NULL
518,923,9,932,1126,0,0,82.77,509,414,"興雅里",NULL
519,1487,25,1512,1892,0,0,79.92,875,612,"敦厚里",NULL
520,1589,28,1617,2063,0,0,78.38,940,649,"敦厚里",NULL
521,1638,32,1670,2046,0,0,81.62,1052,586,"廣居里",NULL
522,1636,14,1650,1986,0,0,83.08,1089,547,"廣居里",NULL
523,1402,21,1423,1782,0,0,79.85,823,579,"廣居里",NULL
524,1655,35,1690,2064,0,0,81.88,964,691,"安康里",NULL
525,1612,18,1630,2002,0,0,81.42,998,614,"安康里",NULL
526,1590,34,1624,2015,0,0,80.6,960,630,"安康里",NULL
527,1160,16,1176,1390,0,0,84.6,621,539,"六藝里",NULL
528,1212,31,1243,1514,0,0,82.1,648,564,"六藝里",NULL
529,1703,43,1746,2129,0,0,82.01,877,826,"雅祥里",NULL
530,1558,24,1582,1908,0,0,82.91,862,696,"雅祥里",NULL
531,1220,27,1247,1553,0,0,80.3,687,533,"五常里",NULL
532,1243,27,1270,1550,0,0,81.94,708,535,"五常里",NULL
533,1702,33,1735,2097,0,0,82.74,804,898,"五全里",NULL
534,1877,33,1910,2269,0,0,84.18,964,913,"五全里",NULL
535,1506,34,1540,1917,0,0,80.33,672,834,"永吉里",NULL
536,1504,71,1575,1903,0,0,82.76,599,905,"永吉里",NULL
537,1319,54,1373,1667,0,0,82.36,641,678,"長春里",NULL
538,1609,58,1667,2015,0,0,82.73,894,715,"長春里",NULL
539,1235,17,1252,1484,0,0,84.37,635,600,"四育里",NULL
540,1333,24,1357,1617,0,0,83.92,615,718,"四育里",NULL
541,1276,30,1306,1562,0,0,83.61,682,594,"四育里",NULL
542,1294,21,1315,1609,0,0,81.73,801,493,"四維里",NULL
543,1290,10,1300,1599,0,0,81.3,777,513,"四維里",NULL
544,1122,30,1152,1426,0,0,80.79,679,443,"四維里",NULL
545,1188,35,1223,1474,0,0,82.97,685,503,"永春里",NULL
546,1227,34,1261,1527,0,0,82.58,676,551,"永春里",NULL
547,1182,41,1223,1459,0,0,83.82,559,623,"永春里",NULL
548,1333,17,1350,1605,0,0,84.11,944,389,"富臺里",NULL
549,1169,27,1196,1500,0,0,79.73,888,281,"富臺里",NULL
550,1571,16,1587,1907,0,0,83.22,985,586,"國業里",NULL
551,1535,34,1569,1886,0,0,83.19,924,611,"國業里",NULL
552,1618,36,1654,2017,0,0,82,988,630,"國業里",NULL
553,927,31,958,1182,0,0,81.05,562,365,"松隆里",NULL
554,851,22,873,1120,0,0,77.95,501,350,"松隆里",NULL
555,1364,37,1401,1719,0,0,81.5,852,512,"松友里",NULL
556,1451,30,1481,1789,0,0,82.78,906,545,"松友里",NULL
557,1449,19,1468,1783,0,0,82.33,904,545,"松友里",NULL
558,1820,33,1853,2266,0,0,81.77,1021,799,"松光里",NULL
559,1835,40,1875,2241,0,0,83.67,1003,832,"松光里",NULL
560,1517,17,1534,1843,0,0,83.23,826,691,"中坡里",NULL
561,1632,32,1664,1996,0,0,83.37,959,673,"中坡里",NULL
562,1282,34,1316,1610,0,0,81.74,642,640,"中行里",NULL
563,1387,39,1426,1716,0,0,83.1,770,617,"中行里",NULL
564,1276,19,1295,1551,0,0,83.49,698,578,"中行里",NULL
565,1401,29,1430,1722,0,0,83.04,807,594,"中行里",NULL
566,1453,40,1493,1788,0,0,83.5,790,663,"大道里",NULL
567,1534,37,1571,1901,0,0,82.64,822,712,"大道里",NULL
568,1369,49,1418,1709,0,0,82.97,750,619,"大道里",NULL
569,1282,37,1319,1543,0,0,85.48,659,623,"大仁里",NULL
570,1077,66,1143,1548,0,0,73.84,680,397,"大仁里",NULL
571,1136,53,1189,1496,0,0,79.48,708,428,"大仁里",NULL
572,1639,21,1660,1989,0,0,83.46,1012,627,"景新里",NULL
573,1633,24,1657,2056,0,0,80.59,1186,447,"景新里",NULL
574,1645,37,1682,2039,0,0,82.49,1057,588,"惠安里",NULL
575,1424,38,1462,1745,0,0,83.78,941,483,"惠安里",NULL
576,1486,32,1518,1792,0,0,84.71,993,493,"惠安里",NULL
577,1625,27,1652,1998,0,0,82.68,956,669,"三張里",NULL
578,1613,29,1642,2004,0,0,81.94,1043,570,"三張里",NULL
579,1478,27,1505,1812,0,0,83.06,1092,386,"三張里",NULL
580,1457,39,1496,1859,0,0,80.47,936,521,"三張里",NULL
581,1344,25,1369,1737,0,0,78.81,882,462,"三犁里",NULL
582,1969,16,1985,2411,0,0,82.33,1260,709,"三犁里",NULL
583,1828,29,1857,2217,0,0,83.76,1320,508,"六合里",NULL
584,1587,35,1622,1996,0,0,81.26,1052,535,"六合里",NULL
585,972,11,983,1328,0,0,74.02,655,317,"六合里",NULL
586,1222,30,1252,1597,0,0,78.4,744,478,"泰和里",NULL
587,1466,25,1491,1766,0,0,84.43,997,469,"泰和里",NULL
588,1348,44,1392,1709,0,0,81.45,813,535,"泰和里",NULL
589,1261,9,1270,1536,0,0,82.68,760,501,"泰和里",NULL
590,1726,30,1756,2180,0,0,80.55,1045,681,"景聯里",NULL
591,1466,24,1490,1787,0,0,83.38,865,601,"景聯里",NULL
592,1474,27,1501,1832,0,0,81.93,884,590,"景勤里",NULL
593,1579,43,1622,1925,0,0,84.26,1118,461,"景勤里",NULL
594,1832,41,1873,2273,0,0,82.4,1172,660,"雙和里",NULL
595,1614,29,1643,2001,0,0,82.11,984,630,"雙和里",NULL
596,1429,26,1455,1781,0,0,81.7,964,465,"雙和里",NULL
597,1201,20,1221,1452,0,0,84.09,661,540,"嘉興里",NULL
598,1046,24,1070,1305,0,0,81.99,620,426,"嘉興里",NULL
599,1310,26,1336,1685,0,0,79.29,812,498,"黎順里",NULL
600,1563,20,1583,1883,0,0,84.07,1042,521,"黎順里",NULL
601,1537,20,1557,1879,0,0,82.86,975,562,"黎平里",NULL
602,1454,27,1481,1766,0,0,83.86,892,562,"黎平里",NULL
603,1668,39,1707,2098,0,0,81.36,1009,659,"黎平里",NULL
604,1582,35,1617,1957,0,0,82.63,984,598,"黎忠里",NULL
605,1764,21,1785,2131,0,0,83.76,1025,739,"黎忠里",NULL
606,831,23,854,1011,0,0,84.47,692,139,"黎安里",NULL
607,982,42,1024,1274,0,0,80.38,709,273,"黎安里",NULL
608,1217,20,1237,1490,0,0,83.02,669,548,"南港里",NULL
609,1243,26,1269,1549,0,0,81.92,624,619,"南港里",NULL
610,1262,29,1291,1764,0,0,73.19,665,597,"南港里",NULL
611,1585,47,1632,2016,0,0,80.95,760,825,"中南里",NULL
612,1082,40,1122,1345,0,0,83.42,544,538,"中南里",NULL
613,1279,34,1313,1560,0,0,84.17,637,642,"新富里",NULL
614,1367,34,1401,1693,0,0,82.75,674,693,"新富里",NULL
615,1093,28,1121,1391,0,0,80.59,545,548,"三重里",NULL
616,987,25,1012,1252,0,0,80.83,493,494,"三重里",NULL
617,1018,27,1045,1260,0,0,82.94,495,523,"東新里",NULL
618,1246,17,1263,1513,0,0,83.48,693,553,"東新里",NULL
619,1431,24,1455,1723,0,0,84.45,859,572,"東新里",NULL
620,994,17,1011,1221,0,0,82.8,551,443,"東新里",NULL
621,1400,27,1427,1702,0,0,83.84,826,574,"新光里",NULL
622,1356,29,1385,1702,0,0,81.37,850,506,"新光里",NULL
623,1682,33,1715,2090,0,0,82.06,1003,679,"東明里",NULL
624,1384,27,1411,1737,0,0,81.23,856,528,"東明里",NULL
625,1334,38,1372,1706,0,0,80.42,619,715,"西新里",NULL
626,1552,23,1575,1875,0,0,84,634,918,"西新里",NULL
627,1459,31,1490,1808,0,0,82.41,762,697,"玉成里",NULL
628,1575,24,1599,1919,0,0,83.32,765,810,"玉成里",NULL
629,1247,25,1272,1520,0,0,83.68,661,586,"合成里",NULL
630,1154,28,1182,1403,0,0,84.25,677,477,"合成里",NULL
631,914,28,942,1108,0,0,85.02,507,407,"合成里",NULL
632,881,13,894,1077,0,0,83.01,467,414,"合成里",NULL
633,1142,23,1165,1366,0,0,85.29,664,478,"成福里",NULL
634,1353,25,1378,1611,0,0,85.54,918,435,"成福里",NULL
635,1146,18,1164,1387,0,0,83.92,631,515,"成福里",NULL
636,1451,22,1473,1771,0,0,83.17,901,550,"成福里",NULL
637,1490,24,1514,1762,0,0,85.93,1049,441,"萬福里",NULL
638,1314,23,1337,1617,0,0,82.68,720,594,"萬福里",NULL
639,1542,28,1570,1882,0,0,83.42,855,687,"鴻福里",NULL
640,1630,38,1668,1954,0,0,85.36,873,757,"鴻福里",NULL
641,1724,20,1744,2112,0,0,82.58,884,840,"百福里",NULL
642,1592,38,1630,1925,0,0,84.68,912,680,"百福里",NULL
643,1189,12,1201,1404,0,0,85.54,759,430,"聯成里",NULL
644,1199,19,1218,1436,0,0,84.82,696,503,"聯成里",NULL
645,1221,10,1231,1466,0,0,83.97,679,542,"聯成里",NULL
646,1034,36,1070,1312,0,0,81.55,532,502,"舊莊里",NULL
647,1041,30,1071,1307,0,0,81.94,553,488,"舊莊里",NULL
648,1149,27,1176,1437,0,0,81.84,604,545,"舊莊里",NULL
649,1083,26,1109,1326,0,0,83.63,606,477,"舊莊里",NULL
650,1150,37,1187,1494,0,0,79.45,570,580,"舊莊里",NULL
651,1120,25,1145,1395,0,0,82.08,608,512,"中研里",NULL
652,1296,32,1328,1608,0,0,82.59,809,487,"中研里",NULL
653,1266,24,1290,1513,0,0,85.26,740,526,"中研里",NULL
654,1096,17,1113,1317,0,0,84.51,667,429,"中研里",NULL
655,1193,15,1208,1459,0,0,82.8,694,499,"中研里",NULL
656,1164,18,1182,1444,0,0,81.86,657,507,"九如里",NULL
657,1260,35,1295,1619,0,0,79.99,685,575,"九如里",NULL
658,1223,27,1250,1490,0,0,83.89,946,277,"九如里",NULL
659,1042,22,1064,1283,0,0,82.93,723,319,"仁福里",NULL
660,1290,19,1309,1573,0,0,83.22,821,469,"仁福里",NULL
661,1311,18,1329,1596,0,0,83.27,848,463,"仁福里",NULL
662,1276,24,1300,1579,0,0,82.33,670,606,"西湖里",NULL
663,1255,18,1273,1544,0,0,82.45,635,620,"西湖里",NULL
664,1306,20,1326,1579,0,0,83.98,701,605,"西湖里",NULL
665,1218,11,1229,1476,0,0,83.27,731,487,"西湖里",NULL
666,1259,28,1287,1540,0,0,83.57,690,569,"西康里",NULL
667,1305,20,1325,1564,0,0,84.72,803,502,"西康里",NULL
668,1134,13,1147,1382,0,0,83,657,477,"西康里",NULL
669,1587,30,1617,1891,0,0,85.51,1178,409,"西康里",NULL
670,1402,23,1425,1690,0,0,84.32,833,569,"西安里",NULL
671,1318,23,1341,1603,0,0,83.66,759,559,"西安里",NULL
672,1343,22,1365,1637,0,0,83.38,835,508,"西安里",NULL
673,1276,22,1298,1539,0,0,84.34,716,560,"港墘里",NULL
674,1238,26,1264,1498,0,0,84.38,702,536,"港墘里",NULL
675,1139,25,1164,1386,0,0,83.98,608,531,"港墘里",NULL
676,1005,11,1016,1203,0,0,84.46,541,464,"港都里",NULL
677,1231,18,1249,1488,0,0,83.94,682,549,"港都里",NULL
678,1118,15,1133,1339,0,0,84.62,617,501,"港都里",NULL
679,1224,18,1242,1481,0,0,83.86,634,590,"麗山里",NULL
680,1054,18,1072,1288,0,0,83.23,518,536,"麗山里",NULL
681,1209,24,1233,1471,0,0,83.82,623,586,"麗山里",NULL
682,1159,27,1186,1434,0,0,82.71,590,569,"港富里",NULL
683,1225,25,1250,1464,0,0,85.38,640,585,"港富里",NULL
684,1286,20,1306,1546,0,0,84.48,691,595,"港富里",NULL
685,1187,21,1208,1424,0,0,84.83,625,562,"港富里",NULL
686,1068,19,1087,1305,0,0,83.3,638,430,"港富里",NULL
687,1275,23,1298,1514,0,0,85.73,636,639,"港華里",NULL
688,1258,22,1280,1532,0,0,83.55,757,501,"港華里",NULL
689,1378,30,1408,1638,0,0,85.96,724,654,"港華里",NULL
690,1284,25,1309,1577,0,0,83.01,778,506,"港華里",NULL
691,1251,15,1266,1518,0,0,83.4,782,469,"內湖里",NULL
692,1177,20,1197,1446,0,0,82.78,699,478,"內湖里",NULL
693,1163,19,1182,1464,0,0,80.74,741,422,"內湖里",NULL
694,1275,22,1297,1607,0,0,80.71,823,452,"湖濱里",NULL
695,1157,22,1179,1369,0,0,86.12,784,373,"湖濱里",NULL
696,933,18,951,1163,0,0,81.77,638,295,"湖濱里",NULL
697,1389,23,1412,1664,0,0,84.86,783,606,"湖濱里",NULL
698,1267,22,1289,1522,0,0,84.69,669,598,"紫星里",NULL
699,1436,19,1455,1729,0,0,84.15,852,584,"紫星里",NULL
700,1344,35,1379,1656,0,0,83.27,757,587,"紫星里",NULL
701,1339,8,1347,1595,0,0,84.45,793,546,"紫星里",NULL
702,1047,20,1067,1330,0,0,80.23,638,409,"大湖里",NULL
703,1006,19,1025,1253,0,0,81.8,628,378,"大湖里",NULL
704,1143,19,1162,1393,0,0,83.42,743,400,"大湖里",NULL
705,1201,25,1226,1539,0,0,79.66,675,526,"秀湖里",NULL
706,1224,19,1243,1484,0,0,83.76,747,477,"秀湖里",NULL
707,1422,25,1447,1707,0,0,84.77,965,457,"秀湖里",NULL
708,1244,12,1256,1541,0,0,81.51,798,446,"金龍里",NULL
709,1275,34,1309,1591,0,0,82.28,733,542,"金龍里",NULL
710,1205,40,1245,1453,0,0,85.68,641,564,"金龍里",NULL
711,1363,19,1382,1647,0,0,83.91,764,599,"金瑞里",NULL
712,1427,23,1450,1720,0,0,84.3,905,522,"金瑞里",NULL
713,1373,31,1404,1633,0,0,85.98,770,603,"金瑞里",NULL
714,328,17,345,407,0,0,84.77,89,239,"碧山里",NULL
715,1494,16,1510,1763,0,0,85.65,949,545,"碧山里",NULL
716,1334,17,1351,1620,0,0,83.4,867,467,"碧山里",NULL
717,1218,21,1239,1524,0,0,81.3,706,512,"碧山里",NULL
718,1238,31,1269,1475,0,0,86.03,939,299,"紫雲里",NULL
719,1214,41,1255,1489,0,0,84.28,678,536,"紫雲里",NULL
720,1181,35,1216,1450,0,0,83.86,828,353,"紫雲里",NULL
721,1395,43,1438,1745,0,0,82.41,920,475,"清白里",NULL
722,1419,21,1440,1711,0,0,84.16,783,636,"清白里",NULL
723,1400,20,1420,1744,0,0,81.42,968,432,"清白里",NULL
724,1541,14,1555,1847,0,0,84.19,1025,516,"葫洲里",NULL
725,1297,12,1309,1535,0,0,85.28,873,424,"葫洲里",NULL
726,1510,15,1525,1799,0,0,84.77,942,568,"葫洲里",NULL
727,1483,17,1500,1820,0,0,82.42,897,586,"葫洲里",NULL
728,1187,19,1206,1411,0,0,85.47,733,454,"金湖里",NULL
729,1330,17,1347,1642,0,0,82.03,837,493,"金湖里",NULL
730,1313,15,1328,1579,0,0,84.1,893,420,"金湖里",NULL
731,1149,20,1169,1418,0,0,82.44,683,466,"康寧里",NULL
732,1220,22,1242,1501,0,0,82.74,723,497,"康寧里",NULL
733,1287,10,1297,1526,0,0,84.99,825,462,"康寧里",NULL
734,1267,25,1292,1594,0,0,81.05,847,420,"康寧里",NULL
735,1525,33,1558,1802,0,0,86.46,860,665,"明湖里",NULL
736,1484,28,1512,1792,0,0,84.38,908,576,"明湖里",NULL
737,626,7,633,791,0,0,80.03,273,353,"蘆洲里",NULL
738,1197,23,1220,1442,0,0,84.6,723,474,"紫陽里",NULL
739,1194,6,1200,1418,0,0,84.63,659,535,"紫陽里",NULL
740,1152,22,1174,1444,0,0,81.3,704,448,"紫陽里",NULL
741,1291,17,1308,1557,0,0,84.01,828,463,"紫陽里",NULL
742,1511,34,1545,1788,0,0,86.41,1036,475,"瑞陽里",NULL
743,1357,7,1364,1639,0,0,83.22,1032,325,"瑞陽里",NULL
744,1276,18,1294,1487,0,0,87.02,933,343,"瑞陽里",NULL
745,1305,15,1320,1488,0,0,88.71,930,375,"瑞陽里",NULL
746,981,22,1003,1196,0,0,83.86,765,216,"瑞光里",NULL
747,1074,11,1085,1276,0,0,85.03,644,430,"瑞光里",NULL
748,1054,21,1075,1253,0,0,85.79,728,326,"瑞光里",NULL
749,1413,24,1437,1743,0,0,82.44,759,654,"五分里",NULL
750,1449,33,1482,1783,0,0,83.12,777,672,"五分里",NULL
751,1364,31,1395,1707,0,0,81.72,653,711,"五分里",NULL
752,1436,22,1458,1744,0,0,83.6,819,617,"五分里",NULL
753,1239,9,1248,1485,0,0,84.04,658,581,"東湖里",NULL
754,1086,24,1110,1341,0,0,82.77,610,476,"東湖里",NULL
755,1451,23,1474,1759,0,0,83.8,786,665,"東湖里",NULL
756,1112,18,1130,1390,0,0,81.29,641,471,"東湖里",NULL
757,1485,27,1512,1781,0,0,84.9,853,632,"安湖里",NULL
758,1381,33,1414,1677,0,0,84.32,772,609,"安湖里",NULL
759,1509,32,1541,1821,0,0,84.62,909,600,"安湖里",NULL
760,1132,33,1165,1425,0,0,81.75,633,499,"樂康里",NULL
761,1335,25,1360,1615,0,0,84.21,745,590,"樂康里",NULL
762,1179,27,1206,1462,0,0,82.49,623,556,"樂康里",NULL
763,1190,22,1212,1475,0,0,82.17,639,551,"樂康里",NULL
764,657,19,676,814,0,0,83.05,239,418,"內溝里",NULL
765,939,13,952,1139,0,0,83.58,569,370,"內溝里",NULL
766,1100,17,1117,1332,0,0,83.86,702,398,"內溝里",NULL
767,1406,24,1430,1698,0,0,84.22,818,588,"週美里",NULL
768,1557,27,1584,1915,0,0,82.72,944,613,"週美里",NULL
769,1117,23,1140,1349,0,0,84.51,428,689,"行善里",NULL
770,1170,26,1196,1427,0,0,83.81,509,661,"行善里",NULL
771,981,21,1002,1194,0,0,83.92,431,550,"行善里",NULL
772,1087,29,1116,1328,0,0,84.04,513,574,"石潭里",NULL
773,842,35,877,1069,0,0,82.04,352,490,"石潭里",NULL
774,1116,20,1136,1383,0,0,82.14,676,440,"石潭里",NULL
775,1203,15,1218,1435,0,0,84.88,672,531,"石潭里",NULL
776,677,25,702,867,0,0,80.97,422,255,"湖興里",NULL
777,552,14,566,712,0,0,79.49,234,318,"湖興里",NULL
778,1245,21,1266,1571,0,0,80.59,725,520,"湖元里",NULL
779,1095,28,1123,2005,0,0,56.01,655,440,"湖元里",NULL
780,1363,24,1387,1617,0,0,85.78,684,679,"湖元里",NULL
781,1243,24,1267,1490,0,0,85.03,644,599,"湖元里",NULL
782,1162,13,1175,1381,0,0,85.08,738,424,"湖元里",NULL
783,1129,29,1158,1344,0,0,86.16,647,482,"東湖里",NULL
784,1021,13,1034,1253,0,0,82.52,589,432,"東湖里",NULL
785,1217,8,1225,1458,0,0,84.02,693,524,"東湖里",NULL
786,1299,14,1313,1609,0,0,81.6,924,375,"德安里",NULL
787,1168,11,1179,1508,0,0,78.18,719,449,"德安里",NULL
788,1137,19,1156,1513,0,0,76.4,715,422,"德安里",NULL
789,1484,34,1518,1987,0,0,76.4,844,640,"仁慈里",NULL
790,1509,21,1530,1933,0,0,79.15,918,591,"仁慈里",NULL
791,1279,23,1302,1647,0,0,79.05,838,441,"和安里",NULL
792,1127,14,1141,1420,0,0,80.35,694,433,"和安里",NULL
793,1630,17,1647,1993,0,0,82.64,1082,548,"和安里",NULL
794,1245,21,1266,1609,0,0,78.68,700,545,"民炤里",NULL
795,1321,16,1337,1699,0,0,78.69,688,633,"民炤里",NULL
796,1221,18,1239,1559,0,0,79.47,787,434,"民炤里",NULL
797,1140,21,1161,1512,0,0,76.79,685,455,"民炤里",NULL
798,1224,22,1246,1636,0,0,76.16,738,486,"仁愛里",NULL
799,1137,11,1148,1552,0,0,73.97,694,443,"仁愛里",NULL
800,1086,9,1095,1490,0,0,73.49,678,408,"仁愛里",NULL
801,1345,18,1363,1654,0,0,82.41,1130,215,"義村里",NULL
802,1468,20,1488,1852,0,0,80.35,1187,281,"義村里",NULL
803,1557,27,1584,2006,0,0,78.96,917,640,"義村里",NULL
804,1489,14,1503,1889,0,0,79.57,858,631,"民輝里",NULL
805,1712,29,1741,2203,0,0,79.03,1012,700,"民輝里",NULL
806,1141,24,1165,1449,0,0,80.4,654,487,"民輝里",NULL
807,967,24,991,1240,0,0,79.92,501,466,"昌隆里",NULL
808,1134,22,1156,1489,0,0,77.64,609,525,"昌隆里",NULL
809,1396,16,1412,1789,0,0,78.93,752,644,"誠安里",NULL
810,1519,22,1541,1946,0,0,79.19,874,645,"誠安里",NULL
811,1516,20,1536,2060,0,0,74.56,954,562,"光武里",NULL
812,1718,30,1748,2231,0,0,78.35,1029,689,"光武里",NULL
813,1733,23,1756,2247,0,0,78.15,1031,702,"光武里",NULL
814,1201,17,1218,1492,0,0,81.64,709,492,"龍坡里",NULL
815,1094,13,1107,1354,0,0,81.76,709,385,"龍坡里",NULL
816,1436,28,1464,1813,0,0,80.75,1044,392,"龍坡里",NULL
817,1526,26,1552,1908,0,0,81.34,902,624,"龍泉里",NULL
818,1372,17,1389,1782,0,0,77.95,838,534,"龍泉里",NULL
819,1222,25,1247,1567,0,0,79.58,728,494,"古風里",NULL
820,1414,27,1441,1775,0,0,81.18,842,572,"古風里",NULL
821,1464,23,1487,1864,0,0,79.77,934,530,"古莊里",NULL
822,1276,22,1298,1598,0,0,81.23,737,539,"古莊里",NULL
823,1295,19,1314,1642,0,0,80.02,757,538,"古莊里",NULL
824,1341,21,1362,2674,0,0,50.93,843,498,"龍安里",NULL
825,1234,16,1250,1512,0,0,82.67,765,469,"龍安里",NULL
826,1193,22,1215,1512,0,0,80.36,731,462,"龍安里",NULL
827,994,13,1007,1251,0,0,80.5,662,332,"錦安里",NULL
828,1119,16,1135,1385,0,0,81.95,758,361,"錦安里",NULL
829,1127,19,1146,1419,0,0,80.76,664,463,"錦安里",NULL
830,1277,22,1299,1621,0,0,80.14,800,477,"福住里",NULL
831,1163,20,1183,1452,0,0,81.47,721,442,"福住里",NULL
832,1031,20,1051,1302,0,0,80.72,652,379,"福住里",NULL
833,1094,15,1109,1395,0,0,79.5,687,407,"永康里",NULL
834,995,17,1012,1236,0,0,81.88,623,372,"永康里",NULL
835,1177,17,1194,1444,0,0,82.69,764,413,"光明里",NULL
836,1204,21,1225,1505,0,0,81.4,789,415,"光明里",NULL
837,1705,36,1741,2067,0,0,84.23,1329,376,"錦泰里",NULL
838,1536,18,1554,1874,0,0,82.92,977,559,"錦泰里",NULL
839,1108,15,1123,1359,0,0,82.63,719,389,"錦華里",NULL
840,1036,23,1059,1297,0,0,81.65,599,437,"錦華里",NULL
841,1196,17,1213,1472,0,0,82.4,798,398,"錦華里",NULL
842,1489,19,1508,1954,0,0,77.18,999,490,"龍圖里",NULL
843,1399,19,1418,1754,0,0,80.84,841,558,"龍圖里",NULL
844,1307,18,1325,1688,0,0,78.5,846,461,"龍圖里",NULL
845,1246,16,1262,1574,0,0,80.18,847,399,"新龍里",NULL
846,1357,17,1374,1667,0,0,82.42,1079,278,"新龍里",NULL
847,1570,20,1590,1932,0,0,82.3,1163,407,"新龍里",NULL
848,1146,20,1166,1458,0,0,79.97,699,447,"龍陣里",NULL
849,1233,23,1256,1585,0,0,79.24,777,456,"龍陣里",NULL
850,1034,16,1050,1282,0,0,81.9,641,393,"龍雲里",NULL
851,1167,23,1190,1460,0,0,81.51,680,487,"龍雲里",NULL
852,1069,21,1090,1372,0,0,79.45,664,405,"龍雲里",NULL
853,1323,13,1336,1599,0,0,83.55,844,479,"龍生里",NULL
854,1414,17,1431,1743,0,0,82.1,953,461,"龍生里",NULL
855,1326,20,1346,1661,0,0,81.04,905,421,"龍生里",NULL
856,1259,27,1286,1566,0,0,82.12,747,512,"住安里",NULL
857,1013,20,1033,1298,0,0,79.58,613,400,"住安里",NULL
858,1222,27,1249,1562,0,0,79.96,795,427,"住安里",NULL
859,1201,18,1219,1575,0,0,77.4,793,408,"義安里",NULL
860,1221,16,1237,1526,0,0,81.06,853,368,"義安里",NULL
861,1108,13,1121,1417,0,0,79.11,696,412,"義安里",NULL
862,1175,28,1203,1464,0,0,82.17,589,586,"通化里",NULL
863,1431,35,1466,1780,0,0,82.36,725,706,"通化里",NULL
864,1453,28,1481,1809,0,0,81.87,793,660,"通化里",NULL
865,1303,28,1331,1663,0,0,80.04,795,508,"通安里",NULL
866,1196,35,1231,1546,0,0,79.62,705,491,"通安里",NULL
867,1227,27,1254,1539,0,0,81.48,745,482,"通安里",NULL
868,1415,30,1445,1768,0,0,81.73,807,608,"臨江里",NULL
869,1400,37,1437,1775,0,0,80.96,809,591,"臨江里",NULL
870,1423,29,1452,1791,0,0,81.07,985,438,"法治里",NULL
871,1394,33,1427,1760,0,0,81.08,868,526,"法治里",NULL
872,1382,29,1411,1768,0,0,79.81,872,510,"全安里",NULL
873,1391,18,1409,1757,0,0,80.19,864,527,"全安里",NULL
874,1392,23,1415,1776,0,0,79.67,883,509,"群賢里",NULL
875,1187,20,1207,1488,0,0,81.12,810,377,"群賢里",NULL
876,1344,18,1362,1772,0,0,76.86,922,422,"群賢里",NULL
877,1069,11,1080,1331,0,0,81.14,928,141,"群英里",NULL
878,1271,13,1284,1595,0,0,80.5,1061,210,"群英里",NULL
879,1186,17,1203,1412,0,0,85.2,840,346,"群英里",NULL
880,1380,21,1401,1669,0,0,83.94,1064,316,"群英里",NULL
881,900,26,926,1122,0,0,82.53,589,311,"虎嘯里",NULL
882,1190,19,1209,1524,0,0,79.33,808,382,"虎嘯里",NULL
883,1365,32,1397,1760,0,0,79.38,946,419,"臥龍里",NULL
884,1349,21,1370,1710,0,0,80.12,904,445,"龍淵里",NULL
885,1480,18,1498,1826,0,0,82.04,959,521,"龍淵里",NULL
886,1371,26,1397,1703,0,0,82.03,890,481,"龍淵里",NULL
887,1392,24,1416,1720,0,0,82.33,823,569,"龍淵里",NULL
888,947,15,962,1208,0,0,79.64,542,405,"龍門里",NULL
889,1599,34,1633,2085,0,0,78.32,1019,580,"龍門里",NULL
890,1228,19,1247,1595,0,0,78.18,777,451,"大學里",NULL
891,1301,31,1332,1658,0,0,80.34,794,507,"大學里",NULL
892,1213,26,1239,1632,0,0,75.92,734,479,"大學里",NULL
893,1276,33,1309,1643,0,0,79.67,824,452,"大學里",NULL
894,1304,23,1327,1595,0,0,83.2,849,455,"芳和里",NULL
895,1302,37,1339,1618,0,0,82.76,823,479,"芳和里",NULL
896,1516,29,1545,1863,0,0,82.93,973,543,"芳和里",NULL
897,1139,39,1178,1416,0,0,83.19,736,403,"黎元里",NULL
898,1445,25,1470,1738,0,0,84.58,855,590,"黎元里",NULL
899,1157,26,1183,1427,0,0,82.9,692,465,"黎元里",NULL
900,1229,28,1257,1507,0,0,83.41,728,501,"黎孝里",NULL
901,1224,26,1250,1482,0,0,84.35,743,481,"黎孝里",NULL
902,1338,12,1350,1582,0,0,85.34,948,390,"黎孝里",NULL
903,1340,26,1366,1657,0,0,82.44,820,520,"黎孝里",NULL
904,1351,34,1385,1693,0,0,81.81,882,469,"黎和里",NULL
905,1554,32,1586,1922,0,0,82.52,1061,493,"黎和里",NULL
906,1776,35,1811,2313,0,0,78.3,1090,686,"建安里",NULL
907,1379,19,1398,1861,0,0,75.12,914,465,"建安里",NULL
908,1287,19,1306,1669,0,0,78.25,786,501,"建倫里",NULL
909,1305,15,1320,1672,0,0,78.95,845,460,"建倫里",NULL
910,1223,18,1241,1586,0,0,78.25,744,479,"建倫里",NULL
911,1127,22,1149,1441,0,0,79.74,648,479,"敦安里",NULL
912,1322,15,1337,1676,0,0,79.77,770,552,"敦安里",NULL
913,1522,22,1544,1918,0,0,80.5,906,616,"敦安里",NULL
914,1498,25,1523,1905,0,0,79.95,985,513,"正聲里",NULL
915,1629,27,1656,2104,0,0,78.71,1060,569,"正聲里",NULL
916,1353,11,1364,1658,0,0,82.27,797,556,"敦煌里",NULL
917,1212,14,1226,1593,0,0,76.96,706,506,"敦煌里",NULL
918,1227,16,1243,1560,0,0,79.68,714,513,"敦煌里",NULL
919,1352,18,1370,1725,0,0,79.42,852,500,"華聲里",NULL
920,1414,31,1445,1812,0,0,79.75,873,541,"華聲里",NULL
921,1353,23,1376,1776,0,0,77.48,801,552,"車層里",NULL
922,1433,21,1454,1822,0,0,79.8,822,611,"車層里",NULL
923,1369,15,1384,1717,0,0,80.61,806,563,"車層里",NULL
924,1285,24,1309,1610,0,0,81.3,793,492,"光信里",NULL
925,1283,21,1304,1632,0,0,79.9,766,517,"光信里",NULL
926,1248,19,1267,1571,0,0,80.65,770,478,"光信里",NULL
927,1146,25,1171,1502,0,0,77.96,673,473,"光信里",NULL
928,609,18,627,792,0,0,79.17,430,179,"學府里",NULL
929,980,25,1005,1340,0,0,75,652,328,"學府里",NULL
930,884,23,907,1115,0,0,81.35,628,256,"學府里",NULL
931,1184,16,1200,1460,0,0,82.19,640,544,"水源里",NULL
932,911,19,930,1147,0,0,81.08,506,405,"水源里",NULL
933,995,9,1004,1327,0,0,75.66,841,154,"富水里",NULL
934,981,30,1011,1217,0,0,83.07,721,260,"富水里",NULL
935,895,17,912,1126,0,0,80.99,515,380,"文盛里",NULL
936,904,14,918,1152,0,0,79.69,527,377,"文盛里",NULL
937,1052,25,1077,1312,0,0,82.09,709,343,"林興里",NULL
938,1038,21,1059,1309,0,0,80.9,669,369,"林興里",NULL
939,1100,20,1120,1396,0,0,80.23,702,398,"林興里",NULL
940,1021,14,1035,1274,0,0,81.24,651,370,"河堤里",NULL
941,929,6,935,1143,0,0,81.8,613,316,"河堤里",NULL
942,1078,23,1101,1440,0,0,76.46,683,395,"河堤里",NULL
943,1354,17,1371,1661,0,0,82.54,791,563,"頂東里",NULL
944,1283,16,1299,1575,0,0,82.48,728,555,"頂東里",NULL
945,1147,26,1173,1464,0,0,80.12,716,431,"頂東里",NULL
946,1276,22,1298,1642,0,0,79.05,806,470,"網溪里",NULL
947,1174,24,1198,1486,0,0,80.62,675,499,"網溪里",NULL
948,1098,12,1110,1361,0,0,81.56,663,435,"網溪里",NULL
949,1124,27,1151,1443,0,0,79.76,608,516,"板溪里",NULL
950,1102,29,1131,1423,0,0,79.48,689,413,"板溪里",NULL
951,1403,19,1422,1737,0,0,81.87,880,523,"螢圃里",NULL
952,1315,32,1347,1620,0,0,83.15,781,534,"螢圃里",NULL
953,883,11,894,1110,0,0,80.54,487,396,"螢圃里",NULL
954,948,13,961,1172,0,0,82,562,386,"螢雪里",NULL
955,1070,24,1094,1293,0,0,84.61,643,427,"螢雪里",NULL
956,939,31,970,1216,0,0,79.77,547,392,"螢雪里",NULL
957,1444,35,1479,1789,0,0,82.67,741,703,"永功里",NULL
958,1421,31,1452,1761,0,0,82.45,739,682,"永功里",NULL
959,1214,21,1235,1540,0,0,80.19,692,522,"永功里",NULL
960,1208,20,1228,1503,0,0,81.7,650,558,"永昌里",NULL
961,1213,28,1241,1542,0,0,80.48,681,532,"永昌里",NULL
962,1125,26,1151,1414,0,0,81.4,640,485,"永昌里",NULL
963,1363,21,1384,1667,0,0,83.02,743,620,"龍興里",NULL
964,1204,16,1220,1470,0,0,82.99,706,498,"龍興里",NULL
965,1190,40,1230,1555,0,0,79.1,755,435,"忠勤里",NULL
966,1222,18,1240,1504,0,0,82.45,760,462,"忠勤里",NULL
967,1054,32,1086,1364,0,0,79.62,637,417,"忠勤里",NULL
968,1105,33,1138,1388,0,0,81.99,589,516,"忠勤里",NULL
969,1192,27,1219,1460,0,0,83.49,692,500,"廈安里",NULL
970,1247,27,1274,1596,0,0,79.82,688,559,"廈安里",NULL
971,999,17,1016,1262,0,0,80.51,533,466,"愛國里",NULL
972,984,18,1002,1236,0,0,81.07,583,401,"愛國里",NULL
973,998,15,1013,1249,0,0,81.1,669,329,"南門里",NULL
974,816,13,829,1055,0,0,78.58,585,231,"南門里",NULL
975,1161,23,1184,1469,0,0,80.6,740,421,"龍光里",NULL
976,1151,11,1162,1427,0,0,81.43,722,429,"龍光里",NULL
977,1396,30,1426,1730,0,0,82.43,808,588,"南福里",NULL
978,1218,19,1237,1453,0,0,85.13,700,518,"南福里",NULL
979,1167,18,1185,1515,0,0,78.22,708,459,"南福里",NULL
980,1240,22,1262,1511,0,0,83.52,777,463,"南福里",NULL
981,1363,19,1382,2069,0,0,66.8,855,508,"龍福里",NULL
982,1305,18,1323,1622,0,0,81.57,833,472,"龍福里",NULL
983,1377,30,1407,1684,0,0,83.55,829,548,"龍福里",NULL
984,1328,22,1350,1562,0,0,86.43,855,473,"新營里",NULL
985,1320,24,1344,1616,0,0,83.17,861,459,"新營里",NULL
986,1348,24,1372,1636,0,0,83.86,914,434,"新營里",NULL
987,1240,24,1264,1518,0,0,83.27,928,312,"新營里",NULL
988,845,9,854,1150,0,0,74.26,585,260,"建國里",NULL
989,1066,24,1090,1356,0,0,80.38,577,489,"光復里",NULL
990,1231,23,1254,1650,0,0,76,705,526,"光復里",NULL
991,753,14,767,1036,0,0,74.03,469,284,"黎明里",NULL
992,1054,25,1079,1422,0,0,75.88,641,413,"黎明里",NULL
993,1147,21,1168,1498,0,0,77.97,672,475,"梅花里",NULL
994,1075,22,1097,1384,0,0,79.26,632,443,"梅花里",NULL
995,1592,37,1629,2047,0,0,79.58,1051,541,"幸福里",NULL
996,1308,31,1339,1670,0,0,80.18,682,626,"幸福里",NULL
997,1351,22,1373,1729,0,0,79.41,714,637,"幸市里",NULL
998,1340,26,1366,1754,0,0,77.88,748,592,"幸市里",NULL
999,922,20,942,1152,0,0,81.77,584,338,"東門里",NULL
1000,944,12,956,1171,0,0,81.64,663,281,"東門里",NULL
1001,993,22,1015,1292,0,0,78.56,710,283,"東門里",NULL
1002,1123,19,1142,1403,0,0,81.4,728,395,"文北里",NULL
1003,1088,16,1104,1395,0,0,79.14,572,516,"文北里",NULL
1004,1023,17,1040,1347,0,0,77.21,582,441,"文北里",NULL
1005,1180,21,1201,1430,0,0,83.99,685,495,"文祥里",NULL
1006,997,16,1013,1222,0,0,82.9,614,383,"文祥里",NULL
1007,1128,27,1155,1415,0,0,81.63,666,462,"文祥里",NULL
1008,1127,27,1154,1378,0,0,83.74,683,444,"文祥里",NULL
1009,1081,25,1106,1392,0,0,79.45,646,435,"三愛里",NULL
1010,1318,19,1337,1634,0,0,81.82,704,614,"三愛里",NULL
1011,1075,14,1089,1356,0,0,80.31,616,459,"三愛里",NULL
1012,1339,27,1366,1695,0,0,80.59,760,579,"三愛里",NULL
1013,1188,25,1213,1488,0,0,81.52,629,559,"福星里",NULL
1014,863,26,889,1123,0,0,79.16,577,286,"福星里",NULL
1015,1281,22,1303,1657,0,0,78.64,629,652,"福星里",NULL
1016,994,33,1027,1406,0,0,73.04,554,440,"萬壽里",NULL
1017,1072,20,1092,1418,0,0,77.01,564,508,"萬壽里",NULL
1018,1182,26,1208,1605,0,0,75.26,719,463,"西門里",NULL
1019,1013,29,1042,1331,0,0,78.29,606,407,"西門里",NULL
1020,1124,41,1165,1426,0,0,81.7,521,603,"新起里",NULL
1021,1243,32,1275,1588,0,0,80.29,675,568,"新起里",NULL
1022,1127,39,1166,1483,0,0,78.62,603,524,"新起里",NULL
1023,1104,28,1132,1388,0,0,81.56,724,380,"新起里",NULL
1024,1240,34,1274,1595,0,0,79.87,660,580,"菜園里",NULL
1025,1301,46,1347,1900,0,0,70.89,598,703,"菜園里",NULL
1026,1416,26,1442,1774,0,0,81.29,624,792,"菜園里",NULL
1027,1187,24,1211,1523,0,0,79.51,551,636,"青山里",NULL
1028,1227,32,1259,1581,0,0,79.63,525,702,"青山里",NULL
1029,1086,36,1122,1424,0,0,78.79,519,567,"青山里",NULL
1030,1375,18,1393,1675,0,0,83.16,597,778,"富民里",NULL
1031,931,32,963,1199,0,0,80.32,391,540,"富民里",NULL
1032,1090,31,1121,1359,0,0,82.49,438,652,"富民里",NULL
1033,1311,31,1342,1591,0,0,84.35,626,685,"福音里",NULL
1034,1219,26,1245,1516,0,0,82.12,560,659,"福音里",NULL
1035,1542,33,1575,1928,0,0,81.69,805,737,"仁德里",NULL
1036,1390,30,1420,1702,0,0,83.43,634,756,"仁德里",NULL
1037,1054,15,1069,1285,0,0,83.19,465,589,"富福里",NULL
1038,1010,16,1026,1217,0,0,84.31,467,543,"富福里",NULL
1039,1146,19,1165,1364,0,0,85.41,483,663,"富福里",NULL
1040,1891,40,1931,2366,0,0,81.61,835,1056,"糖廍里",NULL
1041,1760,40,1800,2185,0,0,82.38,896,864,"糖廍里",NULL
1042,1117,28,1145,1371,0,0,83.52,491,626,"綠堤里",NULL
1043,969,31,1000,1281,0,0,78.06,552,417,"綠堤里",NULL
1044,1027,39,1066,1320,0,0,80.76,543,484,"綠堤里",NULL
1045,1330,37,1367,1627,0,0,84.02,691,639,"華江里",NULL
1046,1263,22,1285,1588,0,0,80.92,565,698,"華江里",NULL
1047,1519,29,1548,1854,0,0,83.5,713,806,"華江里",NULL
1048,1516,39,1555,2003,0,0,77.63,694,822,"華江里",NULL
1049,1535,19,1554,1924,0,0,80.77,638,897,"柳鄉里",NULL
1050,1040,20,1060,1291,0,0,82.11,428,612,"柳鄉里",NULL
1051,1064,33,1097,1342,0,0,81.74,456,608,"柳鄉里",NULL
1052,1362,29,1391,2021,0,0,68.83,518,844,"頂碩里",NULL
1053,1605,17,1622,1920,0,0,84.48,593,1012,"頂碩里",NULL
1054,1202,23,1225,1463,0,0,83.73,524,678,"頂碩里",NULL
1055,1275,36,1311,1544,0,0,84.91,590,685,"頂碩里",NULL
1056,1195,25,1220,1540,0,0,79.22,544,651,"雙園里",NULL
1057,1105,24,1129,1359,0,0,83.08,486,619,"雙園里",NULL
1058,1170,34,1204,1494,0,0,80.59,517,653,"雙園里",NULL
1059,1211,37,1248,1598,0,0,78.1,881,330,"新忠里",NULL
1060,1436,18,1454,1736,0,0,83.76,1295,141,"新忠里",NULL
1061,1299,18,1317,1522,0,0,86.53,1167,132,"新和里",NULL
1062,1244,27,1271,1502,0,0,84.62,980,264,"新和里",NULL
1063,1270,24,1294,1503,0,0,86.09,868,402,"新和里",NULL
1064,1157,35,1192,1495,0,0,79.73,966,191,"新和里",NULL
1065,1195,22,1217,1409,0,0,86.37,821,374,"新和里",NULL
1066,1330,22,1352,1642,0,0,82.34,483,847,"和平里",NULL
1067,1259,35,1294,1542,0,0,83.92,509,750,"和平里",NULL
1068,1062,20,1082,1310,0,0,82.6,483,579,"和平里",NULL
1069,1256,45,1301,1586,0,0,82.03,536,720,"和平里",NULL
1070,1265,29,1294,1543,0,0,83.86,606,659,"日善里",NULL
1071,1416,25,1441,1688,0,0,85.37,646,770,"日善里",NULL
1072,1203,40,1243,1528,0,0,81.35,712,491,"新安里",NULL
1073,1161,24,1185,1429,0,0,82.93,676,485,"新安里",NULL
1074,946,21,967,1197,0,0,80.79,623,323,"新安里",NULL
1075,1049,25,1074,1278,0,0,84.04,802,247,"新安里",NULL
1076,1457,42,1499,1806,0,0,83,595,862,"忠德里",NULL
1077,1615,33,1648,1972,0,0,83.57,715,900,"忠德里",NULL
1078,1217,23,1240,1488,0,0,83.33,492,725,"孝德里",NULL
1079,1048,13,1061,1253,0,0,84.68,449,599,"孝德里",NULL
1080,1306,22,1328,1566,0,0,84.8,533,773,"和德里",NULL
1081,1123,23,1146,1513,0,0,75.74,490,633,"和德里",NULL
1082,1156,31,1187,1484,0,0,79.99,546,610,"和德里",NULL
1083,1152,24,1176,1405,0,0,83.7,469,683,"和德里",NULL
1084,1247,28,1275,1523,0,0,83.72,560,687,"錦德里",NULL
1085,1261,44,1305,1584,0,0,82.39,634,627,"錦德里",NULL
1086,1113,27,1140,1343,0,0,84.88,521,592,"錦德里",NULL
1087,1405,32,1437,1725,0,0,83.3,666,739,"全德里",NULL
1088,1460,24,1484,1809,0,0,82.03,756,704,"全德里",NULL
1089,1035,16,1051,1241,0,0,84.69,487,548,"保德里",NULL
1090,1017,26,1043,1241,0,0,84.05,472,545,"保德里",NULL
1091,1149,18,1167,1392,0,0,83.84,544,605,"銘德里",NULL
1092,1229,31,1260,1469,0,0,85.77,533,696,"銘德里",NULL
1093,939,11,950,1155,0,0,82.25,471,468,"銘德里",NULL
1094,1296,33,1329,1559,0,0,85.25,620,676,"榮德里",NULL
1095,1405,37,1442,1699,0,0,84.87,667,738,"榮德里",NULL
1096,1192,29,1221,1462,0,0,83.52,585,607,"壽德里",NULL
1097,1134,22,1156,1377,0,0,83.95,585,549,"壽德里",NULL
1098,1033,17,1050,1210,0,0,86.78,498,535,"壽德里",NULL
1099,1022,22,1044,1250,0,0,83.52,463,559,"興德里",NULL
1100,1130,32,1162,1404,0,0,82.76,547,583,"興德里",NULL
1101,1070,28,1098,1350,0,0,81.33,448,622,"興德里",NULL
1102,1523,35,1558,1863,0,0,83.63,723,800,"華中里",NULL
1103,1447,42,1489,1760,0,0,84.6,636,811,"華中里",NULL
1104,1313,27,1340,1600,0,0,83.75,605,708,"華中里",NULL
1105,1346,44,1390,1683,0,0,82.59,723,623,"日祥里",NULL
1106,1342,32,1374,1618,0,0,84.92,846,496,"日祥里",NULL
1107,1308,35,1343,1590,0,0,84.47,1100,208,"日祥里",NULL
1108,1089,23,1112,1327,0,0,83.8,891,198,"忠貞里",NULL
1109,1321,18,1339,1541,0,0,86.89,1038,283,"忠貞里",NULL
1110,1143,31,1174,1439,0,0,81.58,629,514,"忠貞里",NULL
1111,1280,15,1295,1583,0,0,81.81,819,461,"凌霄里",NULL
1112,1534,67,1601,1943,0,0,82.4,1120,414,"凌霄里",NULL
1113,1143,19,1162,1413,0,0,82.24,802,341,"騰雲里",NULL
1114,1008,27,1035,1232,0,0,84.01,638,370,"騰雲里",NULL
1115,1044,19,1063,1324,0,0,80.29,599,445,"景行里",NULL
1116,1375,39,1414,1714,0,0,82.5,692,683,"景行里",NULL
1117,1077,14,1091,1308,0,0,83.41,568,509,"景行里",NULL
1118,1436,24,1460,1778,0,0,82.11,985,451,"景東里",NULL
1119,1423,22,1445,1744,0,0,82.86,962,461,"景東里",NULL
1120,1404,20,1424,1732,0,0,82.22,961,443,"景東里",NULL
1121,1466,32,1498,1826,0,0,82.04,952,514,"景美里",NULL
1122,1410,8,1418,1708,0,0,83.02,815,595,"景美里",NULL
1123,1264,32,1296,1584,0,0,81.82,868,396,"景慶里",NULL
1124,1370,34,1404,1697,0,0,82.73,865,505,"景慶里",NULL
1125,1439,27,1466,1741,0,0,84.2,859,580,"景慶里",NULL
1126,1414,17,1431,1716,0,0,83.39,912,502,"景仁里",NULL
1127,1517,32,1549,1879,0,0,82.44,998,519,"景仁里",NULL
1128,1218,18,1236,1502,0,0,82.29,821,397,"景華里",NULL
1129,1248,22,1270,1553,0,0,81.78,818,430,"景華里",NULL
1130,1188,16,1204,1430,0,0,84.2,721,467,"景華里",NULL
1131,1441,26,1467,1729,0,0,84.85,895,546,"萬有里",NULL
1132,1684,36,1720,2025,0,0,84.94,1109,575,"萬有里",NULL
1133,1416,15,1431,1713,0,0,83.54,890,526,"萬祥里",NULL
1134,1543,27,1570,1860,0,0,84.41,974,569,"萬祥里",NULL
1135,1518,13,1531,1861,0,0,82.27,1089,429,"萬隆里",NULL
1136,1404,25,1429,1771,0,0,80.69,961,443,"萬隆里",NULL
1137,1688,20,1708,2017,0,0,84.68,1104,584,"萬隆里",NULL
1138,1232,22,1254,1537,0,0,81.59,716,516,"萬年里",NULL
1139,1122,23,1145,1372,0,0,83.45,685,437,"萬年里",NULL
1140,1133,25,1158,1424,0,0,81.32,762,371,"萬年里",NULL
1141,1201,24,1225,1469,0,0,83.39,874,327,"萬和里",NULL
1142,1074,33,1107,1314,0,0,84.25,926,148,"萬和里",NULL
1143,1474,28,1502,1829,0,0,82.12,980,494,"萬盛里",NULL
1144,1635,38,1673,2007,0,0,83.36,1125,510,"萬盛里",NULL
1145,1480,33,1513,1843,0,0,82.09,893,587,"興豐里",NULL
1146,1243,28,1271,1490,0,0,85.3,807,436,"興豐里",NULL
1147,1458,37,1495,1821,0,0,82.1,1008,450,"興豐里",NULL
1148,1463,36,1499,1748,0,0,85.76,1106,357,"興豐里",NULL
1149,1066,22,1088,1338,0,0,81.32,671,395,"興光里",NULL
1150,1007,24,1031,1224,0,0,84.23,696,311,"興光里",NULL
1151,1568,21,1589,1922,0,0,82.67,1043,525,"興家里",NULL
1152,1779,22,1801,2116,0,0,85.11,1280,499,"興家里",NULL
1153,1530,30,1560,1913,0,0,81.55,1042,488,"興家里",NULL
1154,1268,23,1291,1553,0,0,83.13,836,432,"興得里",NULL
1155,1463,23,1486,1832,0,0,81.11,995,468,"興得里",NULL
1156,1317,26,1343,1645,0,0,81.64,854,463,"興得里",NULL
1157,1321,20,1341,1892,0,0,70.88,949,372,"興業里",NULL
1158,1200,17,1217,1471,0,0,82.73,867,333,"興業里",NULL
1159,1127,23,1150,1396,0,0,82.38,861,266,"興業里",NULL
1160,1278,24,1302,1569,0,0,82.98,843,435,"興安里",NULL
1161,1365,15,1380,1664,0,0,82.93,967,398,"興安里",NULL
1162,1455,26,1481,1743,0,0,84.97,1026,429,"興安里",NULL
1163,1261,16,1277,1472,0,0,86.75,796,465,"興福里",NULL
1164,1249,17,1266,1477,0,0,85.71,781,468,"興福里",NULL
1165,1439,23,1462,1716,0,0,85.2,930,509,"興福里",NULL
1166,1353,28,1381,1681,0,0,82.15,975,378,"興旺里",NULL
1167,1409,24,1433,1716,0,0,83.51,1004,405,"興旺里",NULL
1168,1785,38,1823,2210,0,0,82.49,1247,538,"興旺里",NULL
1169,1334,29,1363,1660,0,0,82.11,905,429,"興泰里",NULL
1170,1181,29,1210,1443,0,0,83.85,805,376,"興泰里",NULL
1171,1367,27,1394,1719,0,0,81.09,1029,338,"興昌里",NULL
1172,1373,33,1406,1701,0,0,82.66,922,451,"興昌里",NULL
1173,1300,19,1319,1591,0,0,82.9,943,357,"興昌里",NULL
1174,1320,16,1336,1588,0,0,84.13,1016,304,"試院里",NULL
1175,1497,18,1515,1799,0,0,84.21,1066,431,"試院里",NULL
1176,1392,17,1409,1672,0,0,84.27,966,426,"試院里",NULL
1177,1664,31,1695,2039,0,0,83.13,1121,543,"華興里",NULL
1178,1699,20,1719,2076,0,0,82.8,1131,568,"華興里",NULL
1179,1556,33,1589,1872,0,0,84.88,1035,521,"華興里",NULL
1180,1408,40,1448,1725,0,0,83.94,946,462,"明義里",NULL
1181,934,58,992,1326,0,0,74.81,616,318,"明義里",NULL
1182,631,43,674,934,0,0,72.16,425,206,"明義里",NULL
1183,1624,34,1658,1973,0,0,84.03,1100,524,"明興里",NULL
1184,1560,38,1598,1937,0,0,82.5,1085,475,"明興里",NULL
1185,1467,20,1487,1761,0,0,84.44,1073,394,"明興里",NULL
1186,1998,34,2032,2438,0,0,83.35,1332,666,"木柵里",NULL
1187,1804,36,1840,2164,0,0,85.03,1262,542,"木柵里",NULL
1188,1118,15,1133,1299,0,0,87.22,919,199,"木柵里",NULL
1189,1168,23,1191,1522,0,0,78.25,693,475,"木新里",NULL
1190,1476,35,1511,1837,0,0,82.25,847,629,"木新里",NULL
1191,1525,26,1551,1887,0,0,82.19,996,529,"木新里",NULL
1192,1450,21,1471,1799,0,0,81.77,907,543,"木新里",NULL
1193,1691,38,1729,2081,0,0,83.09,1026,665,"順興里",NULL
1194,1478,23,1501,1785,0,0,84.09,919,559,"順興里",NULL
1195,1299,24,1323,1596,0,0,82.89,822,477,"順興里",NULL
1196,1262,33,1295,1531,0,0,84.59,954,308,"忠順里",NULL
1197,1221,23,1244,1470,0,0,84.63,881,340,"忠順里",NULL
1198,1206,15,1221,1484,0,0,82.28,880,326,"樟林里",NULL
1199,1359,27,1386,1681,0,0,82.45,931,428,"樟林里",NULL
1200,1527,33,1560,1838,0,0,84.87,950,577,"樟林里",NULL
1201,1356,19,1375,1627,0,0,84.51,938,418,"樟林里",NULL
1202,1263,19,1282,1512,0,0,84.79,801,462,"樟新里",NULL
1203,1389,36,1425,1698,0,0,83.92,870,519,"樟新里",NULL
1204,1608,39,1647,1990,0,0,82.76,1055,553,"樟新里",NULL
1205,1691,33,1724,2067,0,0,83.41,1047,644,"樟新里",NULL
1206,1412,29,1441,1712,0,0,84.17,941,471,"樟新里",NULL
1207,1633,33,1666,2004,0,0,83.13,1025,608,"樟腳里",NULL
1208,1376,25,1401,1651,0,0,84.86,879,497,"樟腳里",NULL
1209,1308,29,1337,1612,0,0,82.94,812,496,"樟腳里",NULL
1210,1583,27,1610,1914,0,0,84.12,988,595,"樟腳里",NULL
1211,838,11,849,1044,0,0,81.32,553,285,"萬芳里",NULL
1212,1625,33,1658,1970,0,0,84.16,1142,483,"萬芳里",NULL
1213,2222,44,2266,2717,0,0,83.4,1542,680,"萬芳里",NULL
1214,1480,35,1515,1857,0,0,81.58,1006,474,"萬美里",NULL
1215,1150,21,1171,1447,0,0,80.93,799,351,"萬美里",NULL
1216,1585,29,1614,1980,0,0,81.52,1024,561,"萬美里",NULL
1217,1442,39,1481,1807,0,0,81.96,882,560,"博嘉里",NULL
1218,1583,33,1616,1992,0,0,81.12,1039,544,"博嘉里",NULL
1219,1782,32,1814,2213,0,0,81.97,1094,688,"萬興里",NULL
1220,1696,32,1728,2070,0,0,83.48,1138,558,"萬興里",NULL
1221,1695,37,1732,2115,0,0,81.89,970,725,"萬興里",NULL
1222,1695,15,1710,1992,0,0,85.84,1184,511,"萬興里",NULL
1223,1335,31,1366,1692,0,0,80.73,811,524,"指南里",NULL
1224,536,32,568,677,0,0,83.9,185,351,"指南里",NULL
1225,574,17,591,711,0,0,83.12,217,357,"老泉里",NULL
1,1040,22,1062,1282,0,0,82.84,348,692,"藍橋里",NULL
2,398,8,406,498,0,0,81.53,183,215,"慈愛里",NULL
3,583,17,600,736,0,0,81.52,189,394,"博愛里",NULL
4,1059,27,1086,1341,0,0,80.98,462,597,"壽星里",NULL
5,961,14,975,1214,0,0,80.31,397,564,"中山里",NULL
6,1822,21,1843,2245,0,0,82.09,719,1103,"教仁里",NULL
7,760,7,767,928,0,0,82.65,330,430,"新樂里",NULL
8,560,3,563,700,0,0,80.43,242,318,"中原里",NULL
9,990,8,998,1248,0,0,79.97,396,594,"光明里",NULL
10,675,9,684,851,0,0,80.38,282,393,"育仁里",NULL
11,1479,19,1498,1841,0,0,81.37,632,847,"河濱里",NULL
12,872,12,884,1097,0,0,80.58,304,568,"沙地里",NULL
13,898,20,918,1128,0,0,81.38,394,504,"南端里",NULL
14,916,22,938,1186,0,0,79.09,377,539,"港都里",NULL
15,1013,10,1023,1238,0,0,82.63,369,644,"江西里",NULL
16,509,15,524,624,0,0,83.97,252,257,"新豐里",NULL
17,1399,25,1424,1807,0,0,78.8,590,809,"府北里",NULL
18,1009,21,1030,1273,0,0,80.91,441,568,"陸橋里",NULL
19,596,9,605,729,0,0,82.99,201,395,"瀨南里",NULL
20,581,10,591,706,0,0,83.71,252,329,"新化里",NULL
21,720,14,734,943,0,0,77.84,211,509,"江南里",NULL
22,864,17,881,1080,0,0,81.57,500,364,"鼓峰里",NULL
23,838,10,848,1022,0,0,82.97,491,347,"鼓峰里",NULL
24,796,15,811,993,0,0,81.67,606,190,"雄峰里",NULL
25,887,10,897,1100,0,0,81.55,598,289,"雄峰里",NULL
26,1377,27,1404,1677,0,0,83.72,608,769,"前峰里",NULL
27,1167,20,1187,1401,0,0,84.73,651,516,"前峰里",NULL
28,1039,17,1056,1241,0,0,85.09,765,274,"前峰里",NULL
29,975,21,996,1192,0,0,83.56,274,701,"光榮里",NULL
30,1094,21,1115,1367,0,0,81.57,380,714,"光榮里",NULL
31,1129,12,1141,1353,0,0,84.33,359,770,"光榮里",NULL
32,1231,17,1248,1488,0,0,83.87,536,695,"民族里",NULL
33,996,21,1017,1206,0,0,84.33,290,706,"內惟里",NULL
34,918,19,937,1093,0,0,85.73,376,542,"建國里",NULL
35,837,13,850,1016,0,0,83.66,342,495,"建國里",NULL
36,1150,13,1163,1410,0,0,82.48,471,679,"忠正里",NULL
37,1077,10,1087,1345,0,0,80.82,423,654,"忠正里",NULL
38,1050,13,1063,1253,0,0,84.84,507,543,"忠正里",NULL
39,713,13,726,851,0,0,85.31,676,37,"自強里",NULL
40,1202,30,1232,1523,0,0,80.89,506,696,"龍井里",NULL
41,1510,21,1531,1856,0,0,82.49,509,1001,"正德里",NULL
42,1337,26,1363,1639,0,0,83.16,408,929,"平和里",NULL
43,1162,23,1185,1392,0,0,85.13,453,709,"平和里",NULL
44,1239,32,1271,1472,0,0,86.35,434,805,"民強里",NULL
45,1091,28,1119,1372,0,0,81.56,459,632,"民強里",NULL
46,1872,35,1907,2279,0,0,83.68,594,1278,"厚生里",NULL
47,1365,16,1381,1681,0,0,82.15,579,786,"龍子里",NULL
48,1508,25,1533,1844,0,0,83.13,554,954,"龍子里",NULL
49,1333,27,1360,1711,0,0,79.49,735,598,"龍子里",NULL
50,1272,12,1284,1579,0,0,81.32,680,592,"龍水里",NULL
51,1548,30,1578,1906,0,0,82.79,717,831,"明誠里",NULL
52,1481,31,1512,1798,0,0,84.09,848,633,"明誠里",NULL
53,1582,28,1610,1977,0,0,81.44,975,607,"明誠里",NULL
54,1495,19,1514,1850,0,0,81.84,875,620,"明誠里",NULL
55,1103,11,1114,1366,0,0,81.55,620,483,"明誠里",NULL
56,1177,14,1191,1445,0,0,82.42,623,554,"明誠里",NULL
57,1498,16,1514,1798,0,0,84.2,913,585,"華豐里",NULL
58,1435,19,1454,1757,0,0,82.75,824,611,"華豐里",NULL
59,1177,18,1195,1447,0,0,82.58,714,463,"裕興里",NULL
60,1214,25,1239,1489,0,0,83.21,665,549,"裕興里",NULL
61,864,5,869,1033,0,0,84.12,589,275,"裕豐里",NULL
62,1020,14,1034,1265,0,0,81.74,663,357,"裕豐里",NULL
63,1185,25,1210,1513,0,0,79.97,403,782,"鼓岩里",NULL
64,930,11,941,1149,0,0,81.9,282,648,"樹德里",NULL
65,842,3,845,1173,0,0,72.04,304,538,"寶樹里",NULL
66,1208,17,1225,1503,0,0,81.5,543,665,"興宗里",NULL
67,1261,9,1270,1562,0,0,81.31,624,637,"光化里",NULL
68,1100,26,1126,1408,0,0,79.97,592,508,"山下里",NULL
69,1261,25,1286,1570,0,0,81.91,514,747,"河邊里",NULL
70,1296,40,1336,1615,0,0,82.72,465,831,"綠川里",NULL
71,608,3,611,820,0,0,74.51,268,340,"登山里",NULL
72,785,22,807,1037,0,0,77.82,301,484,"峰南里",NULL
73,895,29,924,1187,0,0,77.84,339,556,"麗興里",NULL
74,889,20,909,1160,0,0,78.36,283,606,"新民里",NULL
75,734,9,743,923,0,0,80.5,237,497,"延平里",NULL
76,1135,15,1150,1463,0,0,78.61,361,774,"維生里",NULL
77,1117,19,1136,1445,0,0,78.62,360,757,"惠安里",NULL
78,1205,34,1239,1586,0,0,78.12,425,780,"壽山里",NULL
79,930,16,946,1199,0,0,78.9,408,522,"哨船頭里",NULL
80,504,9,513,620,0,0,82.74,221,283,"桃源里",NULL
81,953,34,987,1249,0,0,79.02,331,622,"旗下里",NULL
82,845,18,863,1102,0,0,78.31,289,556,"永安里",NULL
83,1321,10,1331,1700,0,0,78.29,457,864,"振興里",NULL
84,895,21,916,1126,0,0,81.35,323,572,"慈愛里",NULL
85,728,11,739,978,0,0,75.56,248,480,"慈愛里",NULL
86,1116,23,1139,1425,0,0,79.93,425,691,"復興里",NULL
87,1007,30,1037,1347,0,0,76.99,495,512,"復興里",NULL
88,1030,24,1054,1281,0,0,82.28,321,709,"中華里",NULL
89,1006,30,1036,1353,0,0,76.57,693,313,"實踐里",NULL
90,973,19,992,1219,0,0,81.38,336,637,"北汕里",NULL
91,958,14,972,1232,0,0,78.9,367,591,"北汕里",NULL
92,1330,20,1350,1676,0,0,80.55,372,958,"南汕里",NULL
93,678,10,688,869,0,0,79.17,142,536,"上竹里",NULL
94,1306,32,1338,1699,0,0,78.75,382,924,"上竹里",NULL
95,1282,25,1307,1623,0,0,80.53,330,952,"中洲里",NULL
96,753,18,771,955,0,0,80.73,186,567,"安順里",NULL
97,882,17,899,1082,0,0,83.09,221,661,"中興里",NULL
98,895,20,915,1113,0,0,82.21,326,569,"中興里",NULL
99,1284,22,1306,1889,0,0,69.14,645,639,"進學里",NULL
100,984,20,1004,1198,0,0,83.81,313,671,"尾西里",NULL
101,489,10,499,602,0,0,82.89,178,311,"頂北里",NULL
102,611,9,620,731,0,0,84.82,151,460,"中北里",NULL
103,456,12,468,569,0,0,82.25,89,367,"中南里",NULL
104,769,16,785,923,0,0,85.05,176,593,"廟東里",NULL
105,865,20,885,1043,0,0,84.85,200,665,"廟北里",NULL
106,681,24,705,838,0,0,84.13,167,514,"尾南里",NULL
107,1153,32,1185,1417,0,0,83.63,518,635,"尾北里",NULL
108,1284,18,1302,1563,0,0,83.3,444,840,"尾北里",NULL
109,1216,29,1245,1496,0,0,83.22,888,328,"屏山里",NULL
110,480,13,493,598,0,0,82.44,444,36,"祥和里",NULL
111,835,21,856,1043,0,0,82.07,774,61,"永清里",NULL
112,823,24,847,1058,0,0,80.06,769,54,"永清里",NULL
113,1023,22,1045,1265,0,0,82.61,955,68,"復興里",NULL
114,1413,24,1437,1719,0,0,83.6,973,440,"莒光里",NULL
115,921,18,939,1124,0,0,83.54,565,356,"光輝里",NULL
116,1107,23,1130,1362,0,0,82.97,632,475,"光輝里",NULL
117,1112,14,1126,1357,0,0,82.98,1069,43,"合群里",NULL
118,438,7,445,552,0,0,80.62,406,32,"自治里",NULL
119,505,16,521,641,0,0,81.28,482,23,"自治里",NULL
120,1214,12,1226,1536,0,0,79.82,1174,40,"明建里",NULL
121,43,0,43,71,0,0,60.56,39,4,"自立里",NULL
122,988,20,1008,1171,0,0,86.08,267,721,"頂西里",NULL
123,781,13,794,950,0,0,83.58,182,599,"聖后里",NULL
124,312,10,322,382,0,0,84.29,86,226,"聖西里",NULL
125,474,7,481,587,0,0,81.94,153,321,"聖南里",NULL
126,473,5,478,563,0,0,84.9,138,335,"城南里",NULL
127,654,9,663,791,0,0,83.82,208,446,"路東里",NULL
128,446,8,454,537,0,0,84.54,94,352,"廍北里",NULL
129,626,16,642,766,0,0,83.81,241,385,"廍南里",NULL
130,919,12,931,1126,0,0,82.68,382,537,"埤西里",NULL
131,1111,32,1143,1428,0,0,80.04,719,392,"埤北里",NULL
132,976,19,995,1218,0,0,81.69,465,511,"埤東里",NULL
133,1232,23,1255,1483,0,0,84.63,1068,164,"海勝里",NULL
134,1624,28,1652,1994,0,0,82.85,1431,193,"海勝里",NULL
135,1373,29,1402,1595,0,0,87.9,1286,87,"海勝里",NULL
136,66,2,68,123,0,0,55.28,53,13,"自勉里",NULL
137,937,16,953,1138,0,0,83.74,896,41,"崇實里",NULL
138,1151,15,1166,1412,0,0,82.58,1108,43,"自助里",NULL
139,757,27,784,964,0,0,81.33,645,112,"自助里",NULL
140,751,14,765,907,0,0,84.34,682,69,"果貿里",NULL
141,849,18,867,1033,0,0,83.93,773,76,"果貿里",NULL
142,1282,26,1308,1582,0,0,82.68,1018,264,"果惠里",NULL
143,1426,27,1453,1765,0,0,82.32,1270,156,"果峰里",NULL
144,1199,13,1212,1482,0,0,81.78,670,529,"新下里",NULL
145,1620,16,1636,1928,0,0,84.85,917,703,"新下里",NULL
146,1306,23,1329,1634,0,0,81.33,608,698,"新下里",NULL
147,1373,14,1387,1688,0,0,82.17,740,633,"新下里",NULL
148,1445,14,1459,1740,0,0,83.85,836,609,"新下里",NULL
149,1123,29,1152,1392,0,0,82.76,430,693,"新下里",NULL
150,1053,23,1076,1292,0,0,83.28,455,598,"新上里",NULL
151,1187,23,1210,1418,0,0,85.33,365,822,"新上里",NULL
152,1181,18,1199,1431,0,0,83.79,435,746,"新上里",NULL
153,1533,21,1554,1857,0,0,83.68,724,809,"新上里",NULL
154,1582,24,1606,1948,0,0,82.44,812,770,"新上里",NULL
155,1542,24,1566,1944,0,0,80.56,859,683,"新上里",NULL
156,1583,15,1598,1896,0,0,84.28,840,743,"新上里",NULL
157,1286,20,1306,1558,0,0,83.83,685,601,"新上里",NULL
158,1553,15,1568,1938,0,0,80.91,821,732,"新上里",NULL
159,1590,25,1615,1911,0,0,84.51,739,851,"新上里",NULL
160,1387,10,1397,1735,0,0,80.52,659,728,"新上里",NULL
161,1467,24,1491,1764,0,0,84.52,458,1009,"新中里",NULL
162,1079,22,1101,1289,0,0,85.42,320,759,"新中里",NULL
163,1253,19,1272,1530,0,0,83.14,450,803,"新中里",NULL
164,1446,21,1467,1726,0,0,84.99,553,893,"新光里",NULL
165,1486,26,1512,1891,0,0,79.96,768,718,"新光里",NULL
166,1411,23,1434,1716,0,0,83.57,702,709,"新光里",NULL
167,1474,14,1488,1755,0,0,84.79,813,661,"新光里",NULL
168,1687,16,1703,2026,0,0,84.06,888,799,"新光里",NULL
169,1685,19,1704,2088,0,0,81.61,910,775,"菜公里",NULL
170,1698,27,1725,2098,0,0,82.22,742,956,"菜公里",NULL
171,1641,22,1663,1998,0,0,83.23,794,847,"菜公里",NULL
172,1537,22,1559,1853,0,0,84.13,626,911,"菜公里",NULL
173,1615,24,1639,2005,0,0,81.75,803,812,"菜公里",NULL
174,1745,17,1762,2159,0,0,81.61,969,776,"菜公里",NULL
175,1762,26,1788,2110,0,0,84.74,901,861,"菜公里",NULL
176,1164,17,1181,1439,0,0,82.07,626,538,"菜公里",NULL
177,1401,16,1417,1731,0,0,81.86,761,640,"菜公里",NULL
178,1136,10,1146,1429,0,0,80.2,655,481,"福山里",NULL
179,1230,14,1244,1549,0,0,80.31,682,548,"福山里",NULL
180,1400,26,1426,1742,0,0,81.86,629,771,"福山里",NULL
181,1392,13,1405,1722,0,0,81.59,782,610,"福山里",NULL
182,1386,18,1404,1690,0,0,83.08,649,737,"福山里",NULL
183,1429,19,1448,1777,0,0,81.49,770,659,"福山里",NULL
184,1273,14,1287,1651,0,0,77.95,704,569,"福山里",NULL
185,1301,15,1316,1603,0,0,82.1,729,572,"福山里",NULL
186,1044,12,1056,1338,0,0,78.92,530,514,"福山里",NULL
187,1588,24,1612,1967,0,0,81.95,751,837,"福山里",NULL
188,1097,9,1106,1364,0,0,81.09,632,465,"福山里",NULL
189,1099,10,1109,1374,0,0,80.71,702,397,"福山里",NULL
190,1204,12,1216,1464,0,0,83.06,712,492,"福山里",NULL
191,1352,36,1388,1663,0,0,83.46,429,923,"清豐里",NULL
192,1502,28,1530,1860,0,0,82.26,510,992,"清豐里",NULL
193,1614,15,1629,1996,0,0,81.61,669,945,"清豐里",NULL
194,1463,17,1480,1801,0,0,82.18,722,741,"清豐里",NULL
195,1435,22,1457,1755,0,0,83.02,666,769,"清豐里",NULL
196,958,15,973,1181,0,0,82.39,338,620,"東寧里",NULL
197,900,12,912,1094,0,0,83.36,508,392,"東寧里",NULL
198,1087,4,1091,1319,0,0,82.71,331,756,"五常里",NULL
199,1196,19,1215,1512,0,0,80.36,498,698,"五常里",NULL
200,1166,14,1180,1450,0,0,81.38,467,699,"五常里",NULL
201,1095,19,1114,1298,0,0,85.82,335,760,"享平里",NULL
202,1168,12,1180,1431,0,0,82.46,567,601,"享平里",NULL
203,1189,18,1207,1447,0,0,83.41,382,807,"中陽里",NULL
204,1022,14,1036,1250,0,0,82.88,328,694,"中陽里",NULL
205,876,14,890,1288,0,0,69.1,305,571,"惠楠里",NULL
206,1017,16,1033,1249,0,0,82.71,536,481,"惠楠里",NULL
207,1259,32,1291,1582,0,0,81.61,483,776,"惠民里",NULL
208,1371,25,1396,1655,0,0,84.35,587,784,"惠民里",NULL
209,952,17,969,1237,0,0,78.33,432,520,"惠豐里",NULL
210,1327,15,1342,1640,0,0,81.83,691,636,"惠豐里",NULL
211,1398,19,1417,1659,0,0,85.41,332,1066,"錦屏里",NULL
212,1456,11,1467,1749,0,0,83.88,461,995,"錦屏里",NULL
213,875,17,892,1065,0,0,83.76,167,708,"玉屏里",NULL
214,1049,15,1064,1238,0,0,85.95,286,763,"玉屏里",NULL
215,1384,21,1405,1682,0,0,83.53,323,1061,"金田里",NULL
216,1286,11,1297,1535,0,0,84.5,343,943,"金田里",NULL
217,1354,27,1381,1609,0,0,85.83,301,1053,"稔田里",NULL
218,1263,11,1274,1565,0,0,81.41,437,826,"瑞屏里",NULL
219,1295,12,1307,1601,0,0,81.64,583,712,"瑞屏里",NULL
220,1261,15,1276,1574,0,0,81.07,772,489,"翠屏里",NULL
221,1351,19,1370,1646,0,0,83.23,900,451,"翠屏里",NULL
222,1232,16,1248,1547,0,0,80.67,709,523,"翠屏里",NULL
223,1204,25,1229,1539,0,0,79.86,700,504,"翠屏里",NULL
224,1111,19,1130,1424,0,0,79.35,705,406,"翠屏里",NULL
225,1285,14,1299,1587,0,0,81.85,753,532,"翠屏里",NULL
226,1450,17,1467,1797,0,0,81.64,787,663,"翠屏里",NULL
227,1391,13,1404,1706,0,0,82.3,906,485,"宏南里",NULL
228,1232,11,1243,1470,0,0,84.56,496,736,"宏毅里",NULL
229,1214,11,1225,1426,0,0,85.9,493,721,"宏毅里",NULL
230,1077,20,1097,1263,0,0,86.86,461,616,"宏榮里",NULL
231,684,31,715,841,0,0,85.02,559,125,"宏榮里",NULL
232,1164,30,1194,1383,0,0,86.33,445,719,"廣昌里",NULL
233,1363,28,1391,1660,0,0,83.8,814,549,"廣昌里",NULL
234,860,17,877,1074,0,0,81.66,455,405,"久昌里",NULL
235,946,17,963,1189,0,0,80.99,503,443,"久昌里",NULL
236,830,17,847,1011,0,0,83.78,442,388,"大昌里",NULL
237,834,18,852,1032,0,0,82.56,562,272,"大昌里",NULL
238,761,12,773,898,0,0,86.08,295,466,"福昌里",NULL
239,753,13,766,919,0,0,83.35,331,422,"福昌里",NULL
240,1706,18,1724,2052,0,0,84.02,865,841,"盛昌里",NULL
241,1645,19,1664,1988,0,0,83.7,938,707,"盛昌里",NULL
242,1289,30,1319,1571,0,0,83.96,607,682,"泰昌里",NULL
243,1078,19,1097,1301,0,0,84.32,421,657,"興昌里",NULL
244,1426,18,1444,1748,0,0,82.61,701,725,"興昌里",NULL
245,969,18,987,1196,0,0,82.53,497,472,"建昌里",NULL
246,972,16,988,1176,0,0,84.01,498,474,"建昌里",NULL
247,943,8,951,1143,0,0,83.2,549,394,"宏昌里",NULL
248,1005,13,1018,1222,0,0,83.31,552,453,"宏昌里",NULL
249,865,11,876,1039,0,0,84.31,422,443,"和昌里",NULL
250,924,19,943,1090,0,0,86.51,516,408,"和昌里",NULL
251,1369,21,1390,1603,0,0,86.71,842,527,"慶昌里",NULL
252,1203,25,1228,1458,0,0,84.22,514,689,"慶昌里",NULL
253,1374,32,1406,1666,0,0,84.39,746,628,"隆昌里",NULL
254,1308,12,1320,1597,0,0,82.65,697,611,"隆昌里",NULL
255,792,24,816,1010,0,0,80.79,388,404,"秀昌里",NULL
256,836,22,858,1014,0,0,84.62,464,372,"秀昌里",NULL
257,1184,20,1204,1400,0,0,86,421,763,"裕昌里",NULL
258,1129,17,1146,1352,0,0,84.76,521,608,"裕昌里",NULL
259,1310,22,1332,1556,0,0,85.6,647,663,"國昌里",NULL
260,1289,15,1304,1580,0,0,82.53,623,666,"國昌里",NULL
261,1035,16,1051,1317,0,0,79.8,635,400,"加昌里",NULL
262,1210,9,1219,1474,0,0,82.7,692,518,"加昌里",NULL
263,1207,15,1222,1447,0,0,84.45,705,502,"加昌里",NULL
264,1339,17,1356,1607,0,0,84.38,875,464,"加昌里",NULL
265,1392,12,1404,1718,0,0,81.72,834,558,"仁昌里",NULL
266,1403,27,1430,1771,0,0,80.75,831,572,"仁昌里",NULL
267,761,27,788,919,0,0,85.75,310,451,"藍田里",NULL
268,726,7,733,859,0,0,85.33,200,526,"中興里",NULL
269,1279,21,1300,1520,0,0,85.53,315,964,"中和里",NULL
270,1147,35,1182,1495,0,0,79.06,489,658,"鼎金里",NULL
271,1301,26,1327,1613,0,0,82.27,455,846,"鼎金里",NULL
272,1107,11,1118,1363,0,0,82.02,482,625,"鼎盛里",NULL
273,1016,24,1040,1264,0,0,82.28,460,556,"鼎盛里",NULL
274,1233,26,1259,1526,0,0,82.5,525,708,"鼎盛里",NULL
275,1327,10,1337,1640,0,0,81.52,572,755,"鼎盛里",NULL
276,1388,15,1403,1656,0,0,84.72,480,908,"鼎強里",NULL
277,1432,30,1462,1796,0,0,81.4,587,845,"鼎強里",NULL
278,1292,21,1313,1604,0,0,81.86,502,790,"鼎力里",NULL
279,1448,23,1471,1800,0,0,81.72,574,874,"鼎力里",NULL
280,1574,28,1602,1968,0,0,81.4,646,928,"鼎西里",NULL
281,1442,26,1468,1764,0,0,83.22,541,901,"鼎西里",NULL
282,1340,41,1381,1699,0,0,81.28,506,834,"鼎西里",NULL
283,1344,17,1361,1565,0,0,86.96,465,879,"鼎中里",NULL
284,1334,23,1357,1556,0,0,87.21,517,817,"鼎中里",NULL
285,1406,29,1435,1741,0,0,82.42,557,849,"鼎泰里",NULL
286,1282,22,1304,1612,0,0,80.89,608,674,"鼎泰里",NULL
287,1481,16,1497,1766,0,0,84.77,519,962,"鼎泰里",NULL
288,1294,22,1316,1638,0,0,80.34,502,792,"鼎泰里",NULL
289,1638,12,1650,1987,0,0,83.04,921,717,"鼎泰里",NULL
290,1517,14,1531,1837,0,0,83.34,871,646,"鼎泰里",NULL
291,1441,13,1454,1769,0,0,82.19,838,603,"鼎泰里",NULL
292,981,3,984,1177,0,0,83.6,583,398,"鼎泰里",NULL
293,1148,11,1159,1393,0,0,83.2,681,467,"鼎泰里",NULL
294,1253,23,1276,1497,0,0,85.24,720,533,"鼎泰里",NULL
295,1526,32,1558,1916,0,0,81.32,607,919,"本館里",NULL
296,1495,28,1523,1828,0,0,83.32,521,974,"本館里",NULL
297,1454,26,1480,1790,0,0,82.68,620,834,"本館里",NULL
298,1582,21,1603,1920,0,0,83.49,736,846,"本館里",NULL
299,1509,20,1529,1850,0,0,82.65,668,841,"本和里",NULL
300,1571,17,1588,1919,0,0,82.75,662,909,"本和里",NULL
301,1683,23,1706,2089,0,0,81.67,778,905,"本和里",NULL
302,892,14,906,1098,0,0,82.51,394,498,"本文里",NULL
303,795,15,810,938,0,0,86.35,311,484,"本文里",NULL
304,1244,20,1264,1498,0,0,84.38,419,825,"本武里",NULL
305,1212,24,1236,1484,0,0,83.29,560,652,"本元里",NULL
306,1153,14,1167,1435,0,0,81.32,454,699,"本元里",NULL
307,1187,17,1204,1461,0,0,82.41,544,643,"本元里",NULL
308,985,13,998,1199,0,0,83.24,458,527,"本安里",NULL
309,1083,9,1092,1275,0,0,85.65,522,561,"本安里",NULL
310,1083,23,1106,1302,0,0,84.95,502,581,"本安里",NULL
311,1164,19,1183,1375,0,0,86.04,562,602,"本上里",NULL
312,1068,13,1081,1293,0,0,83.6,557,511,"本上里",NULL
313,1176,15,1191,1429,0,0,83.34,612,564,"本上里",NULL
314,1356,16,1372,1620,0,0,84.69,613,743,"本揚里",NULL
315,1341,17,1358,1617,0,0,83.98,653,688,"本揚里",NULL
316,1415,14,1429,1692,0,0,84.46,609,806,"本揚里",NULL
317,1236,19,1255,1556,0,0,80.66,595,641,"本揚里",NULL
318,1442,23,1465,1797,0,0,81.52,644,798,"寶獅里",NULL
319,1340,19,1359,1659,0,0,81.92,569,771,"寶獅里",NULL
320,1109,7,1116,1339,0,0,83.35,519,590,"寶德里",NULL
321,1258,13,1271,1587,0,0,80.09,507,751,"寶德里",NULL
322,1269,13,1282,1558,0,0,82.28,461,808,"寶德里",NULL
323,1239,15,1254,1527,0,0,82.12,523,716,"寶泰里",NULL
324,1242,20,1262,1580,0,0,79.87,582,660,"寶泰里",NULL
325,1110,12,1122,1332,0,0,84.23,433,677,"寶興里",NULL
326,1049,24,1073,1299,0,0,82.6,384,665,"寶興里",NULL
327,1042,15,1057,1258,0,0,84.02,482,560,"寶興里",NULL
328,1037,17,1054,1320,0,0,79.85,435,602,"寶興里",NULL
329,1057,19,1076,1291,0,0,83.35,443,614,"寶中里",NULL
330,1142,12,1154,1375,0,0,83.93,404,738,"寶中里",NULL
331,1115,5,1120,1347,0,0,83.15,597,518,"寶華里",NULL
332,1174,14,1188,1434,0,0,82.85,553,621,"寶華里",NULL
333,1311,23,1334,1662,0,0,80.26,552,759,"寶國里",NULL
334,1212,20,1232,1504,0,0,81.91,507,705,"寶國里",NULL
335,1420,20,1440,1708,0,0,84.31,585,835,"寶國里",NULL
336,1268,17,1285,1478,0,0,86.94,648,620,"寶國里",NULL
337,1047,21,1068,1298,0,0,82.28,460,587,"寶民里",NULL
338,1068,17,1085,1317,0,0,82.38,499,569,"寶民里",NULL
339,962,20,982,1212,0,0,81.02,459,503,"寶慶里",NULL
340,945,16,961,1227,0,0,78.32,400,545,"寶慶里",NULL
341,1194,17,1211,1449,0,0,83.57,532,662,"寶業里",NULL
342,1104,18,1122,1374,0,0,81.66,502,602,"寶業里",NULL
343,1098,16,1114,1365,0,0,81.61,483,615,"寶業里",NULL
344,1041,13,1054,1288,0,0,81.83,475,566,"寶盛里",NULL
345,1004,17,1021,1230,0,0,83.01,435,569,"寶盛里",NULL
346,1197,7,1204,1455,0,0,82.75,596,601,"寶盛里",NULL
347,1600,23,1623,1969,0,0,82.43,680,920,"寶安里",NULL
348,1649,16,1665,2060,0,0,80.83,790,859,"寶安里",NULL
349,1486,22,1508,1921,0,0,78.5,720,766,"寶安里",NULL
350,1097,29,1126,1382,0,0,81.48,390,707,"寶龍里",NULL
351,995,16,1011,1202,0,0,84.11,396,599,"寶龍里",NULL
352,1102,21,1123,1363,0,0,82.39,564,538,"寶龍里",NULL
353,1272,15,1287,1906,0,0,67.52,579,693,"寶珠里",NULL
354,1217,19,1236,1511,0,0,81.8,478,739,"寶珠里",NULL
355,1204,16,1220,1476,0,0,82.66,490,714,"寶珠里",NULL
356,1407,26,1433,1745,0,0,82.12,621,786,"寶玉里",NULL
357,1453,23,1476,1757,0,0,84.01,671,782,"寶玉里",NULL
358,1344,15,1359,1688,0,0,80.51,667,677,"寶玉里",NULL
359,1385,29,1414,1738,0,0,81.36,644,741,"寶玉里",NULL
360,1310,17,1327,1660,0,0,79.94,569,741,"灣子里",NULL
361,1100,19,1119,1408,0,0,79.47,401,699,"灣子里",NULL
362,1124,28,1152,1452,0,0,79.34,354,770,"灣愛里",NULL
363,1114,26,1140,1452,0,0,78.51,426,688,"灣愛里",NULL
364,1114,19,1133,1422,0,0,79.68,392,722,"灣中里",NULL
365,969,14,983,1224,0,0,80.31,372,597,"灣中里",NULL
366,1135,19,1154,1399,0,0,82.49,452,683,"灣中里",NULL
367,1108,10,1118,1372,0,0,81.49,474,634,"灣華里",NULL
368,1028,30,1058,1263,0,0,83.77,373,655,"灣華里",NULL
369,803,18,821,981,0,0,83.69,288,515,"灣勝里",NULL
370,849,8,857,1045,0,0,82.01,279,570,"灣勝里",NULL
371,1384,22,1406,1703,0,0,82.56,525,859,"灣利里",NULL
372,1258,23,1281,1537,0,0,83.34,380,878,"灣利里",NULL
373,1162,22,1184,1438,0,0,82.34,397,765,"灣復里",NULL
374,1160,17,1177,1513,0,0,77.79,512,648,"灣復里",NULL
375,1590,15,1605,1986,0,0,80.82,778,812,"正興里",NULL
376,1476,16,1492,1829,0,0,81.57,578,898,"正興里",NULL
377,1395,13,1408,1713,0,0,82.19,641,754,"正興里",NULL
378,1290,10,1300,1580,0,0,82.28,761,529,"正興里",NULL
379,1345,18,1363,1668,0,0,81.71,681,664,"正興里",NULL
380,1238,27,1265,1570,0,0,80.57,484,754,"正順里",NULL
381,1404,16,1420,1719,0,0,82.61,553,851,"正順里",NULL
382,1268,21,1289,1559,0,0,82.68,437,831,"灣興里",NULL
383,1618,25,1643,2007,0,0,81.86,624,994,"灣成里",NULL
384,1140,15,1155,1474,0,0,78.36,395,745,"安康里",NULL
385,1178,19,1197,1504,0,0,79.59,430,748,"安康里",NULL
386,773,11,784,995,0,0,78.79,262,511,"安寧里",NULL
387,826,23,849,1049,0,0,80.93,307,519,"安寧里",NULL
388,1036,10,1046,1356,0,0,77.14,476,560,"安吉里",NULL
389,1044,22,1066,1314,0,0,81.13,436,608,"安吉里",NULL
390,1278,15,1293,1569,0,0,82.41,535,743,"安吉里",NULL
391,1114,19,1133,1372,0,0,82.58,523,591,"安發里",NULL
392,1112,22,1134,1366,0,0,83.02,505,607,"安發里",NULL
393,1120,19,1139,1408,0,0,80.89,525,595,"安發里",NULL
394,1273,17,1290,1559,0,0,82.75,485,788,"安東里",NULL
395,1291,21,1312,1608,0,0,81.59,510,781,"安東里",NULL
396,1076,19,1095,1312,0,0,83.46,358,718,"安和里",NULL
397,1134,21,1155,1378,0,0,83.82,379,755,"安和里",NULL
398,1231,21,1252,1472,0,0,85.05,441,790,"達德里",NULL
399,1413,12,1425,1696,0,0,84.02,519,894,"達明里",NULL
400,1193,13,1206,1467,0,0,82.21,493,700,"達仁里",NULL
401,850,16,866,1073,0,0,80.71,344,506,"達勇里",NULL
402,1184,14,1198,1433,0,0,83.6,456,728,"同德里",NULL
403,1074,15,1089,1322,0,0,82.38,422,652,"同德里",NULL
404,982,13,995,1193,0,0,83.4,384,598,"德智里",NULL
405,1026,12,1038,1255,0,0,82.71,381,645,"德智里",NULL
406,759,9,768,949,0,0,80.93,332,427,"德仁里",NULL
407,789,15,804,1005,0,0,80,345,444,"德仁里",NULL
408,1394,34,1428,1686,0,0,84.7,490,904,"安生里",NULL
409,726,12,738,876,0,0,84.25,266,460,"德東里",NULL
410,897,10,907,1106,0,0,82.01,308,589,"德行里",NULL
411,1314,31,1345,1618,0,0,83.13,544,770,"精華里",NULL
412,841,18,859,1016,0,0,84.55,283,558,"民享里",NULL
413,857,9,866,1047,0,0,82.71,286,571,"民享里",NULL
414,1327,24,1351,1606,0,0,84.12,451,876,"安宜里",NULL
415,1325,29,1354,1606,0,0,84.31,476,849,"安宜里",NULL
416,1004,23,1027,1206,0,0,85.16,388,616,"安泰里",NULL
417,1007,14,1021,1263,0,0,80.84,358,649,"安泰里",NULL
418,1192,13,1205,1516,0,0,79.49,485,707,"安泰里",NULL
419,861,10,871,1435,0,0,60.7,320,541,"安邦里",NULL
420,1069,16,1085,1299,0,0,83.53,381,688,"安邦里",NULL
421,986,21,1007,1198,0,0,84.06,406,580,"安邦里",NULL
422,1300,13,1313,1582,0,0,83,469,831,"十全里",NULL
423,734,8,742,903,0,0,82.17,261,473,"十美里",NULL
424,733,13,746,908,0,0,82.16,271,462,"十美里",NULL
425,754,12,766,952,0,0,80.46,299,455,"德北里",NULL
426,874,17,891,1106,0,0,80.56,303,571,"德北里",NULL
427,756,14,770,942,0,0,81.74,276,480,"立誠里",NULL
428,927,10,937,1118,0,0,83.81,325,602,"立業里",NULL
429,1113,16,1129,1433,0,0,78.79,397,716,"港東里",NULL
430,1159,12,1171,1451,0,0,80.7,500,659,"港新里",NULL
431,666,13,679,837,0,0,81.12,258,408,"港西里",NULL
432,354,4,358,437,0,0,81.92,166,188,"港北里",NULL
433,879,18,897,1166,0,0,76.93,365,514,"博愛里",NULL
434,1104,19,1123,1327,0,0,84.63,514,590,"博惠里",NULL
435,1097,16,1113,1385,0,0,80.36,411,686,"博惠里",NULL
436,1054,13,1067,1309,0,0,81.51,500,554,"博惠里",NULL
437,930,14,944,1154,0,0,81.8,415,515,"長明里",NULL
438,819,9,828,1131,0,0,73.21,333,486,"建東里",NULL
439,1336,18,1354,1685,0,0,80.36,531,805,"興德里",NULL
440,950,8,958,1132,0,0,84.63,292,658,"鳳南里",NULL
441,803,8,811,960,0,0,84.48,246,557,"鳳北里",NULL
442,752,14,766,945,0,0,81.06,278,474,"鳳北里",NULL
443,990,14,1004,1237,0,0,81.16,368,622,"德西里",NULL
444,354,13,367,454,0,0,80.84,302,52,"九如里",NULL
445,1175,22,1197,1433,0,0,83.53,528,647,"豐裕里",NULL
446,992,17,1009,1256,0,0,80.33,335,657,"豐裕里",NULL
447,766,13,779,952,0,0,81.83,284,482,"川東里",NULL
448,748,10,758,955,0,0,79.37,239,509,"川東里",NULL
449,586,22,608,733,0,0,82.95,221,365,"裕民里",NULL
450,975,11,986,1166,0,0,84.56,400,575,"力行里",NULL
451,978,19,997,1193,0,0,83.57,413,565,"千歲里",NULL
452,1095,16,1111,1351,0,0,82.24,488,607,"立德里",NULL
453,1037,24,1061,1287,0,0,82.44,373,664,"千北里",NULL
454,979,17,996,1237,0,0,80.52,356,623,"千秋里",NULL
455,960,13,973,1180,0,0,82.46,399,561,"千秋里",NULL
456,871,14,885,1089,0,0,81.27,457,414,"浩然里",NULL
457,732,11,743,888,0,0,83.67,359,373,"浩然里",NULL
458,959,10,969,1257,0,0,77.09,437,522,"振成里",NULL
459,1237,15,1252,1549,0,0,80.83,613,624,"德生里",NULL
460,714,16,730,899,0,0,81.2,346,368,"德生里",NULL
461,1020,18,1038,1302,0,0,79.72,525,495,"振華里",NULL
462,1340,18,1358,1626,0,0,83.52,598,742,"正氣里",NULL
463,584,10,594,742,0,0,80.05,302,282,"德政里",NULL
464,618,7,625,827,0,0,75.57,263,355,"仁聲里",NULL
465,789,8,797,1005,0,0,79.3,368,421,"德望里",NULL
466,821,14,835,1051,0,0,79.45,404,417,"德望里",NULL
467,830,11,841,1066,0,0,78.89,362,468,"華聲里",NULL
468,643,10,653,792,0,0,82.45,256,387,"蕉園里",NULL
469,1140,29,1169,1452,0,0,80.51,488,652,"永寧里",NULL
470,841,20,861,1090,0,0,78.99,355,486,"玉衡里",NULL
471,939,19,958,1167,0,0,82.09,319,620,"順昌里",NULL
472,768,12,780,943,0,0,82.71,345,423,"順昌里",NULL
473,1189,10,1199,1465,0,0,81.84,571,618,"文昌里",NULL
474,950,14,964,1144,0,0,84.27,452,498,"文昌里",NULL
475,965,9,974,1210,0,0,80.5,427,538,"光耀里",NULL
476,974,17,991,1206,0,0,82.17,487,487,"光耀里",NULL
477,718,6,724,859,0,0,84.28,327,391,"興昌里",NULL
478,795,14,809,951,0,0,85.07,384,411,"興昌里",NULL
479,1213,11,1224,1490,0,0,82.15,555,658,"開平里",NULL
480,1273,14,1287,1530,0,0,84.12,566,707,"開平里",NULL
481,958,9,967,1185,0,0,81.6,487,471,"成功里",NULL
482,884,15,899,1156,0,0,77.77,305,579,"新江里",NULL
483,720,26,746,946,0,0,78.86,294,426,"黎明里",NULL
484,735,10,745,905,0,0,82.32,290,445,"愛平里",NULL
485,884,17,901,1104,0,0,81.61,314,570,"南港里",NULL
486,954,15,969,1182,0,0,81.98,406,548,"南港里",NULL
487,879,17,896,1229,0,0,72.9,445,434,"中東里",NULL
488,1142,16,1158,1464,0,0,79.1,587,555,"中東里",NULL
489,670,10,680,853,0,0,79.72,261,409,"明莊里",NULL
490,919,24,943,1207,0,0,78.13,340,579,"大明里",NULL
491,729,10,739,993,0,0,74.42,260,469,"秋山里",NULL
492,705,10,715,917,0,0,77.97,291,414,"長驛里",NULL
493,745,9,754,932,0,0,80.9,270,475,"建興里",NULL
494,751,20,771,978,0,0,78.83,275,476,"建華里",NULL
495,720,14,734,873,0,0,84.08,249,471,"漢民里",NULL
496,639,7,646,802,0,0,80.55,293,346,"榮治里",NULL
497,1093,23,1116,1360,0,0,82.06,392,701,"東坡里",NULL
498,674,12,686,817,0,0,83.97,204,470,"三川里",NULL
499,916,15,931,1155,0,0,80.61,444,472,"草江里",NULL
500,1152,25,1177,1457,0,0,80.78,389,763,"長城里",NULL
501,730,12,742,911,0,0,81.45,270,460,"北金里",NULL
502,701,9,710,920,0,0,77.17,288,413,"東金里",NULL
503,1454,21,1475,1753,0,0,84.14,702,752,"新生里",NULL
504,1157,14,1171,1455,0,0,80.48,529,628,"新生里",NULL
505,762,12,774,976,0,0,79.3,341,421,"後金里",NULL
506,893,14,907,1172,0,0,77.39,421,472,"長興里",NULL
507,1130,15,1145,1425,0,0,80.35,535,595,"青山里",NULL
508,583,8,591,757,0,0,78.07,250,333,"民生里",NULL
509,819,12,831,1047,0,0,79.37,416,403,"復元里",NULL
510,932,13,945,1249,0,0,75.66,435,497,"林投里",NULL
511,860,13,873,1094,0,0,79.8,359,501,"國民里",NULL
512,711,9,720,881,0,0,81.73,337,374,"社東里",NULL
513,717,9,726,877,0,0,82.78,333,384,"社東里",NULL
514,948,18,966,1172,0,0,82.42,429,519,"社西里",NULL
515,737,14,751,964,0,0,77.9,319,418,"博孝里",NULL
516,1207,16,1223,1559,0,0,78.45,589,618,"長生里",NULL
517,1007,20,1027,1288,0,0,79.74,392,615,"榮復里",NULL
518,871,16,887,1101,0,0,80.56,386,485,"文西里",NULL
519,1101,18,1119,1384,0,0,80.85,465,636,"文東里",NULL
520,504,5,509,642,0,0,79.28,288,216,"博仁里",NULL
521,1097,25,1122,1387,0,0,80.89,523,574,"苓洲里",NULL
522,1125,24,1149,1440,0,0,79.79,540,585,"苓昇里",NULL
523,1372,25,1397,1670,0,0,83.65,553,819,"苓中里",NULL
524,1172,24,1196,1472,0,0,81.25,552,620,"苓雅里",NULL
525,1180,25,1205,1511,0,0,79.75,470,710,"苓東里",NULL
526,1192,20,1212,1538,0,0,78.8,500,692,"城北里",NULL
527,559,10,569,695,0,0,81.87,214,345,"城西里",NULL
528,1374,20,1394,1722,0,0,80.95,548,826,"城東里",NULL
529,987,5,992,1299,0,0,76.37,494,493,"意誠里",NULL
530,1016,18,1034,1401,0,0,73.8,552,464,"意誠里",NULL
531,955,15,970,1186,0,0,81.79,346,609,"鼓中里",NULL
532,1174,24,1198,1466,0,0,81.72,485,689,"田西里",NULL
533,805,9,814,988,0,0,82.39,335,470,"人和里",NULL
534,726,2,728,943,0,0,77.2,322,404,"人和里",NULL
535,1416,21,1437,1802,0,0,79.74,640,776,"仁政里",NULL
536,1623,29,1652,1968,0,0,83.94,617,1006,"廣澤里",NULL
537,1005,16,1021,1274,0,0,80.14,452,553,"美田里",NULL
538,1093,15,1108,1392,0,0,79.6,417,676,"華堂里",NULL
539,1263,29,1292,1660,0,0,77.83,630,633,"華堂里",NULL
540,926,10,936,1164,0,0,80.41,418,508,"日中里",NULL
541,908,18,926,1142,0,0,81.09,414,494,"日中里",NULL
542,1049,16,1065,1300,0,0,81.92,439,610,"普照里",NULL
543,1089,25,1114,1362,0,0,81.79,489,600,"普照里",NULL
544,823,6,829,1037,0,0,79.94,312,511,"和煦里",NULL
545,934,10,944,1135,0,0,83.17,441,493,"和煦里",NULL
546,984,12,996,1633,0,0,60.99,447,537,"晴朗里",NULL
547,1177,14,1191,1469,0,0,81.08,604,573,"普天里",NULL
548,1132,10,1142,1403,0,0,81.4,503,629,"普天里",NULL
549,1448,14,1462,1806,0,0,80.95,724,724,"林富里",NULL
550,815,13,828,1024,0,0,80.86,432,383,"林圍里",NULL
551,882,20,902,1089,0,0,82.83,460,422,"林圍里",NULL
552,1283,20,1303,1580,0,0,82.47,644,639,"林安里",NULL
553,643,14,657,784,0,0,83.8,243,400,"光華里",NULL
554,1223,15,1238,1474,0,0,83.99,428,795,"林興里",NULL
555,1235,18,1253,1485,0,0,84.38,478,757,"林華里",NULL
556,1229,26,1255,1534,0,0,81.81,547,682,"林華里",NULL
557,1450,21,1471,1824,0,0,80.65,665,785,"林西里",NULL
558,1558,24,1582,1935,0,0,81.76,683,875,"林中里",NULL
559,1071,19,1090,1338,0,0,81.46,505,566,"林中里",NULL
560,1488,10,1498,1851,0,0,80.93,830,658,"林泉里",NULL
561,1223,18,1241,1530,0,0,81.11,704,519,"林南里",NULL
562,1051,16,1067,1339,0,0,79.69,544,507,"林南里",NULL
563,1003,9,1012,1252,0,0,80.83,555,448,"中正里",NULL
564,1030,9,1039,1288,0,0,80.67,469,561,"中正里",NULL
565,1105,17,1122,1432,0,0,78.35,528,577,"尚義里",NULL
566,1298,19,1317,1578,0,0,83.46,700,598,"同慶里",NULL
567,1603,41,1644,1943,0,0,84.61,937,666,"凱旋里",NULL
568,822,17,839,1070,0,0,78.41,423,399,"安祥里",NULL
569,1049,17,1066,1302,0,0,81.87,535,514,"安祥里",NULL
570,1345,25,1370,1653,0,0,82.88,675,670,"奏捷里",NULL
571,1263,24,1287,1553,0,0,82.87,417,846,"福壽里",NULL
572,998,21,1019,1198,0,0,85.06,345,653,"福南里",NULL
573,937,22,959,1178,0,0,81.41,265,672,"福南里",NULL
574,686,10,696,873,0,0,79.73,298,388,"五權里",NULL
575,869,11,880,1094,0,0,80.44,414,455,"五權里",NULL
576,1049,21,1070,1281,0,0,83.53,541,508,"民主里",NULL
577,921,16,937,1163,0,0,80.57,425,496,"民主里",NULL
578,1142,24,1166,1417,0,0,82.29,496,646,"民主里",NULL
579,756,15,771,927,0,0,83.17,396,360,"林德里",NULL
580,627,13,640,804,0,0,79.6,278,349,"林德里",NULL
581,1084,23,1107,1335,0,0,82.92,493,591,"林貴里",NULL
582,1599,16,1615,1959,0,0,82.44,815,784,"林榮里",NULL
583,1609,25,1634,2010,0,0,81.29,791,818,"林榮里",NULL
584,809,14,823,1003,0,0,82.05,354,455,"英明里",NULL
585,876,21,897,1065,0,0,84.23,285,591,"英明里",NULL
586,1345,20,1365,1659,0,0,82.28,838,507,"林靖里",NULL
587,1257,22,1279,1512,0,0,84.59,532,725,"朝陽里",NULL
588,1165,19,1184,1470,0,0,80.54,500,665,"福隆里",NULL
589,1071,20,1091,1296,0,0,84.18,482,589,"福隆里",NULL
590,1065,20,1085,1314,0,0,82.57,453,612,"福祥里",NULL
591,852,9,861,1046,0,0,82.31,434,418,"福海里",NULL
592,770,16,786,933,0,0,84.24,259,511,"福康里",NULL
593,870,15,885,1043,0,0,84.85,319,551,"福康里",NULL
594,845,19,864,1061,0,0,81.43,375,470,"福人里",NULL
595,916,24,940,1158,0,0,81.17,364,552,"福人里",NULL
596,1136,31,1167,1420,0,0,82.18,442,694,"福地里",NULL
597,1226,10,1236,1514,0,0,81.64,614,612,"福地里",NULL
598,1090,27,1117,1346,0,0,82.99,438,652,"福居里",NULL
599,1239,18,1257,1526,0,0,82.37,480,759,"福居里",NULL
600,734,10,744,906,0,0,82.12,324,410,"福東里",NULL
601,1352,17,1369,1679,0,0,81.54,640,712,"福東里",NULL
602,960,20,980,1168,0,0,83.9,364,596,"福西里",NULL
603,776,19,795,978,0,0,81.29,349,427,"福西里",NULL
604,937,20,957,1127,0,0,84.92,482,455,"永康里",NULL
605,980,25,1005,1211,0,0,82.99,468,512,"永康里",NULL
606,1412,26,1438,1782,0,0,80.7,594,818,"正文里",NULL
607,1311,21,1332,1626,0,0,81.92,580,731,"正言里",NULL
608,892,14,906,1143,0,0,79.27,393,499,"正言里",NULL
609,1081,16,1097,1381,0,0,79.44,586,495,"正大里",NULL
610,1168,14,1182,1447,0,0,81.69,549,619,"正大里",NULL
611,1335,29,1364,1762,0,0,77.41,652,683,"正大里",NULL
612,1036,14,1050,1284,0,0,81.78,537,499,"五福里",NULL
613,1050,13,1063,1311,0,0,81.08,483,567,"五福里",NULL
614,1055,17,1072,1333,0,0,80.42,467,588,"五福里",NULL
615,1481,27,1508,1854,0,0,81.34,685,796,"正心里",NULL
616,1404,28,1432,1775,0,0,80.68,698,706,"正心里",NULL
617,1025,9,1034,1274,0,0,81.16,482,543,"正道里",NULL
618,1195,10,1205,1464,0,0,82.31,568,627,"正道里",NULL
619,1139,24,1163,1410,0,0,82.48,523,616,"正道里",NULL
620,1009,14,1023,1222,0,0,83.72,448,561,"正義里",NULL
621,961,8,969,1169,0,0,82.89,393,568,"正義里",NULL
622,1024,23,1047,1231,0,0,85.05,500,524,"正仁里",NULL
623,991,11,1002,1200,0,0,83.5,514,477,"正仁里",NULL
624,1023,15,1038,1251,0,0,82.97,413,610,"文昌里",NULL
625,1043,13,1056,1277,0,0,82.69,450,593,"文昌里",NULL
626,1113,21,1134,1392,0,0,81.47,446,667,"文昌里",NULL
627,1676,36,1712,2082,0,0,82.23,643,1033,"建軍里",NULL
628,871,15,886,1098,0,0,80.69,382,489,"衛武里",NULL
629,866,14,880,1068,0,0,82.4,455,411,"衛武里",NULL
630,1113,24,1137,1381,0,0,82.33,373,740,"草衙里",NULL
631,1432,25,1457,1788,0,0,81.49,524,908,"草衙里",NULL
632,1423,24,1447,1846,0,0,78.39,520,903,"草衙里",NULL
633,1391,32,1423,1845,0,0,77.13,469,922,"草衙里",NULL
634,1340,27,1367,1740,0,0,78.56,508,832,"草衙里",NULL
635,1254,33,1287,1592,0,0,80.84,357,897,"明孝里",NULL
636,703,19,722,900,0,0,80.22,251,452,"明孝里",NULL
637,1315,29,1344,1654,0,0,81.26,458,857,"明正里",NULL
638,1299,24,1323,1616,0,0,81.87,443,856,"明正里",NULL
639,846,13,859,1016,0,0,84.55,381,465,"明義里",NULL
640,665,10,675,799,0,0,84.48,208,457,"明義里",NULL
641,1160,30,1190,1503,0,0,79.17,328,832,"仁愛里",NULL
642,1590,33,1623,2038,0,0,79.64,716,874,"德昌里",NULL
643,1425,37,1462,2172,0,0,67.31,439,986,"平等里",NULL
644,601,8,609,734,0,0,82.97,150,451,"平昌里",NULL
645,1455,15,1470,1782,0,0,82.49,392,1063,"明禮里",NULL
646,1250,28,1278,1589,0,0,80.43,319,931,"信義里",NULL
647,828,32,860,1099,0,0,78.25,200,628,"信德里",NULL
648,1128,16,1144,1428,0,0,80.11,475,653,"信德里",NULL
649,1023,25,1048,1288,0,0,81.37,254,769,"明道里",NULL
650,625,23,648,794,0,0,81.61,133,492,"興化里",NULL
651,751,9,760,932,0,0,81.55,162,589,"興仁里",NULL
652,1230,30,1260,1540,0,0,81.82,386,844,"前鎮里",NULL
653,1603,43,1646,1969,0,0,83.6,465,1138,"鎮東里",NULL
654,1041,26,1067,1270,0,0,84.02,322,719,"鎮榮里",NULL
655,848,24,872,1071,0,0,81.42,304,544,"鎮榮里",NULL
656,988,14,1002,1218,0,0,82.27,319,669,"鎮昌里",NULL
657,706,14,720,864,0,0,83.33,237,469,"鎮昌里",NULL
658,911,24,935,1128,0,0,82.89,362,549,"鎮海里",NULL
659,1064,30,1094,1302,0,0,84.02,364,700,"鎮海里",NULL
660,1205,17,1222,1492,0,0,81.9,485,720,"鎮海里",NULL
661,930,27,957,1149,0,0,83.29,318,612,"鎮陽里",NULL
662,878,24,902,1093,0,0,82.53,440,438,"興邦里",NULL
663,788,17,805,985,0,0,81.73,360,428,"興邦里",NULL
664,668,17,685,855,0,0,80.12,219,449,"鎮中里",NULL
665,846,19,865,1038,0,0,83.33,262,584,"鎮北里",NULL
666,1838,38,1876,2242,0,0,83.68,1462,376,"忠純里",NULL
667,1330,23,1353,1618,0,0,83.62,1119,211,"忠純里",NULL
668,850,23,873,1032,0,0,84.59,760,90,"忠誠里",NULL
669,942,21,963,1083,0,0,88.92,853,89,"忠誠里",NULL
670,1354,25,1379,1686,0,0,81.79,588,766,"西山里",NULL
671,1321,17,1338,1640,0,0,81.59,718,603,"西山里",NULL
672,958,19,977,1192,0,0,81.96,490,468,"民權里",NULL
673,1193,10,1203,1391,0,0,86.48,576,617,"民權里",NULL
674,1038,9,1047,1280,0,0,81.8,643,395,"民權里",NULL
675,702,18,720,903,0,0,79.73,328,374,"建隆里",NULL
676,1525,27,1552,1920,0,0,80.83,643,882,"振興里",NULL
677,835,13,848,1049,0,0,80.84,352,483,"良和里",NULL
678,1234,13,1247,1540,0,0,80.97,762,472,"良和里",NULL
679,1613,37,1650,1986,0,0,83.08,615,998,"西甲里",NULL
680,1048,14,1062,1326,0,0,80.09,548,500,"盛興里",NULL
681,928,18,946,1217,0,0,77.73,462,466,"盛興里",NULL
682,1213,20,1233,1534,0,0,80.38,510,703,"盛豐里",NULL
683,1047,17,1064,1345,0,0,79.11,514,533,"盛豐里",NULL
684,1223,25,1248,1531,0,0,81.52,557,666,"興中里",NULL
685,1214,27,1241,1609,0,0,77.13,575,639,"興中里",NULL
686,1195,14,1209,1459,0,0,82.86,499,696,"興東里",NULL
687,1267,20,1287,1524,0,0,84.45,572,695,"興東里",NULL
688,1261,9,1270,1571,0,0,80.84,654,607,"興東里",NULL
689,947,24,971,1166,0,0,83.28,490,457,"忠孝里",NULL
690,993,19,1012,1190,0,0,85.04,499,494,"忠孝里",NULL
691,1110,16,1126,1346,0,0,83.66,389,721,"復國里",NULL
692,1229,12,1241,1505,0,0,82.46,545,684,"復國里",NULL
693,1027,25,1052,1264,0,0,83.23,387,640,"竹內里",NULL
694,1098,29,1127,1370,0,0,82.26,372,726,"竹內里",NULL
695,840,10,850,1072,0,0,79.29,382,458,"竹東里",NULL
696,833,18,851,1038,0,0,81.98,392,441,"竹東里",NULL
697,1093,28,1121,1349,0,0,83.1,389,704,"竹南里",NULL
698,1062,18,1080,1314,0,0,82.19,455,607,"竹南里",NULL
699,890,6,896,1115,0,0,80.36,432,458,"竹北里",NULL
700,728,18,746,911,0,0,81.89,324,404,"竹北里",NULL
701,965,10,975,1171,0,0,83.26,364,601,"竹西里",NULL
702,1047,11,1058,1240,0,0,85.32,548,499,"竹西里",NULL
703,1131,17,1148,1349,0,0,85.1,499,632,"竹西里",NULL
704,1119,14,1133,1394,0,0,81.28,568,551,"竹中里",NULL
705,1144,19,1163,1355,0,0,85.83,467,677,"竹中里",NULL
706,1022,37,1059,1286,0,0,82.35,312,710,"瑞竹里",NULL
707,1235,33,1268,1517,0,0,83.59,494,741,"瑞南里",NULL
708,1187,19,1206,1462,0,0,82.49,428,759,"瑞南里",NULL
709,1316,28,1344,1606,0,0,83.69,497,819,"瑞南里",NULL
710,1044,34,1078,1287,0,0,83.76,372,672,"瑞豐里",NULL
711,868,20,888,1077,0,0,82.45,363,505,"瑞豐里",NULL
712,1389,23,1412,1689,0,0,83.6,553,836,"瑞祥里",NULL
713,1394,23,1417,1658,0,0,85.46,640,754,"瑞祥里",NULL
714,1167,16,1183,1405,0,0,84.2,530,637,"瑞祥里",NULL
715,965,16,981,1191,0,0,82.37,349,616,"瑞東里",NULL
716,1051,20,1071,1264,0,0,84.73,388,663,"瑞東里",NULL
717,766,17,783,942,0,0,83.12,256,510,"瑞和里",NULL
718,854,15,869,1065,0,0,81.6,254,600,"瑞和里",NULL
719,905,20,925,1110,0,0,83.33,281,624,"瑞平里",NULL
720,1018,18,1036,1207,0,0,85.83,368,650,"瑞平里",NULL
721,1072,11,1083,1309,0,0,82.73,476,596,"瑞平里",NULL
722,1039,21,1060,1258,0,0,84.26,372,667,"瑞隆里",NULL
723,841,13,854,1054,0,0,81.02,356,485,"瑞隆里",NULL
724,987,17,1004,1245,0,0,80.64,363,624,"瑞隆里",NULL
725,1196,24,1220,1470,0,0,82.99,379,817,"瑞北里",NULL
726,1171,18,1189,1453,0,0,81.83,480,691,"瑞北里",NULL
727,1171,28,1199,1417,0,0,84.62,347,824,"瑞西里",NULL
728,1018,21,1039,1220,0,0,85.16,691,327,"瑞西里",NULL
729,1026,21,1047,1207,0,0,86.74,369,657,"瑞崗里",NULL
730,1087,13,1100,1316,0,0,83.59,371,716,"瑞崗里",NULL
731,1124,20,1144,1384,0,0,82.66,398,726,"瑞興里",NULL
732,1010,7,1017,1255,0,0,81.04,342,668,"瑞興里",NULL
733,1107,17,1124,1368,0,0,82.16,425,682,"瑞誠里",NULL
734,863,8,871,1077,0,0,80.87,346,517,"瑞誠里",NULL
735,885,16,901,1095,0,0,82.28,290,595,"瑞文里",NULL
736,1109,15,1124,1317,0,0,85.35,375,734,"瑞文里",NULL
737,1179,6,1185,1411,0,0,83.98,518,661,"瑞華里",NULL
738,1272,15,1287,1533,0,0,83.95,433,839,"瑞華里",NULL
739,1136,10,1146,1359,0,0,84.33,536,600,"瑞華里",NULL
740,1112,26,1138,1386,0,0,82.11,331,781,"瑞昌里",NULL
741,1119,32,1151,1405,0,0,81.92,409,710,"瑞昌里",NULL
742,1376,30,1406,1751,0,0,80.3,511,865,"小港里",NULL
743,1404,14,1418,1682,0,0,84.3,740,664,"港口里",NULL
744,1274,14,1288,1594,0,0,80.8,615,659,"港口里",NULL
745,985,19,1004,1245,0,0,80.64,602,383,"港正里",NULL
746,1045,16,1061,1262,0,0,84.07,485,560,"港正里",NULL
747,1319,19,1338,1581,0,0,84.63,546,773,"港墘里",NULL
748,1214,20,1234,1508,0,0,81.83,477,737,"港明里",NULL
749,1202,26,1228,1493,0,0,82.25,497,705,"港明里",NULL
750,1579,24,1603,1984,0,0,80.8,639,940,"港后里",NULL
751,1115,15,1130,1579,0,0,71.56,399,716,"港南里",NULL
752,1677,37,1714,2042,0,0,83.94,585,1092,"港興里",NULL
753,1513,17,1530,1888,0,0,81.04,584,929,"鳳宮里",NULL
754,1052,23,1075,1379,0,0,77.96,373,679,"店鎮里",NULL
755,1267,11,1278,1543,0,0,82.83,490,777,"店鎮里",NULL
756,1244,20,1264,1573,0,0,80.36,554,690,"店鎮里",NULL
757,854,23,877,1053,0,0,83.29,342,512,"大苓里",NULL
758,959,16,975,1165,0,0,83.69,386,573,"大苓里",NULL
759,1184,39,1223,1469,0,0,83.25,472,712,"二苓里",NULL
760,1282,17,1299,1590,0,0,81.7,465,817,"二苓里",NULL
761,972,11,983,1263,0,0,77.83,412,560,"三苓里",NULL
762,1002,13,1015,1191,0,0,85.22,416,586,"三苓里",NULL
763,1310,20,1330,1706,0,0,77.96,575,735,"正苓里",NULL
764,1292,27,1319,1645,0,0,80.18,596,696,"正苓里",NULL
765,1537,18,1555,1912,0,0,81.33,663,874,"順苓里",NULL
766,1344,12,1356,1649,0,0,82.23,621,723,"順苓里",NULL
767,1274,18,1292,1528,0,0,84.55,553,721,"六苓里",NULL
768,893,11,904,1106,0,0,81.74,381,512,"宏亮里",NULL
769,1112,17,1129,1417,0,0,79.68,494,618,"宏亮里",NULL
770,922,12,934,1169,0,0,79.9,576,346,"山東里",NULL
771,1014,10,1024,1258,0,0,81.4,500,514,"山東里",NULL
772,1396,33,1429,1750,0,0,81.66,968,428,"青島里",NULL
773,1261,17,1278,1566,0,0,81.61,644,617,"濟南里",NULL
774,1203,39,1242,1523,0,0,81.55,755,448,"濟南里",NULL
775,904,17,921,1111,0,0,82.9,371,533,"泰山里",NULL
776,828,9,837,1016,0,0,82.38,354,474,"泰山里",NULL
777,1633,25,1658,2054,0,0,80.72,607,1026,"山明里",NULL
778,1343,24,1367,1642,0,0,83.25,463,880,"山明里",NULL
779,1470,25,1495,1842,0,0,81.16,650,820,"山明里",NULL
780,1135,28,1163,1470,0,0,79.12,469,666,"高松里",NULL
781,1319,35,1354,1651,0,0,82.01,459,860,"高松里",NULL
782,792,8,800,949,0,0,84.3,311,481,"松金里",NULL
783,883,4,887,1129,0,0,78.57,380,503,"松金里",NULL
784,1508,42,1550,1919,0,0,80.77,569,939,"松山里",NULL
785,1018,32,1050,1255,0,0,83.67,286,732,"大坪里",NULL
786,1027,30,1057,1297,0,0,81.5,255,772,"坪頂里",NULL
787,858,29,887,1077,0,0,82.36,228,630,"孔宅里",NULL
788,889,13,902,1166,0,0,77.36,457,432,"孔宅里",NULL
789,745,13,758,931,0,0,81.42,353,392,"孔宅里",NULL
790,1491,31,1522,1846,0,0,82.45,528,963,"廈莊里",NULL
791,913,21,934,1125,0,0,83.02,335,578,"合作里",NULL
792,871,9,880,1089,0,0,80.81,286,585,"合作里",NULL
793,1178,31,1209,1482,0,0,81.58,338,840,"桂林里",NULL
794,1302,41,1343,1582,0,0,84.89,486,816,"桂林里",NULL
795,1251,14,1265,1548,0,0,81.72,542,709,"桂林里",NULL
796,1168,14,1182,1455,0,0,81.24,496,672,"桂林里",NULL
797,981,20,1001,1226,0,0,81.65,365,616,"中厝里",NULL
798,1281,11,1292,1609,0,0,80.3,447,834,"中厝里",NULL
799,946,19,965,1153,0,0,83.69,415,531,"鳳鳴里",NULL
800,893,27,920,1096,0,0,83.94,320,573,"鳳鳴里",NULL
801,815,29,844,1014,0,0,83.23,273,542,"龍鳳里",NULL
802,885,16,901,1074,0,0,83.89,335,550,"龍鳳里",NULL
803,1246,31,1277,1492,0,0,85.59,415,831,"鳳森里",NULL
804,779,17,796,1016,0,0,78.35,226,553,"鳳林里",NULL
805,827,17,844,1027,0,0,82.18,240,587,"鳳林里",NULL
806,1277,26,1303,1584,0,0,82.26,346,931,"鳳興里",NULL
807,863,9,872,1054,0,0,82.73,250,613,"鳳源里",NULL
808,970,24,994,1264,0,0,78.64,295,675,"鳳源里",NULL
809,1085,23,1108,1455,0,0,76.15,342,743,"海澄里",NULL
810,1030,27,1057,1346,0,0,78.53,345,685,"海澄里",NULL
811,1233,27,1260,1676,0,0,75.18,410,823,"海澄里",NULL
812,813,21,834,1136,0,0,73.42,260,553,"海昌里",NULL
813,856,25,881,1153,0,0,76.41,277,579,"海昌里",NULL
814,992,24,1016,1320,0,0,76.97,303,689,"海豐里",NULL
815,785,26,811,1043,0,0,77.76,208,577,"海豐里",NULL
816,964,13,977,1308,0,0,74.69,303,661,"海原里",NULL
817,1022,35,1057,1434,0,0,73.71,363,659,"海原里",NULL
818,1016,23,1039,1396,0,0,74.43,330,686,"海城里",NULL
819,977,25,1002,1400,0,0,71.57,305,672,"海城里",NULL
1,944,18,962,1180,0,0,81.53,514,430,"留侯里",NULL
2,947,24,971,1231,0,0,78.88,486,461,"流芳里",NULL
3,528,12,540,662,0,0,81.57,290,238,"赤松里",NULL
4,815,20,835,1017,0,0,82.1,399,416,"黃石里",NULL
5,639,11,650,799,0,0,81.35,406,233,"挹秀里",NULL
6,505,10,515,643,0,0,80.09,309,196,"挹秀里",NULL
7,737,22,759,942,0,0,80.57,327,410,"湳興里",NULL
8,748,22,770,941,0,0,81.83,374,374,"湳興里",NULL
9,611,25,636,780,0,0,81.54,339,272,"湳興里",NULL
10,903,30,933,1117,0,0,83.53,457,446,"湳興里",NULL
11,925,31,956,1171,0,0,81.64,423,502,"新興里",NULL
12,1074,18,1092,1366,0,0,79.94,574,500,"新興里",NULL
13,972,22,994,1673,0,0,59.41,502,470,"社後里",NULL
14,1167,39,1206,1479,0,0,81.54,583,584,"社後里",NULL
15,849,23,872,1074,0,0,81.19,395,454,"社後里",NULL
16,886,18,904,1123,0,0,80.5,447,439,"社後里",NULL
17,802,16,818,1010,0,0,80.99,323,479,"香社里",NULL
18,900,20,920,1137,0,0,80.91,469,431,"香社里",NULL
19,1166,30,1196,1415,0,0,84.52,529,637,"香社里",NULL
20,841,16,857,1043,0,0,82.17,413,428,"香雅里",NULL
21,928,29,957,1146,0,0,83.51,460,468,"香雅里",NULL
22,920,23,943,1169,0,0,80.67,466,454,"中正里",NULL
23,958,18,976,1180,0,0,82.71,452,506,"中正里",NULL
24,962,23,985,1209,0,0,81.47,471,491,"中正里",NULL
25,944,14,958,1130,0,0,84.78,605,339,"自強里",NULL
26,970,15,985,1196,0,0,82.36,618,352,"自強里",NULL
27,905,17,922,1122,0,0,82.17,591,314,"自強里",NULL
28,866,30,896,1038,0,0,86.32,503,363,"自強里",NULL
29,1070,34,1104,1307,0,0,84.47,522,548,"自立里",NULL
30,880,28,908,1089,0,0,83.38,415,465,"自立里",NULL
31,949,27,976,1175,0,0,83.06,464,485,"光華里",NULL
32,903,14,917,1093,0,0,83.9,554,349,"光華里",NULL
33,822,24,846,1048,0,0,80.73,476,346,"光榮里",NULL
34,876,18,894,1106,0,0,80.83,471,405,"光榮里",NULL
35,1055,13,1068,1238,0,0,86.27,881,174,"國光里",NULL
36,888,9,897,1050,0,0,85.43,788,100,"國光里",NULL
37,855,28,883,1041,0,0,84.82,499,356,"國光里",NULL
38,694,15,709,839,0,0,84.51,324,370,"港尾里",NULL
39,1055,21,1076,1240,0,0,86.77,569,486,"港尾里",NULL
40,981,18,999,1245,0,0,80.24,460,521,"新生里",NULL
41,1124,18,1142,1341,0,0,85.16,593,531,"新生里",NULL
42,921,20,941,1117,0,0,84.24,430,491,"新生里",NULL
43,889,26,915,1124,0,0,81.41,415,474,"金華里",NULL
44,886,26,912,1119,0,0,81.5,436,450,"金華里",NULL
45,907,28,935,1136,0,0,82.31,426,481,"金華里",NULL
46,860,32,892,1107,0,0,80.58,353,507,"港德里",NULL
47,815,41,856,1058,0,0,80.91,368,447,"港德里",NULL
48,683,21,704,868,0,0,81.11,319,364,"港德里",NULL
49,942,11,953,1151,0,0,82.8,448,494,"港德里",NULL
50,947,24,971,1172,0,0,82.85,509,438,"民權里",NULL
51,1076,25,1101,1310,0,0,84.05,607,469,"民權里",NULL
52,675,17,692,809,0,0,85.54,368,307,"民安里",NULL
53,775,17,792,963,0,0,82.24,441,334,"民安里",NULL
54,825,23,848,1044,0,0,81.23,376,449,"建國里",NULL
55,903,17,920,1125,0,0,81.78,403,500,"建國里",NULL
56,839,18,857,1008,0,0,85.02,414,425,"建國里",NULL
57,850,14,864,1047,0,0,82.52,477,373,"漢生里",NULL
58,1147,20,1167,1405,0,0,83.06,607,540,"漢生里",NULL
59,1051,17,1068,1273,0,0,83.9,524,527,"漢生里",NULL
60,876,24,900,1149,0,0,78.33,437,439,"新民里",NULL
61,869,23,892,1084,0,0,82.29,440,429,"新民里",NULL
62,1080,30,1110,1351,0,0,82.16,568,512,"新民里",NULL
63,972,28,1000,1192,0,0,83.89,441,531,"公館里",NULL
64,820,24,844,1018,0,0,82.91,411,409,"公館里",NULL
65,762,18,780,968,0,0,80.58,349,413,"公館里",NULL
66,938,20,958,1192,0,0,80.37,446,492,"幸福里",NULL
67,984,17,1001,1170,0,0,85.56,467,517,"幸福里",NULL
68,825,20,845,1027,0,0,82.28,374,451,"幸福里",NULL
69,1063,31,1094,1335,0,0,81.95,539,524,"文德里",NULL
70,954,18,972,1185,0,0,82.03,483,471,"文德里",NULL
71,1060,13,1073,1270,0,0,84.49,755,305,"忠誠里",NULL
72,869,14,883,1062,0,0,83.15,581,288,"忠誠里",NULL
73,1023,18,1041,1258,0,0,82.75,523,500,"陽明里",NULL
74,977,26,1003,1204,0,0,83.31,439,538,"陽明里",NULL
75,916,24,940,1143,0,0,82.24,448,468,"百壽里",NULL
76,763,11,774,937,0,0,82.6,358,405,"百壽里",NULL
77,1005,22,1027,1266,0,0,81.12,472,533,"介壽里",NULL
78,1029,29,1058,1283,0,0,82.46,533,496,"介壽里",NULL
79,718,20,738,907,0,0,81.37,333,385,"新埔里",NULL
80,896,25,921,1106,0,0,83.27,444,452,"新埔里",NULL
81,1132,21,1153,1402,0,0,82.24,606,526,"華江里",NULL
82,849,11,860,1024,0,0,83.98,377,472,"華江里",NULL
83,1391,37,1428,1700,0,0,84,678,713,"華江里",NULL
84,1130,27,1157,1416,0,0,81.71,490,640,"江翠里",NULL
85,1015,23,1038,1296,0,0,80.09,454,561,"江翠里",NULL
86,1032,30,1062,1284,0,0,82.71,447,585,"江翠里",NULL
87,852,16,868,1051,0,0,82.59,393,459,"純翠里",NULL
88,1116,20,1136,1366,0,0,83.16,486,630,"純翠里",NULL
89,1467,33,1500,1794,0,0,83.61,693,774,"純翠里",NULL
90,949,28,977,1227,0,0,79.63,431,518,"溪頭里",NULL
91,1093,20,1113,1364,0,0,81.6,518,575,"溪頭里",NULL
92,868,23,891,1088,0,0,81.89,370,498,"溪頭里",NULL
93,989,24,1013,1201,0,0,84.35,390,599,"溪頭里",NULL
94,1574,23,1597,1944,0,0,82.15,894,680,"聯翠里",NULL
95,1063,9,1072,1295,0,0,82.78,457,606,"聯翠里",NULL
96,998,20,1018,1221,0,0,83.37,417,581,"文化里",NULL
97,1138,35,1173,1426,0,0,82.26,541,597,"文化里",NULL
98,972,26,998,1222,0,0,81.67,431,541,"宏翠里",NULL
99,1131,34,1165,1420,0,0,82.04,521,610,"宏翠里",NULL
100,1118,37,1155,1445,0,0,79.93,409,709,"仁翠里",NULL
101,1003,37,1040,1286,0,0,80.87,374,629,"仁翠里",NULL
102,1524,35,1559,1924,0,0,81.03,611,913,"新翠里",NULL
103,1758,23,1781,2150,0,0,82.84,920,838,"新翠里",NULL
104,1674,29,1703,2056,0,0,82.83,853,821,"新翠里",NULL
105,664,7,671,800,0,0,83.88,288,376,"朝陽里",NULL
106,728,14,742,893,0,0,83.09,282,446,"朝陽里",NULL
107,987,26,1013,1210,0,0,83.72,447,540,"朝陽里",NULL
108,867,25,892,1044,0,0,85.44,345,522,"吉翠里",NULL
109,777,11,788,939,0,0,83.92,366,411,"吉翠里",NULL
110,843,24,867,1047,0,0,82.81,380,463,"吉翠里",NULL
111,1253,32,1285,1536,0,0,83.66,596,657,"德翠里",NULL
112,1011,20,1031,1203,0,0,85.7,498,513,"德翠里",NULL
113,1660,28,1688,2020,0,0,83.56,889,771,"德翠里",NULL
114,779,13,792,999,0,0,79.28,370,409,"新海里",NULL
115,758,15,773,934,0,0,82.76,301,457,"新海里",NULL
116,771,11,782,955,0,0,81.88,375,396,"新海里",NULL
117,645,16,661,811,0,0,81.5,264,381,"滿翠里",NULL
118,729,17,746,921,0,0,81,281,448,"滿翠里",NULL
119,842,13,855,1023,0,0,83.58,346,496,"滿翠里",NULL
120,634,18,652,814,0,0,80.1,281,353,"明翠里",NULL
121,825,24,849,1027,0,0,82.67,336,489,"明翠里",NULL
122,915,7,922,1111,0,0,82.99,447,468,"明翠里",NULL
123,938,11,949,1135,0,0,83.61,397,541,"明翠里",NULL
124,820,22,842,1040,0,0,80.96,402,418,"松翠里",NULL
125,1535,33,1568,1988,0,0,78.87,694,841,"松翠里",NULL
126,1247,29,1276,1540,0,0,82.86,589,658,"柏翠里",NULL
127,1109,37,1146,1393,0,0,82.27,492,617,"柏翠里",NULL
128,957,27,984,1189,0,0,82.76,385,572,"龍翠里",NULL
129,1015,32,1047,1264,0,0,82.83,413,602,"龍翠里",NULL
130,984,16,1000,1191,0,0,83.96,422,562,"龍翠里",NULL
131,819,22,841,1051,0,0,80.02,370,449,"松柏里",NULL
132,601,10,611,771,0,0,79.25,282,319,"松柏里",NULL
133,1019,22,1041,1263,0,0,82.42,403,616,"華翠里",NULL
134,1186,32,1218,1429,0,0,85.23,565,621,"華翠里",NULL
135,1129,26,1155,1384,0,0,83.45,503,626,"莒光里",NULL
136,924,28,952,1152,0,0,82.64,422,502,"莒光里",NULL
137,1372,32,1404,1646,0,0,85.3,645,727,"忠翠里",NULL
138,1239,30,1269,1478,0,0,85.86,596,643,"忠翠里",NULL
139,1365,20,1385,1611,0,0,85.97,806,559,"忠翠里",NULL
140,1667,28,1695,2090,0,0,81.1,880,787,"忠翠里",NULL
141,875,19,894,1096,0,0,81.57,354,521,"嵐翠里",NULL
142,882,30,912,1103,0,0,82.68,407,475,"嵐翠里",NULL
143,1248,32,1280,1539,0,0,83.17,536,712,"文聖里",NULL
144,1162,27,1189,1408,0,0,84.45,556,606,"文聖里",NULL
145,977,20,997,1214,0,0,82.13,467,510,"文翠里",NULL
146,851,21,872,1052,0,0,82.89,417,434,"文翠里",NULL
147,1054,19,1073,1272,0,0,84.36,478,576,"文翠里",NULL
148,984,26,1010,1255,0,0,80.48,420,564,"青翠里",NULL
149,1007,19,1026,1274,0,0,80.53,425,582,"青翠里",NULL
150,1505,38,1543,1974,0,0,78.17,639,866,"懷翠里",NULL
151,1047,20,1067,1326,0,0,80.47,459,588,"懷翠里",NULL
152,1147,18,1165,1435,0,0,81.18,530,617,"懷翠里",NULL
153,480,30,510,636,0,0,80.19,233,247,"福翠里",NULL
154,686,12,698,854,0,0,81.73,375,311,"福翠里",NULL
155,1066,28,1094,1330,0,0,82.26,551,515,"港嘴里",NULL
156,1049,9,1058,1344,0,0,78.72,480,569,"港嘴里",NULL
157,756,16,772,943,0,0,81.87,336,420,"港嘴里",NULL
158,701,17,718,849,0,0,84.57,335,366,"港嘴里",NULL
159,1040,28,1068,1279,0,0,83.5,531,509,"振興里",NULL
160,1074,11,1085,1279,0,0,84.83,432,642,"振興里",NULL
161,740,23,763,901,0,0,84.68,317,423,"振興里",NULL
162,1138,41,1179,1424,0,0,82.79,510,628,"振義里",NULL
163,900,23,923,1126,0,0,81.97,430,470,"振義里",NULL
164,728,23,751,925,0,0,81.19,259,469,"振義里",NULL
165,1087,14,1101,1318,0,0,83.54,479,608,"光復里",NULL
166,965,34,999,1209,0,0,82.63,434,531,"光復里",NULL
167,1151,34,1185,1442,0,0,82.18,601,550,"埔墘里",NULL
168,1074,32,1106,1361,0,0,81.26,514,560,"埔墘里",NULL
169,1067,23,1090,1340,0,0,81.34,445,622,"埔墘里",NULL
170,715,27,742,899,0,0,82.54,313,402,"富貴里",NULL
171,808,15,823,992,0,0,82.96,473,335,"富貴里",NULL
172,1007,24,1031,1239,0,0,83.21,504,503,"長壽里",NULL
173,945,31,976,1161,0,0,84.07,455,490,"長壽里",NULL
174,1006,22,1028,1240,0,0,82.9,550,456,"福壽里",NULL
175,1094,43,1137,1366,0,0,83.24,513,581,"福壽里",NULL
176,1011,19,1030,1251,0,0,82.33,492,519,"居仁里",NULL
177,1012,22,1034,1228,0,0,84.2,474,538,"居仁里",NULL
178,1248,17,1265,1490,0,0,84.9,572,676,"海山里",NULL
179,701,21,722,864,0,0,83.56,337,364,"海山里",NULL
180,1046,22,1068,1289,0,0,82.85,409,637,"海山里",NULL
181,1433,19,1452,1747,0,0,83.11,826,607,"海山里",NULL
182,1039,12,1051,1286,0,0,81.73,423,616,"九如里",NULL
183,875,25,900,1064,0,0,84.59,388,487,"九如里",NULL
184,1091,28,1119,1344,0,0,83.26,487,604,"正泰里",NULL
185,912,23,935,1085,0,0,86.18,457,455,"正泰里",NULL
186,1291,36,1327,1646,0,0,80.62,699,592,"玉光里",NULL
187,1027,22,1049,1279,0,0,82.02,436,591,"玉光里",NULL
188,907,25,932,1155,0,0,80.69,392,515,"玉光里",NULL
189,1043,33,1076,1274,0,0,84.46,489,554,"光仁里",NULL
190,904,29,933,1117,0,0,83.53,402,502,"光仁里",NULL
191,1405,33,1438,1723,0,0,83.46,701,704,"埤墘里",NULL
192,1017,27,1044,1281,0,0,81.5,448,569,"埤墘里",NULL
193,1309,24,1333,1569,0,0,84.96,650,659,"莊敬里",NULL
194,1028,24,1052,1227,0,0,85.74,482,546,"莊敬里",NULL
195,1095,14,1109,1333,0,0,83.2,459,636,"永安里",NULL
196,1090,25,1115,1356,0,0,82.23,535,555,"永安里",NULL
197,1302,46,1348,1636,0,0,82.4,573,729,"雙玉里",NULL
198,1085,28,1113,1319,0,0,84.38,504,581,"雙玉里",NULL
199,630,21,651,860,0,0,75.7,316,314,"廣新里",NULL
200,792,11,803,1001,0,0,80.22,367,425,"廣新里",NULL
201,878,23,901,1078,0,0,83.58,415,463,"廣新里",NULL
202,837,10,847,1055,0,0,80.28,554,283,"深丘里",NULL
203,1127,17,1144,1394,0,0,82.07,671,456,"深丘里",NULL
204,786,23,809,986,0,0,82.05,333,453,"深丘里",NULL
205,724,15,739,868,0,0,85.14,403,321,"深丘里",NULL
206,818,27,845,1007,0,0,83.91,393,425,"香丘里",NULL
207,699,20,719,872,0,0,82.45,314,385,"香丘里",NULL
208,899,25,924,1123,0,0,82.28,484,415,"香丘里",NULL
209,908,24,932,1160,0,0,80.34,424,484,"西安里",NULL
210,847,26,873,1032,0,0,84.59,412,435,"西安里",NULL
211,872,25,897,1108,0,0,80.96,392,480,"東丘里",NULL
212,975,23,998,1170,0,0,85.3,414,561,"東丘里",NULL
213,941,28,969,1135,0,0,85.37,398,543,"東丘里",NULL
214,578,20,598,750,0,0,79.73,264,314,"民生里",NULL
215,658,17,675,834,0,0,80.94,302,356,"民生里",NULL
216,1094,22,1116,1320,0,0,84.55,548,546,"長安里",NULL
217,1342,32,1374,1643,0,0,83.63,634,708,"長安里",NULL
218,799,15,814,976,0,0,83.4,357,442,"東安里",NULL
219,938,15,953,1662,0,0,57.34,433,505,"東安里",NULL
220,845,21,866,1063,0,0,81.47,458,387,"福丘里",NULL
221,483,12,495,601,0,0,82.36,286,197,"福丘里",NULL
222,1214,30,1244,1587,0,0,78.39,689,525,"福祿里",NULL
223,1107,20,1127,1367,0,0,82.44,675,432,"福祿里",NULL
224,897,19,916,1108,0,0,82.67,462,435,"民族里",NULL
225,838,18,856,1029,0,0,83.19,383,455,"民族里",NULL
226,760,10,770,903,0,0,85.27,372,388,"民族里",NULL
227,934,18,952,1173,0,0,81.16,544,390,"國泰里",NULL
228,1111,22,1133,1400,0,0,80.93,570,541,"國泰里",NULL
229,1150,16,1166,1388,0,0,84.01,667,483,"後埔里",NULL
230,1170,35,1205,1489,0,0,80.93,605,565,"後埔里",NULL
231,1011,22,1033,1219,0,0,84.74,476,535,"福德里",NULL
232,1126,19,1145,1358,0,0,84.32,587,539,"福德里",NULL
233,1257,37,1294,1563,0,0,82.79,644,613,"福德里",NULL
234,954,22,976,1183,0,0,82.5,472,482,"景星里",NULL
235,1179,29,1208,1503,0,0,80.37,603,576,"景星里",NULL
236,1170,31,1201,1442,0,0,83.29,564,606,"福星里",NULL
237,1093,17,1110,1307,0,0,84.93,539,554,"福星里",NULL
238,1372,32,1404,1680,0,0,83.57,758,614,"鄉雲里",NULL
239,974,25,999,1201,0,0,83.18,456,518,"鄉雲里",NULL
240,1300,38,1338,1602,0,0,83.52,716,584,"廣德里",NULL
241,1051,21,1072,1360,0,0,78.82,562,489,"廣德里",NULL
242,1031,22,1053,1232,0,0,85.47,547,484,"廣德里",NULL
243,490,10,500,580,0,0,86.21,224,266,"廣德里",NULL
244,1187,21,1208,1495,0,0,80.8,585,602,"大豐里",NULL
245,898,19,917,1116,0,0,82.17,469,429,"大豐里",NULL
246,961,24,985,1218,0,0,80.87,523,438,"大豐里",NULL
247,1423,43,1466,1794,0,0,81.72,713,710,"重慶里",NULL
248,1237,34,1271,1580,0,0,80.44,659,578,"重慶里",NULL
249,1346,36,1382,1692,0,0,81.68,752,594,"重慶里",NULL
250,1128,10,1138,1366,0,0,83.31,674,454,"重慶里",NULL
251,762,24,786,924,0,0,85.06,610,152,"仁愛里",NULL
252,745,13,758,921,0,0,82.3,465,280,"仁愛里",NULL
253,734,14,748,909,0,0,82.29,425,309,"仁愛里",NULL
254,711,18,729,918,0,0,79.41,386,325,"和平里",NULL
255,1035,40,1075,1307,0,0,82.25,469,566,"廣福里",NULL
256,1109,23,1132,1428,0,0,79.27,564,545,"廣福里",NULL
257,916,15,931,1121,0,0,83.05,514,402,"五權里",NULL
258,1021,20,1041,1239,0,0,84.02,494,527,"五權里",NULL
259,1017,18,1035,1272,0,0,81.37,508,509,"五權里",NULL
260,1236,32,1268,1555,0,0,81.54,612,624,"華興里",NULL
261,1364,24,1388,1699,0,0,81.7,753,611,"華興里",NULL
262,897,37,934,1147,0,0,81.43,449,448,"華貴里",NULL
263,1003,32,1035,1226,0,0,84.42,511,492,"華貴里",NULL
264,803,17,820,969,0,0,84.62,426,377,"華福里",NULL
265,638,6,644,791,0,0,81.42,338,300,"華福里",NULL
266,1408,37,1445,1820,0,0,79.4,755,653,"華德里",NULL
267,1294,24,1318,1638,0,0,80.46,669,625,"華德里",NULL
268,1464,25,1489,1796,0,0,82.91,856,608,"華德里",NULL
269,1134,21,1155,1380,0,0,83.7,688,446,"華東里",NULL
270,1326,19,1345,1597,0,0,84.22,819,507,"華東里",NULL
271,1170,28,1198,1483,0,0,80.78,604,566,"華東里",NULL
272,855,17,872,1109,0,0,78.63,448,407,"信義里",NULL
273,880,20,900,1099,0,0,81.89,483,397,"信義里",NULL
274,929,29,958,1152,0,0,83.16,404,525,"信義里",NULL
275,976,26,1002,1275,0,0,78.59,388,588,"浮洲里",NULL
276,793,28,821,1080,0,0,76.02,436,357,"浮洲里",NULL
277,743,10,753,1240,0,0,60.73,343,400,"浮洲里",NULL
278,997,28,1025,1254,0,0,81.74,451,546,"華中里",NULL
279,1199,24,1223,1515,0,0,80.73,565,634,"華中里",NULL
280,1192,25,1217,1527,0,0,79.7,495,697,"華中里",NULL
281,1046,25,1071,1313,0,0,81.57,506,540,"僑中里",NULL
282,640,25,665,832,0,0,79.93,297,343,"僑中里",NULL
283,727,22,749,887,0,0,84.44,362,365,"僑中里",NULL
284,1035,22,1057,1300,0,0,81.31,495,540,"大觀里",NULL
285,1196,33,1229,1467,0,0,83.78,524,672,"大觀里",NULL
286,811,20,831,986,0,0,84.28,367,444,"歡園里",NULL
287,840,23,863,1081,0,0,79.83,398,442,"中山里",NULL
288,683,15,698,910,0,0,76.7,355,328,"中山里",NULL
289,890,30,920,1146,0,0,80.28,499,391,"中山里",NULL
290,642,22,664,833,0,0,79.71,611,31,"中山里",NULL
291,321,38,359,541,0,0,66.36,238,83,"復興里",NULL
292,435,43,478,639,0,0,74.8,330,105,"復興里",NULL
293,453,45,498,676,0,0,73.67,337,116,"復興里",NULL
294,908,26,934,1175,0,0,79.49,437,471,"大安里",NULL
295,1053,25,1078,1314,0,0,82.04,541,512,"大安里",NULL
296,759,11,770,970,0,0,79.38,372,387,"大安里",NULL
297,967,14,981,1156,0,0,84.86,663,304,"福安里",NULL
298,834,34,868,1088,0,0,79.78,354,480,"福安里",NULL
299,668,20,688,871,0,0,78.99,312,356,"聚安里",NULL
300,828,23,851,1008,0,0,84.42,373,455,"聚安里",NULL
301,751,19,770,964,0,0,79.88,372,379,"聚安里",NULL
302,943,34,977,1243,0,0,78.6,424,519,"聚安里",NULL
303,967,35,1002,1210,0,0,82.81,456,511,"龍安里",NULL
304,942,40,982,1217,0,0,80.69,403,539,"龍安里",NULL
305,1197,29,1226,1542,0,0,79.51,591,606,"崑崙里",NULL
306,1375,37,1412,1753,0,0,80.55,647,728,"崑崙里",NULL
307,1118,30,1148,1468,0,0,78.2,570,548,"崑崙里",NULL
308,1031,24,1055,1271,0,0,83.01,503,528,"崑崙里",NULL
309,1349,34,1383,1726,0,0,80.13,578,771,"成和里",NULL
310,1527,27,1554,1972,0,0,78.8,789,738,"成和里",NULL
311,1050,28,1078,1301,0,0,82.86,506,544,"溪洲里",NULL
312,1306,30,1336,1676,0,0,79.71,638,668,"溪洲里",NULL
313,1087,31,1118,1428,0,0,78.29,545,542,"溪洲里",NULL
314,1273,28,1301,1665,0,0,78.14,645,628,"溪福里",NULL
315,1423,25,1448,1808,0,0,80.09,648,775,"溪福里",NULL
316,1322,24,1346,1676,0,0,80.31,692,630,"溪福里",NULL
317,1373,23,1396,1735,0,0,80.46,706,667,"溪福里",NULL
318,1180,21,1201,1472,0,0,81.59,659,521,"溪福里",NULL
319,1015,26,1041,1272,0,0,81.84,472,543,"溪北里",NULL
320,1078,19,1097,1377,0,0,79.67,547,531,"溪北里",NULL
321,1105,27,1132,1386,0,0,81.67,537,568,"堂春里",NULL
322,1297,17,1314,1607,0,0,81.77,623,674,"堂春里",NULL
323,992,37,1029,1239,0,0,83.05,406,586,"大有里",NULL
324,878,17,895,1057,0,0,84.67,432,446,"大有里",NULL
325,995,19,1014,1248,0,0,81.25,422,573,"大有里",NULL
326,1033,24,1057,1285,0,0,82.26,430,603,"博愛里",NULL
327,1113,31,1144,1372,0,0,83.38,664,449,"博愛里",NULL
328,831,19,850,1021,0,0,83.25,367,464,"博愛里",NULL
329,715,19,734,916,0,0,80.13,265,450,"二重里",NULL
330,635,25,660,830,0,0,79.52,268,367,"二重里",NULL
331,659,20,679,840,0,0,80.83,246,413,"頂崁里",NULL
332,772,12,784,927,0,0,84.57,304,468,"頂崁里",NULL
333,925,20,945,1117,0,0,84.6,372,553,"谷王里",NULL
334,944,30,974,1172,0,0,83.11,408,536,"五谷里",NULL
335,552,19,571,691,0,0,82.63,240,312,"五谷里",NULL
336,1368,30,1398,1642,0,0,85.14,598,770,"中興里",NULL
337,1115,34,1149,1434,0,0,80.13,479,636,"中興里",NULL
338,318,10,328,391,0,0,83.89,107,211,"德厚里",NULL
339,862,29,891,1057,0,0,84.3,378,484,"成功里",NULL
340,1122,16,1138,1392,0,0,81.75,558,564,"成功里",NULL
341,1408,28,1436,1730,0,0,83.01,702,706,"成功里",NULL
342,1162,29,1191,1459,0,0,81.63,571,591,"福祉里",NULL
343,1348,25,1373,1693,0,0,81.1,621,727,"福祉里",NULL
344,1156,27,1183,1456,0,0,81.25,499,657,"福德里",NULL
345,1368,28,1396,1719,0,0,81.21,615,753,"福德里",NULL
346,1049,32,1081,1297,0,0,83.35,483,566,"福民里",NULL
347,1067,21,1088,1333,0,0,81.62,497,570,"福民里",NULL
348,1141,24,1165,1866,0,0,62.43,667,474,"過田里",NULL
349,1258,34,1292,1535,0,0,84.17,594,664,"過田里",NULL
350,1133,33,1166,1432,0,0,81.42,587,546,"過田里",NULL
351,642,18,660,805,0,0,81.99,294,348,"錦田里",NULL
352,764,15,779,947,0,0,82.26,327,437,"錦田里",NULL
353,972,28,1000,1155,0,0,86.58,428,544,"重明里",NULL
354,1001,33,1034,1235,0,0,83.72,427,574,"重明里",NULL
355,856,17,873,1073,0,0,81.36,414,442,"光田里",NULL
356,1073,19,1092,1288,0,0,84.78,516,557,"光田里",NULL
357,970,24,994,1189,0,0,83.6,476,494,"光田里",NULL
358,1309,18,1327,1603,0,0,82.78,617,692,"光陽里",NULL
359,1397,18,1415,1703,0,0,83.09,617,780,"光陽里",NULL
360,1351,54,1405,1666,0,0,84.33,586,765,"光陽里",NULL
361,903,24,927,1107,0,0,83.74,430,473,"田心里",NULL
362,910,13,923,1086,0,0,84.99,441,469,"田心里",NULL
363,999,15,1014,1228,0,0,82.57,389,610,"田心里",NULL
364,1121,15,1136,1361,0,0,83.47,445,676,"福田里",NULL
365,1191,27,1218,1438,0,0,84.7,510,681,"福田里",NULL
366,1151,32,1183,1415,0,0,83.6,440,711,"田中里",NULL
367,1114,21,1135,1350,0,0,84.07,410,704,"田中里",NULL
368,1523,27,1550,1839,0,0,84.28,630,893,"田中里",NULL
369,1306,36,1342,1630,0,0,82.33,576,730,"田安里",NULL
370,1318,35,1353,1665,0,0,81.26,632,686,"田安里",NULL
371,1300,52,1352,1628,0,0,83.05,608,692,"田安里",NULL
372,1242,22,1264,1533,0,0,82.45,527,715,"三民里",NULL
373,828,20,848,1022,0,0,82.97,389,439,"三民里",NULL
374,1037,20,1057,1305,0,0,81,491,546,"光明里",NULL
375,855,29,884,1130,0,0,78.23,449,406,"光明里",NULL
376,948,33,981,1218,0,0,80.54,483,465,"光明里",NULL
377,1123,21,1144,1382,0,0,82.78,480,643,"光明里",NULL
378,1202,32,1234,1559,0,0,79.15,681,521,"光正里",NULL
379,1139,47,1186,1537,0,0,77.16,660,479,"同安里",NULL
380,1159,35,1194,1483,0,0,80.51,581,578,"同慶里",NULL
381,797,16,813,1004,0,0,80.98,381,416,"菜寮里",NULL
382,602,16,618,728,0,0,84.89,285,317,"菜寮里",NULL
383,1178,31,1209,1481,0,0,81.63,601,577,"永春里",NULL
384,926,31,957,1183,0,0,80.9,423,503,"中正里",NULL
385,991,35,1026,1271,0,0,80.72,494,497,"吉利里",NULL
386,1231,16,1247,1568,0,0,79.53,575,656,"大同里",NULL
387,917,36,953,1163,0,0,81.94,473,444,"中民里",NULL
388,1106,48,1154,1463,0,0,78.88,514,592,"平和里",NULL
389,1120,43,1163,1426,0,0,81.56,563,557,"大安里",NULL
390,653,16,669,817,0,0,81.88,289,364,"仁德里",NULL
391,841,37,878,1082,0,0,81.15,363,478,"仁德里",NULL
392,1256,31,1287,1625,0,0,79.2,524,732,"忠孝里",NULL
393,896,25,921,1099,0,0,83.8,453,443,"仁義里",NULL
394,864,35,899,1112,0,0,80.85,384,480,"光榮里",NULL
395,1265,29,1294,1545,0,0,83.75,683,582,"光輝里",NULL
396,629,24,653,792,0,0,82.45,302,327,"福星里",NULL
397,1246,20,1266,1580,0,0,80.13,619,627,"福利里",NULL
398,1565,30,1595,1966,0,0,81.13,785,780,"清和里",NULL
399,956,20,976,1160,0,0,84.14,458,498,"清和里",NULL
400,944,23,967,1193,0,0,81.06,467,477,"永興里",NULL
401,811,19,830,1001,0,0,82.92,363,448,"中山里",NULL
402,920,21,941,1115,0,0,84.39,435,485,"中山里",NULL
403,792,17,809,1005,0,0,80.5,346,446,"大園里",NULL
404,907,16,923,1147,0,0,80.47,370,537,"大園里",NULL
405,857,24,881,1057,0,0,83.35,402,455,"國隆里",NULL
406,934,24,958,1122,0,0,85.38,453,481,"國隆里",NULL
407,1211,25,1236,1511,0,0,81.8,527,684,"重陽里",NULL
408,1115,28,1143,1409,0,0,81.12,541,574,"重陽里",NULL
409,989,25,1014,1240,0,0,81.77,406,583,"民生里",NULL
410,1070,29,1099,1313,0,0,83.7,445,625,"民生里",NULL
411,977,20,997,1176,0,0,84.78,433,544,"民生里",NULL
412,1060,32,1092,1323,0,0,82.54,454,606,"重新里",NULL
413,812,26,838,1017,0,0,82.4,338,474,"正德里",NULL
414,1218,30,1248,1521,0,0,82.05,565,653,"正義里",NULL
415,1318,50,1368,1660,0,0,82.41,595,723,"正安里",NULL
416,1302,44,1346,1624,0,0,82.88,548,754,"自強里",NULL
417,884,19,903,1086,0,0,83.15,378,506,"文化里",NULL
418,854,20,874,1040,0,0,84.04,360,494,"文化里",NULL
419,1250,38,1288,1540,0,0,83.64,541,709,"中央里",NULL
420,637,27,664,833,0,0,79.71,299,338,"雙園里",NULL
421,1133,43,1176,1475,0,0,79.73,542,591,"錦通里",NULL
422,746,10,756,929,0,0,81.38,334,412,"錦安里",NULL
423,662,16,678,825,0,0,82.18,316,346,"錦安里",NULL
424,718,37,755,978,0,0,77.2,346,372,"長安里",NULL
425,796,19,815,980,0,0,83.16,405,391,"長安里",NULL
426,1312,17,1329,1656,0,0,80.25,612,700,"光華里",NULL
427,637,8,645,773,0,0,83.44,228,409,"長生里",NULL
428,1065,13,1078,1311,0,0,82.23,449,616,"開元里",NULL
429,531,17,548,649,0,0,84.44,242,289,"大德里",NULL
430,783,20,803,982,0,0,81.77,327,456,"長元里",NULL
431,938,31,969,1173,0,0,82.61,442,496,"長元里",NULL
432,1338,43,1381,1720,0,0,80.29,578,760,"長江里",NULL
433,897,22,919,1148,0,0,80.05,371,526,"長泰里",NULL
434,705,29,734,920,0,0,79.78,341,364,"長泰里",NULL
435,1120,31,1151,1434,0,0,80.26,516,604,"長福里",NULL
436,841,30,871,1084,0,0,80.35,372,469,"介壽里",NULL
437,701,33,734,909,0,0,80.75,310,391,"萬壽里",NULL
438,676,11,687,815,0,0,84.29,338,338,"萬壽里",NULL
439,820,18,838,1048,0,0,79.96,371,449,"錦江里",NULL
440,819,22,841,1040,0,0,80.87,347,472,"錦江里",NULL
441,995,14,1009,1213,0,0,83.18,426,569,"龍濱里",NULL
442,1149,38,1187,1417,0,0,83.77,477,672,"龍濱里",NULL
443,1316,31,1347,1659,0,0,81.19,574,742,"龍門里",NULL
444,940,26,966,1159,0,0,83.35,410,530,"秀江里",NULL
445,1053,36,1089,1334,0,0,81.63,415,638,"奕壽里",NULL
446,846,18,864,1052,0,0,82.13,401,445,"三安里",NULL
447,990,28,1018,1244,0,0,81.83,417,573,"三安里",NULL
448,942,32,974,1198,0,0,81.3,387,555,"福安里",NULL
449,1069,45,1114,1347,0,0,82.7,450,619,"福安里",NULL
450,1305,27,1332,1607,0,0,82.89,580,725,"信安里",NULL
451,687,23,710,879,0,0,80.77,270,417,"安慶里",NULL
452,765,24,789,981,0,0,80.43,310,455,"安慶里",NULL
453,1061,33,1094,1354,0,0,80.8,507,554,"幸福里",NULL
454,987,15,1002,1204,0,0,83.22,421,566,"幸福里",NULL
455,990,25,1015,1252,0,0,81.07,420,570,"幸福里",NULL
456,1401,27,1428,1722,0,0,82.93,630,771,"六合里",NULL
457,1185,36,1221,1468,0,0,83.17,477,708,"六合里",NULL
458,1230,19,1249,1507,0,0,82.88,470,760,"六福里",NULL
459,1092,26,1118,1315,0,0,85.02,425,667,"六福里",NULL
460,1195,18,1213,1449,0,0,83.71,514,681,"六福里",NULL
461,801,38,839,1014,0,0,82.74,371,430,"順德里",NULL
462,694,10,704,862,0,0,81.67,322,372,"順德里",NULL
463,1313,50,1363,1664,0,0,81.91,627,686,"承德里",NULL
464,798,26,824,995,0,0,82.81,317,481,"瑞德里",NULL
465,943,18,961,1146,0,0,83.86,392,551,"瑞德里",NULL
466,804,14,818,1001,0,0,81.72,348,456,"崇德里",NULL
467,1233,26,1259,1530,0,0,82.29,500,733,"崇德里",NULL
468,744,25,769,910,0,0,84.51,331,413,"崇德里",NULL
469,1072,30,1102,1300,0,0,84.77,432,640,"厚德里",NULL
470,1257,27,1284,1511,0,0,84.98,542,715,"厚德里",NULL
471,1134,34,1168,1400,0,0,83.43,416,718,"維德里",NULL
472,867,20,887,1063,0,0,83.44,401,466,"維德里",NULL
473,1285,28,1313,1604,0,0,81.86,586,699,"尚德里",NULL
474,897,24,921,1125,0,0,81.87,476,421,"尚德里",NULL
475,878,27,905,1083,0,0,83.56,364,514,"培德里",NULL
476,1432,29,1461,1737,0,0,84.11,627,805,"培德里",NULL
477,1141,36,1177,1419,0,0,82.95,510,631,"立德里",NULL
478,1097,13,1110,1331,0,0,83.4,457,640,"立德里",NULL
479,1213,38,1251,1548,0,0,80.81,568,645,"永德里",NULL
480,950,13,963,1169,0,0,82.38,377,573,"永德里",NULL
481,1125,35,1160,1393,0,0,83.27,485,640,"永德里",NULL
482,984,31,1015,1216,0,0,83.47,388,596,"永輝里",NULL
483,775,19,794,973,0,0,81.6,255,520,"永輝里",NULL
484,906,9,915,1105,0,0,82.81,364,542,"永發里",NULL
485,963,15,978,1174,0,0,83.3,378,585,"永發里",NULL
486,1152,22,1174,1364,0,0,86.07,381,771,"永發里",NULL
487,1082,27,1109,1373,0,0,80.77,448,634,"永盛里",NULL
488,1160,31,1191,1485,0,0,80.2,470,690,"永盛里",NULL
489,1017,12,1029,1251,0,0,82.25,477,540,"永吉里",NULL
490,907,25,932,1148,0,0,81.18,351,556,"永吉里",NULL
491,1177,26,1203,1471,0,0,81.78,556,621,"永安里",NULL
492,1033,24,1057,1293,0,0,81.75,436,597,"永安里",NULL
493,1085,7,1092,1334,0,0,81.86,429,656,"永豐里",NULL
494,817,12,829,1051,0,0,78.88,325,492,"永豐里",NULL
495,1266,36,1302,1580,0,0,82.41,531,735,"永豐里",NULL
496,1042,25,1067,1313,0,0,81.26,386,656,"永福里",NULL
497,950,27,977,1197,0,0,81.62,387,563,"永福里",NULL
498,1262,30,1292,1591,0,0,81.21,605,657,"永福里",NULL
499,1211,31,1242,1515,0,0,81.98,498,713,"永清里",NULL
500,1255,34,1289,1556,0,0,82.84,529,726,"永清里",NULL
501,1155,31,1186,1407,0,0,84.29,516,639,"永清里",NULL
502,1103,37,1140,1378,0,0,82.73,493,610,"永順里",NULL
503,1083,28,1111,1393,0,0,79.76,434,649,"永順里",NULL
504,817,18,835,1022,0,0,81.7,292,525,"永順里",NULL
505,1316,25,1341,1594,0,0,84.13,555,761,"溪美里",NULL
506,952,21,973,1418,0,0,68.62,401,551,"溪美里",NULL
507,1180,46,1226,1445,0,0,84.84,531,649,"溪美里",NULL
508,972,22,994,1197,0,0,83.04,438,534,"溪美里",NULL
509,1289,24,1313,1610,0,0,81.55,567,722,"福隆里",NULL
510,1172,27,1199,1502,0,0,79.83,492,680,"福隆里",NULL
511,868,34,902,1079,0,0,83.6,412,456,"五常里",NULL
512,909,27,936,1124,0,0,83.27,365,544,"五常里",NULL
513,918,23,941,1143,0,0,82.33,400,518,"五常里",NULL
514,888,23,911,1111,0,0,82,388,500,"五福里",NULL
515,893,37,930,1161,0,0,80.1,387,506,"五福里",NULL
516,1143,34,1177,1492,0,0,78.89,535,608,"仁忠里",NULL
517,968,28,996,1199,0,0,83.07,417,551,"仁忠里",NULL
518,727,11,738,908,0,0,81.28,277,450,"慈福里",NULL
519,864,25,889,1084,0,0,82.01,391,473,"慈福里",NULL
520,686,17,703,902,0,0,77.94,303,383,"慈生里",NULL
521,940,9,949,1141,0,0,83.17,426,514,"慈生里",NULL
522,831,28,859,1055,0,0,81.42,322,509,"慈惠里",NULL
523,762,19,781,946,0,0,82.56,279,483,"慈惠里",NULL
524,1305,40,1345,1613,0,0,83.38,513,792,"慈愛里",NULL
525,1240,37,1277,1561,0,0,81.81,539,701,"慈愛里",NULL
526,837,27,864,1044,0,0,82.76,336,501,"慈化里",NULL
527,808,30,838,1040,0,0,80.58,370,438,"慈化里",NULL
528,927,33,960,1202,0,0,79.87,391,536,"慈祐里",NULL
529,954,33,987,1238,0,0,79.73,390,564,"慈祐里",NULL
530,1008,24,1032,1232,0,0,83.77,442,566,"慈祐里",NULL
531,834,28,862,1074,0,0,80.26,390,444,"富華里",NULL
532,886,29,915,1139,0,0,80.33,379,507,"富華里",NULL
533,1118,24,1142,1436,0,0,79.53,434,684,"富貴里",NULL
534,990,23,1013,1212,0,0,83.58,446,544,"富貴里",NULL
535,595,16,611,752,0,0,81.25,274,321,"富福里",NULL
536,795,27,822,1034,0,0,79.5,304,491,"富福里",NULL
537,1274,39,1313,1577,0,0,83.26,478,796,"五華里",NULL
538,1087,26,1113,1285,0,0,86.61,436,651,"五華里",NULL
539,794,24,818,1026,0,0,79.73,320,474,"碧華里",NULL
540,920,23,943,1139,0,0,82.79,475,445,"碧華里",NULL
541,1216,35,1251,1491,0,0,83.9,479,737,"福樂里",NULL
542,1217,17,1234,1498,0,0,82.38,529,688,"福樂里",NULL
543,1309,38,1347,1649,0,0,81.69,529,780,"仁華里",NULL
544,1184,37,1221,1508,0,0,80.97,524,660,"仁華里",NULL
545,1208,46,1254,1563,0,0,80.23,541,667,"五順里",NULL
546,1235,29,1264,1554,0,0,81.34,527,708,"五順里",NULL
547,1290,45,1335,1648,0,0,81.01,572,718,"中原里",NULL
548,608,11,619,753,0,0,82.2,255,353,"中原里",NULL
549,1211,21,1232,1516,0,0,81.27,739,472,"中原里",NULL
550,548,9,557,687,0,0,81.08,308,240,"連和里",NULL
551,279,9,288,358,0,0,80.45,246,33,"連和里",NULL
552,1460,28,1488,1800,0,0,82.67,945,515,"連城里",NULL
553,1184,17,1201,1397,0,0,85.97,819,365,"連城里",NULL
554,1466,32,1498,1819,0,0,82.35,804,662,"連城里",NULL
555,1880,54,1934,2323,0,0,83.25,1174,706,"力行里",NULL
556,1695,22,1717,2021,0,0,84.96,1012,683,"力行里",NULL
557,712,20,732,939,0,0,77.96,415,297,"正行里",NULL
558,1046,14,1060,1294,0,0,81.92,699,347,"正行里",NULL
559,1623,15,1638,1992,0,0,82.23,1088,535,"德行里",NULL
560,1411,29,1440,1745,0,0,82.52,808,603,"德行里",NULL
561,1169,21,1190,1421,0,0,83.74,640,529,"枋寮里",NULL
562,1203,34,1237,1565,0,0,79.04,687,516,"枋寮里",NULL
563,1073,31,1104,1314,0,0,84.02,594,479,"漳和里",NULL
564,1207,18,1225,1454,0,0,84.25,710,497,"漳和里",NULL
565,934,29,963,1165,0,0,82.66,509,425,"廟美里",NULL
566,958,26,984,1213,0,0,81.12,570,388,"廟美里",NULL
567,1118,29,1147,1448,0,0,79.21,617,501,"廟美里",NULL
568,1321,34,1355,1673,0,0,80.99,753,568,"福真里",NULL
569,1438,53,1491,1776,0,0,83.95,714,724,"福真里",NULL
570,1306,25,1331,1598,0,0,83.29,734,572,"福善里",NULL
571,842,16,858,1056,0,0,81.25,595,247,"福善里",NULL
572,722,12,734,894,0,0,82.1,411,311,"福善里",NULL
573,1254,32,1286,1533,0,0,83.89,852,402,"福美里",NULL
574,1055,21,1076,1298,0,0,82.9,536,519,"福美里",NULL
575,892,25,917,1120,0,0,81.88,483,409,"福美里",NULL
576,1368,30,1398,1694,0,0,82.53,792,576,"福祥里",NULL
577,1772,58,1830,2224,0,0,82.28,946,826,"福祥里",NULL
578,769,30,799,962,0,0,83.06,406,363,"瓦窯里",NULL
579,1178,39,1217,1479,0,0,82.29,713,465,"瓦窯里",NULL
580,1446,34,1480,1769,0,0,83.66,830,616,"瓦窯里",NULL
581,1168,35,1203,1477,0,0,81.45,639,529,"福和里",NULL
582,1418,40,1458,1768,0,0,82.47,792,626,"福和里",NULL
583,1293,33,1326,1604,0,0,82.67,771,522,"佳和里",NULL
584,1174,14,1188,1427,0,0,83.25,661,513,"佳和里",NULL
585,866,22,888,1069,0,0,83.07,538,328,"佳和里",NULL
586,1419,22,1441,1695,0,0,85.01,871,548,"新南里",NULL
587,651,26,677,822,0,0,82.36,387,264,"新南里",NULL
588,1261,34,1295,1594,0,0,81.24,787,474,"新南里",NULL
589,1905,26,1931,2298,0,0,84.03,1313,592,"新南里",NULL
590,1767,34,1801,2170,0,0,83,1078,689,"南山里",NULL
591,1595,26,1621,1923,0,0,84.3,976,619,"南山里",NULL
592,1437,47,1484,1855,0,0,80,684,753,"平河里",NULL
593,1940,40,1980,2433,0,0,81.38,1068,872,"平河里",NULL
594,1213,30,1243,1461,0,0,85.08,812,401,"平河里",NULL
595,815,12,827,972,0,0,85.08,536,279,"平河里",NULL
596,875,18,893,1085,0,0,82.3,461,414,"信和里",NULL
597,989,44,1033,1279,0,0,80.77,553,436,"信和里",NULL
598,1015,38,1053,1271,0,0,82.85,545,470,"信和里",NULL
599,1075,32,1107,1379,0,0,80.28,673,402,"仁和里",NULL
600,762,23,785,943,0,0,83.24,418,344,"仁和里",NULL
601,995,36,1031,1235,0,0,83.48,533,462,"仁和里",NULL
602,1327,55,1382,1686,0,0,81.97,764,563,"中正里",NULL
603,1358,38,1396,1729,0,0,80.74,751,607,"中正里",NULL
604,830,24,854,1008,0,0,84.72,443,387,"中山里",NULL
605,885,26,911,1103,0,0,82.59,503,382,"中山里",NULL
606,1171,21,1192,1381,0,0,86.31,1014,157,"建和里",NULL
607,1501,56,1557,1914,0,0,81.35,816,685,"建和里",NULL
608,1081,24,1105,1347,0,0,82.03,626,455,"碧河里",NULL
609,1115,27,1142,1343,0,0,85.03,512,603,"碧河里",NULL
610,1253,35,1288,1596,0,0,80.7,848,405,"宜安里",NULL
611,1135,27,1162,1374,0,0,84.57,765,370,"安樂里",NULL
612,1388,22,1410,1677,0,0,84.08,965,423,"安樂里",NULL
613,1087,21,1108,1324,0,0,83.69,669,418,"安和里",NULL
614,951,19,970,1186,0,0,81.79,655,296,"安和里",NULL
615,1270,30,1300,1566,0,0,83.01,819,451,"安順里",NULL
616,751,11,762,900,0,0,84.67,506,245,"安順里",NULL
617,839,24,863,1062,0,0,81.26,573,266,"安順里",NULL
618,907,23,930,1116,0,0,83.33,642,265,"安平里",NULL
619,1003,27,1030,1260,0,0,81.75,705,298,"安平里",NULL
620,1336,30,1366,1621,0,0,84.27,916,420,"安平里",NULL
621,1441,21,1462,1682,0,0,86.92,996,445,"中安里",NULL
622,1474,27,1501,1816,0,0,82.65,1032,442,"中安里",NULL
623,927,28,955,1140,0,0,83.77,566,361,"泰安里",NULL
624,767,13,780,938,0,0,83.16,478,289,"泰安里",NULL
625,979,25,1004,1235,0,0,81.3,607,372,"泰安里",NULL
626,1528,48,1576,1908,0,0,82.6,932,596,"秀山里",NULL
627,1484,35,1519,1809,0,0,83.97,969,515,"秀山里",NULL
628,1108,28,1136,1384,0,0,82.08,698,410,"秀成里",NULL
629,1306,17,1323,1574,0,0,84.05,828,478,"秀成里",NULL
630,996,31,1027,1236,0,0,83.09,583,413,"秀義里",NULL
631,885,18,903,1083,0,0,83.38,573,312,"秀義里",NULL
632,1467,24,1491,1802,0,0,82.74,946,521,"秀福里",NULL
633,830,13,843,993,0,0,84.89,531,299,"秀福里",NULL
634,1076,27,1103,1309,0,0,84.26,689,387,"秀福里",NULL
635,1356,24,1380,1706,0,0,80.89,905,451,"秀景里",NULL
636,1307,25,1332,1640,0,0,81.22,908,399,"秀景里",NULL
637,713,9,722,846,0,0,85.34,462,251,"秀景里",NULL
638,964,15,979,1141,0,0,85.8,693,271,"秀景里",NULL
639,1129,29,1158,1386,0,0,83.55,816,313,"秀明里",NULL
640,2164,42,2206,2723,0,0,81.01,1630,534,"秀明里",NULL
641,1117,27,1144,1352,0,0,84.62,776,341,"秀峰里",NULL
642,837,21,858,1034,0,0,82.98,593,244,"秀峰里",NULL
643,846,16,862,1035,0,0,83.29,662,184,"秀峰里",NULL
644,946,52,998,1255,0,0,79.52,704,242,"秀士里",NULL
645,791,24,815,977,0,0,83.42,542,249,"秀士里",NULL
646,897,25,922,1128,0,0,81.74,614,283,"秀水里",NULL
647,909,34,943,1138,0,0,82.86,615,294,"秀水里",NULL
648,937,30,967,1184,0,0,81.67,717,220,"秀水里",NULL
649,944,32,976,1207,0,0,80.86,590,354,"秀仁里",NULL
650,939,31,970,1160,0,0,83.62,613,326,"秀仁里",NULL
651,893,39,932,1168,0,0,79.79,633,260,"正南里",NULL
652,742,23,765,930,0,0,82.26,490,252,"正南里",NULL
653,885,20,905,1124,0,0,80.52,636,249,"正南里",NULL
654,958,27,985,1181,0,0,83.4,701,257,"頂南里",NULL
655,1164,26,1190,1417,0,0,83.98,791,373,"頂南里",NULL
656,1410,28,1438,1771,0,0,81.2,1046,364,"華新里",NULL
657,1486,47,1533,1927,0,0,79.55,1045,441,"華新里",NULL
658,1507,34,1541,1921,0,0,80.22,999,508,"華新里",NULL
659,862,16,878,1047,0,0,83.86,791,71,"東南里",NULL
660,1138,31,1169,1404,0,0,83.26,852,286,"東南里",NULL
661,1214,24,1238,1472,0,0,84.1,1022,192,"東南里",NULL
662,1500,39,1539,1828,0,0,84.19,1086,414,"華南里",NULL
663,1253,42,1295,1571,0,0,82.43,872,381,"華南里",NULL
664,700,29,729,910,0,0,80.11,490,210,"忠孝里",NULL
665,706,21,727,879,0,0,82.71,470,236,"忠孝里",NULL
666,1024,26,1050,1281,0,0,81.97,762,262,"忠孝里",NULL
667,1052,38,1090,1352,0,0,80.62,778,274,"忠孝里",NULL
668,1245,15,1260,1516,0,0,83.11,882,363,"崇南里",NULL
669,1322,32,1354,1600,0,0,84.63,934,388,"崇南里",NULL
670,1157,42,1199,1451,0,0,82.63,728,429,"興南里",NULL
671,1148,27,1175,1463,0,0,80.31,835,313,"興南里",NULL
672,933,23,956,1138,0,0,84.01,648,285,"景南里",NULL
673,1304,31,1335,1625,0,0,82.15,864,440,"景南里",NULL
674,707,18,725,876,0,0,82.76,401,306,"景本里",NULL
675,842,38,880,1075,0,0,81.86,534,308,"景本里",NULL
676,247,15,262,322,0,0,81.37,122,125,"橫路里",NULL
677,1091,28,1119,1363,0,0,82.1,721,370,"內南里",NULL
678,1098,24,1122,1370,0,0,81.9,749,349,"內南里",NULL
679,1178,37,1215,1501,0,0,80.95,771,407,"內南里",NULL
680,1124,20,1144,1399,0,0,81.77,727,397,"壽南里",NULL
681,655,9,664,817,0,0,81.27,378,277,"壽南里",NULL
682,1288,40,1328,1633,0,0,81.32,932,356,"福南里",NULL
683,1222,50,1272,1570,0,0,81.02,863,359,"福南里",NULL
684,1370,31,1401,1734,0,0,80.8,889,481,"外南里",NULL
685,1401,24,1425,2173,0,0,65.58,871,530,"外南里",NULL
686,1166,26,1192,1422,0,0,83.83,786,380,"中興里",NULL
687,1020,18,1038,1302,0,0,79.72,636,384,"中興里",NULL
688,933,24,957,1152,0,0,83.07,533,400,"中興里",NULL
689,874,20,894,1059,0,0,84.42,574,300,"吉興里",NULL
690,797,16,813,979,0,0,83.04,497,300,"吉興里",NULL
691,1361,28,1389,1661,0,0,83.62,1006,355,"復興里",NULL
692,1213,38,1251,1564,0,0,79.99,754,459,"復興里",NULL
693,1127,26,1153,1400,0,0,82.36,671,456,"復興里",NULL
694,1620,25,1645,1989,0,0,82.7,1102,518,"和興里",NULL
695,1375,46,1421,1740,0,0,81.67,821,554,"和興里",NULL
696,1334,27,1361,1729,0,0,78.72,890,444,"景平里",NULL
697,1743,40,1783,2197,0,0,81.16,1152,591,"景平里",NULL
698,1223,45,1268,1584,0,0,80.05,764,459,"景新里",NULL
699,1261,33,1294,1563,0,0,82.79,814,447,"景新里",NULL
700,1270,21,1291,1590,0,0,81.19,837,433,"景福里",NULL
701,968,22,990,1212,0,0,81.68,664,304,"景福里",NULL
702,1196,16,1212,1488,0,0,81.45,760,436,"景福里",NULL
703,622,22,644,780,0,0,82.56,381,241,"景安里",NULL
704,974,19,993,1201,0,0,82.68,730,244,"景安里",NULL
705,1029,42,1071,1288,0,0,83.15,635,394,"景安里",NULL
706,770,17,787,960,0,0,81.98,486,284,"景安里",NULL
707,1277,22,1299,1522,0,0,85.35,831,446,"景文里",NULL
708,885,23,908,1078,0,0,84.23,529,356,"景文里",NULL
709,1738,34,1772,2129,0,0,83.23,1000,738,"錦和里",NULL
710,1435,25,1460,1752,0,0,83.33,826,609,"錦和里",NULL
711,1400,36,1436,1742,0,0,82.43,789,611,"錦中里",NULL
712,1091,26,1117,1338,0,0,83.48,579,512,"錦中里",NULL
713,1153,27,1180,1418,0,0,83.22,774,379,"錦昌里",NULL
714,1481,42,1523,1848,0,0,82.41,794,687,"錦盛里",NULL
715,1091,28,1119,1340,0,0,83.51,641,450,"錦盛里",NULL
716,401,14,415,516,0,0,80.43,190,211,"灰窯里",NULL
717,1539,45,1584,1990,0,0,79.6,729,810,"積穗里",NULL
718,1621,44,1665,1997,0,0,83.38,918,703,"積穗里",NULL
719,488,5,493,590,0,0,83.56,285,203,"積穗里",NULL
720,862,34,896,1044,0,0,85.82,445,417,"民享里",NULL
721,978,22,1000,1160,0,0,86.21,488,490,"民享里",NULL
722,1110,30,1140,1394,0,0,81.78,658,452,"民有里",NULL
723,1001,30,1031,1222,0,0,84.37,496,505,"民有里",NULL
724,1041,37,1078,1284,0,0,83.96,531,510,"員山里",NULL
725,1235,32,1267,1563,0,0,81.06,619,616,"員山里",NULL
726,631,11,642,772,0,0,83.16,349,282,"員山里",NULL
727,568,16,584,996,0,0,58.63,308,260,"員富里",NULL
728,1108,37,1145,1462,0,0,78.32,466,642,"員富里",NULL
729,1016,17,1033,1221,0,0,84.6,571,445,"嘉穗里",NULL
730,795,17,812,993,0,0,81.77,425,370,"嘉穗里",NULL
731,1256,27,1283,1595,0,0,80.44,693,563,"嘉慶里",NULL
732,1404,43,1447,1779,0,0,81.34,755,649,"嘉慶里",NULL
733,1017,32,1049,1258,0,0,83.39,503,514,"文元里",NULL
734,1297,36,1333,1644,0,0,81.08,623,674,"文元里",NULL
735,1441,37,1478,1775,0,0,83.27,799,642,"文元里",NULL
736,1139,34,1173,1450,0,0,80.9,616,523,"嘉新里",NULL
737,1313,22,1335,1621,0,0,82.36,735,578,"嘉新里",NULL
738,1121,28,1149,1386,0,0,82.9,561,560,"民安里",NULL
739,922,28,950,1141,0,0,83.26,488,434,"民安里",NULL
740,996,21,1017,1239,0,0,82.08,535,461,"民安里",NULL
741,1121,33,1154,1395,0,0,82.72,526,595,"安穗里",NULL
742,1327,51,1378,1675,0,0,82.27,640,687,"安穗里",NULL
743,710,21,731,893,0,0,81.86,386,324,"瑞穗里",NULL
744,767,17,784,940,0,0,83.4,516,251,"瑞穗里",NULL
745,1287,35,1322,1636,0,0,80.81,665,622,"冠穗里",NULL
746,1123,16,1139,1339,0,0,85.06,631,492,"冠穗里",NULL
747,1356,25,1381,1645,0,0,83.95,697,659,"明穗里",NULL
748,1391,20,1411,1723,0,0,81.89,739,652,"明穗里",NULL
749,1122,33,1155,1404,0,0,82.26,560,562,"清穗里",NULL
750,1112,31,1143,1389,0,0,82.29,592,520,"清穗里",NULL
751,890,18,908,1125,0,0,80.71,443,447,"自強里",NULL
752,1286,27,1313,1580,0,0,83.1,598,688,"自強里",NULL
753,1099,28,1127,1358,0,0,82.99,625,474,"自強里",NULL
754,1140,10,1150,1383,0,0,83.15,721,419,"德穗里",NULL
755,939,35,974,1198,0,0,81.3,501,438,"德穗里",NULL
756,904,20,924,1113,0,0,83.02,454,450,"德穗里",NULL
757,1121,32,1153,1366,0,0,84.41,591,530,"民生里",NULL
758,1765,40,1805,2160,0,0,83.56,964,801,"民生里",NULL
759,1414,42,1456,1781,0,0,81.75,707,707,"國光里",NULL
760,1084,17,1101,1315,0,0,83.73,629,455,"國光里",NULL
761,865,37,902,1096,0,0,82.3,401,464,"國華里",NULL
762,1204,34,1238,1528,0,0,81.02,620,584,"國華里",NULL
763,731,20,751,892,0,0,84.19,425,306,"壽德里",NULL
764,1984,53,2037,2381,0,0,85.55,1641,343,"壽德里",NULL
765,1525,39,1564,1871,0,0,83.59,821,704,"明德里",NULL
766,1165,31,1196,1461,0,0,81.86,578,587,"明德里",NULL
767,1176,25,1201,1484,0,0,80.93,784,392,"光復里",NULL
768,837,23,860,1068,0,0,80.52,572,265,"網溪里",NULL
769,717,24,741,928,0,0,79.85,486,231,"復興里",NULL
770,1005,20,1025,1266,0,0,80.96,709,296,"復興里",NULL
771,1355,37,1392,1687,0,0,82.51,881,474,"竹林里",NULL
772,1325,35,1360,1709,0,0,79.58,916,409,"竹林里",NULL
773,1322,28,1350,1656,0,0,81.52,925,397,"桂林里",NULL
774,1226,33,1259,1548,0,0,81.33,877,349,"桂林里",NULL
775,1245,29,1274,1592,0,0,80.03,868,377,"上林里",NULL
776,1262,26,1288,1584,0,0,81.31,921,341,"上林里",NULL
777,1234,20,1254,1536,0,0,81.64,782,452,"福林里",NULL
778,1245,16,1261,1525,0,0,82.69,810,435,"福林里",NULL
779,862,16,878,1081,0,0,81.22,499,363,"勵行里",NULL
780,889,19,908,1123,0,0,80.85,562,327,"中興里",NULL
781,1186,28,1214,1521,0,0,79.82,813,373,"中興里",NULL
782,1185,43,1228,1482,0,0,82.86,812,373,"永興里",NULL
783,1134,37,1171,1454,0,0,80.54,765,369,"永興里",NULL
784,866,19,885,1086,0,0,81.49,557,309,"正興里",NULL
785,752,14,766,953,0,0,80.38,523,229,"正興里",NULL
786,1300,28,1328,1640,0,0,80.98,871,429,"豫溪里",NULL
787,1231,16,1247,2112,0,0,59.04,859,372,"豫溪里",NULL
788,1066,28,1094,1303,0,0,83.96,738,328,"光明里",NULL
789,1093,17,1110,1418,0,0,78.28,720,373,"光明里",NULL
790,1001,13,1014,1273,0,0,79.65,711,290,"福和里",NULL
791,1345,17,1362,1661,0,0,82,897,448,"福和里",NULL
792,917,9,926,1144,0,0,80.94,648,269,"福和里",NULL
793,1120,21,1141,1373,0,0,83.1,760,360,"得和里",NULL
794,1031,11,1042,1232,0,0,84.58,742,289,"得和里",NULL
795,936,22,958,1128,0,0,84.93,629,307,"得和里",NULL
796,1304,20,1324,1620,0,0,81.73,869,435,"永貞里",NULL
797,1211,27,1238,1471,0,0,84.16,757,454,"永貞里",NULL
798,1067,21,1088,1317,0,0,82.61,718,349,"永福里",NULL
799,1029,15,1044,1261,0,0,82.79,696,333,"永福里",NULL
800,1032,28,1060,1283,0,0,82.62,652,380,"河濱里",NULL
801,941,19,960,1192,0,0,80.54,611,330,"河濱里",NULL
802,1597,34,1631,1909,0,0,85.44,969,628,"秀和里",NULL
803,735,11,746,900,0,0,82.89,476,259,"秀和里",NULL
804,928,15,943,1141,0,0,82.65,592,336,"秀和里",NULL
805,1096,23,1119,1342,0,0,83.38,721,375,"永元里",NULL
806,1007,22,1029,1231,0,0,83.59,655,352,"永元里",NULL
807,1194,27,1221,1476,0,0,82.72,742,452,"永元里",NULL
808,1071,25,1096,1327,0,0,82.59,713,358,"民權里",NULL
809,1163,18,1181,1374,0,0,85.95,810,353,"民權里",NULL
810,903,23,926,1120,0,0,82.68,574,329,"民權里",NULL
811,943,19,962,1174,0,0,81.94,646,297,"民族里",NULL
812,1175,18,1193,1420,0,0,84.01,795,380,"民族里",NULL
813,947,17,964,1181,0,0,81.63,667,280,"民族里",NULL
814,1331,43,1374,1707,0,0,80.49,875,456,"秀朗里",NULL
815,1330,32,1362,1654,0,0,82.35,759,571,"秀朗里",NULL
816,814,16,830,1043,0,0,79.58,495,319,"秀成里",NULL
817,1227,22,1249,1476,0,0,84.62,768,459,"秀成里",NULL
818,1356,30,1386,1648,0,0,84.1,808,548,"秀林里",NULL
819,1036,31,1067,1285,0,0,83.04,607,429,"秀林里",NULL
820,928,14,942,1134,0,0,83.07,616,312,"秀得里",NULL
821,947,19,966,1156,0,0,83.56,562,385,"秀得里",NULL
822,1152,20,1172,1401,0,0,83.65,716,436,"秀元里",NULL
823,1103,11,1114,1342,0,0,83.01,714,389,"秀元里",NULL
824,881,15,896,1090,0,0,82.2,567,314,"民生里",NULL
825,1105,22,1127,1323,0,0,85.19,681,424,"民生里",NULL
826,874,19,893,1055,0,0,84.64,549,325,"民生里",NULL
827,969,22,991,1206,0,0,82.17,603,366,"民本里",NULL
828,1068,30,1098,1334,0,0,82.31,707,361,"民本里",NULL
829,1139,16,1155,1361,0,0,84.86,690,449,"民富里",NULL
830,995,17,1012,1181,0,0,85.69,668,327,"民富里",NULL
831,1260,22,1282,1564,0,0,81.97,896,364,"民樂里",NULL
832,1790,43,1833,2191,0,0,83.66,1229,561,"民樂里",NULL
833,1025,30,1055,1290,0,0,81.78,713,312,"民治里",NULL
834,1054,30,1084,1326,0,0,81.75,729,325,"民治里",NULL
835,1141,38,1179,1459,0,0,80.81,814,327,"智光里",NULL
836,1210,15,1225,1493,0,0,82.05,817,393,"智光里",NULL
837,1423,24,1447,1742,0,0,83.07,938,485,"潭安里",NULL
838,937,14,951,1169,0,0,81.35,659,278,"潭安里",NULL
839,866,11,877,1095,0,0,80.09,597,269,"潭安里",NULL
840,736,15,751,925,0,0,81.19,532,204,"潭墘里",NULL
841,1013,14,1027,1254,0,0,81.9,690,323,"潭墘里",NULL
842,1137,34,1171,1443,0,0,81.15,820,317,"潭墘里",NULL
843,1258,22,1280,1561,0,0,82,815,443,"店街里",NULL
844,1350,24,1374,1717,0,0,80.02,936,414,"店街里",NULL
845,895,9,904,1076,0,0,84.01,590,305,"大新里",NULL
846,876,29,905,1098,0,0,82.42,610,266,"大新里",NULL
847,1299,28,1327,1627,0,0,81.56,828,471,"永安里",NULL
848,1616,15,1631,1938,0,0,84.16,1097,519,"永安里",NULL
849,837,20,857,1057,0,0,81.08,546,291,"永樂里",NULL
850,852,21,873,1071,0,0,81.51,526,326,"永樂里",NULL
851,1439,23,1462,1803,0,0,81.09,1048,391,"水源里",NULL
852,1367,21,1388,1676,0,0,82.82,855,512,"水源里",NULL
853,1045,23,1068,1289,0,0,82.85,647,398,"協和里",NULL
854,1099,20,1119,1359,0,0,82.34,703,396,"協和里",NULL
855,1482,41,1523,1836,0,0,82.95,1045,437,"雙和里",NULL
856,1189,29,1218,1439,0,0,84.64,735,454,"雙和里",NULL
857,1279,20,1299,1592,0,0,81.6,841,438,"安和里",NULL
858,1250,24,1274,1532,0,0,83.16,912,338,"安和里",NULL
859,1392,12,1404,1761,0,0,79.73,927,465,"前溪里",NULL
860,1490,34,1524,1820,0,0,83.74,913,577,"和平里",NULL
861,1534,34,1568,1894,0,0,82.79,960,574,"和平里",NULL
862,1765,29,1794,2160,0,0,83.06,1100,665,"保平里",NULL
863,1378,42,1420,1706,0,0,83.24,786,592,"保平里",NULL
864,1173,16,1189,1429,0,0,83.21,748,425,"中溪里",NULL
865,1008,25,1033,1249,0,0,82.71,633,375,"中溪里",NULL
866,1235,38,1273,1500,0,0,84.87,671,564,"中溪里",NULL
867,1448,34,1482,1800,0,0,82.33,805,643,"保安里",NULL
868,1111,14,1125,1314,0,0,85.62,766,345,"保安里",NULL
869,1901,29,1930,2241,0,0,86.12,1280,621,"保安里",NULL
870,1297,27,1324,1587,0,0,83.43,740,557,"保順里",NULL
871,1380,14,1394,1656,0,0,84.18,951,429,"保順里",NULL
872,1537,21,1558,1887,0,0,82.56,1092,445,"保順里",NULL
873,1221,51,1272,1546,0,0,82.28,717,504,"下溪里",NULL
874,1408,31,1439,1752,0,0,82.13,854,554,"下溪里",NULL
875,723,39,762,903,0,0,84.39,560,163,"大同里",NULL
876,591,32,623,789,0,0,78.96,435,156,"新生里",NULL
877,714,34,748,956,0,0,78.24,637,77,"永成里",NULL
878,583,18,601,714,0,0,84.17,496,87,"忠義里",NULL
879,864,23,887,1061,0,0,83.6,600,264,"文化里",NULL
880,1063,38,1101,1353,0,0,81.37,724,339,"文化里",NULL
881,811,13,824,1018,0,0,80.94,515,296,"仁愛里",NULL
882,967,21,988,1214,0,0,81.38,601,366,"仁愛里",NULL
883,912,8,920,1168,0,0,78.77,569,343,"信義里",NULL
884,824,15,839,1031,0,0,81.38,492,332,"信義里",NULL
885,1227,32,1259,1585,0,0,79.43,707,520,"後溪里",NULL
886,550,16,566,708,0,0,79.94,368,182,"上溪里",NULL
887,830,21,851,1053,0,0,80.82,523,307,"上溪里",NULL
888,970,11,981,1213,0,0,80.87,615,355,"頂溪里",NULL
889,855,7,862,1028,0,0,83.85,537,318,"頂溪里",NULL
890,790,16,806,968,0,0,83.26,515,275,"河堤里",NULL
891,806,17,823,1035,0,0,79.52,517,289,"河堤里",NULL
892,739,22,761,947,0,0,80.36,493,246,"新廍里",NULL
893,961,17,978,1183,0,0,82.67,647,314,"新廍里",NULL
894,980,23,1003,1215,0,0,82.55,499,481,"海山里",NULL
895,1182,30,1212,1517,0,0,79.89,516,666,"海山里",NULL
896,1444,42,1486,1754,0,0,84.72,708,736,"海山里",NULL
897,971,29,1000,1163,0,0,85.98,444,527,"全安里",NULL
898,1092,19,1111,1345,0,0,82.6,527,565,"全安里",NULL
899,746,18,764,905,0,0,84.42,350,396,"全安里",NULL
900,1219,26,1245,1486,0,0,83.78,702,517,"全泰里",NULL
901,1259,19,1278,1521,0,0,84.02,678,581,"全泰里",NULL
902,1057,10,1067,1262,0,0,84.55,547,510,"全泰里",NULL
903,921,23,944,1155,0,0,81.73,468,453,"忠孝里",NULL
904,1011,24,1035,1241,0,0,83.4,467,544,"忠孝里",NULL
905,1109,27,1136,1361,0,0,83.47,519,590,"忠孝里",NULL
906,1463,43,1506,1757,0,0,85.71,701,762,"文衡里",NULL
907,1321,32,1353,1607,0,0,84.19,711,610,"文聖里",NULL
908,1164,27,1191,1438,0,0,82.82,632,532,"文聖里",NULL
909,559,9,568,691,0,0,82.2,237,322,"興漢里",NULL
910,984,29,1013,1196,0,0,84.7,582,402,"興漢里",NULL
911,1046,17,1063,1272,0,0,83.57,547,499,"興漢里",NULL
912,887,15,902,1120,0,0,80.54,456,431,"榮和里",NULL
913,1229,30,1259,2250,0,0,55.96,676,553,"榮和里",NULL
914,1169,31,1200,1449,0,0,82.82,596,573,"文德里",NULL
915,1273,36,1309,1588,0,0,82.43,622,651,"文明里",NULL
916,972,20,992,1194,0,0,83.08,361,611,"化成里",NULL
917,806,31,837,1006,0,0,83.2,353,453,"化成里",NULL
918,1260,20,1280,1545,0,0,82.85,455,805,"頭前里",NULL
919,1345,21,1366,1708,0,0,79.98,489,856,"頭前里",NULL
920,932,24,956,1164,0,0,82.13,413,519,"福基里",NULL
921,741,18,759,900,0,0,84.33,365,376,"福基里",NULL
922,1341,20,1361,1645,0,0,82.74,641,700,"福興里",NULL
923,1197,22,1219,1460,0,0,83.49,571,626,"福興里",NULL
924,1190,22,1212,1494,0,0,81.12,630,560,"昌平里",NULL
925,1059,17,1076,1325,0,0,81.21,591,468,"昌平里",NULL
926,1055,11,1066,1304,0,0,81.75,467,588,"和平里",NULL
927,1039,18,1057,1281,0,0,82.51,422,617,"和平里",NULL
928,1135,20,1155,1336,0,0,86.45,526,609,"和平里",NULL
929,923,25,948,1159,0,0,81.79,407,516,"幸福里",NULL
930,963,28,991,1225,0,0,80.9,433,530,"幸福里",NULL
931,1017,36,1053,1300,0,0,81,392,625,"幸福里",NULL
932,1199,15,1214,1423,0,0,85.31,600,599,"昌隆里",NULL
933,1052,19,1071,1287,0,0,83.22,531,521,"昌隆里",NULL
934,1112,30,1142,1418,0,0,80.54,521,591,"信義里",NULL
935,1096,26,1122,1369,0,0,81.96,510,586,"信義里",NULL
936,1207,34,1241,1552,0,0,79.96,554,653,"信義里",NULL
937,955,15,970,1188,0,0,81.65,487,468,"昌信里",NULL
938,947,8,955,1146,0,0,83.33,496,451,"昌信里",NULL
939,1082,27,1109,1345,0,0,82.45,438,644,"昌明里",NULL
940,1135,6,1141,1332,0,0,85.66,567,568,"昌明里",NULL
941,1110,24,1134,1421,0,0,79.8,436,674,"仁義里",NULL
942,1130,32,1162,1454,0,0,79.92,480,650,"仁義里",NULL
943,930,34,964,1204,0,0,80.07,414,516,"仁愛里",NULL
944,985,13,998,1161,0,0,85.96,425,560,"仁愛里",NULL
945,564,20,584,747,0,0,78.18,239,325,"自信里",NULL
946,1037,27,1064,1285,0,0,82.8,436,601,"自信里",NULL
947,1166,13,1179,1425,0,0,82.74,513,653,"自立里",NULL
948,982,24,1006,1260,0,0,79.84,422,560,"自立里",NULL
949,1051,31,1082,1331,0,0,81.29,504,547,"自立里",NULL
950,1001,21,1022,1281,0,0,79.78,423,578,"自強里",NULL
951,895,29,924,1158,0,0,79.79,393,502,"自強里",NULL
952,1165,21,1186,1462,0,0,81.12,509,656,"思源里",NULL
953,1250,13,1263,1538,0,0,82.12,535,715,"思源里",NULL
954,1070,21,1091,1331,0,0,81.97,443,627,"思源里",NULL
955,1411,34,1445,1758,0,0,82.2,644,767,"思賢里",NULL
956,1167,42,1209,1443,0,0,83.78,530,637,"思賢里",NULL
957,1263,19,1282,1590,0,0,80.63,530,733,"中華里",NULL
958,1293,33,1326,1587,0,0,83.55,615,678,"中美里",NULL
959,1256,30,1286,1547,0,0,83.13,640,616,"中美里",NULL
960,1242,33,1275,1577,0,0,80.85,533,709,"中美里",NULL
961,1056,26,1082,1279,0,0,84.6,528,528,"恆安里",NULL
962,1026,22,1048,1287,0,0,81.43,526,500,"恆安里",NULL
963,939,18,957,1157,0,0,82.71,486,453,"恆安里",NULL
964,1438,36,1474,1729,0,0,85.25,900,538,"立人里",NULL
965,920,14,934,1105,0,0,84.52,501,419,"立德里",NULL
966,915,21,936,1124,0,0,83.27,438,477,"立德里",NULL
967,921,23,944,1171,0,0,80.61,445,476,"中和里",NULL
968,1116,15,1131,1348,0,0,83.9,469,647,"中和里",NULL
969,1008,24,1032,1242,0,0,83.09,436,572,"中和里",NULL
970,1063,25,1088,1299,0,0,83.76,434,629,"中泰里",NULL
971,1043,25,1068,1276,0,0,83.7,425,618,"中泰里",NULL
972,1069,19,1088,1307,0,0,83.24,494,575,"中泰里",NULL
973,1002,17,1019,1272,0,0,80.11,448,554,"中宏里",NULL
974,1197,19,1216,1448,0,0,83.98,565,632,"中宏里",NULL
975,1184,25,1209,1455,0,0,83.09,511,673,"中全里",NULL
976,1127,14,1141,1412,0,0,80.81,421,706,"中全里",NULL
977,1178,33,1211,1478,0,0,81.94,488,690,"立志里",NULL
978,1342,20,1362,1625,0,0,83.82,597,745,"立志里",NULL
979,883,18,901,1073,0,0,83.97,404,479,"立廷里",NULL
980,1063,16,1079,1319,0,0,81.8,480,583,"立廷里",NULL
981,1464,27,1491,1789,0,0,83.34,730,734,"立基里",NULL
982,1105,15,1120,1375,0,0,81.45,555,550,"立基里",NULL
983,1154,17,1171,1423,0,0,82.29,607,547,"立基里",NULL
984,1382,34,1416,1769,0,0,80.05,554,828,"中誠里",NULL
985,1257,21,1278,1546,0,0,82.66,566,691,"中港里",NULL
986,1259,19,1278,1544,0,0,82.77,588,671,"中港里",NULL
987,1294,20,1314,1560,0,0,84.23,706,588,"中港里",NULL
988,1033,22,1055,1301,0,0,81.09,424,609,"中信里",NULL
989,1217,22,1239,1495,0,0,82.88,540,677,"中信里",NULL
990,1351,24,1375,1686,0,0,81.55,631,720,"中信里",NULL
991,1025,21,1046,1251,0,0,83.61,517,508,"中信里",NULL
992,1473,23,1496,1815,0,0,82.42,821,652,"中平里",NULL
993,1462,25,1487,1836,0,0,80.99,846,616,"中平里",NULL
994,1579,14,1593,1946,0,0,81.86,838,741,"中平里",NULL
995,1592,35,1627,1990,0,0,81.76,758,834,"中原里",NULL
996,1502,15,1517,1843,0,0,82.31,734,768,"中原里",NULL
997,1593,24,1617,1918,0,0,84.31,743,850,"中原里",NULL
998,1191,10,1201,1443,0,0,83.23,597,594,"中隆里",NULL
999,974,21,995,1295,0,0,76.83,422,552,"中隆里",NULL
1000,1235,41,1276,1560,0,0,81.79,572,663,"立功里",NULL
1001,1273,25,1298,1582,0,0,82.05,569,704,"立功里",NULL
1002,1095,28,1123,1342,0,0,83.68,536,559,"立泰里",NULL
1003,927,19,946,1150,0,0,82.26,477,450,"立泰里",NULL
1004,1019,30,1049,1288,0,0,81.44,474,545,"立泰里",NULL
1005,1056,18,1074,1310,0,0,81.98,491,565,"立言里",NULL
1006,1004,8,1012,1202,0,0,84.19,524,480,"立言里",NULL
1007,1162,17,1179,1451,0,0,81.25,589,573,"立言里",NULL
1008,1291,23,1314,1604,0,0,81.92,621,670,"豐年里",NULL
1009,1179,17,1196,1450,0,0,82.48,509,670,"豐年里",NULL
1010,1148,36,1184,1421,0,0,83.32,559,589,"國泰里",NULL
1011,906,24,930,1149,0,0,80.94,467,439,"泰豐里",NULL
1012,723,13,736,884,0,0,83.26,403,320,"泰豐里",NULL
1013,1337,34,1371,1686,0,0,81.32,550,787,"瓊林里",NULL
1014,1141,40,1181,1469,0,0,80.39,520,621,"瓊林里",NULL
1015,1138,29,1167,1467,0,0,79.55,479,659,"瓊林里",NULL
1016,839,20,859,1054,0,0,81.5,395,444,"福營里",NULL
1017,800,23,823,962,0,0,85.55,337,463,"福營里",NULL
1018,750,27,777,939,0,0,82.75,350,400,"營盤里",NULL
1019,830,15,845,1009,0,0,83.75,382,448,"營盤里",NULL
1020,1232,45,1277,1585,0,0,80.57,649,583,"丹鳳里",NULL
1021,1482,32,1514,1883,0,0,80.4,692,790,"丹鳳里",NULL
1022,1463,42,1505,1939,0,0,77.62,800,663,"丹鳳里",NULL
1023,860,24,884,1131,0,0,78.16,409,451,"合鳳里",NULL
1024,938,8,946,1217,0,0,77.73,463,475,"合鳳里",NULL
1025,1039,24,1063,1301,0,0,81.71,490,549,"合鳳里",NULL
1026,1443,35,1478,1784,0,0,82.85,716,727,"祥鳳里",NULL
1027,1314,25,1339,1688,0,0,79.32,580,734,"雙鳳里",NULL
1028,1650,34,1684,2120,0,0,79.43,831,819,"雙鳳里",NULL
1029,422,3,425,516,0,0,82.36,216,206,"雙鳳里",NULL
1030,1214,27,1241,1552,0,0,79.96,640,574,"龍福里",NULL
1031,1188,28,1216,1498,0,0,81.17,528,660,"龍鳳里",NULL
1032,1057,22,1079,1321,0,0,81.68,493,564,"龍鳳里",NULL
1033,1227,21,1248,1511,0,0,82.59,630,597,"龍鳳里",NULL
1034,1006,29,1035,1274,0,0,81.24,467,539,"裕民里",NULL
1035,1101,31,1132,1381,0,0,81.97,470,631,"裕民里",NULL
1036,1063,27,1090,1348,0,0,80.86,499,564,"裕民里",NULL
1037,845,12,857,1064,0,0,80.55,415,430,"裕民里",NULL
1038,723,17,740,932,0,0,79.4,340,383,"龍安里",NULL
1039,800,21,821,1016,0,0,80.81,397,403,"龍安里",NULL
1040,794,11,805,998,0,0,80.66,319,475,"富國里",NULL
1041,862,21,883,1065,0,0,82.91,395,467,"富國里",NULL
1042,1097,24,1121,1379,0,0,81.29,507,590,"富民里",NULL
1043,1033,33,1066,1313,0,0,81.19,536,497,"富民里",NULL
1044,868,11,879,1063,0,0,82.69,417,451,"後德里",NULL
1045,958,15,973,1181,0,0,82.39,512,446,"後德里",NULL
1046,1059,26,1085,1345,0,0,80.67,507,552,"萬安里",NULL
1047,1033,27,1060,1307,0,0,81.1,471,562,"萬安里",NULL
1048,750,17,767,932,0,0,82.3,367,383,"建福里",NULL
1049,841,17,858,1052,0,0,81.56,399,442,"建福里",NULL
1050,990,26,1016,1259,0,0,80.7,448,542,"後港里",NULL
1051,1017,23,1040,1265,0,0,82.21,473,544,"後港里",NULL
1052,1033,19,1052,1283,0,0,82,524,509,"後港里",NULL
1053,989,15,1004,1181,0,0,85.01,518,471,"後港里",NULL
1054,938,12,950,1218,0,0,78,443,495,"四維里",NULL
1055,1012,22,1034,1326,0,0,77.98,409,603,"四維里",NULL
1056,1019,19,1038,1300,0,0,79.85,429,590,"四維里",NULL
1057,1007,25,1032,1278,0,0,80.75,488,519,"南港里",NULL
1058,1383,23,1406,1760,0,0,79.89,665,718,"南港里",NULL
1059,688,7,695,834,0,0,83.33,342,346,"南港里",NULL
1060,1209,17,1226,1500,0,0,81.73,615,594,"建安里",NULL
1061,1247,16,1263,1524,0,0,82.87,614,633,"建安里",NULL
1062,1174,15,1189,1454,0,0,81.77,586,588,"建安里",NULL
1063,943,10,953,1171,0,0,81.38,446,497,"民全里",NULL
1064,993,23,1016,1232,0,0,82.47,480,513,"民全里",NULL
1065,994,23,1017,1252,0,0,81.23,400,594,"民本里",NULL
1066,954,26,980,1236,0,0,79.29,421,533,"民本里",NULL
1067,1045,22,1067,1322,0,0,80.71,505,540,"八德里",NULL
1068,961,16,977,1201,0,0,81.35,479,482,"八德里",NULL
1069,1074,27,1101,1364,0,0,80.72,469,605,"民安里",NULL
1070,945,28,973,1223,0,0,79.56,517,428,"民安里",NULL
1071,946,23,969,1158,0,0,83.68,471,475,"民安里",NULL
1072,1227,34,1261,1584,0,0,79.61,510,717,"成德里",NULL
1073,1633,20,1653,2046,0,0,80.79,827,806,"成德里",NULL
1074,1199,30,1229,1526,0,0,80.54,532,667,"光明里",NULL
1075,1138,27,1165,1460,0,0,79.79,531,607,"光明里",NULL
1076,1132,25,1157,1470,0,0,78.71,580,552,"光華里",NULL
1077,1076,26,1102,1446,0,0,76.21,522,554,"光華里",NULL
1078,1178,39,1217,1560,0,0,78.01,555,623,"光華里",NULL
1079,1177,26,1203,1463,0,0,82.23,621,556,"光榮里",NULL
1080,1157,19,1176,1444,0,0,81.44,532,625,"光榮里",NULL
1081,1202,25,1227,1477,0,0,83.07,548,654,"光正里",NULL
1082,1011,34,1045,1252,0,0,83.47,455,556,"光正里",NULL
1083,792,14,806,976,0,0,82.58,358,434,"光和里",NULL
1084,775,16,791,977,0,0,80.96,341,434,"光和里",NULL
1085,1056,21,1077,1336,0,0,80.61,557,499,"民有里",NULL
1086,1155,19,1174,1461,0,0,80.36,537,618,"民有里",NULL
1087,1024,29,1053,1255,0,0,83.9,420,604,"西盛里",NULL
1088,1302,39,1341,1697,0,0,79.02,601,701,"西盛里",NULL
1089,1075,24,1099,1332,0,0,82.51,475,600,"西盛里",NULL
1090,1160,42,1202,1461,0,0,82.27,579,581,"新店里",NULL
1091,877,26,903,1113,0,0,81.13,469,408,"張南里",NULL
1092,1022,48,1070,1333,0,0,80.27,600,422,"國校里",NULL
1093,694,4,698,907,0,0,76.96,474,220,"國校里",NULL
1094,1084,33,1117,1414,0,0,79,736,348,"文中里",NULL
1095,578,24,602,704,0,0,85.51,256,322,"廣明里",NULL
1096,875,27,902,1045,0,0,86.32,467,408,"文明里",NULL
1097,905,11,916,1073,0,0,85.37,581,324,"文明里",NULL
1098,1396,36,1432,1741,0,0,82.25,1036,360,"中興里",NULL
1099,1065,13,1078,1987,0,0,54.25,762,303,"中興里",NULL
1100,1319,21,1340,1660,0,0,80.72,894,425,"中興里",NULL
1101,1518,27,1545,1843,0,0,83.83,1145,373,"新生里",NULL
1102,1217,26,1243,1514,0,0,82.1,749,468,"新生里",NULL
1103,1183,21,1204,1480,0,0,81.35,795,388,"新生里",NULL
1104,903,25,928,1149,0,0,80.77,516,387,"新德里",NULL
1105,925,17,942,1138,0,0,82.78,596,329,"新德里",NULL
1106,1092,35,1127,1422,0,0,79.25,712,380,"張北里",NULL
1107,1156,15,1171,1444,0,0,81.09,744,412,"張北里",NULL
1108,1095,32,1127,1413,0,0,79.76,757,338,"張北里",NULL
1109,1006,11,1017,1247,0,0,81.56,761,245,"張北里",NULL
1110,1115,20,1135,1399,0,0,81.13,820,295,"五峰里",NULL
1111,1283,25,1308,1568,0,0,83.42,869,414,"五峰里",NULL
1112,1234,19,1253,1504,0,0,83.31,922,312,"五峰里",NULL
1113,1127,29,1156,1402,0,0,82.45,710,417,"五峰里",NULL
1114,878,11,889,1047,0,0,84.91,653,225,"長春里",NULL
1115,754,8,762,935,0,0,81.5,562,192,"長春里",NULL
1116,1170,23,1193,1421,0,0,83.95,804,366,"新安里",NULL
1117,1243,28,1271,1583,0,0,80.29,905,338,"新安里",NULL
1118,938,19,957,1147,0,0,83.44,641,297,"忠誠里",NULL
1119,901,15,916,1086,0,0,84.35,626,275,"忠誠里",NULL
1120,1011,21,1032,1224,0,0,84.31,657,354,"中正里",NULL
1121,1251,21,1272,1553,0,0,81.91,808,443,"中正里",NULL
1122,1293,28,1321,1666,0,0,79.29,863,430,"中正里",NULL
1123,1040,17,1057,1334,0,0,79.24,842,198,"中正里",NULL
1124,813,17,830,1040,0,0,79.81,628,185,"中華里",NULL
1125,914,16,930,1123,0,0,82.81,675,239,"中華里",NULL
1126,796,25,821,1009,0,0,81.37,565,231,"中華里",NULL
1127,924,10,934,1126,0,0,82.95,622,302,"仁愛里",NULL
1128,773,23,796,977,0,0,81.47,609,164,"仁愛里",NULL
1129,859,13,872,1041,0,0,83.77,621,238,"建國里",NULL
1130,1200,17,1217,1487,0,0,81.84,917,283,"建國里",NULL
1131,782,20,802,962,0,0,83.37,536,246,"百忍里",NULL
1132,924,14,938,1124,0,0,83.45,667,257,"百忍里",NULL
1133,1073,31,1104,1316,0,0,83.89,767,306,"百忍里",NULL
1134,1041,22,1063,1262,0,0,84.23,707,334,"百和里",NULL
1135,1270,22,1292,1551,0,0,83.3,864,406,"百和里",NULL
1136,1127,18,1145,1402,0,0,81.67,767,360,"福德里",NULL
1137,764,7,771,921,0,0,83.71,523,241,"福德里",NULL
1138,841,12,853,1040,0,0,82.02,631,210,"福德里",NULL
1139,984,15,999,1187,0,0,84.16,651,333,"百福里",NULL
1140,1081,29,1110,1352,0,0,82.1,776,305,"百福里",NULL
1141,1295,27,1322,1622,0,0,81.5,1029,266,"福民里",NULL
1142,1464,38,1502,1839,0,0,81.67,1121,343,"福民里",NULL
1143,435,17,452,533,0,0,84.8,140,295,"中山里",NULL
1144,1425,38,1463,1851,0,0,79.04,1106,319,"中山里",NULL
1145,659,35,694,833,0,0,83.31,476,183,"和平里",NULL
1146,1508,20,1528,1831,0,0,83.45,1064,444,"中央里",NULL
1147,1432,13,1445,1754,0,0,82.38,1060,372,"中央里",NULL
1148,844,10,854,1042,0,0,81.96,619,225,"國豐里",NULL
1149,750,22,772,953,0,0,81.01,576,174,"國豐里",NULL
1150,813,16,829,1015,0,0,81.67,611,202,"國豐里",NULL
1151,992,20,1012,1228,0,0,82.41,650,342,"明德里",NULL
1152,881,19,900,1082,0,0,83.18,564,317,"明德里",NULL
1153,1063,21,1084,1308,0,0,82.87,699,364,"明德里",NULL
1154,1307,27,1334,1624,0,0,82.14,874,433,"大豐里",NULL
1155,1267,15,1282,1542,0,0,83.14,853,414,"大豐里",NULL
1156,1423,11,1434,1709,0,0,83.91,868,555,"大同里",NULL
1157,1336,30,1366,1609,0,0,84.9,877,459,"大同里",NULL
1158,996,20,1016,1224,0,0,83.01,671,325,"江陵里",NULL
1159,1016,14,1030,1234,0,0,83.47,734,282,"江陵里",NULL
1160,1153,17,1170,1400,0,0,83.57,767,386,"江陵里",NULL
1161,1164,24,1188,1498,0,0,79.31,648,516,"復興里",NULL
1162,1280,28,1308,1610,0,0,81.24,825,455,"復興里",NULL
1163,939,20,959,1156,0,0,82.96,679,260,"寶興里",NULL
1164,1120,22,1142,1392,0,0,82.04,703,417,"寶興里",NULL
1165,1001,31,1032,1253,0,0,82.36,639,362,"寶興里",NULL
1166,984,19,1003,1234,0,0,81.28,614,370,"寶福里",NULL
1167,1476,35,1511,1825,0,0,82.79,988,488,"寶福里",NULL
1168,1159,22,1181,1421,0,0,83.11,867,292,"寶福里",NULL
1169,897,23,920,1168,0,0,78.77,618,279,"寶安里",NULL
1170,1384,24,1408,1702,0,0,82.73,1006,378,"寶安里",NULL
1171,1412,31,1443,1731,0,0,83.36,976,436,"寶安里",NULL
1172,1067,11,1078,1300,0,0,82.92,748,319,"信義里",NULL
1173,956,28,984,1169,0,0,84.17,600,356,"信義里",NULL
1174,1301,29,1330,1620,0,0,82.1,835,466,"信義里",NULL
1175,1160,19,1179,1452,0,0,81.2,688,472,"信義里",NULL
1176,1412,34,1446,1731,0,0,83.54,1063,349,"忠孝里",NULL
1177,748,20,768,943,0,0,81.44,505,243,"忠孝里",NULL
1178,1414,16,1430,1657,0,0,86.3,1293,121,"大鵬里",NULL
1179,1129,35,1164,1440,0,0,80.83,707,422,"太平里",NULL
1180,898,25,923,1128,0,0,81.83,674,224,"太平里",NULL
1181,875,18,893,1059,0,0,84.32,598,277,"美城里",NULL
1182,865,21,886,1078,0,0,82.19,608,257,"美城里",NULL
1183,1030,50,1080,1381,0,0,78.2,616,414,"頂城里",NULL
1184,1421,48,1469,1789,0,0,82.11,800,621,"下城里",NULL
1185,1066,28,1094,1328,0,0,82.38,735,331,"柴埕里",NULL
1186,1175,33,1208,1452,0,0,83.2,773,402,"柴埕里",NULL
1187,1322,53,1375,1673,0,0,82.19,712,610,"柴埕里",NULL
1188,1281,19,1300,1583,0,0,82.12,784,497,"柴埕里",NULL
1189,1045,23,1068,1302,0,0,82.03,676,369,"安和里",NULL
1190,1270,29,1299,1550,0,0,83.81,790,480,"安和里",NULL
1191,1005,34,1039,1303,0,0,79.74,563,442,"安和里",NULL
1192,1171,35,1206,1448,0,0,83.29,731,440,"永安里",NULL
1193,1101,21,1122,1390,0,0,80.72,653,448,"永安里",NULL
1194,1014,12,1026,1247,0,0,82.28,595,419,"永安里",NULL
1195,1299,20,1319,1596,0,0,82.64,946,353,"新和里",NULL
1196,1264,23,1287,1546,0,0,83.25,852,412,"新和里",NULL
1197,857,12,869,1070,0,0,81.21,536,321,"永平里",NULL
1198,1058,22,1080,1299,0,0,83.14,743,315,"永平里",NULL
1199,1333,40,1373,1659,0,0,82.76,783,550,"永平里",NULL
1200,1372,29,1401,1755,0,0,79.83,836,536,"公崙里",NULL
1201,1344,29,1373,1645,0,0,83.47,765,579,"公崙里",NULL
1202,1339,27,1366,1727,0,0,79.1,812,527,"公崙里",NULL
1203,1268,20,1288,1610,0,0,80,913,355,"公崙里",NULL
1204,1265,23,1288,1568,0,0,82.14,814,451,"安昌里",NULL
1205,1313,5,1318,1630,0,0,80.86,915,398,"安昌里",NULL
1206,1171,34,1205,1440,0,0,83.68,699,472,"德安里",NULL
1207,1291,31,1322,1601,0,0,82.57,806,485,"德安里",NULL
1208,297,17,314,366,0,0,85.79,151,146,"德安里",NULL
1209,1016,30,1046,1321,0,0,79.18,565,451,"德安里",NULL
1210,1054,16,1070,1324,0,0,80.82,776,278,"達觀里",NULL
1211,1071,8,1079,1337,0,0,80.7,781,290,"達觀里",NULL
1212,1139,11,1150,1399,0,0,82.2,860,279,"明城里",NULL
1213,927,14,941,1187,0,0,79.28,696,231,"明城里",NULL
1214,977,16,993,1168,0,0,85.02,706,271,"小城里",NULL
1215,1349,17,1366,1617,0,0,84.48,1048,301,"小城里",NULL
1216,793,21,814,1025,0,0,79.41,426,367,"雙城里",NULL
1217,701,16,717,851,0,0,84.25,376,325,"雙城里",NULL
1218,1223,32,1255,1559,0,0,80.5,757,466,"雙城里",NULL
1219,947,20,967,1203,0,0,80.38,554,393,"雙城里",NULL
1220,1499,26,1525,1871,0,0,81.51,1058,441,"香坡里",NULL
1221,1059,23,1082,1408,0,0,76.85,792,267,"香坡里",NULL
1222,1086,19,1105,1415,0,0,78.09,810,276,"香坡里",NULL
1223,1336,16,1352,1686,0,0,80.19,685,651,"日興里",NULL
1224,1036,40,1076,1348,0,0,79.82,667,369,"日興里",NULL
1225,1060,36,1096,1364,0,0,80.35,647,413,"日興里",NULL
1226,1329,17,1346,1634,0,0,82.37,962,367,"玫瑰里",NULL
1227,1229,23,1252,1515,0,0,82.64,858,371,"玫瑰里",NULL
1228,1100,11,1111,1378,0,0,80.62,797,303,"玫瑰里",NULL
1229,797,10,807,1007,0,0,80.14,615,182,"吉祥里",NULL
1230,922,24,946,1136,0,0,83.27,698,224,"吉祥里",NULL
1231,1049,28,1077,1339,0,0,80.43,804,245,"吉祥里",NULL
1232,558,27,585,732,0,0,79.92,144,414,"塗潭里",NULL
1233,1189,12,1201,1456,0,0,82.49,768,421,"華城里",NULL
1234,1548,35,1583,1916,0,0,82.62,920,628,"青潭里",NULL
1235,1617,41,1658,2015,0,0,82.28,1063,554,"青潭里",NULL
1236,1144,23,1167,1403,0,0,83.18,774,370,"美潭里",NULL
1237,1288,38,1326,1618,0,0,81.95,812,476,"美潭里",NULL
1238,828,16,844,1020,0,0,82.75,590,238,"美潭里",NULL
1239,1262,44,1306,1595,0,0,81.88,810,452,"員潭里",NULL
1240,1090,34,1124,1447,0,0,77.68,635,455,"員潭里",NULL
1241,549,24,573,780,0,0,73.46,209,340,"雙坑里",NULL
1242,317,8,325,392,0,0,82.91,136,181,"粗坑里",NULL
1243,1327,38,1365,1750,0,0,78,838,489,"粗坑里",NULL
1244,807,34,841,1015,0,0,82.86,343,464,"屈尺里",NULL
1245,888,18,906,1218,0,0,74.38,535,353,"屈尺里",NULL
1246,1051,20,1071,1374,0,0,77.95,492,559,"龜山里",NULL
1247,818,53,871,1103,0,0,78.97,263,555,"廣興里",NULL
1248,308,17,325,418,0,0,77.75,98,210,"直潭里",NULL
1249,270,9,279,328,0,0,85.06,73,197,"直潭里",NULL
1250,995,33,1028,1250,0,0,82.24,449,546,"祖田里",NULL
1251,615,17,632,766,0,0,82.51,500,115,"頂新里",NULL
1252,947,36,983,1269,0,0,77.46,531,416,"頂福里",NULL
1253,812,28,840,1034,0,0,81.24,397,415,"頂福里",NULL
1254,1081,38,1119,1341,0,0,83.45,554,527,"頂福里",NULL
1255,891,26,917,1162,0,0,78.92,436,455,"頂埔里",NULL
1256,1045,30,1075,1352,0,0,79.51,572,473,"頂埔里",NULL
1257,975,26,1001,1217,0,0,82.25,660,315,"頂埔里",NULL
1258,1073,38,1111,1354,0,0,82.05,428,645,"沛陂里",NULL
1259,951,28,979,1270,0,0,77.09,471,480,"沛陂里",NULL
1260,1078,35,1113,1386,0,0,80.3,555,523,"永寧里",NULL
1261,944,28,972,1257,0,0,77.33,505,439,"永寧里",NULL
1262,1045,27,1072,1407,0,0,76.19,547,498,"永寧里",NULL
1263,1404,25,1429,1811,0,0,78.91,762,642,"永寧里",NULL
1264,533,12,545,663,0,0,82.2,191,342,"大安里",NULL
1265,1224,29,1253,1562,0,0,80.22,574,650,"大安里",NULL
1266,1086,29,1115,1404,0,0,79.42,626,460,"大安里",NULL
1267,1158,29,1187,1493,0,0,79.5,569,589,"員仁里",NULL
1268,938,23,961,1213,0,0,79.23,531,407,"員仁里",NULL
1269,1131,35,1166,1519,0,0,76.76,602,529,"員仁里",NULL
1270,1003,29,1032,1874,0,0,55.07,484,519,"埤塘里",NULL
1271,988,36,1024,1229,0,0,83.32,519,469,"埤塘里",NULL
1272,676,15,691,856,0,0,80.72,379,297,"土城里",NULL
1273,672,13,685,846,0,0,80.97,345,327,"土城里",NULL
1274,1343,12,1355,1583,0,0,85.6,1162,181,"長風里",NULL
1275,1379,24,1403,1752,0,0,80.08,808,571,"員信里",NULL
1276,1168,28,1196,1486,0,0,80.48,626,542,"員信里",NULL
1277,1021,22,1043,1288,0,0,80.98,563,458,"員林里",NULL
1278,1287,38,1325,1616,0,0,81.99,733,554,"員林里",NULL
1279,1139,23,1162,1403,0,0,82.82,603,536,"員林里",NULL
1280,861,24,885,1081,0,0,81.87,421,440,"員福里",NULL
1281,1278,22,1300,1553,0,0,83.71,676,602,"員福里",NULL
1282,1250,29,1279,1566,0,0,81.67,641,609,"員福里",NULL
1283,1024,18,1042,1288,0,0,80.9,422,602,"日和里",NULL
1284,1255,19,1274,1589,0,0,80.18,610,645,"日和里",NULL
1285,1057,21,1078,1313,0,0,82.1,478,579,"日和里",NULL
1286,1100,24,1124,1404,0,0,80.06,521,579,"日新里",NULL
1287,933,22,955,1185,0,0,80.59,442,491,"日新里",NULL
1288,941,23,964,1179,0,0,81.76,441,500,"日新里",NULL
1289,1153,27,1180,1450,0,0,81.38,550,603,"裕生里",NULL
1290,1134,28,1162,1480,0,0,78.51,583,551,"裕生里",NULL
1291,1244,26,1270,1554,0,0,81.72,644,600,"裕生里",NULL
1292,1213,29,1242,1510,0,0,82.25,529,684,"貨饒里",NULL
1293,1274,20,1294,1610,0,0,80.37,615,659,"貨饒里",NULL
1294,1103,25,1128,1349,0,0,83.62,512,591,"瑞興里",NULL
1295,1035,37,1072,1282,0,0,83.62,449,586,"瑞興里",NULL
1296,1254,29,1283,1619,0,0,79.25,591,663,"復興里",NULL
1297,1573,22,1595,1929,0,0,82.69,810,763,"復興里",NULL
1298,1141,14,1155,1370,0,0,84.31,705,436,"廣福里",NULL
1299,1026,19,1045,1268,0,0,82.41,584,442,"廣福里",NULL
1300,1151,14,1165,1392,0,0,83.69,625,526,"廣福里",NULL
1301,1124,17,1141,1370,0,0,83.28,499,625,"學成里",NULL
1302,927,29,956,1157,0,0,82.63,452,475,"學成里",NULL
1303,1139,22,1161,1436,0,0,80.85,534,605,"埤林里",NULL
1304,924,12,936,1148,0,0,81.53,441,483,"埤林里",NULL
1305,945,21,966,1134,0,0,85.19,511,434,"埤林里",NULL
1306,1017,23,1040,1257,0,0,82.74,666,351,"埤林里",NULL
1307,821,5,826,963,0,0,85.77,534,287,"埤林里",NULL
1308,857,20,877,1074,0,0,81.66,487,370,"廣興里",NULL
1309,1180,19,1199,1446,0,0,82.92,605,575,"廣興里",NULL
1310,1090,21,1111,1367,0,0,81.27,576,514,"樂利里",NULL
1311,1188,18,1206,1465,0,0,82.32,577,611,"樂利里",NULL
1312,1062,17,1079,1340,0,0,80.52,621,441,"樂利里",NULL
1313,1220,25,1245,1552,0,0,80.22,656,564,"學府里",NULL
1314,945,20,965,1169,0,0,82.55,514,431,"學府里",NULL
1315,863,9,872,1037,0,0,84.09,486,377,"明德里",NULL
1316,899,13,912,1094,0,0,83.36,528,371,"明德里",NULL
1317,921,13,934,1148,0,0,81.36,538,383,"明德里",NULL
1318,1450,12,1462,1772,0,0,82.51,826,624,"學士里",NULL
1319,1318,19,1337,1609,0,0,83.1,678,640,"學士里",NULL
1320,1423,29,1452,1832,0,0,79.26,738,685,"柑林里",NULL
1321,395,14,409,545,0,0,75.05,141,254,"柑林里",NULL
1322,876,22,898,1115,0,0,80.54,519,357,"中正里",NULL
1323,912,25,937,1142,0,0,82.05,483,429,"中正里",NULL
1324,1080,30,1110,1318,0,0,84.22,480,600,"青雲里",NULL
1325,776,14,790,936,0,0,84.4,411,365,"青雲里",NULL
1326,1159,28,1187,1472,0,0,80.64,479,680,"清和里",NULL
1327,1329,34,1363,1771,0,0,76.96,574,755,"清和里",NULL
1328,1201,23,1224,1577,0,0,77.62,634,567,"清和里",NULL
1329,1050,33,1083,1323,0,0,81.86,514,536,"清化里",NULL
1330,949,17,966,1170,0,0,82.56,557,392,"清溪里",NULL
1331,816,14,830,983,0,0,84.44,501,315,"清溪里",NULL
1332,1232,24,1256,1549,0,0,81.08,681,551,"清溪里",NULL
1333,1236,38,1274,1567,0,0,81.3,758,478,"清溪里",NULL
1334,900,23,923,1157,0,0,79.78,494,406,"青山里",NULL
1335,976,21,997,1211,0,0,82.33,556,420,"青山里",NULL
1336,1104,18,1122,1385,0,0,81.01,591,513,"清水里",NULL
1337,1172,17,1189,1440,0,0,82.57,636,536,"清水里",NULL
1338,1095,29,1124,1380,0,0,81.45,560,535,"清水里",NULL
1339,1157,27,1184,1423,0,0,83.2,613,544,"清水里",NULL
1340,965,22,987,1236,0,0,79.85,526,439,"永豐里",NULL
1341,896,28,924,1157,0,0,79.86,467,429,"永豐里",NULL
1342,902,18,920,1188,0,0,77.44,492,410,"永富里",NULL
1343,1100,20,1120,1404,0,0,79.77,549,551,"永富里",NULL
1344,1123,28,1151,1455,0,0,79.11,637,486,"永富里",NULL
1345,974,17,991,1204,0,0,82.31,425,549,"廷寮里",NULL
1346,836,11,847,1016,0,0,83.37,383,453,"廷寮里",NULL
1347,970,20,990,1209,0,0,81.89,567,403,"廷寮里",NULL
1348,1185,21,1206,1485,0,0,81.21,720,465,"金城里",NULL
1349,942,7,949,1147,0,0,82.74,560,382,"金城里",NULL
1350,1250,19,1269,1544,0,0,82.19,712,538,"金城里",NULL
1351,931,28,959,1172,0,0,81.83,494,437,"峰廷里",NULL
1352,1114,20,1134,1419,0,0,79.92,572,542,"峰廷里",NULL
1353,1120,27,1147,1393,0,0,82.34,540,580,"峰廷里",NULL
1354,1300,19,1319,1626,0,0,81.12,680,620,"峰廷里",NULL
1355,1086,38,1124,1381,0,0,81.39,509,577,"延吉里",NULL
1356,864,15,879,1084,0,0,81.09,411,453,"延吉里",NULL
1357,798,14,812,999,0,0,81.28,412,386,"延吉里",NULL
1358,724,6,730,953,0,0,76.6,369,355,"延壽里",NULL
1359,1239,27,1266,1513,0,0,83.67,641,598,"延壽里",NULL
1360,829,6,835,1011,0,0,82.59,403,426,"延壽里",NULL
1361,712,14,726,895,0,0,81.12,410,302,"延祿里",NULL
1362,875,13,888,1115,0,0,79.64,378,497,"延祿里",NULL
1363,1001,21,1022,1240,0,0,82.42,511,490,"延祿里",NULL
1364,1067,30,1097,1312,0,0,83.61,526,541,"平和里",NULL
1365,1192,24,1216,1477,0,0,82.33,604,588,"平和里",NULL
1366,864,16,880,1080,0,0,81.48,428,436,"平和里",NULL
1367,1072,19,1091,1311,0,0,83.22,529,543,"平和里",NULL
1368,972,23,995,1218,0,0,81.69,461,511,"安和里",NULL
1369,1029,17,1046,1253,0,0,83.48,579,450,"安和里",NULL
1370,1047,24,1071,1301,0,0,82.32,482,565,"安和里",NULL
1371,1083,22,1105,1379,0,0,80.13,529,554,"延和里",NULL
1372,1183,23,1206,1508,0,0,79.97,596,587,"延和里",NULL
1373,1308,20,1328,1696,0,0,78.3,761,547,"延和里",NULL
1374,1133,34,1167,1379,0,0,84.63,597,536,"光華里",NULL
1375,1105,37,1142,1383,0,0,82.57,537,568,"光華里",NULL
1376,1007,24,1031,1230,0,0,83.82,506,501,"光華里",NULL
1377,1170,28,1198,1512,0,0,79.23,481,689,"光明里",NULL
1378,1472,31,1503,1840,0,0,81.68,674,798,"光明里",NULL
1379,1053,22,1075,1300,0,0,82.69,467,586,"中路里",NULL
1380,1169,37,1206,1415,0,0,85.23,492,677,"中路里",NULL
1381,1182,27,1209,1515,0,0,79.8,519,663,"永安里",NULL
1382,1253,21,1274,1508,0,0,84.48,552,701,"永安里",NULL
1383,1059,12,1071,1334,0,0,80.28,428,631,"九芎里",NULL
1384,812,19,831,1018,0,0,81.63,350,462,"九芎里",NULL
1385,1120,29,1149,1358,0,0,84.61,569,551,"九芎里",NULL
1386,1197,19,1216,1476,0,0,82.38,533,664,"延平里",NULL
1387,1095,18,1113,1336,0,0,83.31,466,629,"延平里",NULL
1388,1083,46,1129,1373,0,0,82.23,485,598,"中華里",NULL
1389,878,26,904,1070,0,0,84.49,402,476,"中華里",NULL
1390,1135,24,1159,1422,0,0,81.5,540,595,"中原里",NULL
1391,1339,26,1365,1693,0,0,80.63,534,805,"中原里",NULL
1392,1351,25,1376,1752,0,0,78.54,567,784,"長安里",NULL
1393,1406,37,1443,1800,0,0,80.17,607,799,"長安里",NULL
1394,1345,31,1376,1713,0,0,80.33,615,730,"忠義里",NULL
1395,518,8,526,645,0,0,81.55,234,284,"正義里",NULL
1396,1190,29,1219,1535,0,0,79.41,539,651,"南港里",NULL
1397,985,17,1002,1196,0,0,83.78,426,559,"南港里",NULL
1398,1051,10,1061,1301,0,0,81.55,424,627,"南港里",NULL
1399,1148,21,1169,1435,0,0,81.46,538,610,"永樂里",NULL
1400,1097,15,1112,1347,0,0,82.55,460,637,"永樂里",NULL
1401,1172,30,1202,1482,0,0,81.11,542,630,"永樂里",NULL
1402,1090,13,1103,1378,0,0,80.04,455,635,"成功里",NULL
1403,1186,26,1212,1486,0,0,81.56,514,672,"成功里",NULL
1404,1321,19,1340,1625,0,0,82.46,545,776,"成功里",NULL
1405,998,21,1019,1259,0,0,80.94,421,577,"永康里",NULL
1406,1015,13,1028,1224,0,0,83.99,391,624,"永康里",NULL
1407,1434,45,1479,1790,0,0,82.63,640,794,"永康里",NULL
1408,1183,11,1194,1467,0,0,81.39,553,630,"永德里",NULL
1409,1266,21,1287,1573,0,0,81.82,523,743,"永德里",NULL
1410,1357,17,1374,1687,0,0,81.45,634,723,"樓厝里",NULL
1411,1090,28,1118,1383,0,0,80.84,522,568,"樓厝里",NULL
1412,910,23,933,1113,0,0,83.83,424,486,"樓厝里",NULL
1413,1239,41,1280,1540,0,0,83.12,524,715,"信義里",NULL
1414,1250,26,1276,1573,0,0,81.12,535,715,"信義里",NULL
1415,1636,41,1677,2080,0,0,80.63,754,882,"玉清里",NULL
1416,1311,27,1338,1629,0,0,82.14,569,742,"玉清里",NULL
1417,1012,21,1033,1281,0,0,80.64,363,649,"復興里",NULL
1418,1155,27,1182,1435,0,0,82.37,457,698,"復興里",NULL
1419,952,19,971,1167,0,0,83.2,380,572,"福安里",NULL
1420,913,23,936,1126,0,0,83.13,387,526,"福安里",NULL
1421,1349,26,1375,1714,0,0,80.22,620,729,"鷺江里",NULL
1422,948,25,973,1201,0,0,81.02,458,490,"鷺江里",NULL
1423,969,15,984,1201,0,0,81.93,407,562,"鷺江里",NULL
1424,1362,29,1391,1725,0,0,80.64,657,705,"恆德里",NULL
1425,1172,29,1201,1497,0,0,80.23,556,616,"恆德里",NULL
1426,1164,35,1199,1508,0,0,79.51,524,640,"恆德里",NULL
1427,953,18,971,1184,0,0,82.01,329,624,"溪墘里",NULL
1428,1130,19,1149,1427,0,0,80.52,529,601,"溪墘里",NULL
1429,1265,32,1297,1573,0,0,82.45,572,693,"仁復里",NULL
1430,1033,15,1048,1294,0,0,80.99,400,633,"仁德里",NULL
1431,1064,26,1090,1292,0,0,84.37,500,564,"仁德里",NULL
1432,1104,30,1134,1379,0,0,82.23,453,651,"仁德里",NULL
1433,913,21,934,1505,0,0,62.06,403,510,"仁義里",NULL
1434,921,21,942,1160,0,0,81.21,352,569,"仁義里",NULL
1435,1008,25,1033,1245,0,0,82.97,448,560,"得勝里",NULL
1436,1251,16,1267,1530,0,0,82.81,513,738,"得勝里",NULL
1437,864,27,891,1066,0,0,83.58,391,473,"得仁里",NULL
1438,870,15,885,1083,0,0,81.72,368,502,"得仁里",NULL
1439,794,23,817,1004,0,0,81.37,371,423,"保和里",NULL
1440,849,15,864,1086,0,0,79.56,393,456,"保和里",NULL
1441,1100,28,1128,1365,0,0,82.64,504,596,"樹德里",NULL
1442,967,27,994,1243,0,0,79.97,459,508,"樹德里",NULL
1443,1022,37,1059,1312,0,0,80.72,468,554,"民和里",NULL
1444,865,36,901,1092,0,0,82.51,412,453,"民和里",NULL
1445,1216,14,1230,1521,0,0,80.87,531,685,"水湳里",NULL
1446,989,25,1014,1319,0,0,76.88,405,584,"水湳里",NULL
1447,1510,30,1540,1884,0,0,81.74,707,803,"水湳里",NULL
1448,1190,28,1218,1460,0,0,83.42,550,640,"水湳里",NULL
1449,1272,25,1297,1562,0,0,83.03,563,709,"水河里",NULL
1450,1322,32,1354,1685,0,0,80.36,597,725,"水河里",NULL
1451,1022,16,1038,1311,0,0,79.18,428,594,"水河里",NULL
1452,1347,25,1372,1646,0,0,83.35,653,694,"水河里",NULL
1453,1110,29,1139,1420,0,0,80.21,470,640,"仁愛里",NULL
1454,999,24,1023,1256,0,0,81.45,465,534,"仁愛里",NULL
1455,942,17,959,1196,0,0,80.18,412,530,"仁愛里",NULL
1456,762,12,774,938,0,0,82.52,325,437,"忠孝里",NULL
1457,643,15,658,805,0,0,81.74,248,395,"忠孝里",NULL
1458,1339,32,1371,1672,0,0,82,628,711,"保佑里",NULL
1459,1003,28,1031,1304,0,0,79.06,428,575,"保佑里",NULL
1460,815,14,829,1025,0,0,80.88,356,459,"保新里",NULL
1461,881,31,912,1082,0,0,84.29,368,513,"保新里",NULL
1462,1195,38,1233,1525,0,0,80.85,624,571,"仁德里",NULL
1463,948,29,977,1208,0,0,80.88,520,428,"義民里",NULL
1464,694,25,719,938,0,0,76.65,348,346,"禮門里",NULL
1465,1156,12,1168,1456,0,0,80.22,690,466,"智慧里",NULL
1466,1095,19,1114,1370,0,0,81.31,652,443,"智慧里",NULL
1467,712,19,731,949,0,0,77.03,419,293,"大同里",NULL
1468,782,17,799,985,0,0,81.12,516,266,"大同里",NULL
1469,315,6,321,407,0,0,78.87,157,158,"信望里",NULL
1470,1073,31,1104,1372,0,0,80.47,540,533,"新昌里",NULL
1471,1128,19,1147,1423,0,0,80.6,613,515,"新昌里",NULL
1472,1242,24,1266,1562,0,0,81.05,638,604,"新昌里",NULL
1473,934,26,960,1156,0,0,83.04,517,417,"福安里",NULL
1474,940,15,955,1193,0,0,80.05,508,432,"福安里",NULL
1475,658,22,680,853,0,0,79.72,305,353,"秀峰里",NULL
1476,741,15,756,983,0,0,76.91,372,369,"秀峰里",NULL
1477,919,18,937,1131,0,0,82.85,475,444,"秀峰里",NULL
1478,1107,19,1126,1362,0,0,82.67,580,527,"秀山里",NULL
1479,1168,18,1186,1466,0,0,80.9,718,450,"秀山里",NULL
1480,1268,29,1297,1918,0,0,67.62,734,534,"復興里",NULL
1481,1346,18,1364,1673,0,0,81.53,833,513,"復興里",NULL
1482,1342,14,1356,1626,0,0,83.39,807,535,"復興里",NULL
1483,1255,38,1293,1621,0,0,79.77,628,627,"自強里",NULL
1484,1393,36,1429,1807,0,0,79.08,774,619,"自強里",NULL
1485,1041,19,1060,1324,0,0,80.06,545,496,"文化里",NULL
1486,1065,28,1093,1329,0,0,82.24,630,435,"文化里",NULL
1487,1194,20,1214,1552,0,0,78.22,663,531,"白雲里",NULL
1488,1297,22,1319,1595,0,0,82.7,767,530,"白雲里",NULL
1489,1266,20,1286,1653,0,0,77.8,593,673,"茄苳里",NULL
1490,1108,41,1149,1457,0,0,78.86,593,515,"茄苳里",NULL
1491,1294,36,1330,1670,0,0,79.64,655,639,"崇德里",NULL
1492,1222,31,1253,1563,0,0,80.17,704,518,"崇德里",NULL
1493,985,7,992,1249,0,0,79.42,565,420,"橋東里",NULL
1494,742,17,759,944,0,0,80.4,395,347,"橋東里",NULL
1495,1350,32,1382,1719,0,0,80.4,769,581,"橋東里",NULL
1496,1074,24,1098,1319,0,0,83.24,673,401,"橋東里",NULL
1497,1373,9,1382,1661,0,0,83.2,857,516,"橋東里",NULL
1498,1171,14,1185,1477,0,0,80.23,783,388,"橋東里",NULL
1499,1070,26,1096,1386,0,0,79.08,499,571,"長安里",NULL
1500,975,30,1005,1271,0,0,79.07,515,460,"保安里",NULL
1501,385,18,403,497,0,0,81.09,169,216,"東山里",NULL
1502,976,13,989,1275,0,0,77.57,515,461,"保長里",NULL
1503,813,31,844,1053,0,0,80.15,360,453,"保長里",NULL
1504,1107,26,1133,1491,0,0,75.99,621,486,"保長里",NULL
1505,1316,19,1335,1672,0,0,79.84,711,605,"鄉長里",NULL
1506,1090,17,1107,1365,0,0,81.1,570,520,"江北里",NULL
1507,904,23,927,1187,0,0,78.1,487,417,"江北里",NULL
1508,1289,28,1317,1644,0,0,80.11,659,630,"江北里",NULL
1509,972,35,1007,1295,0,0,77.76,557,415,"拱北里",NULL
1510,836,9,845,1101,0,0,76.75,551,285,"拱北里",NULL
1511,880,25,905,1164,0,0,77.75,508,372,"拱北里",NULL
1512,907,30,937,1177,0,0,79.61,477,430,"烘內里",NULL
1513,611,18,629,789,0,0,79.72,305,306,"八連里",NULL
1514,710,12,722,903,0,0,79.96,460,250,"長青里",NULL
1515,1190,51,1241,1563,0,0,79.4,578,612,"北峰里",NULL
1516,1323,33,1356,1703,0,0,79.62,684,639,"北峰里",NULL
1517,1470,23,1493,1928,0,0,77.44,833,637,"金龍里",NULL
1518,1451,35,1486,1867,0,0,79.59,848,603,"金龍里",NULL
1519,1319,37,1356,1685,0,0,80.47,631,688,"樟樹里",NULL
1520,1042,27,1069,1356,0,0,78.83,612,430,"忠孝里",NULL
1521,1491,37,1528,1929,0,0,79.21,879,612,"忠孝里",NULL
1522,1567,28,1595,2031,0,0,78.53,990,577,"忠孝里",NULL
1523,1101,24,1125,1378,0,0,81.64,640,461,"厚德里",NULL
1524,1133,19,1152,1469,0,0,78.42,708,425,"厚德里",NULL
1525,1306,22,1328,1715,0,0,77.43,859,447,"厚德里",NULL
1526,1446,26,1472,1911,0,0,77.03,1002,444,"山光里",NULL
1527,1374,29,1403,1774,0,0,79.09,732,642,"中興里",NULL
1528,1422,33,1455,1838,0,0,79.16,755,667,"中興里",NULL
1529,1226,27,1253,1563,0,0,80.17,634,592,"中興里",NULL
1530,874,21,895,1125,0,0,79.56,468,406,"福德里",NULL
1531,858,14,872,1158,0,0,75.3,489,369,"福德里",NULL
1532,880,14,894,1088,0,0,82.17,556,324,"興福里",NULL
1533,853,3,856,1078,0,0,79.41,488,365,"興福里",NULL
1534,969,22,991,1256,0,0,78.9,580,389,"康福里",NULL
1535,936,17,953,1157,0,0,82.37,540,396,"康福里",NULL
1536,1330,29,1359,1688,0,0,80.51,860,470,"湖光里",NULL
1537,1392,17,1409,1723,0,0,81.78,828,564,"湖光里",NULL
1538,803,7,810,1059,0,0,76.49,521,282,"湖光里",NULL
1539,1367,22,1389,1791,0,0,77.55,916,451,"湖興里",NULL
1540,1689,17,1706,2162,0,0,78.91,1154,535,"湖興里",NULL
1541,773,15,788,957,0,0,82.34,439,334,"北山里",NULL
1542,972,14,986,1220,0,0,80.82,590,382,"北山里",NULL
1543,1517,35,1552,1908,0,0,81.34,857,660,"北山里",NULL
1544,1091,18,1109,1351,0,0,82.09,692,399,"忠山里",NULL
1545,984,12,996,1169,0,0,85.2,637,347,"忠山里",NULL
1546,768,28,796,984,0,0,80.89,311,457,"環河里",NULL
1547,1272,24,1296,1603,0,0,80.85,782,490,"橫科里",NULL
1548,1034,17,1051,1268,0,0,82.89,565,469,"橫科里",NULL
1549,877,30,907,1101,0,0,82.38,509,368,"橫科里",NULL
1550,1136,13,1149,1406,0,0,81.72,642,494,"福山里",NULL
1551,1187,11,1198,1469,0,0,81.55,745,442,"福山里",NULL
1552,1064,22,1086,1313,0,0,82.71,675,389,"宜興里",NULL
1553,891,19,910,1102,0,0,82.58,576,315,"宜興里",NULL
1554,825,19,844,1020,0,0,82.75,429,396,"東勢里",NULL
1555,1321,13,1334,1608,0,0,82.96,888,433,"東勢里",NULL
1556,866,28,894,1152,0,0,77.6,418,448,"三興里",NULL
1557,886,22,908,1127,0,0,80.57,472,414,"三興里",NULL
1558,1056,35,1091,1447,0,0,75.4,481,575,"三興里",NULL
1559,866,29,895,1119,0,0,79.98,444,422,"三福里",NULL
1560,902,23,925,1140,0,0,81.14,473,429,"三福里",NULL
1561,854,17,871,1069,0,0,81.48,474,380,"三福里",NULL
1562,1071,25,1096,1411,0,0,77.68,497,574,"三多里",NULL
1563,1289,32,1321,1561,0,0,84.63,567,722,"三多里",NULL
1564,1196,40,1236,1525,0,0,81.05,557,639,"三龍里",NULL
1565,902,19,921,1133,0,0,81.29,367,535,"羌寮里",NULL
1566,1003,27,1030,1273,0,0,80.91,496,507,"羌寮里",NULL
1567,863,16,879,1111,0,0,79.12,435,428,"羌寮里",NULL
1568,1071,32,1103,1387,0,0,79.52,501,570,"光興里",NULL
1569,1050,25,1075,1398,0,0,76.9,547,503,"光興里",NULL
1570,1120,34,1154,1415,0,0,81.55,547,573,"金寮里",NULL
1571,1223,36,1259,1584,0,0,79.48,569,654,"金寮里",NULL
1572,797,24,821,1252,0,0,65.58,297,500,"潭底里",NULL
1573,706,22,728,872,0,0,83.49,330,376,"潭底里",NULL
1574,1073,24,1097,1348,0,0,81.38,522,551,"潭底里",NULL
1575,1212,26,1238,1485,0,0,83.37,550,662,"文林里",NULL
1576,903,22,925,1175,0,0,78.72,484,419,"文林里",NULL
1577,815,25,840,1056,0,0,79.55,450,365,"文林里",NULL
1578,1067,31,1098,1333,0,0,82.37,526,541,"保安里",NULL
1579,1097,28,1125,1352,0,0,83.21,567,530,"保安里",NULL
1580,930,22,952,1162,0,0,81.93,442,488,"保安里",NULL
1581,865,17,882,1071,0,0,82.35,422,443,"保安里",NULL
1582,821,22,843,1032,0,0,81.69,307,514,"圳安里",NULL
1583,1238,11,1249,1582,0,0,78.95,596,642,"圳安里",NULL
1584,843,20,863,1087,0,0,79.39,393,450,"圳福里",NULL
1585,807,18,825,973,0,0,84.79,378,429,"圳福里",NULL
1586,844,17,861,1075,0,0,80.09,435,409,"圳福里",NULL
1587,730,12,742,928,0,0,79.96,360,370,"圳民里",NULL
1588,797,20,817,1022,0,0,79.94,402,395,"圳民里",NULL
1589,1003,19,1022,1252,0,0,81.63,398,605,"圳生里",NULL
1590,1125,30,1155,1412,0,0,81.8,604,521,"樹德里",NULL
1591,1224,36,1260,1536,0,0,82.03,608,616,"樹德里",NULL
1592,911,16,927,1137,0,0,81.53,492,419,"樹福里",NULL
1593,613,20,633,764,0,0,82.85,284,329,"樹福里",NULL
1594,842,19,861,1056,0,0,81.53,406,436,"樹西里",NULL
1595,1185,21,1206,1451,0,0,83.12,606,579,"樹西里",NULL
1596,1324,23,1347,1589,0,0,84.77,667,657,"樹西里",NULL
1597,960,24,984,1239,0,0,79.42,492,468,"樹興里",NULL
1598,1359,34,1393,1693,0,0,82.28,703,656,"樹興里",NULL
1599,1010,21,1031,1245,0,0,82.81,565,445,"樹人里",NULL
1600,1000,19,1019,1226,0,0,83.12,550,450,"樹人里",NULL
1601,954,22,976,1179,0,0,82.78,476,478,"育英里",NULL
1602,948,21,969,1177,0,0,82.33,480,468,"育英里",NULL
1603,1354,20,1374,1669,0,0,82.32,678,676,"樹南里",NULL
1604,1231,41,1272,1545,0,0,82.33,668,563,"樹南里",NULL
1605,1019,37,1056,1280,0,0,82.5,457,562,"坡內里",NULL
1606,853,18,871,1059,0,0,82.25,451,402,"樹東里",NULL
1607,830,11,841,1015,0,0,82.86,421,409,"樹北里",NULL
1608,1044,43,1087,1385,0,0,78.48,505,539,"彭福里",NULL
1609,932,34,966,1215,0,0,79.51,367,565,"彭福里",NULL
1610,989,23,1012,1251,0,0,80.9,513,476,"彭福里",NULL
1611,1311,43,1354,1673,0,0,80.93,578,733,"和平里",NULL
1612,1198,32,1230,1551,0,0,79.3,546,652,"和平里",NULL
1613,1115,22,1137,1467,0,0,77.51,500,615,"彭興里",NULL
1614,1114,32,1146,1466,0,0,78.17,552,562,"彭興里",NULL
1615,1057,29,1086,1383,0,0,78.52,436,621,"彭興里",NULL
1616,938,18,956,1193,0,0,80.13,400,538,"彭厝里",NULL
1617,1073,26,1099,1324,0,0,83.01,554,519,"彭厝里",NULL
1618,796,21,817,1025,0,0,79.71,364,432,"彭厝里",NULL
1619,1081,20,1101,1313,0,0,83.85,566,515,"大同里",NULL
1620,820,19,839,1069,0,0,78.48,459,361,"大同里",NULL
1621,947,22,969,1208,0,0,80.22,492,455,"中華里",NULL
1622,833,20,853,1067,0,0,79.94,431,402,"中華里",NULL
1623,791,20,811,1010,0,0,80.3,401,390,"太順里",NULL
1624,835,24,859,1071,0,0,80.21,418,417,"太順里",NULL
1625,771,33,804,987,0,0,81.46,321,450,"東昇里",NULL
1626,978,19,997,1202,0,0,82.95,464,514,"東昇里",NULL
1627,681,22,703,849,0,0,82.8,330,351,"東昇里",NULL
1628,1153,34,1187,1486,0,0,79.88,523,630,"東陽里",NULL
1629,1124,44,1168,1453,0,0,80.39,548,576,"東陽里",NULL
1630,1007,16,1023,1299,0,0,78.75,552,455,"東陽里",NULL
1631,1232,30,1262,1544,0,0,81.74,550,682,"東山里",NULL
1632,832,36,868,1091,0,0,79.56,397,435,"東山里",NULL
1633,818,24,842,1042,0,0,80.81,372,446,"山佳里",NULL
1634,976,37,1013,1259,0,0,80.46,447,529,"山佳里",NULL
1635,692,14,706,863,0,0,81.81,360,332,"山佳里",NULL
1636,1173,48,1221,1537,0,0,79.44,581,592,"中山里",NULL
1637,1238,43,1281,1580,0,0,81.08,586,652,"中山里",NULL
1638,1040,46,1086,1339,0,0,81.11,480,560,"樂山里",NULL
1639,1036,32,1068,1262,0,0,84.63,438,598,"柑園里",NULL
1640,1015,31,1046,1329,0,0,78.71,308,707,"西園里",NULL
1641,529,21,550,651,0,0,84.49,181,348,"南園里",NULL
1642,1056,48,1104,1348,0,0,81.9,368,688,"東園里",NULL
1643,1203,31,1234,1525,0,0,80.92,471,732,"北園里",NULL
1644,340,7,347,446,0,0,77.8,173,167,"建德里",NULL
1645,720,20,740,904,0,0,81.86,322,398,"東鶯里",NULL
1646,1051,27,1078,1433,0,0,75.23,558,493,"北鶯里",NULL
1647,803,12,815,984,0,0,82.83,379,424,"西鶯里",NULL
1648,656,19,675,848,0,0,79.6,287,369,"西鶯里",NULL
1649,682,5,687,825,0,0,83.27,328,354,"中鶯里",NULL
1650,1188,32,1220,1471,0,0,82.94,554,634,"南鶯里",NULL
1651,1058,34,1092,1353,0,0,80.71,517,541,"南鶯里",NULL
1652,1099,31,1130,1381,0,0,81.82,503,596,"南鶯里",NULL
1653,1146,28,1174,1489,0,0,78.84,533,613,"建國里",NULL
1654,1134,27,1161,1497,0,0,77.56,552,582,"建國里",NULL
1655,1075,16,1091,1412,0,0,77.27,582,493,"建國里",NULL
1656,651,24,675,809,0,0,83.44,266,385,"二甲里",NULL
1657,1293,30,1323,1708,0,0,77.46,609,684,"二橋里",NULL
1658,1246,40,1286,1590,0,0,80.88,522,724,"二橋里",NULL
1659,1316,47,1363,1695,0,0,80.41,555,761,"二橋里",NULL
1660,1062,32,1094,1336,0,0,81.89,498,564,"尖山里",NULL
1661,1177,26,1203,1462,0,0,82.28,546,631,"尖山里",NULL
1662,1251,28,1279,1598,0,0,80.04,585,666,"尖山里",NULL
1663,942,13,955,1148,0,0,83.19,440,502,"南靖里",NULL
1664,668,12,680,803,0,0,84.68,297,371,"南靖里",NULL
1665,612,18,630,785,0,0,80.25,273,339,"南靖里",NULL
1666,1102,22,1124,1351,0,0,83.2,467,635,"同慶里",NULL
1667,1007,27,1034,1298,0,0,79.66,501,506,"永昌里",NULL
1668,1124,18,1142,1415,0,0,80.71,593,531,"永昌里",NULL
1669,1108,25,1133,1464,0,0,77.39,551,557,"永昌里",NULL
1670,919,21,940,1165,0,0,80.69,428,491,"永昌里",NULL
1671,672,14,686,875,0,0,78.4,315,357,"永昌里",NULL
1672,1090,36,1126,1376,0,0,81.83,538,552,"永吉里",NULL
1673,997,29,1026,1240,0,0,82.74,468,529,"永吉里",NULL
1674,868,10,878,1084,0,0,81,403,465,"永吉里",NULL
1675,986,43,1029,1287,0,0,79.95,485,501,"鳳祥里",NULL
1676,874,14,888,1143,0,0,77.69,402,472,"鳳祥里",NULL
1677,801,17,818,1059,0,0,77.24,398,403,"鳳祥里",NULL
1678,880,41,921,1181,0,0,77.98,445,435,"鳳鳴里",NULL
1679,1002,34,1036,1266,0,0,81.83,493,509,"鳳鳴里",NULL
1680,890,13,903,1086,0,0,83.15,409,481,"鳳鳴里",NULL
1681,885,22,907,1079,0,0,84.06,425,460,"鳳福里",NULL
1682,867,26,893,1123,0,0,79.52,417,450,"鳳福里",NULL
1683,1036,36,1072,1336,0,0,80.24,480,556,"鳳福里",NULL
1684,1072,26,1098,1361,0,0,80.68,551,521,"大湖里",NULL
1685,1193,26,1219,1518,0,0,80.3,732,461,"大湖里",NULL
1686,1009,32,1041,1250,0,0,83.28,568,441,"大湖里",NULL
1687,1285,39,1324,1735,0,0,76.31,695,590,"中湖里",NULL
1688,965,40,1005,1256,0,0,80.02,429,536,"中湖里",NULL
1689,1127,44,1171,1420,0,0,82.46,546,581,"中湖里",NULL
1690,171,14,185,226,0,0,81.86,74,97,"東湖里",NULL
1691,283,9,292,351,0,0,83.19,148,135,"三峽里",NULL
1692,321,10,331,402,0,0,82.34,158,163,"秀川里",NULL
1693,1024,33,1057,1287,0,0,82.13,488,536,"八張里",NULL
1694,1074,24,1098,1339,0,0,82,556,518,"八張里",NULL
1695,1172,17,1189,1483,0,0,80.18,622,550,"中埔里",NULL
1696,735,32,767,930,0,0,82.47,271,464,"弘道里",NULL
1697,982,29,1011,1277,0,0,79.17,530,452,"永館里",NULL
1698,1011,24,1035,1250,0,0,82.8,474,537,"永館里",NULL
1699,902,29,931,1132,0,0,82.24,497,405,"永館里",NULL
1700,1074,28,1102,1373,0,0,80.26,505,569,"永館里",NULL
1701,873,26,899,1076,0,0,83.55,434,439,"鳶山里",NULL
1702,793,31,824,1035,0,0,79.61,400,393,"鳶山里",NULL
1703,812,20,832,1031,0,0,80.7,388,424,"鳶山里",NULL
1704,890,28,918,1172,0,0,78.33,455,435,"鳶山里",NULL
1705,1094,29,1123,1433,0,0,78.37,553,541,"鳶山里",NULL
1706,1083,22,1105,1377,0,0,80.25,588,495,"龍埔里",NULL
1707,1110,17,1127,1361,0,0,82.81,647,463,"龍埔里",NULL
1708,953,26,979,1236,0,0,79.21,496,457,"龍埔里",NULL
1709,1115,14,1129,1429,0,0,79.01,432,683,"龍埔里",NULL
1710,878,20,898,1119,0,0,80.25,437,441,"礁溪里",NULL
1711,723,17,740,898,0,0,82.41,417,306,"礁溪里",NULL
1712,893,14,907,1125,0,0,80.62,471,422,"礁溪里",NULL
1713,1010,34,1044,1297,0,0,80.49,506,504,"安溪里",NULL
1714,1082,33,1115,1443,0,0,77.27,611,471,"安溪里",NULL
1715,1069,16,1085,1305,0,0,83.14,616,453,"安溪里",NULL
1716,899,8,907,1123,0,0,80.77,575,324,"安溪里",NULL
1717,920,25,945,1268,0,0,74.53,436,484,"介壽里",NULL
1718,940,19,959,1213,0,0,79.06,466,474,"介壽里",NULL
1719,993,16,1009,1263,0,0,79.89,501,492,"介壽里",NULL
1720,882,26,908,1154,0,0,78.68,466,416,"中正里",NULL
1721,914,28,942,1145,0,0,82.27,469,445,"中正里",NULL
1722,889,27,916,1121,0,0,81.71,368,521,"中正里",NULL
1723,894,44,938,1220,0,0,76.89,427,467,"大埔里",NULL
1724,793,23,816,1028,0,0,79.38,408,385,"大埔里",NULL
1725,749,31,780,932,0,0,83.69,539,210,"大埔里",NULL
1726,939,10,949,1182,0,0,80.29,488,451,"嘉添里",NULL
1727,978,63,1041,1409,0,0,73.88,737,241,"嘉添里",NULL
1728,770,38,808,988,0,0,81.78,344,426,"添福里",NULL
1729,328,32,360,465,0,0,77.42,149,179,"金圳里",NULL
1730,674,43,717,881,0,0,81.38,343,331,"五寮里",NULL
1731,589,51,640,811,0,0,78.91,244,345,"插角里",NULL
1732,558,43,601,793,0,0,75.79,220,338,"有木里",NULL
1733,899,28,927,1187,0,0,78.1,578,321,"二鬮里",NULL
1734,1012,16,1028,1264,0,0,81.33,558,454,"二鬮里",NULL
1735,988,38,1026,1254,0,0,81.82,425,563,"溪南里",NULL
1736,496,5,501,618,0,0,81.07,209,287,"溪北里",NULL
1737,1026,7,1033,1244,0,0,83.04,393,633,"溪北里",NULL
1738,798,36,834,1044,0,0,79.89,383,415,"溪東里",NULL
1739,996,32,1028,1326,0,0,77.53,494,502,"溪東里",NULL
1740,683,17,700,830,0,0,84.34,261,422,"成福里",NULL
1741,633,51,684,860,0,0,79.53,199,434,"竹崙里",NULL
1742,702,28,730,891,0,0,81.93,308,394,"竹崙里",NULL
1743,921,59,980,1275,0,0,76.86,323,598,"安坑里",NULL
1744,444,28,472,577,0,0,81.8,176,268,"中和里",NULL
1745,730,41,771,959,0,0,80.4,327,403,"屯山里",NULL
1746,1027,48,1075,1338,0,0,80.34,576,451,"賢孝里",NULL
1747,1079,50,1129,1397,0,0,80.82,512,567,"興仁里",NULL
1748,563,21,584,791,0,0,73.83,316,247,"蕃薯里",NULL
1749,662,28,690,820,0,0,84.15,325,337,"忠山里",NULL
1750,808,38,846,1086,0,0,77.9,389,419,"義山里",NULL
1751,822,34,856,1092,0,0,78.39,443,379,"義山里",NULL
1752,710,22,732,950,0,0,77.05,307,403,"水源里",NULL
1753,679,42,721,888,0,0,81.19,241,438,"水源里",NULL
1754,754,56,810,999,0,0,81.08,289,465,"忠寮里",NULL
1755,586,30,616,780,0,0,78.97,201,385,"樹興里",NULL
1756,825,30,855,1047,0,0,81.66,420,405,"坪頂里",NULL
1757,1566,22,1588,1931,0,0,82.24,925,641,"福德里",NULL
1758,1106,19,1125,1399,0,0,80.41,733,373,"福德里",NULL
1759,1136,34,1170,1430,0,0,81.82,735,401,"福德里",NULL
1760,1328,31,1359,1655,0,0,82.11,790,538,"竹圍里",NULL
1761,1361,39,1400,1737,0,0,80.6,765,596,"竹圍里",NULL
1762,1333,34,1367,1699,0,0,80.46,754,579,"竹圍里",NULL
1763,1332,31,1363,1660,0,0,82.11,757,575,"竹圍里",NULL
1764,1195,10,1205,1517,0,0,79.43,657,538,"民生里",NULL
1765,1078,35,1113,1417,0,0,78.55,603,475,"民生里",NULL
1766,1038,27,1065,1307,0,0,81.48,546,492,"民生里",NULL
1767,1396,40,1436,1784,0,0,80.49,752,644,"八勢里",NULL
1768,1609,23,1632,2076,0,0,78.61,917,692,"竿蓁里",NULL
1769,1101,28,1129,1381,0,0,81.75,573,528,"竿蓁里",NULL
1770,1049,14,1063,1263,0,0,84.16,552,497,"崁頂里",NULL
1771,827,31,858,1071,0,0,80.11,334,493,"埤島里",NULL
1772,1124,29,1153,1424,0,0,80.97,542,582,"水碓里",NULL
1773,1170,40,1210,1474,0,0,82.09,616,554,"水碓里",NULL
1774,1103,10,1113,1374,0,0,81,587,516,"水碓里",NULL
1775,1278,16,1294,1594,0,0,81.18,782,496,"水碓里",NULL
1776,1357,21,1378,1695,0,0,81.3,830,527,"水碓里",NULL
1777,1204,21,1225,1514,0,0,80.91,686,518,"水碓里",NULL
1778,1291,38,1329,1614,0,0,82.34,652,639,"新興里",NULL
1779,1331,41,1372,1744,0,0,78.67,643,688,"新興里",NULL
1780,1249,26,1275,1592,0,0,80.09,712,537,"新興里",NULL
1781,1153,20,1173,1500,0,0,78.2,674,479,"新興里",NULL
1782,1271,30,1301,1703,0,0,76.39,761,510,"新興里",NULL
1783,1165,25,1190,1478,0,0,80.51,710,455,"新興里",NULL
1784,1104,30,1134,1429,0,0,79.36,611,493,"新興里",NULL
1785,1174,19,1193,1479,0,0,80.66,702,472,"新興里",NULL
1786,1296,14,1310,1642,0,0,79.78,698,598,"新興里",NULL
1787,1297,45,1342,1675,0,0,80.12,649,648,"北投里",NULL
1788,1320,27,1347,1655,0,0,81.39,730,590,"鄧公里",NULL
1789,1468,36,1504,1837,0,0,81.87,859,609,"鄧公里",NULL
1790,1340,22,1362,1670,0,0,81.56,787,553,"鄧公里",NULL
1791,1351,25,1376,1741,0,0,79.04,749,602,"鄧公里",NULL
1792,1272,45,1317,1628,0,0,80.9,684,588,"鄧公里",NULL
1793,1371,41,1412,1742,0,0,81.06,712,659,"鄧公里",NULL
1794,860,27,887,1112,0,0,79.77,499,361,"中興里",NULL
1795,1024,20,1044,1300,0,0,80.31,510,514,"中興里",NULL
1796,920,28,948,1144,0,0,82.87,487,433,"中興里",NULL
1797,1179,19,1198,1474,0,0,81.28,559,620,"長庚里",NULL
1798,787,27,814,1056,0,0,77.08,381,406,"清文里",NULL
1799,661,33,694,811,0,0,85.57,253,408,"草東里",NULL
1800,1086,34,1120,1375,0,0,81.45,569,517,"協元里",NULL
1801,595,18,613,739,0,0,82.95,304,291,"永吉里",NULL
1802,589,8,597,736,0,0,81.11,240,349,"民安里",NULL
1803,368,7,375,638,0,0,58.78,194,174,"新生里",NULL
1804,1162,28,1190,1498,0,0,79.44,657,505,"文化里",NULL
1805,947,30,977,1201,0,0,81.35,556,391,"油車里",NULL
1806,1017,18,1035,1304,0,0,79.37,615,402,"油車里",NULL
1807,1019,30,1049,1251,0,0,83.85,567,452,"油車里",NULL
1808,1338,35,1373,1686,0,0,81.44,728,610,"沙崙里",NULL
1809,1291,25,1316,1668,0,0,78.9,718,573,"沙崙里",NULL
1810,1257,15,1272,1593,0,0,79.85,650,607,"沙崙里",NULL
1811,612,15,627,767,0,0,81.75,349,263,"龍潭里",NULL
1812,724,17,741,924,0,0,80.19,392,332,"龍興里",NULL
1813,600,18,618,762,0,0,81.1,370,230,"龍興里",NULL
1814,944,42,986,1298,0,0,75.96,511,433,"龍鎮里",NULL
1815,462,19,481,634,0,0,75.87,272,190,"龍安里",NULL
1816,644,20,664,845,0,0,78.58,363,281,"龍川里",NULL
1817,548,25,573,751,0,0,76.3,290,258,"龍川里",NULL
1818,948,30,978,1292,0,0,75.7,548,400,"龍山里",NULL
1819,1187,54,1241,1552,0,0,79.96,612,575,"爪峰里",NULL
1820,817,41,858,1072,0,0,80.04,447,370,"爪峰里",NULL
1821,753,33,786,980,0,0,80.2,411,342,"爪峰里",NULL
1822,767,41,808,1052,0,0,76.81,435,332,"新峰里",NULL
1823,1077,40,1117,1560,0,0,71.6,687,390,"新峰里",NULL
1824,818,13,831,1085,0,0,76.59,405,413,"東和里",NULL
1825,546,15,561,735,0,0,76.33,307,239,"東和里",NULL
1826,824,52,876,1112,0,0,78.78,398,426,"柑坪里",NULL
1827,206,9,215,298,0,0,72.15,100,106,"弓橋里",NULL
1828,351,23,374,504,0,0,74.21,176,175,"侯硐里",NULL
1829,249,17,266,347,0,0,76.66,120,129,"光復里",NULL
1830,80,3,83,118,0,0,70.34,40,40,"碩仁里",NULL
1831,643,22,665,843,0,0,78.88,361,282,"吉慶里",NULL
1832,561,28,589,797,0,0,73.9,301,260,"吉慶里",NULL
1833,705,33,738,940,0,0,78.51,382,323,"吉安里",NULL
1834,643,16,659,832,0,0,79.21,365,278,"吉安里",NULL
1835,798,13,811,1031,0,0,78.66,434,364,"吉安里",NULL
1836,499,23,522,650,0,0,80.31,273,226,"上天里",NULL
1837,456,26,482,620,0,0,77.74,207,249,"上天里",NULL
1838,742,14,756,966,0,0,78.26,364,378,"傑魚里",NULL
1839,612,29,641,853,0,0,75.15,306,306,"傑魚里",NULL
1840,381,20,401,557,0,0,71.99,182,199,"基山里",NULL
1841,383,19,402,558,0,0,72.04,164,219,"永慶里",NULL
1842,276,8,284,420,0,0,67.62,139,137,"崇文里",NULL
1843,169,11,180,249,0,0,72.29,89,80,"福住里",NULL
1844,283,6,289,397,0,0,72.8,147,136,"頌德里",NULL
1845,183,7,190,264,0,0,71.97,104,79,"瓜山里",NULL
1846,212,7,219,287,0,0,76.31,130,82,"銅山里",NULL
1847,335,10,345,447,0,0,77.18,175,160,"新山里",NULL
1848,309,14,323,452,0,0,71.46,190,119,"石山里",NULL
1849,430,21,451,612,0,0,73.69,271,159,"濂洞里",NULL
1850,253,10,263,338,0,0,77.81,132,121,"濂新里",NULL
1851,189,6,195,258,0,0,75.58,97,92,"南雅里",NULL
1852,519,22,541,767,0,0,70.53,290,229,"鼻頭里",NULL
1853,732,32,764,1004,0,0,76.1,439,293,"海濱里",NULL
1854,762,7,769,1037,0,0,74.16,390,372,"瑞濱里",NULL
1855,665,28,693,900,0,0,77,436,229,"瑞濱里",NULL
1856,815,33,848,1184,0,0,71.62,528,287,"深澳里",NULL
1857,981,19,1000,1256,0,0,79.62,363,618,"興珍村",NULL
1858,1088,24,1112,1377,0,0,80.76,491,597,"興珍村",NULL
1859,988,26,1014,1197,0,0,84.71,326,662,"興珍村",NULL
1860,885,42,927,1137,0,0,81.53,278,607,"更寮村",NULL
1861,1528,34,1562,1945,0,0,80.31,750,778,"集福村",NULL
1862,402,13,415,520,0,0,79.81,162,240,"集福村",NULL
1863,1140,29,1169,1442,0,0,81.07,494,646,"集賢村",NULL
1864,1033,22,1055,1300,0,0,81.15,481,552,"集賢村",NULL
1865,970,50,1020,1281,0,0,79.63,321,649,"觀音村",NULL
1866,1152,26,1178,1443,0,0,81.64,477,675,"成州村",NULL
1867,930,24,954,1191,0,0,80.1,380,550,"成州村",NULL
1868,1160,27,1187,1501,0,0,79.08,480,680,"成州村",NULL
1869,888,27,915,1153,0,0,79.36,358,530,"成德村",NULL
1870,887,29,916,1132,0,0,80.92,311,576,"成德村",NULL
1871,1143,29,1172,1514,0,0,77.41,467,676,"成功村",NULL
1872,1218,21,1239,1599,0,0,77.49,528,690,"成功村",NULL
1873,1088,37,1125,1386,0,0,81.17,431,657,"成泰村",NULL
1874,987,38,1025,1255,0,0,81.67,388,599,"成泰村",NULL
1875,913,45,958,1179,0,0,81.26,285,628,"五龍村",NULL
1876,1094,23,1117,1391,0,0,80.3,634,460,"五福村",NULL
1877,1198,29,1227,1505,0,0,81.53,642,556,"五福村",NULL
1878,1049,14,1063,1298,0,0,81.9,686,363,"六福村",NULL
1879,1092,15,1107,1314,0,0,84.25,632,460,"六福村",NULL
1880,1181,25,1206,1610,0,0,74.91,575,606,"五股村",NULL
1881,1323,16,1339,1610,0,0,83.17,607,716,"陸一村、五股村",NULL
1882,1127,25,1152,1397,0,0,82.46,640,487,"民義村",NULL
1883,912,28,940,1176,0,0,79.93,463,449,"民義村",NULL
1884,969,19,988,1206,0,0,81.92,542,427,"德音村",NULL
1885,972,17,989,1210,0,0,81.74,536,436,"德音村",NULL
1886,990,26,1016,1218,0,0,83.42,488,502,"德音村",NULL
1887,1005,24,1029,1246,0,0,82.58,457,548,"水碓村",NULL
1888,1051,17,1068,1337,0,0,79.88,527,524,"水碓村",NULL
1889,1012,30,1042,1277,0,0,81.6,489,523,"水碓村",NULL
1890,1034,30,1064,1283,0,0,82.93,552,482,"水碓村",NULL
1891,1103,13,1116,1367,0,0,81.64,598,505,"德泰村",NULL
1892,998,20,1018,1291,0,0,78.85,515,483,"德泰村",NULL
1893,1604,39,1643,2114,0,0,77.72,842,762,"德泰村",NULL
1894,1422,31,1453,1646,0,0,88.27,1379,43,"貿商村",NULL
1895,485,23,508,619,0,0,82.07,170,315,"大科村",NULL
1896,239,1,240,281,0,0,85.41,131,108,"大科村",NULL
1897,1085,18,1103,1309,0,0,84.26,538,547,"黎明村",NULL
1898,878,13,891,1048,0,0,85.02,409,469,"黎明村",NULL
1899,413,8,421,486,0,0,86.63,311,102,"黎明村",NULL
1900,1023,20,1043,1281,0,0,81.42,566,457,"山腳村",NULL
1901,945,20,965,1206,0,0,80.02,493,452,"山腳村",NULL
1902,743,18,761,961,0,0,79.19,397,346,"山腳村",NULL
1903,797,11,808,982,0,0,82.28,413,384,"山腳村",NULL
1904,832,23,855,1036,0,0,82.53,462,370,"福泰村",NULL
1905,848,16,864,1042,0,0,82.92,413,435,"福泰村",NULL
1906,1037,25,1062,1253,0,0,84.76,533,504,"福泰村",NULL
1907,1079,21,1100,1301,0,0,84.55,530,549,"福泰村",NULL
1908,761,12,773,936,0,0,82.59,387,374,"楓樹村",NULL
1909,620,24,644,804,0,0,80.1,324,296,"楓樹村",NULL
1910,727,9,736,880,0,0,83.64,327,400,"楓樹村",NULL
1911,1015,16,1031,1231,0,0,83.75,619,396,"同榮村",NULL
1912,860,16,876,1060,0,0,82.64,466,394,"同榮村",NULL
1913,653,22,675,828,0,0,81.52,298,355,"同榮村",NULL
1914,1310,34,1344,1679,0,0,80.05,637,673,"同興村",NULL
1915,1277,26,1303,1552,0,0,83.96,607,670,"同興村",NULL
1916,776,8,784,962,0,0,81.5,365,411,"義學村",NULL
1917,751,21,772,974,0,0,79.26,349,402,"義學村",NULL
1918,1003,25,1028,1260,0,0,81.59,487,516,"義學村",NULL
1919,1168,20,1188,1447,0,0,82.1,489,679,"義仁村",NULL
1920,1214,29,1243,1451,0,0,85.67,578,636,"義仁村",NULL
1921,1084,30,1114,1326,0,0,84.01,467,617,"義仁村",NULL
1922,857,21,878,1082,0,0,81.15,397,460,"明志村",NULL
1923,761,4,765,944,0,0,81.04,386,375,"明志村",NULL
1924,810,15,825,981,0,0,84.1,469,341,"明志村",NULL
1925,759,13,772,929,0,0,83.1,402,357,"泰友村",NULL
1926,699,14,713,867,0,0,82.24,340,359,"泰友村",NULL
1927,1136,21,1157,1381,0,0,83.78,560,576,"新明村",NULL
1928,1076,22,1098,1358,0,0,80.85,514,562,"新明村",NULL
1929,836,20,856,1032,0,0,82.95,409,427,"貴子村",NULL
1930,828,21,849,1039,0,0,81.71,405,423,"貴子村",NULL
1931,864,11,875,1051,0,0,83.25,447,417,"貴子村",NULL
1932,1166,13,1179,1397,0,0,84.4,662,504,"貴賢村",NULL
1933,1252,32,1284,1575,0,0,81.52,597,655,"貴賢村",NULL
1934,1125,18,1143,1377,0,0,83.01,646,479,"貴和村",NULL
1935,1072,19,1091,1323,0,0,82.46,498,574,"貴和村",NULL
1936,928,25,953,1195,0,0,79.75,450,478,"貴和村",NULL
1937,889,30,919,1122,0,0,81.91,374,515,"東林村",NULL
1938,802,21,823,1037,0,0,79.36,398,404,"東林村",NULL
1939,1050,30,1080,1323,0,0,81.63,539,511,"東林村",NULL
1940,771,18,789,1087,0,0,72.59,406,365,"林口村",NULL
1941,1038,28,1066,1315,0,0,81.06,557,481,"林口村",NULL
1942,939,19,958,1148,0,0,83.45,497,442,"林口村",NULL
1943,878,22,900,1090,0,0,82.57,460,418,"西林村",NULL
1944,1049,42,1091,1346,0,0,81.05,532,517,"西林村",NULL
1945,695,21,716,863,0,0,82.97,371,324,"西林村",NULL
1946,1360,27,1387,1675,0,0,82.81,680,680,"菁湖村",NULL
1947,1255,47,1302,1586,0,0,82.09,612,643,"菁湖村",NULL
1948,1062,37,1099,1358,0,0,80.93,491,571,"中湖村",NULL
1949,815,26,841,1005,0,0,83.68,408,407,"中湖村",NULL
1950,872,42,914,1098,0,0,83.24,295,577,"湖北村",NULL
1951,1058,18,1076,1292,0,0,83.28,429,629,"湖南村",NULL
1952,590,26,616,774,0,0,79.59,225,365,"南勢村",NULL
1953,1068,16,1084,1304,0,0,83.13,682,386,"仁愛村",NULL
1954,856,19,875,1088,0,0,80.42,576,280,"仁愛村",NULL
1955,787,8,795,950,0,0,83.68,468,319,"仁愛村",NULL
1956,942,10,952,1197,0,0,79.53,600,342,"麗林村",NULL
1957,1176,24,1200,1475,0,0,81.36,728,448,"麗林村",NULL
1958,1015,11,1026,1226,0,0,83.69,682,333,"麗林村",NULL
1959,1015,17,1032,1274,0,0,81,543,472,"東勢村",NULL
1960,1003,22,1025,1268,0,0,80.84,583,420,"東勢村",NULL
1961,1181,31,1212,1532,0,0,79.11,705,476,"東勢村",NULL
1962,1050,27,1077,1341,0,0,80.31,602,448,"麗園村",NULL
1963,1153,19,1172,1433,0,0,81.79,666,487,"麗園村",NULL
1964,707,57,764,963,0,0,79.34,227,480,"頂福村",NULL
1965,729,44,773,931,0,0,83.03,351,378,"下福村",NULL
1966,522,39,561,653,0,0,85.91,193,329,"嘉寶村",NULL
1967,335,27,362,453,0,0,79.91,122,213,"瑞平村",NULL
1968,639,33,672,809,0,0,83.07,210,429,"太平村",NULL
1969,719,30,749,932,0,0,80.36,353,366,"萬順村",NULL
1970,784,19,803,995,0,0,80.7,407,377,"萬順村",NULL
1971,795,17,812,1010,0,0,80.4,382,413,"萬福村",NULL
1972,661,24,685,868,0,0,78.92,357,304,"萬福村",NULL
1973,851,25,876,1065,0,0,82.25,472,379,"土庫村",NULL
1974,784,23,807,1018,0,0,79.27,424,360,"土庫村",NULL
1975,1194,28,1222,1540,0,0,79.35,770,424,"賴仲村",NULL
1976,938,32,970,1196,0,0,81.1,477,461,"深坑村",NULL
1977,991,30,1021,1254,0,0,81.42,564,427,"深坑村",NULL
1978,979,17,996,1244,0,0,80.06,591,388,"埔新村",NULL
1979,958,17,975,1193,0,0,81.73,568,390,"埔新村",NULL
1980,1039,23,1062,1302,0,0,81.57,601,438,"埔新村",NULL
1981,1215,37,1252,1587,0,0,78.89,720,495,"昇高村",NULL
1982,370,18,388,467,0,0,83.08,159,211,"阿柔村",NULL
1983,323,9,332,392,0,0,84.69,148,175,"石碇村",NULL
1984,507,40,547,674,0,0,81.16,243,264,"潭邊村",NULL
1985,507,9,516,607,0,0,85.01,158,349,"烏塗村",NULL
1986,224,14,238,300,0,0,79.33,102,122,"彭山村",NULL
1987,226,17,243,301,0,0,80.73,74,152,"豐田村",NULL
1988,101,5,106,125,0,0,84.8,49,52,"豐田村",NULL
1989,543,8,551,696,0,0,79.17,225,318,"隆盛村",NULL
1990,173,8,181,230,0,0,78.7,85,88,"豐林村",NULL
1991,584,29,613,764,0,0,80.24,258,326,"中民村",NULL
1992,425,23,448,583,0,0,76.84,186,239,"永定村",NULL
1993,193,11,204,245,0,0,83.27,77,116,"光明村",NULL
1994,328,20,348,430,0,0,80.93,138,190,"永安村",NULL
1995,529,31,560,679,0,0,82.47,173,356,"格頭村",NULL
1996,812,45,857,1046,0,0,81.93,310,502,"坪林村",NULL
1997,438,25,463,571,0,0,81.09,182,256,"水德村",NULL
1998,645,39,684,939,0,0,72.84,185,460,"大林村",NULL
1999,245,26,271,375,0,0,72.27,73,172,"石曹村",NULL
2000,412,1,413,516,0,0,80.04,123,289,"粗窟村",NULL
2001,155,8,163,212,0,0,76.89,88,67,"粗窟村",NULL
2002,219,23,242,313,0,0,77.32,74,145,"上德村",NULL
2003,299,20,319,394,0,0,80.96,165,134,"上德村",NULL
2004,271,21,292,372,0,0,78.49,61,210,"漁光村",NULL
2005,293,26,319,404,0,0,78.96,87,206,"漁光村",NULL
2006,283,17,300,381,0,0,78.74,121,162,"八賢村",NULL
2007,445,9,454,583,0,0,77.87,267,178,"埔頭村",NULL
2008,1025,35,1060,1341,0,0,79.05,580,445,"埔頭村",NULL
2009,1311,31,1342,1726,0,0,77.75,729,582,"埔頭村",NULL
2010,647,40,687,920,0,0,74.67,363,284,"古庄村",NULL
2011,595,29,624,800,0,0,78,345,250,"新庄村",NULL
2012,1652,35,1687,2278,0,0,74.06,986,666,"埔坪村",NULL
2013,820,38,858,1087,0,0,78.93,504,316,"埔坪村",NULL
2014,1186,52,1238,1659,0,0,74.62,728,458,"埔坪村",NULL
2015,339,18,357,444,0,0,80.41,197,142,"茂長村",NULL
2016,411,27,438,545,0,0,80.37,229,182,"橫山村",NULL
2017,610,19,629,770,0,0,81.69,299,311,"錫板村",NULL
2018,1242,47,1289,1609,0,0,80.11,776,466,"後厝村",NULL
2019,487,33,520,665,0,0,78.2,267,220,"福德村",NULL
2020,372,27,399,507,0,0,78.7,162,210,"圓山村",NULL
2021,459,44,503,630,0,0,79.84,144,315,"店子村",NULL
2022,806,49,855,1120,0,0,76.34,378,428,"興華村",NULL
2023,666,25,691,901,0,0,76.69,339,327,"德茂村",NULL
2024,837,42,879,1094,0,0,80.35,494,343,"富基村",NULL
2025,1291,85,1376,1798,0,0,76.53,662,629,"老梅村",NULL
2026,529,40,569,735,0,0,77.41,308,221,"山溪村",NULL
2027,942,33,975,1221,0,0,79.85,573,369,"石門村",NULL
2028,939,49,988,1247,0,0,79.23,552,387,"尖鹿村",NULL
2029,217,11,228,307,0,0,74.27,124,93,"乾華村",NULL
2030,388,24,412,518,0,0,79.54,213,175,"茂林村",NULL
2031,576,29,605,767,0,0,78.88,357,219,"草里村",NULL
2032,1313,19,1332,1637,0,0,81.37,712,601,"龍源村",NULL
2033,1192,27,1219,1509,0,0,80.78,674,518,"龍源村",NULL
2034,1017,27,1044,1260,0,0,82.86,575,442,"龍源村",NULL
2035,967,35,1002,1273,0,0,78.71,462,505,"米倉村",NULL
2036,818,39,857,1031,0,0,83.12,414,404,"米倉村",NULL
2037,1159,53,1212,1504,0,0,80.59,560,599,"大崁村",NULL
2038,890,22,912,1139,0,0,80.07,434,456,"埤頭村",NULL
2039,1026,47,1073,1324,0,0,81.04,480,546,"埤頭村",NULL
2040,903,32,935,1141,0,0,81.95,419,484,"頂罟村",NULL
2041,1114,17,1131,1441,0,0,78.49,535,579,"舊城村",NULL
2042,1179,31,1210,1583,0,0,76.44,632,547,"舊城村",NULL
2043,1091,29,1120,1399,0,0,80.06,607,484,"舊城村",NULL
2044,1058,35,1093,1367,0,0,79.96,584,474,"訊塘村",NULL
2045,963,24,987,1204,0,0,81.98,492,471,"訊塘村",NULL
2046,1006,35,1041,1313,0,0,79.28,482,524,"荖阡村",NULL
2047,892,45,937,1113,0,0,84.19,465,427,"長坑村",NULL
2048,851,44,895,1072,0,0,83.49,524,327,"下罟村",NULL
2049,317,26,343,448,0,0,76.56,128,189,"薯榔村",NULL
2050,228,11,239,308,0,0,77.6,131,97,"菁桐村",NULL
2051,225,6,231,281,0,0,82.21,90,135,"白石村",NULL
2052,412,25,437,561,0,0,77.9,174,238,"石底村",NULL
2053,190,14,204,271,0,0,75.28,112,78,"平溪村",NULL
2054,473,38,511,685,0,0,74.6,236,237,"嶺腳村",NULL
2055,308,20,328,428,0,0,76.64,139,169,"東勢村",NULL
2056,706,43,749,1000,0,0,74.9,338,368,"十分村",NULL
2057,116,6,122,152,0,0,80.26,55,61,"望古村",NULL
2058,356,29,385,492,0,0,78.25,147,209,"南山村",NULL
2059,130,9,139,185,0,0,75.14,69,61,"新寮村",NULL
2060,122,6,128,167,0,0,76.65,60,62,"平湖村",NULL
2061,414,21,435,562,0,0,77.4,217,197,"雙溪村",NULL
2062,234,8,242,307,0,0,78.83,165,69,"新基村",NULL
2063,464,13,477,591,0,0,80.71,256,208,"新基村",NULL
2064,307,28,335,460,0,0,72.83,120,187,"三港村",NULL
2065,716,54,770,1033,0,0,74.54,376,340,"牡丹村",NULL
2066,567,33,600,761,0,0,78.84,283,284,"牡丹村",NULL
2067,257,20,277,355,0,0,78.03,135,122,"三貂村",NULL
2068,487,22,509,645,0,0,78.91,272,215,"平林村",NULL
2069,211,18,229,301,0,0,76.08,102,109,"平林村",NULL
2070,493,36,529,704,0,0,75.14,223,270,"上林村",NULL
2071,335,31,366,501,0,0,73.05,143,192,"外柑村",NULL
2072,287,28,315,421,0,0,74.82,80,207,"長源村",NULL
2073,104,4,108,151,0,0,71.52,75,29,"共和村",NULL
2074,232,8,240,326,0,0,73.62,113,119,"共和村",NULL
2075,245,13,258,338,0,0,76.33,112,133,"魚行村",NULL
2076,238,14,252,324,0,0,77.78,124,114,"魚行村",NULL
2077,256,20,276,385,0,0,71.69,101,155,"泰平村",NULL
2078,94,5,99,143,0,0,69.23,61,33,"泰平村",NULL
2079,654,45,699,908,0,0,76.98,301,353,"貢寮村",NULL
2080,311,26,337,443,0,0,76.07,129,182,"龍崗村",NULL
2081,330,23,353,514,0,0,68.68,143,187,"吉林村",NULL
2082,320,18,338,438,0,0,77.17,106,214,"雙玉村",NULL
2083,246,23,269,350,0,0,76.86,104,142,"雙玉村",NULL
2084,743,33,776,988,0,0,78.54,383,360,"福隆村",NULL
2085,431,28,459,626,0,0,73.32,179,252,"福隆村",NULL
2086,613,32,645,866,0,0,74.48,223,390,"福連村",NULL
2087,485,26,511,689,0,0,74.17,162,323,"龍門村",NULL
2088,1198,69,1267,1669,0,0,75.91,495,703,"仁里村",NULL
2089,785,46,831,1136,0,0,73.15,243,542,"真理村",NULL
2090,572,21,593,805,0,0,73.66,144,428,"真理村",NULL
2091,284,28,312,409,0,0,76.28,96,188,"美豐村",NULL
2092,287,36,323,421,0,0,76.72,90,197,"美豐村",NULL
2093,331,26,357,470,0,0,75.96,114,217,"和美村",NULL
2094,309,19,328,454,0,0,72.25,123,186,"和美村",NULL
2095,344,11,355,449,0,0,79.06,172,172,"和平村",NULL
2096,510,8,518,644,0,0,80.43,289,221,"大同村",NULL
2097,343,22,365,479,0,0,76.2,166,177,"豐漁村",NULL
2098,1116,73,1189,1584,0,0,75.06,435,681,"磺港村",NULL
2099,1395,57,1452,1831,0,0,79.3,746,649,"美田村",NULL
2100,1245,55,1300,1649,0,0,78.84,670,575,"美田村",NULL
2101,1332,45,1377,1784,0,0,77.19,666,666,"美田村",NULL
2102,1196,26,1222,1586,0,0,77.05,683,513,"美田村",NULL
2103,540,22,562,690,0,0,81.45,309,231,"五湖村",NULL
2104,555,32,587,757,0,0,77.54,239,316,"五湖村",NULL
2105,690,45,735,976,0,0,75.31,297,393,"重和村",NULL
2106,280,35,315,389,0,0,80.98,138,142,"兩湖村",NULL
2107,402,29,431,535,0,0,80.56,173,229,"六股村",NULL
2108,428,36,464,587,0,0,79.05,189,239,"三界村",NULL
2109,587,50,637,836,0,0,76.2,299,288,"清泉村",NULL
2110,153,12,165,200,0,0,82.5,72,81,"西湖村",NULL
2111,348,24,372,461,0,0,80.69,173,175,"萬壽村",NULL
2112,395,31,426,586,0,0,72.7,195,200,"永興村",NULL
2113,1298,60,1358,1664,0,0,81.61,748,550,"萬里村",NULL
2114,1060,67,1127,1485,0,0,75.89,600,460,"萬里村",NULL
2115,714,29,743,1066,0,0,69.7,458,256,"北基村",NULL
2116,701,26,727,1017,0,0,71.48,431,270,"北基村",NULL
2117,347,36,383,590,0,0,64.92,224,123,"龜吼村",NULL
2118,813,47,860,1154,0,0,74.52,442,371,"龜吼村",NULL
2119,940,41,981,1278,0,0,76.76,502,438,"野柳村",NULL
2120,828,37,865,1128,0,0,76.68,404,424,"野柳村",NULL
2121,546,16,562,723,0,0,77.73,283,263,"大鵬村",NULL
2122,1137,32,1169,1493,0,0,78.3,648,489,"大鵬村",NULL
2123,371,21,392,477,0,0,82.18,215,156,"磺潭村",NULL
2124,589,52,641,781,0,0,82.07,236,353,"雙興村",NULL
2125,393,25,418,537,0,0,77.84,150,243,"溪底村",NULL
2126,405,22,427,560,0,0,76.25,187,218,"崁腳村",NULL
2127,583,35,618,823,0,0,75.09,342,241,"中幅村",NULL
2128,793,23,816,1012,0,0,80.63,485,308,"忠治村",NULL
2129,1307,25,1332,1650,0,0,80.73,814,493,"烏來村",NULL
2130,116,3,119,142,0,0,83.8,52,64,"孝義村",NULL
2131,262,16,278,341,0,0,81.52,154,108,"信賢村",NULL
2132,321,2,323,415,0,0,77.83,257,64,"福山村",NULL
1,464,10,474,618,0,0,76.7,260,204,"南門里",NULL
2,607,16,623,772,0,0,80.7,338,269,"負郭里",NULL
3,1117,28,1145,1433,0,0,79.9,562,555,"負郭里",NULL
4,918,20,938,1168,0,0,80.31,500,418,"民族里",NULL
5,892,25,917,1125,0,0,81.51,510,382,"民族里",NULL
6,1045,11,1056,1339,0,0,78.86,538,507,"建軍里",NULL
7,972,20,992,1243,0,0,79.81,555,417,"建軍里",NULL
8,809,10,819,1031,0,0,79.44,555,254,"復興里",NULL
9,640,14,654,798,0,0,81.95,326,314,"復興里",NULL
10,812,27,839,1048,0,0,80.06,418,394,"復興里",NULL
11,1434,16,1450,1807,0,0,80.24,759,675,"思源里",NULL
12,1331,23,1354,1692,0,0,80.02,749,582,"思源里",NULL
13,895,20,915,1136,0,0,80.55,529,366,"思源里",NULL
14,1056,25,1081,1366,0,0,79.14,564,492,"文化里",NULL
15,1124,23,1147,1450,0,0,79.1,596,528,"文化里",NULL
16,501,5,506,648,0,0,78.09,272,229,"神農里",NULL
17,340,11,351,427,0,0,82.2,120,220,"民生里",NULL
18,549,13,562,697,0,0,80.63,222,327,"昇平里",NULL
19,426,10,436,552,0,0,78.99,193,233,"大東里",NULL
20,476,12,488,612,0,0,79.74,241,235,"新興里",NULL
21,569,10,579,734,0,0,78.88,300,269,"和睦里",NULL
22,1061,19,1080,1392,0,0,77.59,607,454,"和睦里",NULL
23,456,8,464,602,0,0,77.08,249,207,"民權里",NULL
24,750,15,765,1028,0,0,74.42,435,315,"民權里",NULL
25,1048,12,1060,1289,0,0,82.23,581,467,"進士里",NULL
26,1101,10,1111,1424,0,0,78.02,560,541,"進士里",NULL
27,483,15,498,666,0,0,74.77,190,293,"進士里",NULL
28,1071,14,1085,1344,0,0,80.73,568,503,"進士里",NULL
29,530,19,549,691,0,0,79.45,214,316,"南橋里",NULL
30,749,29,778,1028,0,0,75.68,312,437,"建業里",NULL
31,581,28,609,792,0,0,76.89,206,375,"南津里",NULL
32,806,38,844,1069,0,0,78.95,318,488,"凱旋里",NULL
33,1008,38,1046,1303,0,0,80.28,397,611,"黎明里",NULL
34,761,16,777,968,0,0,80.27,343,418,"東村里",NULL
35,1004,21,1025,1261,0,0,81.28,544,460,"東村里",NULL
36,1156,22,1178,1500,0,0,78.53,575,581,"東村里",NULL
37,776,21,797,995,0,0,80.1,353,423,"延平里",NULL
38,1295,27,1322,1657,0,0,79.78,710,585,"延平里",NULL
39,885,18,903,1143,0,0,79,441,444,"延平里",NULL
40,898,47,945,1178,0,0,80.22,298,600,"七張里",NULL
41,902,32,934,1232,0,0,75.81,457,445,"慈安里",NULL
42,1023,27,1050,1344,0,0,78.13,529,494,"慈安里",NULL
43,1137,9,1146,1491,0,0,76.86,611,526,"慈安里",NULL
44,505,16,521,659,0,0,79.06,207,298,"新民里",NULL
45,437,9,446,545,0,0,81.83,180,257,"東門里",NULL
46,461,14,475,619,0,0,76.74,200,261,"中正里",NULL
47,1015,27,1042,1304,0,0,79.91,506,509,"小東里",NULL
48,1040,27,1067,1342,0,0,79.51,504,536,"菜園里",NULL
49,765,29,794,1009,0,0,78.69,320,445,"孝廉里",NULL
50,1029,35,1064,1375,0,0,77.38,408,621,"新生里",NULL
51,639,19,658,821,0,0,80.15,268,371,"新生里",NULL
52,1350,41,1391,1822,0,0,76.34,504,846,"茭白里",NULL
53,1146,33,1179,1508,0,0,78.18,457,689,"北津里",NULL
54,1061,28,1089,1373,0,0,79.32,405,656,"梅洲里",NULL
55,886,27,913,1147,0,0,79.6,294,592,"梅洲里",NULL
56,718,14,732,921,0,0,79.48,310,408,"北門里",NULL
57,533,19,552,724,0,0,76.24,193,340,"慶和里",NULL
58,592,16,608,800,0,0,76,213,379,"鄂王里",NULL
59,957,30,987,1257,0,0,78.52,386,571,"西門里",NULL
60,549,26,575,781,0,0,73.62,199,350,"中山里",NULL
61,1023,29,1052,1359,0,0,77.41,440,583,"大道里",NULL
62,372,10,382,498,0,0,76.71,144,228,"開羅里",NULL
63,423,15,438,539,0,0,81.26,141,282,"開元里",NULL
64,368,21,389,500,0,0,77.8,138,230,"東明里",NULL
65,955,20,975,1243,0,0,78.44,372,583,"大新里",NULL
66,661,22,683,843,0,0,81.02,219,442,"東安里",NULL
67,1245,19,1264,1613,0,0,78.36,551,694,"東安里",NULL
68,863,27,890,1084,0,0,82.1,252,611,"新群里",NULL
69,723,24,747,985,0,0,75.84,261,462,"新群里",NULL
70,821,22,843,1077,0,0,78.27,330,491,"羅莊里",NULL
71,771,9,780,1006,0,0,77.53,335,436,"羅莊里",NULL
72,1091,28,1119,1420,0,0,78.8,455,636,"南昌里",NULL
73,685,17,702,873,0,0,80.41,426,259,"南昌里",NULL
74,1034,35,1069,1316,0,0,81.23,425,609,"南豪里",NULL
75,1039,21,1060,1270,0,0,83.46,457,582,"成功里",NULL
76,682,20,702,863,0,0,81.34,287,395,"仁德里",NULL
77,546,15,561,734,0,0,76.43,232,314,"居仁里",NULL
78,624,19,643,832,0,0,77.28,243,381,"義和里",NULL
79,491,14,505,616,0,0,81.98,210,281,"羅東里",NULL
80,556,13,569,710,0,0,80.14,214,342,"浮崙里",NULL
81,824,22,846,1070,0,0,79.07,317,507,"漢民里",NULL
82,1136,18,1154,1434,0,0,80.47,567,569,"漢民里",NULL
83,797,15,812,1026,0,0,79.14,389,408,"漢民里",NULL
84,791,4,795,995,0,0,79.9,357,434,"西安里",NULL
85,1191,11,1202,1503,0,0,79.97,529,662,"西安里",NULL
86,829,27,856,1093,0,0,78.32,315,514,"西安里",NULL
87,1078,19,1097,1394,0,0,78.69,478,600,"西安里",NULL
88,1063,30,1093,1388,0,0,78.75,344,719,"北成里",NULL
89,1057,22,1079,1338,0,0,80.64,446,611,"北成里",NULL
90,1149,14,1163,1426,0,0,81.56,498,651,"北成里",NULL
91,1107,11,1118,1373,0,0,81.43,477,630,"北成里",NULL
92,1047,24,1071,1370,0,0,78.18,494,553,"賢文里",NULL
93,789,25,814,1041,0,0,78.19,318,471,"賢文里",NULL
94,813,13,826,1043,0,0,79.19,383,430,"賢文里",NULL
95,796,15,811,1009,0,0,80.38,335,461,"公正里",NULL
96,694,12,706,856,0,0,82.48,318,376,"公正里",NULL
97,794,9,803,1051,0,0,76.4,332,462,"集祥里",NULL
98,1184,18,1202,1527,0,0,78.72,534,650,"信義里",NULL
99,1193,29,1222,1520,0,0,80.39,496,697,"信義里",NULL
100,911,11,922,1139,0,0,80.95,470,441,"樹林里",NULL
101,917,14,931,1173,0,0,79.37,398,519,"樹林里",NULL
102,854,16,870,1126,0,0,77.26,369,485,"樹林里",NULL
103,1086,31,1117,1413,0,0,79.05,443,643,"竹林里",NULL
104,934,24,958,1231,0,0,77.82,343,591,"竹林里",NULL
105,1122,31,1153,1419,0,0,81.25,450,672,"仁愛里",NULL
106,968,2,970,1194,0,0,81.24,343,625,"仁愛里",NULL
107,499,32,531,653,0,0,81.32,172,327,"龍德里",NULL
108,899,38,937,1208,0,0,77.57,311,588,"龍德里",NULL
109,889,30,919,1167,0,0,78.75,328,561,"龍德里",NULL
110,622,31,653,775,0,0,84.26,193,429,"頂寮里",NULL
111,841,20,861,1100,0,0,78.27,319,522,"永榮里",NULL
112,781,26,807,1009,0,0,79.98,320,461,"永榮里",NULL
113,710,20,730,906,0,0,80.57,278,432,"永榮里",NULL
114,460,25,485,601,0,0,80.7,161,299,"存仁里",NULL
115,283,1,284,358,0,0,79.33,77,206,"存仁里",NULL
116,555,40,595,758,0,0,78.5,193,362,"港邊里",NULL
117,332,14,346,441,0,0,78.46,123,209,"港邊里",NULL
118,154,2,156,253,0,0,61.66,141,13,"岳明里",NULL
119,792,30,822,1040,0,0,79.04,306,486,"隘丁里",NULL
120,807,27,834,1084,0,0,76.94,295,512,"隘丁里",NULL
121,825,29,854,1098,0,0,77.78,331,494,"新城里",NULL
122,997,33,1030,1394,0,0,73.89,433,564,"聖湖里",NULL
123,765,20,785,1019,0,0,77.04,383,382,"聖湖里",NULL
124,1013,28,1041,1323,0,0,78.68,495,518,"聖湖里",NULL
125,967,25,992,1339,0,0,74.09,521,446,"聖湖里",NULL
126,893,22,915,1149,0,0,79.63,423,470,"蘇西里",NULL
127,887,34,921,1209,0,0,76.18,453,434,"蘇西里",NULL
128,915,24,939,1217,0,0,77.16,447,468,"蘇北里",NULL
129,415,19,434,562,0,0,77.22,191,224,"蘇南里",NULL
130,358,14,372,535,0,0,69.53,159,199,"蘇東里",NULL
131,460,19,479,613,0,0,78.14,223,237,"長安里",NULL
132,385,8,393,495,0,0,79.39,192,193,"永光里",NULL
133,451,20,471,642,0,0,73.36,170,281,"永春里",NULL
134,361,29,390,503,0,0,77.53,157,204,"永樂里",NULL
135,798,31,829,1065,0,0,77.84,324,474,"南安里",NULL
136,761,15,776,1048,0,0,74.05,290,471,"南正里",NULL
137,880,45,925,1249,0,0,74.06,351,529,"南成里",NULL
138,604,23,627,855,0,0,73.33,291,313,"南興里",NULL
139,525,33,558,802,0,0,69.58,223,302,"南興里",NULL
140,821,28,849,1144,0,0,74.21,357,464,"南寧里",NULL
141,956,22,978,1324,0,0,73.87,348,608,"南建里",NULL
142,223,7,230,303,0,0,75.91,106,117,"東澳里",NULL
143,592,25,617,872,0,0,70.76,219,373,"南強里",NULL
144,335,23,358,493,0,0,72.62,100,235,"朝陽里",NULL
145,171,9,180,253,0,0,71.15,49,122,"朝陽里",NULL
146,253,17,270,374,0,0,72.19,117,136,"石城里",NULL
147,505,33,538,739,0,0,72.8,259,246,"大里里",NULL
148,484,20,504,652,0,0,77.3,276,208,"龜山里",NULL
149,657,34,691,929,0,0,74.38,275,382,"大溪里",NULL
150,281,20,301,403,0,0,74.69,150,131,"合興里",NULL
151,965,46,1011,1409,0,0,71.75,564,401,"更新里",NULL
152,603,47,650,937,0,0,69.37,319,284,"外澳里",NULL
153,467,21,488,641,0,0,76.13,233,234,"港口里",NULL
154,1075,39,1114,1447,0,0,76.99,650,425,"武營里",NULL
155,898,31,929,1208,0,0,76.9,467,431,"大坑里",NULL
156,594,12,606,745,0,0,81.34,353,241,"城東里",NULL
157,421,16,437,560,0,0,78.04,263,158,"城北里",NULL
158,501,3,504,632,0,0,79.75,284,217,"城西里",NULL
159,494,11,505,628,0,0,80.41,310,184,"城南里",NULL
160,685,22,707,994,0,0,71.13,300,385,"竹安里",NULL
161,752,21,773,1026,0,0,75.34,464,288,"竹安里",NULL
162,593,20,613,787,0,0,77.89,281,312,"新建里",NULL
163,731,19,750,1006,0,0,74.55,403,328,"新建里",NULL
164,1038,36,1074,1406,0,0,76.39,557,481,"拔雅里",NULL
165,744,32,776,1004,0,0,77.29,350,394,"福成里",NULL
166,1207,51,1258,1669,0,0,75.37,668,539,"金面里",NULL
167,515,26,541,711,0,0,76.09,275,240,"金盈里",NULL
168,964,33,997,1274,0,0,78.26,534,430,"頂埔里",NULL
169,716,27,743,962,0,0,77.23,355,361,"下埔里",NULL
170,726,31,757,963,0,0,78.61,386,340,"中崙里",NULL
171,800,37,837,1076,0,0,77.79,372,428,"二城里",NULL
172,1041,56,1097,1406,0,0,78.02,476,565,"白雲村",NULL
173,1245,56,1301,1660,0,0,78.37,608,637,"玉石村",NULL
174,1252,38,1290,1706,0,0,75.62,648,604,"德陽村",NULL
175,1321,36,1357,1799,0,0,75.43,830,491,"德陽村",NULL
176,1026,27,1053,1357,0,0,77.6,606,420,"大忠村",NULL
177,618,29,647,800,0,0,80.88,331,287,"大忠村",NULL
178,510,22,532,665,0,0,80,210,300,"大義村",NULL
179,1077,29,1106,1394,0,0,79.34,590,487,"六結村",NULL
180,843,33,876,1092,0,0,80.22,316,527,"二龍村",NULL
181,1005,45,1050,1380,0,0,76.09,304,701,"時潮村",NULL
182,599,41,640,850,0,0,75.29,180,419,"玉田村",NULL
183,792,31,823,1009,0,0,81.57,196,596,"玉田村",NULL
184,1036,52,1088,1385,0,0,78.56,405,631,"三民村",NULL
185,667,30,697,905,0,0,77.02,306,361,"三民村",NULL
186,815,57,872,1085,0,0,80.37,294,521,"林美村",NULL
187,567,22,589,737,0,0,79.92,225,342,"白鵝村",NULL
188,760,27,787,963,0,0,81.72,216,544,"玉光村",NULL
189,839,41,880,1109,0,0,79.35,305,534,"光武村",NULL
190,808,21,829,1049,0,0,79.03,376,432,"吳沙村",NULL
191,856,33,889,1141,0,0,77.91,300,556,"吳沙村",NULL
192,1124,50,1174,1451,0,0,80.91,316,808,"龍潭村",NULL
193,1027,48,1075,1322,0,0,81.32,314,713,"龍潭村",NULL
194,712,25,737,955,0,0,77.17,232,480,"匏崙村",NULL
195,331,10,341,414,0,0,82.37,86,245,"二結村",NULL
196,739,27,766,957,0,0,80.04,304,435,"吉祥村",NULL
197,669,25,694,888,0,0,78.15,273,396,"吉祥村",NULL
198,719,22,741,936,0,0,79.17,236,483,"古結村",NULL
199,608,26,634,815,0,0,77.79,254,354,"美福村",NULL
200,616,24,640,801,0,0,79.9,214,402,"美福村",NULL
201,677,37,714,872,0,0,81.88,249,428,"新南村",NULL
202,733,8,741,989,0,0,74.92,271,462,"東港村",NULL
203,599,17,616,788,0,0,78.17,197,402,"復興村",NULL
204,581,38,619,814,0,0,76.04,212,369,"復興村",NULL
205,653,22,675,889,0,0,75.93,210,443,"過嶺村",NULL
206,502,22,524,687,0,0,76.27,210,292,"過嶺村",NULL
207,623,26,649,857,0,0,75.73,184,439,"永鎮村",NULL
208,606,31,637,830,0,0,76.75,241,365,"忠孝村",NULL
209,952,35,987,1256,0,0,78.58,342,610,"忠孝村",NULL
210,950,43,993,1264,0,0,78.56,308,642,"古亭村",NULL
211,746,40,786,986,0,0,79.72,267,479,"功勞村",NULL
212,712,34,746,934,0,0,79.87,248,464,"美城村",NULL
213,776,26,802,1010,0,0,79.41,273,503,"美城村",NULL
214,772,43,815,1066,0,0,76.45,303,469,"新社村",NULL
215,632,32,664,882,0,0,75.28,254,378,"大福村",NULL
216,546,27,573,742,0,0,77.22,201,345,"大福村",NULL
217,1131,43,1174,1525,0,0,76.98,468,663,"員山村",NULL
218,1042,39,1081,1363,0,0,79.31,418,624,"員山村",NULL
219,1112,13,1125,1445,0,0,77.85,628,484,"員山村",NULL
220,706,41,747,971,0,0,76.93,213,493,"尚德村",NULL
221,675,27,702,909,0,0,77.23,278,397,"尚德村",NULL
222,962,42,1004,1228,0,0,81.76,276,686,"惠好村",NULL
223,712,38,750,958,0,0,78.29,329,383,"七賢村",NULL
224,1020,52,1072,1435,0,0,74.7,287,733,"深溝村",NULL
225,836,50,886,1190,0,0,74.45,237,599,"蓁巷村",NULL
226,700,47,747,986,0,0,75.76,383,317,"內城村",NULL
227,326,25,351,450,0,0,78,191,135,"內城村",NULL
228,330,26,356,458,0,0,77.73,86,244,"中華村",NULL
229,175,13,188,273,0,0,68.86,68,107,"中華村",NULL
230,1231,49,1280,1620,0,0,79.01,478,753,"永和村",NULL
231,811,50,861,1064,0,0,80.92,295,516,"頭分村",NULL
232,1222,49,1271,1585,0,0,80.19,330,892,"枕山村",NULL
233,381,21,402,513,0,0,78.36,104,277,"枕山村",NULL
234,935,41,976,1246,0,0,78.33,365,570,"同樂村",NULL
235,949,40,989,1246,0,0,79.37,323,626,"同樂村",NULL
236,593,43,636,850,0,0,74.82,224,369,"湖東村",NULL
237,598,41,639,824,0,0,77.55,153,445,"逸仙村",NULL
238,727,52,779,1008,0,0,77.28,257,470,"湖北村",NULL
239,1033,77,1110,1457,0,0,76.18,276,757,"湖西村",NULL
240,1056,44,1100,1346,0,0,81.72,322,734,"珍珠村",NULL
241,766,33,799,988,0,0,80.87,220,546,"補城村",NULL
242,613,39,652,820,0,0,79.51,188,425,"三奇村",NULL
243,737,26,763,956,0,0,79.81,219,518,"大興村",NULL
244,944,33,977,1223,0,0,79.89,339,605,"東城村",NULL
245,767,32,799,992,0,0,80.54,274,493,"香和村",NULL
246,825,46,871,1079,0,0,80.72,262,563,"香和村",NULL
247,648,21,669,828,0,0,80.8,237,411,"南興村",NULL
248,864,24,888,1087,0,0,81.69,306,558,"南興村",NULL
249,520,20,540,702,0,0,76.92,149,371,"安平村",NULL
250,631,19,650,833,0,0,78.03,232,399,"冬山村",NULL
251,1074,45,1119,1321,0,0,84.71,346,728,"太和村",NULL
252,612,21,633,796,0,0,79.52,181,431,"八寶村",NULL
253,999,43,1042,1276,0,0,81.66,308,691,"丸山村",NULL
254,365,17,382,449,0,0,85.08,93,272,"中山村",NULL
255,914,23,937,1205,0,0,77.76,301,613,"順安村",NULL
256,1198,39,1237,1608,0,0,76.93,368,830,"順安村",NULL
257,1166,36,1202,1531,0,0,78.51,389,777,"順安村",NULL
258,690,15,705,872,0,0,80.85,219,471,"永美村",NULL
259,892,43,935,1176,0,0,79.51,309,583,"永美村",NULL
260,820,42,862,1055,0,0,81.71,242,578,"武淵村",NULL
261,978,14,992,1209,0,0,82.05,329,649,"群英村",NULL
262,818,24,842,1073,0,0,78.47,301,517,"群英村",NULL
263,1005,27,1032,1255,0,0,82.23,435,570,"群英村",NULL
264,761,13,774,970,0,0,79.79,299,462,"群英村",NULL
265,1004,30,1034,1308,0,0,79.05,371,633,"清溝村",NULL
266,1052,22,1074,1398,0,0,76.82,356,696,"清溝村",NULL
267,829,37,866,1111,0,0,77.95,198,631,"鹿埔村",NULL
268,813,62,875,1101,0,0,79.47,340,473,"鹿埔村",NULL
269,771,39,810,1050,0,0,77.14,293,478,"得安村",NULL
270,854,36,890,1110,0,0,80.18,298,556,"廣興村",NULL
271,870,28,898,1099,0,0,81.71,291,579,"廣興村",NULL
272,1002,49,1051,1347,0,0,78.03,362,640,"廣安村",NULL
273,870,28,898,1111,0,0,80.83,277,593,"柯林村",NULL
274,644,37,681,847,0,0,80.4,155,489,"大進村",NULL
275,1163,59,1222,1572,0,0,77.74,315,848,"三興村",NULL
276,1174,34,1208,1476,0,0,81.84,483,691,"二結村",NULL
277,796,13,809,1023,0,0,79.08,276,520,"鎮安村",NULL
278,822,14,836,1047,0,0,79.85,265,557,"鎮安村",NULL
279,1139,27,1166,1466,0,0,79.54,418,721,"上四村",NULL
280,784,26,810,1040,0,0,77.88,263,521,"中興村",NULL
281,703,27,730,913,0,0,79.96,346,357,"四結村",NULL
282,917,25,942,1176,0,0,80.1,355,562,"四結村",NULL
283,1149,42,1191,1499,0,0,79.45,375,774,"福興村",NULL
284,1096,24,1120,1373,0,0,81.57,449,647,"五結村",NULL
285,1067,28,1095,1408,0,0,77.77,397,670,"五結村",NULL
286,1328,26,1354,1670,0,0,81.08,536,792,"大吉村",NULL
287,868,40,908,1106,0,0,82.1,280,588,"大吉村",NULL
288,1142,38,1180,1461,0,0,80.77,361,781,"協和村",NULL
289,661,21,682,905,0,0,75.36,199,462,"協和村",NULL
290,999,55,1054,1361,0,0,77.44,266,733,"孝威村",NULL
291,1075,67,1142,1467,0,0,77.85,333,742,"錦眾村",NULL
292,757,25,782,1003,0,0,77.97,280,477,"利澤村",NULL
293,732,35,767,967,0,0,79.32,209,523,"利澤村",NULL
294,1222,53,1275,1616,0,0,78.9,382,840,"成興村",NULL
295,564,14,578,739,0,0,78.21,155,409,"成興村",NULL
296,1295,50,1345,1734,0,0,77.57,438,857,"季新村",NULL
297,569,23,592,770,0,0,76.88,186,383,"季新村",NULL
298,185,3,188,246,0,0,76.42,79,106,"員山村",NULL
299,412,20,432,584,0,0,73.97,159,253,"天山村",NULL
300,547,42,589,796,0,0,73.99,163,384,"天福村",NULL
301,472,39,511,672,0,0,76.04,145,327,"雙賢村",NULL
302,335,26,361,463,0,0,77.97,151,184,"人和村",NULL
303,817,46,863,1103,0,0,78.24,381,436,"義德村",NULL
304,870,40,910,1184,0,0,76.86,335,535,"集慶村",NULL
305,586,41,627,800,0,0,78.38,240,346,"月眉村",NULL
306,743,57,800,1004,0,0,79.68,225,518,"拱照村",NULL
307,1273,43,1316,1682,0,0,78.24,450,823,"大隱村",NULL
308,1067,67,1134,1474,0,0,76.93,370,697,"大隱村",NULL
309,479,33,512,667,0,0,76.76,153,326,"行健村",NULL
310,418,28,446,585,0,0,76.24,198,220,"萬德村",NULL
311,349,16,365,495,0,0,73.74,158,191,"貴林村",NULL
312,505,27,532,678,0,0,78.47,155,350,"萬富村",NULL
313,810,39,849,1087,0,0,78.1,211,599,"大義村",NULL
314,573,41,614,783,0,0,78.42,171,402,"尚武村",NULL
315,987,41,1028,1257,0,0,81.78,239,748,"大洲村",NULL
316,879,43,922,1138,0,0,81.02,185,694,"尾塹村",NULL
317,579,25,604,753,0,0,80.21,527,52,"寒溪村",NULL
318,369,9,378,479,0,0,78.91,338,31,"崙埤村",NULL
319,423,17,440,557,0,0,78.99,285,138,"松羅村",NULL
320,204,9,213,291,0,0,73.2,103,101,"復興村",NULL
321,221,6,227,331,0,0,68.58,168,53,"英士村",NULL
322,222,11,233,303,0,0,76.9,191,31,"樂水村",NULL
323,44,2,46,68,0,0,67.65,19,25,"太平村",NULL
324,150,2,152,174,0,0,87.36,138,12,"茂安村",NULL
325,457,29,486,613,0,0,79.28,431,26,"四季村",NULL
326,442,11,453,543,0,0,83.43,329,113,"南山村",NULL
327,320,10,330,417,0,0,79.14,297,23,"東岳村",NULL
328,788,16,804,1019,0,0,78.9,721,67,"南澳村",NULL
329,585,13,598,736,0,0,81.25,544,41,"碧候村",NULL
330,273,3,276,364,0,0,75.82,255,18,"金岳村",NULL
331,303,4,307,409,0,0,75.06,238,65,"武塔村",NULL
332,299,15,314,407,0,0,77.15,281,18,"金洋村",NULL
333,451,18,469,625,0,0,75.04,412,39,"澳花村",NULL
1,903,19,922,1104,0,0,83.51,417,486,"大林里",NULL
2,1171,28,1199,1430,0,0,83.85,498,673,"大林里",NULL
3,1309,14,1323,1635,0,0,80.92,690,619,"大林里",NULL
4,969,24,993,1161,0,0,85.53,492,477,"大林里",NULL
5,1494,21,1515,1837,0,0,82.47,874,620,"雲林里",NULL
6,1049,21,1070,1266,0,0,84.52,662,387,"雲林里",NULL
7,1316,39,1355,1655,0,0,81.87,681,635,"雲林里",NULL
8,1000,27,1027,1232,0,0,83.36,495,505,"大豐里",NULL
9,1283,31,1314,1556,0,0,84.45,621,662,"大豐里",NULL
10,1090,25,1115,1378,0,0,80.91,595,495,"大豐里",NULL
11,1073,35,1108,1297,0,0,85.43,528,545,"福林里",NULL
12,1459,27,1486,1784,0,0,83.3,874,585,"福林里",NULL
13,1123,35,1158,1398,0,0,82.83,541,582,"福林里",NULL
14,1352,40,1392,1732,0,0,80.37,748,604,"福安里",NULL
15,1259,39,1298,1555,0,0,83.47,613,646,"福安里",NULL
16,1268,36,1304,1603,0,0,81.35,637,631,"豐林里",NULL
17,1412,34,1446,1776,0,0,81.42,697,715,"豐林里",NULL
18,1382,30,1412,1709,0,0,82.62,768,614,"豐林里",NULL
19,1150,29,1179,1460,0,0,80.75,566,584,"建國里",NULL
20,1319,31,1350,1636,0,0,82.52,756,563,"建國里",NULL
21,946,12,958,1200,0,0,79.83,518,428,"建國里",NULL
22,1000,14,1014,1274,0,0,79.59,568,432,"東門里",NULL
23,1058,10,1068,1333,0,0,80.12,570,488,"東門里",NULL
24,819,22,841,1026,0,0,81.97,415,404,"東山里",NULL
25,636,12,648,832,0,0,77.88,296,340,"東山里",NULL
26,721,31,752,914,0,0,82.28,352,369,"萬壽里",NULL
27,1162,50,1212,1542,0,0,78.6,559,603,"武陵里",NULL
28,1122,31,1153,1409,0,0,81.83,533,589,"民生里",NULL
29,640,12,652,806,0,0,80.89,369,271,"文化里",NULL
30,1107,42,1149,1406,0,0,81.72,598,509,"文明里",NULL
31,760,10,770,944,0,0,81.57,314,446,"文昌里",NULL
32,914,16,930,1148,0,0,81.01,457,457,"南門里",NULL
33,1212,21,1233,1487,0,0,82.92,663,549,"南門里",NULL
34,903,23,926,1118,0,0,82.83,476,427,"南門里",NULL
35,816,32,848,1045,0,0,81.15,431,385,"南門里",NULL
36,1128,22,1150,1375,0,0,83.64,481,647,"南華里",NULL
37,1052,29,1081,1376,0,0,78.56,506,546,"西門里",NULL
38,1097,22,1119,1334,0,0,83.88,570,527,"西湖里",NULL
39,757,11,768,925,0,0,83.03,300,457,"長美里",NULL
40,631,18,649,783,0,0,82.89,213,418,"永興里",NULL
41,760,20,780,943,0,0,82.71,340,420,"永興里",NULL
42,1365,36,1401,1671,0,0,83.84,592,773,"中興里",NULL
43,1110,26,1136,1348,0,0,84.27,530,580,"中興里",NULL
44,1364,30,1394,1719,0,0,81.09,710,654,"中興里",NULL
45,1117,36,1153,1402,0,0,82.24,492,625,"光興里",NULL
46,1199,37,1236,1464,0,0,84.43,572,627,"光興里",NULL
47,1174,18,1192,1821,0,0,65.46,642,532,"光興里",NULL
48,1131,20,1151,1418,0,0,81.17,584,547,"中路里",NULL
49,1339,32,1371,1659,0,0,82.64,806,533,"中路里",NULL
50,1227,25,1252,1528,0,0,81.94,658,569,"中信里",NULL
51,886,15,901,1102,0,0,81.76,439,447,"中信里",NULL
52,816,29,845,1068,0,0,79.12,437,379,"中信里",NULL
53,1317,22,1339,1616,0,0,82.86,703,614,"中山里",NULL
54,1190,25,1215,1487,0,0,81.71,651,539,"中山里",NULL
55,1088,18,1106,1334,0,0,82.91,606,482,"中山里",NULL
56,1394,28,1422,1765,0,0,80.57,865,529,"中平里",NULL
57,1343,35,1378,1688,0,0,81.64,703,640,"中平里",NULL
58,1120,28,1148,1391,0,0,82.53,711,409,"中原里",NULL
59,1126,15,1141,1380,0,0,82.68,673,453,"中原里",NULL
60,1194,16,1210,1482,0,0,81.65,754,440,"中泰里",NULL
61,1330,16,1346,1576,0,0,85.41,911,419,"中泰里",NULL
62,1130,18,1148,1410,0,0,81.42,675,455,"中泰里",NULL
63,1186,21,1207,1543,0,0,78.22,832,354,"中泰里",NULL
64,1210,48,1258,1568,0,0,80.23,803,407,"中德里",NULL
65,1037,28,1065,1284,0,0,82.94,614,423,"中德里",NULL
66,1229,27,1256,1490,0,0,84.3,453,776,"中德里",NULL
67,1124,23,1147,1361,0,0,84.28,639,485,"中正里",NULL
68,965,21,986,1208,0,0,81.62,577,388,"中正里",NULL
69,1297,32,1329,1576,0,0,84.33,672,625,"中正里",NULL
70,998,28,1026,1262,0,0,81.3,458,540,"文中里",NULL
71,1040,20,1060,1243,0,0,85.28,630,410,"文中里",NULL
72,804,32,836,1002,0,0,83.43,293,511,"中成里",NULL
73,1208,24,1232,1494,0,0,82.46,534,674,"中成里",NULL
74,880,27,907,1155,0,0,78.53,551,329,"中成里",NULL
75,1042,29,1071,1292,0,0,82.89,416,626,"玉山里",NULL
76,1109,32,1141,1389,0,0,82.15,575,534,"玉山里",NULL
77,1177,31,1208,1529,0,0,79.01,611,566,"玉山里",NULL
78,1051,29,1080,1303,0,0,82.89,536,515,"泰山里",NULL
79,1349,40,1389,1710,0,0,81.23,739,610,"泰山里",NULL
80,1624,25,1649,1980,0,0,83.28,957,667,"龍岡里",NULL
81,1410,29,1439,1790,0,0,80.39,944,466,"龍岡里",NULL
82,1273,27,1300,1608,0,0,80.85,715,558,"龍安里",NULL
83,1144,15,1159,1384,0,0,83.74,632,512,"龍安里",NULL
84,1433,26,1459,1785,0,0,81.74,850,583,"龍鳳里",NULL
85,1012,12,1024,1231,0,0,83.18,629,383,"龍鳳里",NULL
86,1117,37,1154,1447,0,0,79.75,696,421,"龍鳳里",NULL
87,1048,25,1073,1348,0,0,79.6,660,388,"龍祥里",NULL
88,1158,36,1194,1413,0,0,84.5,666,492,"龍祥里",NULL
89,1194,15,1209,1559,0,0,77.55,715,479,"龍祥里",NULL
90,1151,17,1168,1430,0,0,81.68,671,480,"龍祥里",NULL
91,761,27,788,950,0,0,82.95,323,438,"龍山里",NULL
92,723,19,742,926,0,0,80.13,456,267,"龍山里",NULL
93,1125,61,1186,1480,0,0,80.14,796,329,"龍山里",NULL
94,1115,28,1143,1393,0,0,82.05,504,611,"東埔里",NULL
95,1092,28,1120,1365,0,0,82.05,491,601,"東埔里",NULL
96,1018,34,1052,1286,0,0,81.8,481,537,"東埔里",NULL
97,1018,31,1049,1307,0,0,80.26,484,534,"信光里",NULL
98,1326,31,1357,1664,0,0,81.55,681,645,"信光里",NULL
99,924,28,952,1185,0,0,80.34,407,517,"信光里",NULL
100,951,25,976,1183,0,0,82.5,395,556,"永安里",NULL
101,969,33,1002,1226,0,0,81.73,384,585,"永安里",NULL
102,1143,33,1176,1438,0,0,81.78,502,641,"永安里",NULL
103,1360,15,1375,1697,0,0,81.03,797,563,"中寧里",NULL
104,1115,14,1129,1355,0,0,83.32,661,454,"中寧里",NULL
105,1192,18,1210,1453,0,0,83.28,693,499,"中寧里",NULL
106,1051,14,1065,1314,0,0,81.05,580,471,"中寧里",NULL
107,1235,13,1248,1542,0,0,80.93,715,520,"中寧里",NULL
108,823,31,854,1034,0,0,82.59,298,525,"中埔里",NULL
109,740,30,770,913,0,0,84.34,258,482,"中埔里",NULL
110,1324,10,1334,1623,0,0,82.19,724,600,"南埔里",NULL
111,1091,22,1113,1343,0,0,82.87,521,570,"南埔里",NULL
112,1756,24,1780,2149,0,0,82.83,1070,686,"寶慶里",NULL
113,1266,24,1290,1633,0,0,79,767,499,"寶慶里",NULL
114,1448,31,1479,1844,0,0,80.21,848,600,"寶慶里",NULL
115,1201,17,1218,1581,0,0,77.04,718,483,"北埔里",NULL
116,1068,24,1092,1347,0,0,81.07,607,461,"北埔里",NULL
117,1595,32,1627,2049,0,0,79.4,855,740,"北埔里",NULL
118,1231,15,1246,1553,0,0,80.23,775,456,"北埔里",NULL
119,1083,51,1134,1348,0,0,84.12,360,723,"西埔里",NULL
120,885,33,918,1062,0,0,86.44,300,585,"西埔里",NULL
121,1126,41,1167,1448,0,0,80.59,586,540,"慈文里",NULL
122,1229,30,1259,1540,0,0,81.75,573,656,"慈文里",NULL
123,1153,23,1176,1461,0,0,80.49,611,542,"慈文里",NULL
124,1478,25,1503,1819,0,0,82.63,833,645,"新埔里",NULL
125,1465,35,1500,1852,0,0,80.99,870,595,"新埔里",NULL
126,1448,42,1490,1730,0,0,86.13,893,555,"新埔里",NULL
127,964,20,984,1235,0,0,79.68,566,398,"同安里",NULL
128,1120,28,1148,1414,0,0,81.19,540,580,"同安里",NULL
129,1001,7,1008,1224,0,0,82.35,531,470,"同安里",NULL
130,976,20,996,1246,0,0,79.94,513,463,"同安里",NULL
131,1163,20,1183,1418,0,0,83.43,724,439,"莊敬里",NULL
132,1121,14,1135,1409,0,0,80.55,719,402,"莊敬里",NULL
133,960,19,979,1190,0,0,82.27,564,396,"莊敬里",NULL
134,857,12,869,1119,0,0,77.66,522,335,"莊敬里",NULL
135,1683,27,1710,2057,0,0,83.13,933,750,"自強里",NULL
136,1232,19,1251,1511,0,0,82.79,696,536,"自強里",NULL
137,981,4,985,1205,0,0,81.74,627,354,"自強里",NULL
138,1117,33,1150,1408,0,0,81.68,530,587,"長安里",NULL
139,1145,33,1178,1459,0,0,80.74,554,591,"長安里",NULL
140,1275,26,1301,1616,0,0,80.51,602,673,"長德里",NULL
141,1263,38,1301,1592,0,0,81.72,625,638,"長德里",NULL
142,1160,28,1188,1408,0,0,84.38,450,710,"中和里",NULL
143,1267,41,1308,1584,0,0,82.58,550,717,"北門里",NULL
144,1445,51,1496,1867,0,0,80.13,681,764,"朝陽里",NULL
145,1188,28,1216,1505,0,0,80.8,469,719,"青溪里",NULL
146,907,35,942,1133,0,0,83.14,351,556,"青溪里",NULL
147,1331,24,1355,1614,0,0,83.95,706,625,"青溪里",NULL
148,1255,19,1274,1515,0,0,84.09,715,540,"成功里",NULL
149,1544,22,1566,1871,0,0,83.7,848,696,"成功里",NULL
150,1442,25,1467,1750,0,0,83.83,895,547,"三民里",NULL
151,1461,37,1498,1837,0,0,81.55,985,476,"三民里",NULL
152,1275,45,1320,1655,0,0,79.76,760,515,"忠義里",NULL
153,1010,13,1023,1281,0,0,79.86,641,369,"忠義里",NULL
154,1599,51,1650,2018,0,0,81.76,887,712,"忠義里",NULL
155,1308,19,1327,1634,0,0,81.21,842,466,"忠義里",NULL
156,1123,22,1145,1414,0,0,80.98,622,501,"大興里",NULL
157,986,41,1027,1302,0,0,78.88,449,537,"大興里",NULL
158,1692,23,1715,2099,0,0,81.71,925,767,"大興里",NULL
159,861,33,894,1085,0,0,82.4,425,436,"大興里",NULL
160,1372,16,1388,1802,0,0,77.03,891,481,"會稽里",NULL
161,1277,27,1304,1638,0,0,79.61,766,511,"會稽里",NULL
162,1137,21,1158,1512,0,0,76.59,719,418,"會稽里",NULL
163,1069,16,1085,1312,0,0,82.7,665,404,"大有里",NULL
164,975,22,997,1288,0,0,77.41,683,292,"大有里",NULL
165,1706,20,1726,2156,0,0,80.06,977,729,"寶山里",NULL
166,1891,42,1933,2429,0,0,79.58,1196,695,"寶山里",NULL
167,1124,35,1159,1458,0,0,79.49,645,479,"春日里",NULL
168,1216,43,1259,1559,0,0,80.76,576,640,"春日里",NULL
169,1081,24,1105,1446,0,0,76.42,625,456,"春日里",NULL
170,1213,40,1253,1492,0,0,83.98,478,735,"汴洲里",NULL
171,1433,62,1495,1844,0,0,81.07,761,672,"汴洲里",NULL
172,1253,31,1284,1612,0,0,79.65,746,507,"後寮里",NULL
173,1368,43,1411,1771,0,0,79.67,899,469,"後寮里",NULL
174,1385,37,1422,1749,0,0,81.3,775,610,"明德里",NULL
175,1442,20,1462,1759,0,0,83.12,783,659,"明德里",NULL
176,1360,34,1394,1760,0,0,79.2,942,418,"至善里",NULL
177,1438,22,1460,1749,0,0,83.48,1082,356,"至善里",NULL
178,1535,49,1584,2012,0,0,78.73,1110,425,"至善里",NULL
179,1060,29,1089,1307,0,0,83.32,601,459,"龍興里",NULL
180,765,27,792,985,0,0,80.41,424,341,"龍興里",NULL
181,960,12,972,1161,0,0,83.72,604,356,"龍興里",NULL
182,769,22,791,983,0,0,80.47,573,196,"龍德里",NULL
183,1211,37,1248,1509,0,0,82.7,786,425,"龍德里",NULL
184,1134,30,1164,1399,0,0,83.2,797,337,"龍岡里",NULL
185,938,35,973,1162,0,0,83.73,718,220,"龍岡里",NULL
186,1078,37,1115,1329,0,0,83.9,806,272,"龍岡里",NULL
187,1068,39,1107,1353,0,0,81.82,823,245,"龍東里",NULL
188,1185,29,1214,1438,0,0,84.42,975,210,"龍東里",NULL
189,1130,38,1168,1349,0,0,86.58,975,155,"龍東里",NULL
190,1127,39,1166,1429,0,0,81.6,795,332,"龍昌里",NULL
191,1145,41,1186,1430,0,0,82.94,798,347,"龍昌里",NULL
192,1337,46,1383,1680,0,0,82.32,952,385,"龍昌里",NULL
193,1115,37,1152,1333,0,0,86.42,973,142,"龍平里",NULL
194,1189,46,1235,1480,0,0,83.45,932,257,"龍平里",NULL
195,888,26,914,1077,0,0,84.87,776,112,"龍安里",NULL
196,1117,39,1156,1346,0,0,85.88,928,189,"龍安里",NULL
197,1035,22,1057,1260,0,0,83.89,680,355,"仁美里",NULL
198,1116,19,1135,1404,0,0,80.84,714,402,"仁美里",NULL
199,681,24,705,841,0,0,83.83,452,229,"仁美里",NULL
200,969,25,994,1223,0,0,81.28,648,321,"仁福里",NULL
201,953,33,986,1199,0,0,82.24,758,195,"仁福里",NULL
202,992,29,1021,1301,0,0,78.48,690,302,"仁福里",NULL
203,692,26,718,854,0,0,84.07,392,300,"仁愛里",NULL
204,1006,22,1028,1260,0,0,81.59,631,375,"仁愛里",NULL
205,869,28,897,1095,0,0,81.92,661,208,"華愛里",NULL
206,849,12,861,1057,0,0,81.46,590,259,"華愛里",NULL
207,957,51,1008,1188,0,0,84.85,705,252,"仁德里",NULL
208,1007,28,1035,1283,0,0,80.67,762,245,"仁德里",NULL
209,929,27,956,1195,0,0,80,651,278,"仁和里",NULL
210,866,19,885,1084,0,0,81.64,623,243,"仁和里",NULL
211,1040,32,1072,1338,0,0,80.12,789,251,"仁祥里",NULL
212,1090,38,1128,1335,0,0,84.49,805,285,"仁祥里",NULL
213,1243,38,1281,1486,0,0,86.2,982,261,"華勛里",NULL
214,1095,52,1147,1362,0,0,84.21,902,193,"華勛里",NULL
215,956,43,999,1201,0,0,83.18,832,124,"中堅里",NULL
216,866,35,901,1115,0,0,80.81,708,158,"中堅里",NULL
217,662,24,686,827,0,0,82.95,535,127,"中堅里",NULL
218,663,21,684,829,0,0,82.51,647,16,"中堅里",NULL
219,845,32,877,1085,0,0,80.83,479,366,"普仁里",NULL
220,877,24,901,1113,0,0,80.95,502,375,"普仁里",NULL
221,945,27,972,1226,0,0,79.28,564,381,"普仁里",NULL
222,1029,31,1060,1313,0,0,80.73,606,423,"普忠里",NULL
223,952,23,975,1208,0,0,80.71,623,329,"普忠里",NULL
224,1199,19,1218,1408,0,0,86.51,767,432,"普強里",NULL
225,1208,24,1232,1505,0,0,81.86,803,405,"普強里",NULL
226,1264,23,1287,1519,0,0,84.73,743,521,"信義里",NULL
227,1324,34,1358,1642,0,0,82.7,807,517,"信義里",NULL
228,1486,32,1518,1910,0,0,79.48,820,666,"正義里",NULL
229,1226,24,1250,1522,0,0,82.13,719,507,"正義里",NULL
230,855,25,880,1073,0,0,82.01,471,384,"普慶里",NULL
231,996,26,1022,1222,0,0,83.63,613,383,"普慶里",NULL
232,788,12,800,981,0,0,81.55,442,346,"普義里",NULL
233,703,17,720,888,0,0,81.08,474,229,"普義里",NULL
234,791,27,818,997,0,0,82.05,368,423,"德義里",NULL
235,1025,25,1050,1258,0,0,83.47,626,399,"德義里",NULL
236,1137,27,1164,1438,0,0,80.95,621,516,"仁義里",NULL
237,752,14,766,979,0,0,78.24,394,358,"仁義里",NULL
238,1204,32,1236,1515,0,0,81.58,670,534,"忠義里",NULL
239,1046,48,1094,1408,0,0,77.7,732,314,"興仁里",NULL
240,1231,30,1261,1558,0,0,80.94,852,379,"興仁里",NULL
241,1376,35,1411,1710,0,0,82.51,1018,358,"中正里",NULL
242,1467,35,1502,1847,0,0,81.32,1014,453,"中正里",NULL
243,1249,30,1279,1533,0,0,83.43,883,366,"中山里",NULL
244,1323,32,1355,1677,0,0,80.8,950,373,"中山里",NULL
245,1690,32,1722,2126,0,0,81,1170,520,"中山里",NULL
246,1399,67,1466,1840,0,0,79.67,1137,262,"篤行里",NULL
247,362,11,373,411,0,0,90.75,345,17,"自立里",NULL
248,99,2,101,124,0,0,81.45,91,8,"自立里",NULL
249,980,25,1005,1212,0,0,82.92,736,244,"自立里",NULL
250,1323,22,1345,1616,0,0,83.23,952,371,"自立里",NULL
251,1053,27,1080,1315,0,0,82.13,696,357,"自強里",NULL
252,1121,11,1132,1358,0,0,83.36,842,279,"自強里",NULL
253,1137,26,1163,1378,0,0,84.4,965,172,"自治里",NULL
254,1097,22,1119,1314,0,0,85.16,983,114,"自治里",NULL
255,608,19,627,714,0,0,87.82,557,51,"莊敬里",NULL
256,905,26,931,1157,0,0,80.47,682,223,"莊敬里",NULL
257,930,34,964,1196,0,0,80.6,648,282,"內壢里",NULL
258,927,37,964,1170,0,0,82.39,634,293,"內壢里",NULL
259,991,33,1024,1257,0,0,81.46,643,348,"成功里",NULL
260,1316,35,1351,1684,0,0,80.23,823,493,"成功里",NULL
261,1042,29,1071,1291,0,0,82.96,620,422,"福德里",NULL
262,985,22,1007,1218,0,0,82.68,638,347,"福德里",NULL
263,881,18,899,1049,0,0,85.7,424,457,"中原里",NULL
264,932,32,964,1156,0,0,83.39,546,386,"中原里",NULL
265,1103,27,1130,1402,0,0,80.6,731,372,"中原里",NULL
266,924,31,955,1145,0,0,83.41,555,369,"忠孝里",NULL
267,803,22,825,1030,0,0,80.1,510,293,"忠孝里",NULL
268,926,28,954,1169,0,0,81.61,567,359,"復興里",NULL
269,908,14,922,1149,0,0,80.24,565,343,"復興里",NULL
270,1640,53,1693,2122,0,0,79.78,971,669,"復興里",NULL
271,1412,41,1453,1733,0,0,83.84,856,556,"復華里",NULL
272,1340,34,1374,1661,0,0,82.72,842,498,"復華里",NULL
273,1393,36,1429,1740,0,0,82.13,787,606,"文化里",NULL
274,1341,28,1369,1722,0,0,79.5,797,544,"文化里",NULL
275,1233,30,1263,1572,0,0,80.34,670,563,"文化里",NULL
276,762,22,784,949,0,0,82.61,454,308,"和平里",NULL
277,849,26,875,1032,0,0,84.79,510,339,"和平里",NULL
278,1495,53,1548,1847,0,0,83.81,605,890,"內定里",NULL
279,1335,57,1392,1675,0,0,83.1,601,734,"內定里",NULL
280,746,27,773,1018,0,0,75.93,354,392,"石頭里",NULL
281,664,16,680,1325,0,0,51.32,355,309,"石頭里",NULL
282,947,25,972,1164,0,0,83.51,587,360,"中央里",NULL
283,769,22,791,1009,0,0,78.39,420,349,"中央里",NULL
284,863,27,890,1074,0,0,82.87,423,440,"中央里",NULL
285,1331,33,1364,1637,0,0,83.32,734,597,"新興里",NULL
286,1204,25,1229,1525,0,0,80.59,693,511,"新興里",NULL
287,1219,29,1248,1513,0,0,82.49,729,490,"新興里",NULL
288,1157,23,1180,1447,0,0,81.55,680,477,"新興里",NULL
289,860,16,876,1050,0,0,83.43,468,392,"振興里",NULL
290,1264,32,1296,1613,0,0,80.35,827,437,"振興里",NULL
291,1137,26,1163,1387,0,0,83.85,628,509,"振興里",NULL
292,1046,31,1077,1364,0,0,78.96,572,474,"東興里",NULL
293,983,26,1009,1255,0,0,80.4,491,492,"東興里",NULL
294,1103,26,1129,1367,0,0,82.59,652,451,"健行里",NULL
295,1620,32,1652,2096,0,0,78.82,948,672,"健行里",NULL
296,1063,36,1099,1332,0,0,82.51,450,613,"水尾里",NULL
297,1400,38,1438,1742,0,0,82.55,722,678,"水尾里",NULL
298,801,7,808,973,0,0,83.04,547,254,"水尾里",NULL
299,910,12,922,1061,0,0,86.9,653,257,"水尾里",NULL
300,936,24,960,1152,0,0,83.33,384,552,"忠福里",NULL
301,919,25,944,1122,0,0,84.14,605,314,"忠福里",NULL
302,1062,46,1108,1364,0,0,81.23,454,608,"忠福里",NULL
303,1406,19,1425,1720,0,0,82.85,840,566,"忠福里",NULL
304,1036,22,1058,1308,0,0,80.89,485,551,"幸福里",NULL
305,1145,18,1163,1429,0,0,81.39,672,473,"幸福里",NULL
306,1184,28,1212,1494,0,0,81.12,697,487,"幸福里",NULL
307,646,23,669,835,0,0,80.12,296,350,"永福里",NULL
308,1264,22,1286,1564,0,0,82.23,632,632,"永福里",NULL
309,1485,34,1519,1840,0,0,82.55,825,660,"永福里",NULL
310,897,20,917,1098,0,0,83.52,431,466,"青埔里",NULL
311,1470,48,1518,1950,0,0,77.85,826,644,"新街里",NULL
312,1598,17,1615,2063,0,0,78.28,899,699,"興南里",NULL
313,1032,17,1049,1325,0,0,79.17,494,538,"興國里",NULL
314,1207,30,1237,1466,0,0,84.38,584,623,"興國里",NULL
315,1336,37,1373,1670,0,0,82.22,623,713,"興國里",NULL
316,915,32,947,1098,0,0,86.25,327,588,"興和里",NULL
317,1129,28,1157,1405,0,0,82.35,530,599,"興和里",NULL
318,815,32,847,1040,0,0,81.44,408,407,"永興里",NULL
319,670,26,696,836,0,0,83.25,311,359,"中壢里",NULL
320,729,21,750,979,0,0,76.61,345,384,"中榮里",NULL
321,821,11,832,1064,0,0,78.2,359,462,"中建里",NULL
322,856,28,884,1042,0,0,84.84,597,259,"舊明里",NULL
323,852,32,884,1077,0,0,82.08,428,424,"舊明里",NULL
324,823,27,850,1021,0,0,83.25,371,452,"新明里",NULL
325,884,16,900,1079,0,0,83.41,418,466,"新明里",NULL
326,1176,27,1203,1472,0,0,81.73,667,509,"新明里",NULL
327,1034,29,1063,1361,0,0,78.1,597,437,"光明里",NULL
328,1144,44,1188,1449,0,0,81.99,608,536,"光明里",NULL
329,1358,31,1389,1662,0,0,83.57,857,501,"光明里",NULL
330,1101,33,1134,1380,0,0,82.17,459,642,"永光里",NULL
331,1515,35,1550,1931,0,0,80.27,865,650,"永光里",NULL
332,1105,45,1150,1383,0,0,83.15,378,727,"三民里",NULL
333,1006,33,1039,1263,0,0,82.26,486,520,"三民里",NULL
334,934,31,965,1210,0,0,79.75,463,471,"五權里",NULL
335,1013,18,1031,1303,0,0,79.13,473,540,"五權里",NULL
336,1307,38,1345,1613,0,0,83.38,604,703,"五權里",NULL
337,1445,52,1497,1834,0,0,81.62,635,810,"五福里",NULL
338,1136,33,1169,1447,0,0,80.79,581,555,"五福里",NULL
339,666,39,705,834,0,0,84.53,210,456,"芝芭里",NULL
340,943,34,977,1172,0,0,83.36,303,640,"芝芭里",NULL
341,982,53,1035,1285,0,0,80.54,334,648,"洽溪里",NULL
342,1411,78,1489,1828,0,0,81.46,570,841,"內厝里",NULL
343,1349,40,1389,1691,0,0,82.14,479,870,"內厝里",NULL
344,1224,48,1272,1532,0,0,83.03,401,823,"月眉里",NULL
345,1347,45,1392,1614,0,0,86.25,305,1042,"月眉里",NULL
346,1046,64,1110,1353,0,0,82.04,382,664,"山東里",NULL
347,1223,54,1277,1506,0,0,84.79,331,892,"山東里",NULL
348,1070,30,1100,1299,0,0,84.68,454,616,"過嶺里",NULL
349,951,36,987,1201,0,0,82.18,412,539,"過嶺里",NULL
350,773,28,801,985,0,0,81.32,347,426,"平鎮里",NULL
351,959,54,1013,1257,0,0,80.59,439,520,"平鎮里",NULL
352,800,35,835,1007,0,0,82.92,464,336,"平鎮里",NULL
353,965,33,998,1208,0,0,82.62,425,540,"鎮興里",NULL
354,967,43,1010,1239,0,0,81.52,476,491,"鎮興里",NULL
355,982,33,1015,1245,0,0,81.53,471,511,"南勢里",NULL
356,1017,33,1050,1264,0,0,83.07,516,501,"南勢里",NULL
357,1030,21,1051,1326,0,0,79.26,601,429,"南勢里",NULL
358,863,21,884,1114,0,0,79.35,477,386,"金星里",NULL
359,922,16,938,1152,0,0,81.42,491,431,"金星里",NULL
360,1192,37,1229,1514,0,0,81.18,562,630,"平安里",NULL
361,1240,38,1278,1539,0,0,83.04,671,569,"平安里",NULL
362,1301,27,1328,1621,0,0,81.92,777,524,"平南里",NULL
363,1463,26,1489,1801,0,0,82.68,905,558,"平南里",NULL
364,908,23,931,1132,0,0,82.24,603,305,"山峰里",NULL
365,939,32,971,1170,0,0,82.99,614,325,"山峰里",NULL
366,630,32,662,789,0,0,83.9,171,459,"福林里",NULL
367,1044,34,1078,1275,0,0,84.55,654,390,"福林里",NULL
368,820,35,855,1018,0,0,83.99,442,378,"湧光里",NULL
369,826,36,862,1047,0,0,82.33,543,283,"湧光里",NULL
370,738,19,757,945,0,0,80.11,543,195,"湧光里",NULL
371,656,7,663,792,0,0,83.71,454,202,"湧光里",NULL
372,591,21,612,744,0,0,82.26,341,250,"湧光里",NULL
373,835,45,880,1037,0,0,84.86,618,217,"莊敬里",NULL
374,763,16,779,959,0,0,81.23,518,245,"莊敬里",NULL
375,809,35,844,1007,0,0,83.81,709,100,"莊敬里",NULL
376,784,16,800,956,0,0,83.68,487,297,"莊敬里",NULL
377,1150,38,1188,1440,0,0,82.5,673,477,"湧豐里",NULL
378,654,24,678,853,0,0,79.48,388,266,"湧安里",NULL
379,840,27,867,1073,0,0,80.8,495,345,"湧安里",NULL
380,828,21,849,1062,0,0,79.94,480,348,"湧安里",NULL
381,1077,46,1123,1397,0,0,80.39,570,507,"宋屋里",NULL
382,1274,25,1299,1600,0,0,81.19,722,552,"宋屋里",NULL
383,949,26,975,1225,0,0,79.59,590,359,"平興里",NULL
384,1086,21,1107,1426,0,0,77.63,657,429,"平興里",NULL
385,1068,10,1078,1296,0,0,83.18,480,588,"廣興里",NULL
386,1074,25,1099,1338,0,0,82.14,582,492,"廣興里",NULL
387,1187,21,1208,1499,0,0,80.59,662,525,"廣興里",NULL
388,783,18,801,966,0,0,82.92,370,413,"廣達里",NULL
389,840,17,857,1029,0,0,83.28,395,445,"廣達里",NULL
390,845,30,875,1058,0,0,82.7,396,449,"廣達里",NULL
391,893,25,918,1147,0,0,80.03,461,432,"廣仁里",NULL
392,872,26,898,1140,0,0,78.77,492,380,"廣仁里",NULL
393,971,35,1006,1282,0,0,78.47,549,422,"廣仁里",NULL
394,886,13,899,1053,0,0,85.38,550,336,"復旦里",NULL
395,909,11,920,1138,0,0,80.84,560,349,"復旦里",NULL
396,895,15,910,1121,0,0,81.18,545,350,"復旦里",NULL
397,1049,26,1075,1302,0,0,82.57,554,495,"復興里",NULL
398,713,24,737,916,0,0,80.46,371,342,"復興里",NULL
399,1102,27,1129,1322,0,0,85.4,583,519,"復興里",NULL
400,883,31,914,1121,0,0,81.53,497,386,"義民里",NULL
401,876,18,894,1048,0,0,85.31,508,368,"義民里",NULL
402,930,6,936,1174,0,0,79.73,546,384,"義民里",NULL
403,1071,22,1093,1258,0,0,86.88,549,522,"義興里",NULL
404,955,34,989,1165,0,0,84.89,453,502,"義興里",NULL
405,873,29,902,1086,0,0,83.06,447,426,"義興里",NULL
406,1058,23,1081,1355,0,0,79.78,607,451,"義興里",NULL
407,1137,47,1184,1428,0,0,82.91,666,471,"雙連里",NULL
408,1028,31,1059,1259,0,0,84.11,602,426,"雙連里",NULL
409,849,48,897,1122,0,0,79.95,566,283,"雙連里",NULL
410,964,39,1003,1212,0,0,82.76,305,659,"高雙里",NULL
411,1296,26,1322,1579,0,0,83.72,665,631,"高雙里",NULL
412,968,18,986,1195,0,0,82.51,548,420,"北勢里",NULL
413,912,15,927,1096,0,0,84.58,433,479,"北勢里",NULL
414,978,21,999,1226,0,0,81.48,597,381,"北華里",NULL
415,1016,20,1036,1196,0,0,86.62,526,490,"北華里",NULL
416,1280,41,1321,1645,0,0,80.3,638,642,"新勢里",NULL
417,1463,28,1491,1828,0,0,81.56,819,644,"新勢里",NULL
418,610,25,635,746,0,0,85.12,335,275,"北安里",NULL
419,673,18,691,822,0,0,84.06,310,363,"北安里",NULL
420,1181,23,1204,1431,0,0,84.14,708,473,"新榮里",NULL
421,913,21,934,1198,0,0,77.96,548,365,"新榮里",NULL
422,1123,30,1153,1363,0,0,84.59,584,539,"新榮里",NULL
423,986,29,1015,1459,0,0,69.57,524,462,"新富里",NULL
424,1417,19,1436,1741,0,0,82.48,935,482,"新富里",NULL
425,972,22,994,1191,0,0,83.46,651,321,"新英里",NULL
426,766,5,771,942,0,0,81.85,513,253,"新英里",NULL
427,1014,26,1040,1270,0,0,81.89,613,401,"北興里",NULL
428,1081,31,1112,1388,0,0,80.12,603,478,"北興里",NULL
429,759,14,773,939,0,0,82.32,329,430,"北興里",NULL
430,754,13,767,904,0,0,84.85,441,313,"金陵里",NULL
431,647,20,667,794,0,0,84.01,364,283,"金陵里",NULL
432,1132,28,1160,1425,0,0,81.4,591,541,"新貴里",NULL
433,1030,39,1069,1282,0,0,83.39,507,523,"新貴里",NULL
434,1012,28,1040,1276,0,0,81.5,575,437,"建安里",NULL
435,945,38,983,1188,0,0,82.74,534,411,"建安里",NULL
436,851,24,875,1059,0,0,82.63,347,504,"建安里",NULL
437,966,29,995,1208,0,0,82.37,762,204,"華安里",NULL
438,951,12,963,1124,0,0,85.68,684,267,"華安里",NULL
439,931,22,953,1190,0,0,80.08,691,240,"華安里",NULL
440,877,43,920,1099,0,0,83.71,607,270,"東安里",NULL
441,929,26,955,1179,0,0,81,664,265,"東安里",NULL
442,1249,37,1286,1612,0,0,79.78,840,409,"新安里",NULL
443,1219,42,1261,1521,0,0,82.91,804,415,"新安里",NULL
444,643,27,670,817,0,0,82.01,176,467,"東勢里",NULL
445,824,17,841,1015,0,0,82.86,348,476,"東勢里",NULL
446,914,23,937,1118,0,0,83.81,387,527,"東勢里",NULL
447,953,36,989,1244,0,0,79.5,650,303,"東勢里",NULL
448,1150,24,1174,1433,0,0,81.93,570,580,"北貴里",NULL
449,1358,34,1392,1692,0,0,82.27,809,549,"北貴里",NULL
450,746,20,766,939,0,0,81.58,378,368,"北富里",NULL
451,946,22,968,1118,0,0,86.58,572,374,"北富里",NULL
452,932,23,955,1180,0,0,80.93,434,498,"北富里",NULL
453,1224,22,1246,1544,0,0,80.7,947,277,"龍恩里",NULL
454,852,9,861,1087,0,0,79.21,627,225,"龍恩里",NULL
455,1180,45,1225,1453,0,0,84.31,713,467,"東社里",NULL
456,1304,48,1352,1657,0,0,81.59,946,358,"東社里",NULL
457,955,37,992,1258,0,0,78.86,922,33,"忠貞里",NULL
458,1027,45,1072,1265,0,0,84.74,993,34,"貿易里",NULL
459,721,23,744,906,0,0,82.12,683,38,"貿易里",NULL
460,875,33,908,1109,0,0,81.88,633,242,"龍興里",NULL
461,938,41,979,1186,0,0,82.55,752,186,"龍興里",NULL
462,1091,46,1137,1347,0,0,84.41,1023,68,"中正里",NULL
463,1225,46,1271,1617,0,0,78.6,593,632,"興仁里",NULL
464,1327,41,1368,2008,0,0,68.13,781,546,"興仁里",NULL
465,1199,26,1225,1475,0,0,83.05,543,656,"福興里",NULL
466,1071,51,1122,1378,0,0,81.42,658,413,"福興里",NULL
467,1126,43,1169,1395,0,0,83.8,782,344,"瑞豐里",NULL
468,1743,53,1796,2191,0,0,81.97,892,851,"瑞興里",NULL
469,1243,33,1276,1591,0,0,80.2,722,521,"瑞泰里",NULL
470,1208,34,1242,1555,0,0,79.87,613,595,"瑞泰里",NULL
471,1220,54,1274,1523,0,0,83.65,737,483,"瑞發里",NULL
472,1296,56,1352,1670,0,0,80.96,893,403,"瑞發里",NULL
473,1286,49,1335,1580,0,0,84.49,886,400,"瑞德里",NULL
474,1281,12,1293,1624,0,0,79.62,1020,261,"瑞德里",NULL
475,1209,56,1265,1517,0,0,83.39,868,341,"瑞祥里",NULL
476,1221,39,1260,1511,0,0,83.39,965,256,"瑞祥里",NULL
477,1496,53,1549,1945,0,0,79.64,752,744,"廣興里",NULL
478,1372,53,1425,1737,0,0,82.04,752,620,"廣興里",NULL
479,1017,22,1039,1214,0,0,85.58,563,454,"廣興里",NULL
480,1687,83,1770,2074,0,0,85.34,1119,568,"廣隆里",NULL
481,823,22,845,1007,0,0,83.91,456,367,"廣隆里",NULL
482,1176,47,1223,1517,0,0,80.62,695,481,"竹園里",NULL
483,1121,21,1142,1408,0,0,81.11,579,542,"竹園里",NULL
484,1228,36,1264,1607,0,0,78.66,637,591,"霄裡里",NULL
485,890,32,922,1126,0,0,81.88,741,149,"霄裡里",NULL
486,976,44,1020,1197,0,0,85.21,767,209,"霄裡里",NULL
487,1273,37,1310,1639,0,0,79.93,746,527,"茄明里",NULL
488,1052,23,1075,1394,0,0,77.12,650,402,"茄明里",NULL
489,1309,39,1348,1616,0,0,83.42,604,705,"茄苳里",NULL
490,1041,32,1073,1323,0,0,81.1,501,540,"茄苳里",NULL
491,1017,34,1051,1269,0,0,82.82,564,453,"茄苳里",NULL
492,1382,49,1431,1768,0,0,80.94,696,686,"高明里",NULL
493,1020,44,1064,1307,0,0,81.41,586,434,"高明里",NULL
494,1633,47,1680,2080,0,0,80.77,923,710,"高城里",NULL
495,1404,46,1450,1748,0,0,82.95,622,782,"白鷺里",NULL
496,571,23,594,732,0,0,81.15,354,217,"白鷺里",NULL
497,945,27,972,1161,0,0,83.72,406,539,"大湳里",NULL
498,1204,30,1234,1575,0,0,78.35,637,567,"大湳里",NULL
499,1328,42,1370,1722,0,0,79.56,630,698,"大發里",NULL
500,1490,28,1518,1834,0,0,82.77,755,735,"大仁里",NULL
501,1079,36,1115,1360,0,0,81.99,510,569,"大仁里",NULL
502,1506,32,1538,1894,0,0,81.2,703,803,"大明里",NULL
503,293,6,299,379,0,0,78.89,144,149,"大明里",NULL
504,919,31,950,1148,0,0,82.75,380,539,"大安里",NULL
505,1167,28,1195,1425,0,0,83.86,618,549,"大安里",NULL
506,1157,42,1199,1492,0,0,80.36,568,589,"大竹里",NULL
507,889,20,909,1117,0,0,81.38,524,365,"大興里",NULL
508,938,29,967,1106,0,0,87.43,416,522,"大興里",NULL
509,740,31,771,937,0,0,82.28,476,264,"大愛里",NULL
510,739,12,751,881,0,0,85.24,445,294,"大愛里",NULL
511,994,17,1011,1219,0,0,82.94,599,395,"大華里",NULL
512,1229,23,1252,1613,0,0,77.62,717,512,"大華里",NULL
513,1001,41,1042,1274,0,0,81.79,648,353,"大華里",NULL
514,1563,39,1602,1997,0,0,80.22,1051,512,"大和里",NULL
515,950,29,979,1225,0,0,79.92,554,396,"大和里",NULL
516,793,31,824,962,0,0,85.65,432,361,"大昌里",NULL
517,1320,47,1367,1697,0,0,80.55,828,492,"大昌里",NULL
518,1397,35,1432,1889,0,0,75.81,842,555,"大信里",NULL
519,877,63,940,1140,0,0,82.46,636,241,"大信里",NULL
520,781,159,940,1868,0,0,50.32,758,23,"大信里",NULL
521,1758,59,1817,2109,0,0,86.15,1679,79,"大同里",NULL
522,1191,36,1227,1455,0,0,84.33,591,600,"大同里",NULL
523,1125,29,1154,1414,0,0,81.61,637,488,"大慶里",NULL
524,1382,47,1429,1706,0,0,83.76,683,699,"大成里",NULL
525,1406,64,1470,1756,0,0,83.71,855,551,"大成里",NULL
526,1187,60,1247,1560,0,0,79.94,821,366,"大義里",NULL
527,1274,47,1321,1603,0,0,82.41,788,486,"大義里",NULL
528,797,25,822,1008,0,0,81.55,393,404,"大忠里",NULL
529,636,42,678,868,0,0,78.11,501,135,"大忠里",NULL
530,1055,57,1112,1327,0,0,83.8,761,294,"大智里",NULL
531,903,14,917,1075,0,0,85.3,645,258,"大智里",NULL
532,1694,21,1715,2069,0,0,82.89,1043,651,"大宏里",NULL
533,894,14,908,1091,0,0,83.23,452,442,"大正里",NULL
534,822,10,832,1057,0,0,78.71,514,308,"大正里",NULL
535,1160,27,1187,1469,0,0,80.8,556,604,"大福里",NULL
536,826,19,845,1039,0,0,81.33,412,414,"大福里",NULL
537,810,7,817,951,0,0,85.91,529,281,"大福里",NULL
538,1260,36,1296,1592,0,0,81.41,666,594,"大強里",NULL
539,835,26,861,1041,0,0,82.71,358,477,"大強里",NULL
540,977,38,1015,1186,0,0,85.58,479,498,"大勇里",NULL
541,840,19,859,1054,0,0,81.5,464,376,"大勇里",NULL
542,1220,25,1245,1547,0,0,80.48,659,561,"大榮里",NULL
543,1272,54,1326,1611,0,0,82.31,859,413,"大千里",NULL
544,971,27,998,1253,0,0,79.65,614,357,"大漢里",NULL
545,1117,23,1140,1355,0,0,84.13,801,316,"大漢里",NULL
546,881,30,911,1138,0,0,80.05,494,387,"仁美里",NULL
547,1204,41,1245,1547,0,0,80.48,727,477,"仁美里",NULL
548,936,23,959,1152,0,0,83.25,602,334,"仁美里",NULL
549,1199,27,1226,1494,0,0,82.06,557,642,"埔心里",NULL
550,1212,60,1272,1503,0,0,84.63,779,433,"光華里",NULL
551,1212,31,1243,1501,0,0,82.81,779,433,"光華里",NULL
552,1147,52,1199,1401,0,0,85.58,1097,50,"金龍里",NULL
553,496,24,520,609,0,0,85.39,442,54,"四維里",NULL
554,720,15,735,916,0,0,80.24,489,231,"四維里",NULL
555,1098,28,1126,1429,0,0,78.8,677,421,"永平里",NULL
556,944,45,989,1236,0,0,80.02,452,492,"瑞塘里",NULL
557,902,32,934,1185,0,0,78.82,557,345,"瑞塘里",NULL
558,1129,23,1152,1451,0,0,79.39,664,465,"瑞塘里",NULL
559,934,15,949,1174,0,0,80.83,706,228,"瑞坪里",NULL
560,1058,25,1083,1398,0,0,77.47,666,392,"瑞坪里",NULL
561,1310,43,1353,1690,0,0,80.06,723,587,"梅溪里",NULL
562,1210,24,1234,1590,0,0,77.61,771,439,"梅溪里",NULL
563,1034,31,1065,1320,0,0,80.68,667,367,"金溪里",NULL
564,785,13,798,1056,0,0,75.57,519,266,"金溪里",NULL
565,1114,17,1131,1380,0,0,81.96,765,349,"金溪里",NULL
566,937,26,963,1208,0,0,79.72,573,364,"楊明里",NULL
567,1174,18,1192,1455,0,0,81.92,743,431,"楊明里",NULL
568,1728,30,1758,2196,0,0,80.05,1195,533,"裕成里",NULL
569,1029,25,1054,1480,0,0,71.22,698,331,"裕成里",NULL
570,1103,39,1142,1358,0,0,84.09,672,431,"大同里",NULL
571,1221,41,1262,1533,0,0,82.32,728,493,"大同里",NULL
572,854,13,867,1045,0,0,82.97,512,342,"中山里",NULL
573,919,14,933,1161,0,0,80.36,577,342,"中山里",NULL
574,1248,47,1295,1629,0,0,79.5,689,559,"楊梅里",NULL
575,1026,37,1063,1307,0,0,81.33,607,419,"楊梅里",NULL
576,901,32,933,1164,0,0,80.15,529,372,"楊江里",NULL
577,1189,52,1241,1579,0,0,78.59,724,465,"梅新里",NULL
578,693,26,719,893,0,0,80.52,354,339,"紅梅里",NULL
579,951,13,964,1138,0,0,84.71,565,386,"紅梅里",NULL
580,1374,46,1420,1811,0,0,78.41,771,603,"永寧里",NULL
581,1530,53,1583,1982,0,0,79.87,798,732,"永寧里",NULL
582,1081,58,1139,1397,0,0,81.53,621,460,"大平里",NULL
583,1210,54,1264,1564,0,0,80.82,678,532,"大平里",NULL
584,1058,58,1116,1366,0,0,81.7,505,553,"秀才里",NULL
585,1092,41,1133,1397,0,0,81.1,642,450,"秀才里",NULL
586,1165,53,1218,1519,0,0,80.18,568,597,"東流里",NULL
587,597,20,617,788,0,0,78.3,304,293,"東流里",NULL
588,1322,48,1370,1700,0,0,80.59,766,556,"豐野里",NULL
589,1008,42,1050,1308,0,0,80.28,483,525,"豐野里",NULL
590,998,60,1058,1327,0,0,79.73,496,502,"富岡里",NULL
591,990,39,1029,1260,0,0,81.67,510,480,"富岡里",NULL
592,1118,55,1173,1472,0,0,79.69,582,536,"富岡里",NULL
593,773,37,810,993,0,0,81.57,364,409,"員本里",NULL
594,659,34,693,867,0,0,79.93,309,350,"員本里",NULL
595,1425,25,1450,1919,0,0,75.56,846,579,"三湖里",NULL
596,1044,55,1099,1382,0,0,79.52,501,543,"三湖里",NULL
597,1251,73,1324,1710,0,0,77.43,672,579,"上湖里",NULL
598,1177,53,1230,1575,0,0,78.1,669,508,"上湖里",NULL
599,910,35,945,1121,0,0,84.3,398,512,"上田里",NULL
600,921,9,930,1143,0,0,81.36,431,490,"上田里",NULL
601,880,43,923,1194,0,0,77.3,460,420,"高山里",NULL
602,1010,31,1041,1316,0,0,79.1,608,402,"高山里",NULL
603,1028,37,1065,1281,0,0,83.14,551,477,"高山里",NULL
604,1317,35,1352,1807,0,0,74.82,869,448,"青山里",NULL
605,1027,18,1045,1263,0,0,82.74,423,604,"高榮里",NULL
606,669,18,687,870,0,0,78.97,374,295,"高榮里",NULL
607,1429,36,1465,1819,0,0,80.54,751,678,"雙榮里",NULL
608,969,16,985,1186,0,0,83.05,481,488,"新榮里",NULL
609,974,20,994,1223,0,0,81.28,531,443,"新榮里",NULL
610,725,31,756,979,0,0,77.22,395,330,"水美里",NULL
611,823,30,853,1072,0,0,79.57,434,389,"水美里",NULL
612,870,19,889,1125,0,0,79.02,455,415,"水美里",NULL
613,1133,62,1195,1456,0,0,82.07,566,567,"瑞原里",NULL
614,1245,48,1293,1697,0,0,76.19,676,569,"瑞原里",NULL
615,676,23,699,817,0,0,85.56,255,421,"興和里",NULL
616,681,24,705,853,0,0,82.65,268,413,"興和里",NULL
617,867,24,891,1079,0,0,82.58,257,610,"福仁里",NULL
618,1148,31,1179,1404,0,0,83.97,472,676,"田心里",NULL
619,906,26,932,1149,0,0,81.11,310,596,"田心里",NULL
620,1037,30,1067,1274,0,0,83.75,464,573,"田心里",NULL
621,912,35,947,1165,0,0,81.29,395,517,"一心里",NULL
622,1026,22,1048,1268,0,0,82.65,466,560,"一心里",NULL
623,863,27,890,1064,0,0,83.65,375,488,"一心里",NULL
624,1245,30,1275,1595,0,0,79.94,598,647,"一德里",NULL
625,1002,29,1031,1212,0,0,85.07,349,653,"一德里",NULL
626,1050,41,1091,1353,0,0,80.64,454,596,"一德里",NULL
627,869,29,898,1065,0,0,84.32,284,585,"月眉里",NULL
628,726,27,753,947,0,0,79.51,234,492,"永福里",NULL
629,859,24,883,1069,0,0,82.6,261,598,"康安里",NULL
630,784,43,827,976,0,0,84.73,243,541,"義和里",NULL
631,429,36,465,607,0,0,76.61,135,294,"義和里",NULL
632,850,31,881,1043,0,0,84.47,301,549,"美華里",NULL
633,832,39,871,1032,0,0,84.4,290,542,"美華里",NULL
634,581,27,608,737,0,0,82.5,193,388,"美華里",NULL
635,921,46,967,1214,0,0,79.65,306,615,"福安里",NULL
636,752,38,790,941,0,0,83.95,198,554,"福安里",NULL
637,737,53,790,969,0,0,81.53,246,491,"復興里",NULL
638,510,3,513,636,0,0,80.66,203,307,"新峰里",NULL
639,210,11,221,282,0,0,78.37,66,144,"新峰里",NULL
640,668,35,703,820,0,0,85.73,204,464,"中新里",NULL
641,586,24,610,765,0,0,79.74,233,353,"中新里",NULL
642,1082,56,1138,1379,0,0,82.52,364,718,"瑞興里",NULL
643,785,29,814,1094,0,0,74.41,403,382,"瑞興里",NULL
644,826,38,864,1022,0,0,84.54,304,522,"仁善里",NULL
645,620,19,639,796,0,0,80.28,368,252,"仁善里",NULL
646,731,27,758,937,0,0,80.9,488,243,"仁善里",NULL
647,1435,64,1499,1765,0,0,84.93,1320,115,"僑愛里",NULL
648,803,49,852,1050,0,0,81.14,618,185,"仁義里",NULL
649,641,49,690,824,0,0,83.74,562,79,"仁義里",NULL
650,680,11,691,836,0,0,82.66,590,90,"仁義里",NULL
651,860,23,883,1128,0,0,78.28,518,342,"仁和里",NULL
652,1074,40,1114,1386,0,0,80.38,601,473,"仁和里",NULL
653,1041,37,1078,1275,0,0,84.55,472,569,"仁愛里",NULL
654,798,23,821,1016,0,0,80.81,498,300,"仁愛里",NULL
655,761,21,782,990,0,0,78.99,544,217,"仁武里",NULL
656,954,36,990,1196,0,0,82.78,546,408,"仁武里",NULL
657,984,35,1019,1270,0,0,80.24,578,406,"仁文里",NULL
658,720,36,756,958,0,0,78.91,446,274,"仁文里",NULL
659,647,26,673,816,0,0,82.48,356,291,"仁文里",NULL
660,1030,41,1071,1352,0,0,79.22,451,579,"南興里",NULL
661,1185,57,1242,1502,0,0,82.69,446,739,"南興里",NULL
662,1077,51,1128,1389,0,0,81.21,573,504,"南興里",NULL
663,938,35,973,1173,0,0,82.95,542,396,"員林里",NULL
664,699,25,724,909,0,0,79.65,468,231,"光明里",NULL
665,819,21,840,1069,0,0,78.58,605,214,"光明里",NULL
666,716,16,732,854,0,0,85.71,436,280,"瑞源里",NULL
667,795,23,818,1033,0,0,79.19,381,414,"瑞源里",NULL
668,912,46,958,1159,0,0,82.66,359,553,"瑞源里",NULL
669,831,26,857,1039,0,0,82.48,531,300,"三元里",NULL
670,852,29,881,1048,0,0,84.06,661,191,"三元里",NULL
671,355,7,362,440,0,0,82.27,306,49,"三元里",NULL
672,1064,28,1092,1346,0,0,81.13,452,612,"龜山村",NULL
673,1241,61,1302,1588,0,0,81.99,758,483,"龜山村",NULL
674,1377,40,1417,1761,0,0,80.47,734,643,"龜山村",NULL
675,1246,52,1298,1535,0,0,84.56,752,494,"新路村",NULL
676,854,28,882,1095,0,0,80.55,426,428,"新路村",NULL
677,1048,25,1073,1354,0,0,79.25,618,430,"新路村",NULL
678,1029,35,1064,1263,0,0,84.24,517,512,"新路村",NULL
679,1206,19,1225,1544,0,0,79.34,681,525,"大同村",NULL
680,1113,31,1144,1444,0,0,79.22,545,568,"大同村",NULL
681,1100,31,1131,1373,0,0,82.37,693,407,"大同村",NULL
682,1004,37,1041,1309,0,0,79.53,602,402,"中興村",NULL
683,1035,26,1061,1328,0,0,79.89,523,512,"中興村",NULL
684,961,41,1002,1227,0,0,81.66,463,498,"中興村",NULL
685,1201,36,1237,1730,0,0,71.5,865,336,"新興村",NULL
686,512,21,533,679,0,0,78.5,496,16,"陸光村",NULL
687,1044,26,1070,1258,0,0,85.06,814,230,"精忠村",NULL
688,774,33,807,916,0,0,88.1,697,77,"精忠村",NULL
689,1432,50,1482,1841,0,0,80.5,798,634,"福源村",NULL
690,1034,35,1069,1389,0,0,76.96,555,479,"兔坑村",NULL
691,1022,25,1047,1371,0,0,76.37,508,514,"兔坑村",NULL
692,1274,32,1306,1620,0,0,80.62,605,669,"迴龍村",NULL
693,1075,19,1094,1379,0,0,79.33,588,487,"迴龍村",NULL
694,1116,33,1149,1461,0,0,78.64,596,520,"迴龍村",NULL
695,1011,27,1038,1305,0,0,79.54,523,488,"龍華村",NULL
696,1118,19,1137,1430,0,0,79.51,608,510,"龍華村",NULL
697,440,21,461,602,0,0,76.58,233,207,"龍壽村",NULL
698,791,27,818,954,0,0,85.74,242,549,"龍壽村",NULL
699,724,37,761,976,0,0,77.97,271,453,"嶺頂村",NULL
700,840,29,869,1078,0,0,80.61,417,423,"嶺頂村",NULL
701,840,20,860,1120,0,0,76.79,410,430,"嶺頂村",NULL
702,1132,33,1165,1501,0,0,77.61,682,450,"新嶺村",NULL
703,1215,37,1252,1614,0,0,77.57,565,650,"新嶺村",NULL
704,812,54,866,1047,0,0,82.71,275,537,"舊路村",NULL
705,698,44,742,905,0,0,81.99,258,440,"舊路村",NULL
706,1203,33,1236,1599,0,0,77.3,688,515,"山德村",NULL
707,1186,39,1225,1500,0,0,81.67,606,580,"山德村",NULL
708,1357,43,1400,1721,0,0,81.35,701,656,"山德村",NULL
709,1146,44,1190,1469,0,0,81.01,722,424,"山頂村",NULL
710,1786,63,1849,2674,0,0,69.15,978,808,"山頂村",NULL
711,1168,29,1197,1497,0,0,79.96,603,565,"山福村",NULL
712,1064,31,1095,1361,0,0,80.46,551,513,"山福村",NULL
713,1098,35,1133,1456,0,0,77.82,662,436,"幸福村",NULL
714,1109,37,1146,1494,0,0,76.71,649,460,"幸福村",NULL
715,1081,36,1117,1437,0,0,77.73,654,427,"幸福村",NULL
716,1143,24,1167,1478,0,0,78.96,720,423,"大湖村",NULL
717,802,10,812,981,0,0,82.77,453,349,"大湖村",NULL
718,1226,22,1248,1582,0,0,78.89,672,554,"大華村",NULL
719,1405,20,1425,1765,0,0,80.74,719,686,"大華村",NULL
720,1206,71,1277,1625,0,0,78.58,795,411,"大崗村",NULL
721,1198,41,1239,1518,0,0,81.62,548,650,"大崗村",NULL
722,926,44,970,1187,0,0,81.72,499,427,"公西村",NULL
723,1063,32,1095,1333,0,0,82.15,525,538,"文化村",NULL
724,1216,28,1244,1568,0,0,79.34,626,590,"文化村",NULL
725,1171,35,1206,1575,0,0,76.57,517,654,"樂善村",NULL
726,1001,24,1025,1339,0,0,76.55,601,400,"樂善村",NULL
727,1009,24,1033,1300,0,0,79.46,543,466,"長庚村",NULL
728,1196,19,1215,1462,0,0,83.11,625,571,"長庚村",NULL
729,1068,43,1111,1361,0,0,81.63,410,658,"大坑村",NULL
730,1046,44,1090,1308,0,0,83.33,476,570,"南上村",NULL
731,1136,35,1171,1432,0,0,81.77,579,557,"南美村",NULL
732,1223,33,1256,1533,0,0,81.93,561,662,"楓樹村",NULL
733,1260,29,1289,1540,0,0,83.7,567,693,"楓樹村",NULL
734,978,42,1020,1220,0,0,83.61,268,710,"新興村",NULL
735,823,29,852,1014,0,0,84.02,279,544,"新興村",NULL
736,872,28,900,1093,0,0,82.34,386,486,"新興村",NULL
737,1355,44,1399,1737,0,0,80.54,589,766,"中福村",NULL
738,1331,45,1376,1654,0,0,83.19,408,923,"中福村",NULL
739,1410,10,1420,1785,0,0,79.55,513,897,"新莊村",NULL
740,991,48,1039,1246,0,0,83.39,423,568,"新莊村",NULL
741,979,20,999,1201,0,0,83.18,466,513,"上竹村",NULL
742,833,18,851,1001,0,0,85.01,419,414,"上竹村",NULL
743,869,46,915,1074,0,0,85.2,346,523,"宏竹村",NULL
744,942,36,978,1157,0,0,84.53,318,624,"宏竹村",NULL
745,1399,28,1427,1708,0,0,83.55,729,670,"大竹村",NULL
746,979,28,1007,1219,0,0,82.61,508,471,"大竹村",NULL
747,937,40,977,1150,0,0,84.96,254,683,"富竹村",NULL
748,564,29,593,747,0,0,79.38,544,20,"大華村",NULL
749,705,27,732,846,0,0,86.52,683,22,"大華村",NULL
750,791,44,835,1000,0,0,83.5,265,526,"蘆竹村",NULL
751,817,39,856,979,0,0,87.44,192,625,"蘆竹村",NULL
752,780,37,817,966,0,0,84.58,271,509,"蘆竹村",NULL
753,1031,43,1074,1246,0,0,86.2,358,673,"南興村",NULL
754,1700,31,1731,2118,0,0,81.73,1013,687,"南興村",NULL
755,1164,26,1190,1472,0,0,80.84,677,487,"南興村",NULL
756,1956,36,1992,2528,0,0,78.8,1109,847,"南興村",NULL
757,2285,31,2316,2868,0,0,80.75,1334,951,"南興村",NULL
758,760,21,781,1000,0,0,78.1,356,404,"南榮村",NULL
759,1530,34,1564,1906,0,0,82.06,853,677,"南榮村",NULL
760,906,27,933,1136,0,0,82.13,412,494,"南崁村",NULL
761,1145,31,1176,1571,0,0,74.86,591,554,"南崁村",NULL
762,1146,42,1188,1399,0,0,84.92,534,612,"錦興村",NULL
763,1431,28,1459,1781,0,0,81.92,769,662,"錦興村",NULL
764,718,18,736,883,0,0,83.35,320,398,"錦中村",NULL
765,763,27,790,967,0,0,81.7,324,439,"錦中村",NULL
766,1379,33,1412,1787,0,0,79.02,631,748,"長興村",NULL
767,1757,36,1793,2178,0,0,82.32,949,808,"五福村",NULL
768,1796,26,1822,2280,0,0,79.91,1056,740,"五福村",NULL
769,1506,47,1553,1855,0,0,83.72,791,715,"羊稠村",NULL
770,1179,17,1196,1431,0,0,83.58,751,428,"羊稠村",NULL
771,1845,23,1868,2299,0,0,81.25,1166,679,"羊稠村",NULL
772,1395,20,1415,1793,0,0,78.92,825,570,"營盤村",NULL
773,1654,37,1691,2104,0,0,80.37,927,727,"營盤村",NULL
774,1291,39,1330,1782,0,0,74.64,761,530,"瓦窯村",NULL
775,720,30,750,880,0,0,85.23,306,414,"內厝村",NULL
776,815,40,855,1037,0,0,82.45,302,513,"內厝村",NULL
777,1150,55,1205,1485,0,0,81.14,460,690,"山鼻村",NULL
778,873,42,915,1121,0,0,81.62,275,598,"山腳村",NULL
779,881,32,913,1113,0,0,82.03,363,518,"山腳村",NULL
780,773,36,809,988,0,0,81.88,274,499,"山腳村",NULL
781,991,58,1049,1241,0,0,84.53,292,699,"外社村",NULL
782,1268,66,1334,1580,0,0,84.43,320,948,"坑子村",NULL
783,702,35,737,883,0,0,83.47,275,427,"坑口村",NULL
784,1035,67,1102,1316,0,0,83.74,375,660,"坑口村",NULL
785,1182,41,1223,1595,0,0,76.68,664,518,"海湖村",NULL
786,981,52,1033,1300,0,0,79.46,474,507,"海湖村",NULL
787,957,44,1001,1273,0,0,78.63,472,485,"海湖村",NULL
788,1470,57,1527,1835,0,0,83.22,601,869,"大園村",NULL
789,1257,57,1314,1578,0,0,83.27,633,624,"大園村",NULL
790,1405,57,1462,1851,0,0,78.98,660,745,"大園村",NULL
791,1030,40,1070,1302,0,0,82.18,406,624,"田心村",NULL
792,1107,32,1139,1439,0,0,79.15,542,565,"田心村",NULL
793,1275,55,1330,1678,0,0,79.26,532,743,"田心村",NULL
794,1227,66,1293,1616,0,0,80.01,551,676,"溪海村",NULL
795,1275,80,1355,1767,0,0,76.68,517,758,"溪海村",NULL
796,1104,68,1172,1428,0,0,82.07,360,744,"和平村",NULL
797,1369,53,1422,1802,0,0,78.91,609,760,"橫峰村",NULL
798,1450,79,1529,1935,0,0,79.02,704,746,"橫峰村",NULL
799,1134,37,1171,1461,0,0,80.15,529,605,"橫峰村",NULL
800,887,49,936,1102,0,0,84.94,294,593,"五權村",NULL
801,1084,44,1128,1381,0,0,81.68,377,707,"五權村",NULL
802,1032,45,1077,1315,0,0,81.9,404,628,"五權村",NULL
803,1023,46,1069,1265,0,0,84.51,319,704,"埔心村",NULL
804,1156,46,1202,1493,0,0,80.51,552,604,"埔心村",NULL
805,1321,64,1385,1682,0,0,82.34,599,722,"埔心村",NULL
806,1096,45,1141,1371,0,0,83.22,638,458,"大海村",NULL
807,587,29,616,721,0,0,85.44,568,19,"建華村",NULL
808,884,49,933,1129,0,0,82.64,338,546,"三石村",NULL
809,1184,63,1247,1453,0,0,85.82,632,552,"三石村",NULL
810,1421,16,1437,1782,0,0,80.64,650,771,"菓林村",NULL
811,1001,42,1043,1329,0,0,78.48,507,494,"菓林村",NULL
812,1082,48,1130,1448,0,0,78.04,491,591,"菓林村",NULL
813,674,29,703,824,0,0,85.32,346,328,"竹圍村",NULL
814,1152,40,1192,1517,0,0,78.58,598,554,"竹圍村",NULL
815,1105,59,1164,1437,0,0,81,562,543,"海口村",NULL
816,882,57,939,1200,0,0,78.25,458,424,"沙崙村",NULL
817,1005,56,1061,1370,0,0,77.45,460,545,"沙崙村",NULL
818,1417,12,1429,1759,0,0,81.24,632,785,"後厝村",NULL
819,683,28,711,900,0,0,79,319,364,"圳頭村",NULL
820,862,34,896,1125,0,0,79.64,294,568,"圳頭村",NULL
821,1366,73,1439,1785,0,0,80.62,633,733,"內海村",NULL
822,933,45,978,1224,0,0,79.9,373,560,"北港村",NULL
823,827,49,876,1128,0,0,77.66,410,417,"北港村",NULL
824,1070,40,1110,1456,0,0,76.24,496,574,"南港村",NULL
825,912,28,940,1244,0,0,75.56,474,438,"南港村",NULL
826,963,28,991,1274,0,0,77.79,633,330,"黃唐村",NULL
827,989,22,1011,1232,0,0,82.06,520,469,"黃唐村",NULL
828,862,27,889,1094,0,0,81.26,482,380,"黃唐村",NULL
829,1064,43,1107,1346,0,0,82.24,624,440,"永興村",NULL
830,936,39,975,1169,0,0,83.4,558,378,"永興村",NULL
831,944,38,982,1196,0,0,82.11,507,437,"中山村",NULL
832,1226,42,1268,1508,0,0,84.08,638,588,"中山村",NULL
833,916,28,944,1133,0,0,83.32,569,347,"中山村",NULL
834,1474,48,1522,1936,0,0,78.62,734,740,"烏樹林村",NULL
835,1182,39,1221,1546,0,0,78.98,672,510,"烏林村",NULL
836,1275,59,1334,1656,0,0,80.56,913,362,"烏林村",NULL
837,1890,34,1924,2334,0,0,82.43,1388,502,"百年村",NULL
838,460,29,489,598,0,0,81.77,447,13,"干城村",NULL
839,1039,55,1094,1372,0,0,79.74,673,366,"凌雲村",NULL
840,1191,51,1242,1548,0,0,80.23,723,468,"凌雲村",NULL
841,891,28,919,1157,0,0,79.43,582,309,"龍祥村",NULL
842,1023,45,1068,1282,0,0,83.31,697,326,"龍祥村",NULL
843,859,29,888,1096,0,0,81.02,452,407,"八德村",NULL
844,806,34,840,1093,0,0,76.85,509,297,"八德村",NULL
845,808,27,835,1029,0,0,81.15,442,366,"八德村",NULL
846,867,32,899,1161,0,0,77.43,437,430,"聖德村",NULL
847,903,22,925,1200,0,0,77.08,558,345,"聖德村",NULL
848,940,18,958,1217,0,0,78.72,431,509,"上林村",NULL
849,1350,61,1411,1738,0,0,81.19,775,575,"上林村",NULL
850,865,23,888,1058,0,0,83.93,409,456,"龍潭村",NULL
851,725,22,747,898,0,0,83.18,352,373,"龍潭村",NULL
852,1086,20,1106,1320,0,0,83.79,664,422,"龍星村",NULL
853,1137,30,1167,1518,0,0,76.88,600,537,"龍星村",NULL
854,1128,32,1160,1389,0,0,83.51,706,422,"中正村",NULL
855,1125,29,1154,1447,0,0,79.75,697,428,"中正村",NULL
856,900,19,919,1110,0,0,82.79,545,355,"上華村",NULL
857,848,33,881,1085,0,0,81.2,651,197,"上華村",NULL
858,934,27,961,1183,0,0,81.23,650,284,"九龍村",NULL
859,1350,9,1359,1684,0,0,80.7,825,525,"九龍村",NULL
860,845,21,866,1063,0,0,81.47,552,293,"武漢村",NULL
861,733,21,754,963,0,0,78.3,427,306,"武漢村",NULL
862,1384,21,1405,1710,0,0,82.16,1060,324,"東興村",NULL
863,1255,65,1320,1654,0,0,79.81,995,260,"東興村",NULL
864,1301,52,1353,1652,0,0,81.9,865,436,"中興村",NULL
865,1340,57,1397,1702,0,0,82.08,925,415,"中興村",NULL
866,873,17,890,1120,0,0,79.46,596,277,"北興村",NULL
867,649,22,671,858,0,0,78.21,512,137,"北興村",NULL
868,851,38,889,1068,0,0,83.24,471,380,"佳安村",NULL
869,930,20,950,1148,0,0,82.75,782,148,"佳安村",NULL
870,834,12,846,967,0,0,87.49,666,168,"佳安村",NULL
871,985,44,1029,1301,0,0,79.09,366,619,"三坑村",NULL
872,890,29,919,1126,0,0,81.62,390,500,"大平村",NULL
873,1051,28,1079,1320,0,0,81.74,698,353,"三林村",NULL
874,689,6,695,816,0,0,85.17,477,212,"三林村",NULL
875,1253,18,1271,1502,0,0,84.62,949,304,"建林村",NULL
876,1343,16,1359,1634,0,0,83.17,1000,343,"建林村",NULL
877,1260,26,1286,1561,0,0,82.38,955,305,"富林村",NULL
878,1003,23,1026,1218,0,0,84.24,707,296,"富林村",NULL
879,1004,29,1033,1247,0,0,82.84,509,495,"高平村",NULL
880,1038,28,1066,1305,0,0,81.69,514,524,"高平村",NULL
881,1125,30,1155,1411,0,0,81.86,556,569,"高原村",NULL
882,1161,22,1183,1478,0,0,80.04,580,581,"高原村",NULL
883,1055,25,1080,1294,0,0,83.46,470,585,"三和村",NULL
884,518,47,565,681,0,0,82.97,148,370,"三水村",NULL
885,915,42,957,1197,0,0,79.95,417,498,"觀音村",NULL
886,934,44,978,1192,0,0,82.05,417,517,"觀音村",NULL
887,849,58,907,1114,0,0,81.42,396,453,"白玉村",NULL
888,1033,61,1094,1319,0,0,82.94,482,551,"廣興村",NULL
889,897,34,931,1172,0,0,79.44,352,545,"大潭村",NULL
890,1224,71,1295,1605,0,0,80.69,505,719,"保生村",NULL
891,541,20,561,686,0,0,81.78,198,343,"武威村",NULL
892,567,37,604,753,0,0,80.21,214,353,"三和村",NULL
893,504,31,535,662,0,0,80.82,185,319,"新興村",NULL
894,926,64,990,1230,0,0,80.49,379,547,"坑尾村",NULL
895,1485,68,1553,1916,0,0,81.05,591,894,"金湖村",NULL
896,1498,64,1562,1928,0,0,81.02,557,941,"藍埔村",NULL
897,1441,54,1495,1824,0,0,81.96,478,963,"大同村",NULL
898,818,40,858,1050,0,0,81.71,248,570,"大堀村",NULL
899,1345,62,1407,1745,0,0,80.63,531,814,"崙坪村",NULL
900,1452,82,1534,1860,0,0,82.47,581,871,"崙坪村",NULL
901,1515,69,1584,1975,0,0,80.2,673,842,"富源村",NULL
902,1308,69,1377,1729,0,0,79.64,502,806,"上大村",NULL
903,1058,38,1096,1304,0,0,84.05,425,633,"新坡村",NULL
904,1002,54,1056,1286,0,0,82.12,272,730,"新坡村",NULL
905,1431,60,1491,1830,0,0,81.48,437,994,"廣福村",NULL
906,734,43,777,969,0,0,80.19,289,445,"塔腳村",NULL
907,1439,76,1515,1884,0,0,80.41,536,903,"保障村",NULL
908,1236,46,1282,1517,0,0,84.51,441,795,"草漯村",NULL
909,1539,46,1585,1990,0,0,79.65,719,820,"草漯村",NULL
910,1233,72,1305,1695,0,0,76.99,525,708,"樹林村",NULL
911,1075,17,1092,1348,0,0,81.01,425,650,"富林村",NULL
912,947,35,982,1181,0,0,83.15,474,473,"新屋村",NULL
913,980,6,986,1227,0,0,80.36,491,489,"新屋村",NULL
914,1126,47,1173,1383,0,0,84.82,560,566,"新生村",NULL
915,1261,44,1305,1574,0,0,82.91,700,561,"新生村",NULL
916,970,45,1015,1242,0,0,81.72,430,540,"後湖村",NULL
917,1216,58,1274,1580,0,0,80.63,585,631,"清華村",NULL
918,1220,11,1231,1516,0,0,81.2,525,695,"清華村",NULL
919,1314,81,1395,1690,0,0,82.54,527,787,"石磊村",NULL
920,922,57,979,1186,0,0,82.55,393,529,"東明村",NULL
921,1117,12,1129,1325,0,0,85.21,414,703,"社子村",NULL
922,1617,68,1685,2075,0,0,81.2,751,866,"埔頂村",NULL
923,1405,87,1492,1841,0,0,81.04,578,827,"九斗村",NULL
924,1141,17,1158,1407,0,0,82.3,516,625,"頭洲村",NULL
925,1174,46,1220,1468,0,0,83.11,450,724,"頭洲村",NULL
926,1026,42,1068,1328,0,0,80.42,369,657,"大坡村",NULL
927,1186,50,1236,1474,0,0,83.85,437,749,"望間村",NULL
928,905,9,914,1115,0,0,81.97,435,470,"後庄村",NULL
929,679,11,690,866,0,0,79.68,258,421,"蚵間村",NULL
930,503,34,537,674,0,0,79.67,237,266,"深圳村",NULL
931,805,58,863,1050,0,0,82.19,340,465,"康榔村",NULL
932,763,65,828,1033,0,0,80.15,351,412,"笨港村",NULL
933,747,33,780,902,0,0,86.47,337,410,"永安村",NULL
934,1049,46,1095,1335,0,0,82.02,482,567,"永安村",NULL
935,732,43,775,944,0,0,82.1,239,493,"永興村",NULL
936,514,31,545,688,0,0,79.22,200,314,"下埔村",NULL
937,657,17,674,804,0,0,83.83,261,396,"石牌村",NULL
938,1210,72,1282,1591,0,0,80.58,490,720,"下田村",NULL
939,845,5,850,1066,0,0,79.74,367,478,"赤欄村",NULL
940,1290,72,1362,1742,0,0,78.19,706,584,"三民村",NULL
941,853,46,899,1190,0,0,75.55,630,223,"澤仁村",NULL
942,324,11,335,452,0,0,74.12,300,24,"霞雲村",NULL
943,418,28,446,580,0,0,76.9,387,31,"義盛村",NULL
944,589,39,628,860,0,0,73.02,464,125,"羅浮村",NULL
945,377,24,401,532,0,0,75.38,300,77,"長興村",NULL
946,352,22,374,514,0,0,72.76,315,37,"奎輝村",NULL
947,413,17,430,639,0,0,67.29,349,64,"高義村",NULL
948,364,21,385,512,0,0,75.2,332,32,"三光村",NULL
949,676,28,704,1028,0,0,68.48,488,188,"華陵村",NULL
1,999,31,1030,1230,0,0,83.74,600,399,"鹿場里",NULL
2,202,5,207,237,0,0,87.34,80,122,"東平里",NULL
3,1222,24,1246,1516,0,0,82.19,712,510,"中興里",NULL
4,449,13,462,559,0,0,82.65,250,199,"隘口里",NULL
5,1029,35,1064,1296,0,0,82.1,684,345,"東海里",NULL
6,995,41,1036,1288,0,0,80.43,636,359,"東海里",NULL
7,883,25,908,1094,0,0,83,543,340,"十興里",NULL
8,1113,43,1156,1393,0,0,82.99,724,389,"十興里",NULL
9,1238,22,1260,1548,0,0,81.4,708,530,"十興里",NULL
10,1327,23,1350,1602,0,0,84.27,902,425,"十興里",NULL
11,1355,20,1375,1640,0,0,83.84,880,475,"斗崙里",NULL
12,1577,23,1600,1869,0,0,85.61,976,601,"斗崙里",NULL
13,1193,28,1221,1421,0,0,85.93,730,463,"斗崙里",NULL
14,1043,11,1054,1214,0,0,86.82,689,354,"北崙里",NULL
15,1095,18,1113,1304,0,0,85.35,688,407,"北崙里",NULL
16,856,22,878,1064,0,0,82.52,522,334,"新崙里",NULL
17,1122,12,1134,1382,0,0,82.05,677,445,"新崙里",NULL
18,972,27,999,1237,0,0,80.76,496,476,"新崙里",NULL
19,917,22,939,1129,0,0,83.17,647,270,"竹北里",NULL
20,957,21,978,1196,0,0,81.77,592,365,"竹北里",NULL
21,915,24,939,1184,0,0,79.31,607,308,"竹北里",NULL
22,1334,32,1366,1700,0,0,80.35,837,497,"竹仁里",NULL
23,1124,21,1145,1412,0,0,81.09,750,374,"竹仁里",NULL
24,1000,22,1022,1276,0,0,80.09,659,341,"竹仁里",NULL
25,1024,14,1038,1260,0,0,82.38,675,349,"竹仁里",NULL
26,939,20,959,1154,0,0,83.1,593,346,"竹仁里",NULL
27,633,9,642,782,0,0,82.1,402,231,"福德里",NULL
28,877,16,893,1071,0,0,83.38,583,294,"福德里",NULL
29,760,13,773,1016,0,0,76.08,423,337,"福德里",NULL
30,607,16,623,756,0,0,82.41,366,241,"竹義里",NULL
31,588,9,597,734,0,0,81.34,379,209,"竹義里",NULL
32,945,20,965,1190,0,0,81.09,557,388,"竹義里",NULL
33,942,12,954,1200,0,0,79.5,569,373,"竹義里",NULL
34,1165,47,1212,1487,0,0,81.51,689,476,"泰和里",NULL
35,897,25,922,1158,0,0,79.62,560,337,"泰和里",NULL
36,897,6,903,1088,0,0,83,604,293,"泰和里",NULL
37,987,21,1008,1262,0,0,79.87,653,334,"新社里",NULL
38,1119,21,1140,1423,0,0,80.11,672,447,"新社里",NULL
39,1179,11,1190,1450,0,0,82.07,760,419,"新社里",NULL
40,994,19,1013,1251,0,0,80.98,586,408,"新社里",NULL
41,962,22,984,1200,0,0,82,578,384,"新國里",NULL
42,1115,28,1143,1379,0,0,82.89,681,434,"新國里",NULL
43,805,18,823,1017,0,0,80.92,447,358,"新國里",NULL
44,1007,15,1022,1247,0,0,81.96,567,440,"聯興里",NULL
45,817,21,838,1007,0,0,83.22,438,379,"聯興里",NULL
46,833,18,851,1031,0,0,82.54,525,308,"聯興里",NULL
47,987,40,1027,1214,0,0,84.6,455,532,"麻園里",NULL
48,701,16,717,858,0,0,83.57,341,360,"溪州里",NULL
49,740,18,758,967,0,0,78.39,387,353,"溪州里",NULL
50,717,22,739,919,0,0,80.41,363,354,"新庄里",NULL
51,576,20,596,717,0,0,83.12,297,279,"白地里",NULL
52,795,24,819,984,0,0,83.23,309,486,"白地里",NULL
53,912,18,930,1097,0,0,84.78,320,592,"新港里",NULL
54,1145,36,1181,1443,0,0,81.84,635,510,"大眉里",NULL
55,700,15,715,851,0,0,84.02,302,398,"大義里",NULL
56,447,18,465,567,0,0,82.01,176,271,"大義里",NULL
57,545,19,564,669,0,0,84.3,216,329,"尚義里",NULL
58,546,17,563,673,0,0,83.66,231,315,"尚義里",NULL
59,729,21,750,897,0,0,83.61,350,379,"崇義里",NULL
60,687,10,697,818,0,0,85.21,274,413,"崇義里",NULL
61,326,12,338,427,0,0,79.16,234,92,"上坪里",NULL
62,276,11,287,375,0,0,76.53,198,78,"瑞峰里",NULL
63,290,9,299,369,0,0,81.03,175,115,"軟橋里",NULL
64,650,14,664,862,0,0,77.03,466,184,"員崠里",NULL
65,848,15,863,1076,0,0,80.2,613,235,"員崠里",NULL
66,1104,30,1134,1419,0,0,79.92,826,278,"上館里",NULL
67,1248,11,1259,1590,0,0,79.18,915,333,"上館里",NULL
68,1121,29,1150,1444,0,0,79.64,822,299,"上館里",NULL
69,1103,21,1124,1317,0,0,85.35,724,379,"上館里",NULL
70,946,28,974,1141,0,0,85.36,709,237,"上館里",NULL
71,782,28,810,985,0,0,82.23,641,141,"東寧里",NULL
72,738,5,743,909,0,0,81.74,529,209,"東寧里",NULL
73,775,15,790,967,0,0,81.7,498,277,"東寧里",NULL
74,562,16,578,736,0,0,78.53,355,207,"中正里",NULL
75,682,11,693,822,0,0,84.31,443,239,"中正里",NULL
76,953,21,974,1212,0,0,80.36,664,289,"大鄉里",NULL
77,875,20,895,1110,0,0,80.63,595,280,"大鄉里",NULL
78,1098,29,1127,1340,0,0,84.1,802,296,"大鄉里",NULL
79,733,14,747,914,0,0,81.73,505,228,"中山里",NULL
80,748,7,755,875,0,0,86.29,476,272,"中山里",NULL
81,946,25,971,1155,0,0,84.07,630,316,"南華里",NULL
82,667,17,684,798,0,0,85.71,433,234,"東華里",NULL
83,1120,27,1147,1460,0,0,78.56,821,299,"商華里",NULL
84,915,23,938,1137,0,0,82.5,610,305,"商華里",NULL
85,763,13,776,998,0,0,77.76,552,211,"鷄林里",NULL
86,1060,12,1072,1291,0,0,83.04,771,289,"鷄林里",NULL
87,853,25,878,1041,0,0,84.34,610,243,"鷄林里",NULL
88,1044,31,1075,1356,0,0,79.28,776,268,"仁愛里",NULL
89,1188,33,1221,1471,0,0,83,775,413,"仁愛里",NULL
90,527,11,538,640,0,0,84.06,332,195,"竹東里",NULL
91,668,11,679,818,0,0,83.01,427,241,"竹東里",NULL
92,1140,28,1168,1435,0,0,81.39,795,345,"忠孝里",NULL
93,601,13,614,740,0,0,82.97,399,202,"榮樂里",NULL
94,579,8,587,696,0,0,84.34,410,169,"榮樂里",NULL
95,944,23,967,1149,0,0,84.16,676,268,"榮華里",NULL
96,879,22,901,1054,0,0,85.48,631,248,"榮華里",NULL
97,716,13,729,886,0,0,82.28,517,199,"榮華里",NULL
98,1158,10,1168,1390,0,0,84.03,857,301,"榮華里",NULL
99,804,21,825,1014,0,0,81.36,604,200,"榮華里",NULL
100,1542,22,1564,1978,0,0,79.07,1129,413,"五豐里",NULL
101,848,23,871,1074,0,0,81.1,626,222,"五豐里",NULL
102,570,16,586,701,0,0,83.59,382,188,"五豐里",NULL
103,1000,17,1017,1233,0,0,82.48,790,210,"五豐里",NULL
104,720,27,747,918,0,0,81.37,553,167,"五豐里",NULL
105,382,12,394,509,0,0,77.41,257,125,"陸豐里",NULL
106,996,25,1021,1228,0,0,83.14,664,332,"三重里",NULL
107,853,22,875,1088,0,0,80.42,598,255,"三重里",NULL
108,772,19,791,945,0,0,83.7,517,255,"三重里",NULL
109,475,10,485,578,0,0,83.91,325,150,"三重里",NULL
110,922,12,934,1169,0,0,79.9,673,249,"三重里",NULL
111,849,29,878,1074,0,0,81.75,554,295,"二重里",NULL
112,1011,14,1025,1262,0,0,81.22,646,365,"二重里",NULL
113,1513,40,1553,2015,0,0,77.07,1072,441,"二重里",NULL
114,1120,23,1143,1430,0,0,79.93,774,346,"二重里",NULL
115,805,17,822,1001,0,0,82.12,581,224,"二重里",NULL
116,946,11,957,1180,0,0,81.1,597,349,"頭重里",NULL
117,912,24,936,1109,0,0,84.4,617,295,"頭重里",NULL
118,1032,17,1049,1289,0,0,81.38,745,287,"頭重里",NULL
119,1183,41,1224,1480,0,0,82.7,806,377,"員山里",NULL
120,507,27,534,658,0,0,81.16,288,219,"柯湖里",NULL
121,851,18,869,1021,0,0,85.11,532,319,"新埔里",NULL
122,545,21,566,685,0,0,82.63,312,233,"新生里",NULL
123,867,24,891,1070,0,0,83.27,572,295,"新民里",NULL
124,694,28,722,871,0,0,82.89,472,222,"田新里",NULL
125,598,10,608,736,0,0,82.61,419,179,"田新里",NULL
126,628,9,637,757,0,0,84.15,350,278,"田新里",NULL
127,715,25,740,929,0,0,79.66,477,238,"旱坑里",NULL
128,621,25,646,816,0,0,79.17,332,289,"旱坑里",NULL
129,704,28,732,882,0,0,82.99,411,293,"五埔里",NULL
130,773,30,803,979,0,0,82.02,478,295,"五埔里",NULL
131,764,22,786,945,0,0,83.17,429,335,"四座里",NULL
132,776,15,791,951,0,0,83.18,426,350,"四座里",NULL
133,766,26,792,982,0,0,80.65,401,365,"四座里",NULL
134,1086,37,1123,1390,0,0,80.79,556,530,"照門里",NULL
135,351,15,366,446,0,0,82.06,148,203,"清水里",NULL
136,601,22,623,737,0,0,84.53,258,343,"鹿鳴里",NULL
137,488,17,505,602,0,0,83.89,193,295,"新北里",NULL
138,899,39,938,1086,0,0,86.37,438,461,"巨埔里",NULL
139,890,27,917,1115,0,0,82.24,475,415,"內立里",NULL
140,652,25,677,806,0,0,84,351,301,"寶石里",NULL
141,1091,39,1130,1401,0,0,80.66,615,476,"文山里",NULL
142,920,39,959,1152,0,0,83.25,674,246,"文山里",NULL
143,1088,32,1120,1393,0,0,80.4,664,424,"文山里",NULL
144,1341,49,1390,1711,0,0,81.24,728,613,"上寮里",NULL
145,743,23,766,927,0,0,82.63,406,337,"下寮里",NULL
146,692,24,716,881,0,0,81.27,413,279,"下寮里",NULL
147,777,43,820,999,0,0,82.08,447,330,"南平里",NULL
148,510,28,538,664,0,0,81.02,233,277,"北平里",NULL
149,475,6,481,552,0,0,87.14,309,166,"東興里",NULL
150,594,16,610,717,0,0,85.08,422,172,"西安里",NULL
151,858,20,878,1040,0,0,84.42,616,242,"西安里",NULL
152,620,19,639,754,0,0,84.75,391,229,"南雄里",NULL
153,909,20,929,1118,0,0,83.09,589,320,"北斗里",NULL
154,931,15,946,1130,0,0,83.72,573,358,"北斗里",NULL
155,1071,29,1100,1351,0,0,81.42,638,433,"北斗里",NULL
156,613,8,621,746,0,0,83.24,331,282,"北山里",NULL
157,876,20,896,1097,0,0,81.68,492,384,"仁安里",NULL
158,790,35,825,1048,0,0,78.72,434,356,"南山里",NULL
159,1156,53,1209,1487,0,0,81.3,742,414,"東安里",NULL
160,1165,39,1204,1480,0,0,81.35,728,437,"東安里",NULL
161,629,31,660,789,0,0,83.65,341,288,"東山里",NULL
162,991,28,1019,1217,0,0,83.73,562,429,"東光里",NULL
163,770,38,808,983,0,0,82.2,475,295,"南新里",NULL
164,462,15,477,608,0,0,78.45,234,228,"新富里",NULL
165,414,21,435,541,0,0,80.41,236,178,"玉山里",NULL
166,496,10,506,645,0,0,78.45,297,199,"金山里",NULL
167,868,16,884,1101,0,0,80.29,531,337,"錦山里",NULL
168,595,23,618,738,0,0,83.74,278,317,"大同里",NULL
169,704,31,735,899,0,0,81.76,445,259,"石光里",NULL
170,753,22,775,935,0,0,82.89,447,306,"石光里",NULL
171,791,27,818,976,0,0,83.81,439,352,"東平里",NULL
172,655,23,678,845,0,0,80.24,437,218,"上林里",NULL
173,497,28,525,620,0,0,84.68,297,200,"新力里",NULL
174,676,9,685,797,0,0,85.95,385,291,"南和里",NULL
175,966,46,1012,1216,0,0,83.22,530,436,"和興村",NULL
176,935,30,965,1163,0,0,82.98,537,398,"和興村",NULL
177,1030,30,1060,1310,0,0,80.92,664,366,"東興村",NULL
178,1352,29,1381,1750,0,0,78.91,870,482,"東興村",NULL
179,903,22,925,1111,0,0,83.26,488,415,"德盛村",NULL
180,990,18,1008,1217,0,0,82.83,618,372,"德盛村",NULL
181,922,39,961,1203,0,0,79.88,578,344,"德盛村",NULL
182,897,20,917,1121,0,0,81.8,533,364,"愛勢村",NULL
183,1099,28,1127,1325,0,0,85.06,770,329,"愛勢村",NULL
184,1142,23,1165,1412,0,0,82.51,767,375,"愛勢村",NULL
185,693,10,703,856,0,0,82.13,438,255,"仁勢村",NULL
186,1038,36,1074,1306,0,0,82.24,704,334,"孝勢村",NULL
187,873,10,883,1046,0,0,84.42,589,284,"中勢村",NULL
188,1097,31,1128,1327,0,0,85,727,370,"中勢村",NULL
189,953,25,978,1143,0,0,85.56,595,358,"中正村",NULL
190,845,17,862,1030,0,0,83.69,562,283,"中正村",NULL
191,842,21,863,1012,0,0,85.28,498,344,"信勢村",NULL
192,854,19,873,1082,0,0,80.68,570,284,"信勢村",NULL
193,1089,36,1125,1406,0,0,80.01,697,392,"信勢村",NULL
194,884,26,910,1104,0,0,82.43,561,323,"信義村",NULL
195,875,24,899,1081,0,0,83.16,579,296,"信義村",NULL
196,1371,30,1401,1803,0,0,77.7,858,513,"波羅村",NULL
197,935,36,971,1177,0,0,82.5,600,335,"長嶺村",NULL
198,1117,36,1153,1406,0,0,82.01,708,409,"長嶺村",NULL
199,778,26,804,1005,0,0,80,427,351,"長安村",NULL
200,1094,29,1123,1330,0,0,84.44,715,379,"湖口村",NULL
201,820,18,838,1023,0,0,81.92,522,298,"湖口村",NULL
202,946,30,976,1188,0,0,82.15,669,277,"湖鏡村",NULL
203,799,25,824,973,0,0,84.69,605,194,"湖鏡村",NULL
204,1034,33,1067,1344,0,0,79.39,720,314,"湖南村",NULL
205,937,34,971,1173,0,0,82.78,800,137,"中興村",NULL
206,908,33,941,1124,0,0,83.72,810,98,"中興村",NULL
207,1195,22,1217,1509,0,0,80.65,870,325,"中興村",NULL
208,800,8,808,1017,0,0,79.45,519,281,"鳳凰村",NULL
209,1000,18,1018,1301,0,0,78.25,704,296,"鳳凰村",NULL
210,830,14,844,1056,0,0,79.92,536,294,"鳳凰村",NULL
211,1030,21,1051,1323,0,0,79.44,695,335,"勝利村",NULL
212,852,30,882,1064,0,0,82.89,750,102,"勝利村",NULL
213,1159,29,1188,1479,0,0,80.32,810,349,"鳳山村",NULL
214,892,21,913,1161,0,0,78.64,741,151,"鳳山村",NULL
215,739,2,741,889,0,0,83.35,414,325,"福興村",NULL
216,641,26,667,806,0,0,82.75,424,217,"後湖村",NULL
217,681,24,705,870,0,0,81.03,359,322,"後湖村",NULL
218,1099,40,1139,1392,0,0,81.82,693,406,"青埔村",NULL
219,997,29,1026,1272,0,0,80.66,465,532,"埔和村",NULL
220,778,23,801,984,0,0,81.4,319,459,"埔和村",NULL
221,650,23,673,805,0,0,83.6,305,345,"坡頭村",NULL
222,875,24,899,1063,0,0,84.57,408,467,"新豐村",NULL
223,796,37,833,1032,0,0,80.72,307,489,"新豐村",NULL
224,1066,29,1095,1366,0,0,80.16,611,455,"瑞興村",NULL
225,1017,34,1051,1278,0,0,82.24,607,410,"中崙村",NULL
226,825,32,857,1094,0,0,78.34,577,248,"中崙村",NULL
227,928,17,945,1235,0,0,76.52,600,328,"重興村",NULL
228,898,21,919,1100,0,0,83.55,626,272,"重興村",NULL
229,866,13,879,1135,0,0,77.44,573,293,"重興村",NULL
230,1010,17,1027,1284,0,0,79.98,663,347,"重興村",NULL
231,902,19,921,1158,0,0,79.53,633,269,"重興村",NULL
232,1110,27,1137,1437,0,0,79.12,687,423,"上坑村",NULL
233,775,27,802,966,0,0,83.02,476,299,"鳳坑村",NULL
234,1114,26,1140,1394,0,0,81.78,731,383,"員山村",NULL
235,1031,34,1065,1323,0,0,80.5,692,339,"員山村",NULL
236,1144,11,1155,1381,0,0,83.64,812,332,"員山村",NULL
237,1183,31,1214,1512,0,0,80.29,812,371,"員山村",NULL
238,1266,25,1291,1632,0,0,79.11,813,453,"員山村",NULL
239,733,7,740,932,0,0,79.4,515,218,"松林村",NULL
240,948,21,969,1239,0,0,78.21,639,309,"松林村",NULL
241,899,29,928,1160,0,0,80,669,230,"松林村",NULL
242,809,20,829,1061,0,0,78.13,574,235,"松林村",NULL
243,338,12,350,424,0,0,82.55,209,129,"華龍村",NULL
244,398,15,413,484,0,0,85.33,279,119,"五龍村",NULL
245,701,18,719,855,0,0,84.09,519,182,"秀湖村",NULL
246,328,4,332,397,0,0,83.63,236,92,"永興村",NULL
247,751,9,760,947,0,0,80.25,558,193,"石潭村",NULL
248,1128,29,1157,1420,0,0,81.48,701,427,"石潭村",NULL
249,1076,41,1117,1389,0,0,80.42,666,410,"新鳳村",NULL
250,441,18,459,551,0,0,83.3,338,103,"中坑村",NULL
251,544,12,556,664,0,0,83.73,347,197,"水坑村",NULL
252,838,34,872,1040,0,0,83.85,536,302,"文林村",NULL
253,873,21,894,1067,0,0,83.79,582,291,"文林村",NULL
254,1200,32,1232,1474,0,0,83.58,766,434,"芎林村",NULL
255,1142,34,1176,1384,0,0,84.97,710,432,"上山村",NULL
256,648,16,664,805,0,0,82.48,395,253,"上山村",NULL
257,731,33,764,914,0,0,83.59,433,298,"上山村",NULL
258,870,36,906,1068,0,0,84.83,544,326,"下山村",NULL
259,963,24,987,1170,0,0,84.36,684,279,"橫山村",NULL
260,779,11,790,1006,0,0,78.53,552,227,"橫山村",NULL
261,821,30,851,1072,0,0,79.38,505,316,"橫山村",NULL
262,692,19,711,846,0,0,84.04,424,268,"田寮村",NULL
263,122,12,134,165,0,0,81.21,78,44,"南昌村",NULL
264,124,2,126,166,0,0,75.9,86,38,"豐鄉村",NULL
265,270,12,282,332,0,0,84.94,157,113,"豐田村",NULL
266,808,33,841,1068,0,0,78.75,605,203,"內灣村",NULL
267,486,6,492,599,0,0,82.14,353,133,"力行村",NULL
268,216,13,229,266,0,0,86.09,154,62,"力行村",NULL
269,390,11,401,472,0,0,84.96,232,158,"福興村",NULL
270,619,3,622,754,0,0,82.49,422,197,"沙坑村",NULL
271,298,6,304,344,0,0,88.37,144,154,"沙坑村",NULL
272,615,15,630,740,0,0,85.14,430,185,"新興村",NULL
273,676,15,691,811,0,0,85.2,485,191,"新興村",NULL
274,1129,16,1145,1370,0,0,83.58,842,287,"大肚村",NULL
275,915,27,942,1163,0,0,81,603,312,"北埔村",NULL
276,1016,35,1051,1268,0,0,82.89,718,298,"南興村",NULL
277,387,18,405,508,0,0,79.72,262,125,"大湖村",NULL
278,765,23,788,922,0,0,85.47,499,266,"埔尾村",NULL
279,1120,41,1161,1445,0,0,80.35,704,416,"埔尾村",NULL
280,590,25,615,789,0,0,77.95,326,264,"水際村",NULL
281,305,12,317,379,0,0,83.64,209,96,"南埔村",NULL
282,538,29,567,659,0,0,86.04,388,150,"大林村",NULL
283,273,10,283,358,0,0,79.05,175,98,"南坑村",NULL
284,241,8,249,309,0,0,80.58,125,116,"外坪村",NULL
285,990,18,1008,1227,0,0,82.15,651,339,"雙溪村",NULL
286,999,19,1018,1258,0,0,80.92,688,311,"雙溪村",NULL
287,1043,17,1060,1268,0,0,83.6,737,306,"雙溪村",NULL
288,730,24,754,949,0,0,79.45,442,288,"大崎村",NULL
289,613,33,646,755,0,0,85.56,362,251,"三峰村",NULL
290,855,6,861,1066,0,0,80.77,494,361,"新城村",NULL
291,515,17,532,649,0,0,81.97,277,238,"寶斗村",NULL
292,583,5,588,713,0,0,82.47,383,200,"深井村",NULL
293,509,12,521,626,0,0,83.23,364,145,"寶山村",NULL
294,450,2,452,558,0,0,81,254,196,"油田村",NULL
295,387,5,392,488,0,0,80.33,226,161,"山湖村",NULL
296,723,23,746,879,0,0,84.87,477,246,"峨眉村",NULL
297,585,26,611,724,0,0,84.39,283,302,"中盛村",NULL
298,508,20,528,622,0,0,84.89,276,232,"石井村",NULL
299,266,17,283,333,0,0,84.98,142,124,"七星村",NULL
300,235,9,244,285,0,0,85.61,128,107,"七星村",NULL
301,927,28,955,1232,0,0,77.52,523,404,"富興村",NULL
302,376,17,393,492,0,0,79.88,171,205,"湖光村",NULL
303,333,17,350,410,0,0,85.37,158,175,"湖光村",NULL
304,553,19,572,717,0,0,79.78,421,132,"義興村",NULL
305,212,8,220,270,0,0,81.48,172,40,"義興村",NULL
306,272,11,283,351,0,0,80.63,230,42,"嘉樂村",NULL
307,776,21,797,1044,0,0,76.34,690,86,"新樂村",NULL
308,322,4,326,418,0,0,77.99,288,34,"錦屏村",NULL
309,419,7,426,549,0,0,77.6,364,55,"錦屏村",NULL
310,359,13,372,492,0,0,75.61,289,70,"梅花村",NULL
311,307,7,314,385,0,0,81.56,271,36,"玉峰村",NULL
312,236,6,242,334,0,0,72.46,181,55,"玉峰村",NULL
313,207,2,209,272,0,0,76.84,170,37,"秀巒村",NULL
314,404,7,411,633,0,0,64.93,303,101,"秀巒村",NULL
315,152,4,156,198,0,0,78.79,79,73,"秀巒村",NULL
316,532,4,536,678,0,0,79.06,475,57,"大隘村",NULL
317,453,4,457,617,0,0,74.07,393,60,"大隘村",NULL
318,458,3,461,610,0,0,75.57,340,118,"花園村",NULL
319,223,2,225,289,0,0,77.85,188,35,"竹林村",NULL
320,401,9,410,572,0,0,71.68,338,63,"桃山村",NULL
321,555,8,563,730,0,0,77.12,439,116,"桃山村",NULL
1,795,15,810,1010,0,0,80.2,543,252,"中苗里",NULL
2,798,18,816,1046,0,0,78.01,519,279,"青苗里",NULL
3,838,14,852,1036,0,0,82.24,609,229,"維祥里",NULL
4,788,19,807,1004,0,0,80.38,541,247,"維祥里",NULL
5,816,17,833,1037,0,0,80.33,551,265,"維祥里",NULL
6,946,26,972,1264,0,0,76.9,638,308,"維新里",NULL
7,1035,28,1063,1290,0,0,82.4,745,290,"維新里",NULL
8,913,29,942,1218,0,0,77.34,615,298,"維新里",NULL
9,900,20,920,1151,0,0,79.93,655,245,"玉清里",NULL
10,933,24,957,1170,0,0,81.79,622,311,"玉清里",NULL
11,911,23,934,1152,0,0,81.08,658,253,"玉華里",NULL
12,804,25,829,1049,0,0,79.03,564,240,"玉華里",NULL
13,936,31,967,1163,0,0,83.15,673,263,"玉華里",NULL
14,698,24,722,894,0,0,80.76,447,251,"綠苗里",NULL
15,1014,25,1039,1288,0,0,80.67,696,318,"高苗里",NULL
16,1094,23,1117,1443,0,0,77.41,711,383,"高苗里",NULL
17,751,23,774,947,0,0,81.73,475,276,"新苗里",NULL
18,795,25,820,1050,0,0,78.1,519,276,"玉苗里",NULL
19,500,15,515,642,0,0,80.22,342,158,"大同里",NULL
20,1258,26,1284,1580,0,0,81.27,895,363,"恭敬里",NULL
21,1076,18,1094,1376,0,0,79.51,751,325,"水源里",NULL
22,830,21,851,1015,0,0,83.84,628,202,"水源里",NULL
23,1013,31,1044,1300,0,0,80.31,702,311,"勝利里",NULL
24,1144,27,1171,1419,0,0,82.52,795,349,"勝利里",NULL
25,648,23,671,818,0,0,82.03,397,251,"勝利里",NULL
26,713,10,723,894,0,0,80.87,485,228,"清華里",NULL
27,970,25,995,1209,0,0,82.3,668,302,"清華里",NULL
28,745,12,757,925,0,0,81.84,481,264,"清華里",NULL
29,626,14,640,779,0,0,82.16,410,216,"上苗里",NULL
30,796,17,813,996,0,0,81.63,507,289,"上苗里",NULL
31,1016,27,1043,1254,0,0,83.17,659,357,"北苗里",NULL
32,1300,36,1336,1649,0,0,81.02,917,383,"北苗里",NULL
33,1177,13,1190,1437,0,0,82.81,838,339,"北苗里",NULL
34,1240,38,1278,1603,0,0,79.73,789,451,"嘉盛里",NULL
35,1162,45,1207,1525,0,0,79.15,813,349,"嘉盛里",NULL
36,1092,26,1118,1336,0,0,83.68,756,336,"嘉新里",NULL
37,1009,7,1016,1194,0,0,85.09,711,298,"嘉新里",NULL
38,1243,35,1278,1599,0,0,79.92,849,394,"福星里",NULL
39,1357,31,1388,1726,0,0,80.42,916,441,"福星里",NULL
40,947,31,978,1216,0,0,80.43,651,296,"福安里",NULL
41,1083,31,1114,1437,0,0,77.52,728,355,"福安里",NULL
42,687,12,699,865,0,0,80.81,462,225,"建功里",NULL
43,1040,30,1070,1271,0,0,84.19,723,317,"建功里",NULL
44,1179,13,1192,1463,0,0,81.48,858,321,"建功里",NULL
45,1062,17,1079,1349,0,0,79.99,711,351,"福麗里",NULL
46,1214,28,1242,1527,0,0,81.34,887,327,"福麗里",NULL
47,1044,26,1070,1367,0,0,78.27,716,328,"福麗里",NULL
48,1264,31,1295,1601,0,0,80.89,876,388,"文山里",NULL
49,1174,31,1205,1522,0,0,79.17,817,357,"文山里",NULL
50,1338,36,1374,1758,0,0,78.16,843,495,"文山里",NULL
51,803,41,844,1110,0,0,76.04,523,280,"新川里",NULL
52,1094,46,1140,1505,0,0,75.75,715,379,"新英里",NULL
53,614,30,644,813,0,0,79.21,464,150,"南勢里",NULL
54,727,23,750,965,0,0,77.72,435,292,"南勢里",NULL
55,539,15,554,684,0,0,80.99,258,281,"苑東里",NULL
56,869,31,900,1102,0,0,81.67,373,496,"苑東里",NULL
57,758,18,776,945,0,0,82.12,366,392,"苑南里",NULL
58,555,22,577,726,0,0,79.48,218,337,"苑南里",NULL
59,694,17,711,901,0,0,78.91,314,380,"苑北里",NULL
60,1043,41,1084,1321,0,0,82.06,423,620,"西平里",NULL
61,884,50,934,1145,0,0,81.57,286,598,"苑港里",NULL
62,727,9,736,912,0,0,80.7,334,393,"西勢里",NULL
63,605,23,628,777,0,0,80.82,259,346,"西勢里",NULL
64,788,38,826,1024,0,0,80.66,297,491,"海岸里",NULL
65,818,36,854,1055,0,0,80.95,381,437,"房裡里",NULL
66,835,33,868,1109,0,0,78.27,332,503,"房裡里",NULL
67,860,24,884,1090,0,0,81.1,396,464,"客庄里",NULL
68,914,19,933,1131,0,0,82.49,413,501,"客庄里",NULL
69,898,18,916,1119,0,0,81.86,447,451,"客庄里",NULL
70,742,20,762,916,0,0,83.19,275,467,"中正里",NULL
71,724,25,749,893,0,0,83.87,299,425,"中正里",NULL
72,773,45,818,1011,0,0,80.91,244,529,"苑坑里",NULL
73,432,23,455,604,0,0,75.33,159,273,"水坡里",NULL
74,885,37,922,1114,0,0,82.76,407,478,"新復里",NULL
75,614,25,639,800,0,0,79.88,236,378,"山腳里",NULL
76,532,26,558,701,0,0,79.6,240,292,"山腳里",NULL
77,753,30,783,954,0,0,82.08,352,401,"舊社里",NULL
78,597,18,615,752,0,0,81.78,259,338,"舊社里",NULL
79,907,48,955,1233,0,0,77.45,351,556,"福田里",NULL
80,488,24,512,618,0,0,82.85,213,275,"石鎮里",NULL
81,688,37,725,893,0,0,81.19,323,365,"蕉埔里",NULL
82,545,29,574,727,0,0,78.95,204,341,"南勢里",NULL
83,619,23,642,803,0,0,79.95,279,340,"泰田里",NULL
84,522,21,543,679,0,0,79.97,206,316,"泰田里",NULL
85,1146,66,1212,1539,0,0,78.75,500,646,"上館里",NULL
86,1210,47,1257,1623,0,0,77.45,503,707,"玉田里",NULL
87,790,35,825,1022,0,0,80.72,337,453,"社苓里",NULL
88,806,44,850,1029,0,0,82.6,297,509,"社苓里",NULL
89,969,34,1003,1207,0,0,83.1,429,540,"山柑里",NULL
90,1073,45,1118,1362,0,0,82.09,447,626,"田心里",NULL
91,1009,27,1036,1259,0,0,82.29,497,512,"通東里",NULL
92,760,13,773,952,0,0,81.2,367,393,"通西里",NULL
93,955,40,995,1207,0,0,82.44,515,440,"通西里",NULL
94,969,25,994,1212,0,0,82.01,455,514,"平元里",NULL
95,1053,32,1085,1382,0,0,78.51,463,590,"平元里",NULL
96,898,36,934,1203,0,0,77.64,435,463,"平元里",NULL
97,584,49,633,760,0,0,83.29,250,334,"圳頭里",NULL
98,637,16,653,827,0,0,78.96,310,327,"梅南里",NULL
99,510,31,541,666,0,0,81.23,228,282,"梅南里",NULL
100,962,24,986,1248,0,0,79.01,492,470,"通南里",NULL
101,1018,30,1048,1343,0,0,78.03,509,509,"通南里",NULL
102,566,29,595,743,0,0,80.08,271,295,"內湖里",NULL
103,789,44,833,1024,0,0,81.35,410,379,"內湖里",NULL
104,398,26,424,539,0,0,78.66,186,212,"楓樹里",NULL
105,702,32,734,943,0,0,77.84,405,297,"烏眉里",NULL
106,360,8,368,478,0,0,76.99,221,139,"福龍里",NULL
107,587,33,620,787,0,0,78.78,322,265,"福源里",NULL
108,541,21,562,702,0,0,80.06,216,325,"城北里",NULL
109,726,52,778,998,0,0,77.96,308,418,"城南里",NULL
110,652,28,680,834,0,0,81.53,279,373,"南和里",NULL
111,467,29,496,645,0,0,76.9,182,285,"福興里",NULL
112,909,51,960,1193,0,0,80.47,468,441,"坪頂里",NULL
113,1035,33,1068,1336,0,0,79.94,524,511,"五南里",NULL
114,539,27,566,693,0,0,81.67,285,254,"五北里",NULL
115,603,41,644,767,0,0,83.96,214,389,"五北里",NULL
116,834,38,872,1143,0,0,76.29,418,416,"通灣里",NULL
117,747,28,775,1049,0,0,73.88,370,377,"通灣里",NULL
118,917,55,972,1254,0,0,77.51,331,586,"新埔里",NULL
119,535,34,569,765,0,0,74.38,262,273,"內島里",NULL
120,486,32,518,665,0,0,77.89,247,239,"白東里",NULL
121,501,21,522,705,0,0,74.04,275,226,"白東里",NULL
122,579,30,609,794,0,0,76.7,263,316,"白西里",NULL
123,839,15,854,1043,0,0,81.88,429,410,"竹南里",NULL
124,698,19,717,866,0,0,82.79,433,265,"竹南里",NULL
125,1031,31,1062,1289,0,0,82.39,528,503,"照南里",NULL
126,844,23,867,1072,0,0,80.88,403,441,"照南里",NULL
127,963,26,989,1223,0,0,80.87,507,456,"正南里",NULL
128,837,15,852,1091,0,0,78.09,458,379,"正南里",NULL
129,668,13,681,835,0,0,81.56,386,282,"新南里",NULL
130,678,10,688,851,0,0,80.85,383,295,"新南里",NULL
131,905,31,936,1141,0,0,82.03,481,424,"新南里",NULL
132,981,27,1008,1227,0,0,82.15,559,422,"大厝里",NULL
133,871,24,895,1078,0,0,83.02,470,401,"大厝里",NULL
134,732,18,750,882,0,0,85.03,388,344,"大厝里",NULL
135,1043,27,1070,1314,0,0,81.43,514,529,"營盤里",NULL
136,1109,26,1135,1370,0,0,82.85,574,535,"營盤里",NULL
137,810,30,840,1023,0,0,82.11,464,346,"聖福里",NULL
138,992,28,1020,1262,0,0,80.82,616,376,"聖福里",NULL
139,667,11,678,898,0,0,75.5,393,274,"竹興里",NULL
140,739,21,760,1000,0,0,76,396,343,"竹興里",NULL
141,737,25,762,972,0,0,78.4,406,331,"竹興里",NULL
142,739,17,756,910,0,0,83.08,437,302,"龍鳳里",NULL
143,642,17,659,851,0,0,77.44,326,316,"龍鳳里",NULL
144,1120,28,1148,1408,0,0,81.53,659,461,"龍鳳里",NULL
145,1037,22,1059,1308,0,0,80.96,571,466,"龍鳳里",NULL
146,1104,41,1145,1450,0,0,78.97,628,476,"山佳里",NULL
147,1215,40,1255,1605,0,0,78.19,709,506,"山佳里",NULL
148,853,27,880,1113,0,0,79.07,464,389,"佳興里",NULL
149,816,23,839,1022,0,0,82.09,455,361,"佳興里",NULL
150,727,30,757,957,0,0,79.1,417,310,"中港里",NULL
151,656,23,679,825,0,0,82.3,319,337,"中華里",NULL
152,1166,31,1197,1451,0,0,82.49,688,478,"中華里",NULL
153,945,38,983,1245,0,0,78.96,531,414,"中英里",NULL
154,1277,33,1310,1652,0,0,79.3,733,544,"中美里",NULL
155,441,5,446,545,0,0,81.83,222,219,"開元里",NULL
156,915,34,949,1186,0,0,80.02,432,483,"海口里",NULL
157,798,48,846,1080,0,0,78.33,401,397,"海口里",NULL
158,1165,44,1209,1439,0,0,84.02,647,518,"港墘里",NULL
159,874,9,883,1112,0,0,79.41,562,312,"公館里",NULL
160,653,22,675,817,0,0,82.62,354,299,"大埔里",NULL
161,968,39,1007,1298,0,0,77.58,509,459,"大埔里",NULL
162,792,35,827,1041,0,0,79.44,385,407,"大埔里",NULL
163,891,33,924,1130,0,0,81.77,514,377,"頂埔里",NULL
164,820,10,830,1015,0,0,81.77,474,346,"頂埔里",NULL
165,1141,47,1188,1517,0,0,78.31,636,505,"崎頂里",NULL
166,894,46,940,1173,0,0,80.14,421,473,"崎頂里",NULL
167,738,28,766,940,0,0,81.49,354,384,"公義里",NULL
168,571,21,592,744,0,0,79.57,384,187,"流東里",NULL
169,949,37,986,1336,0,0,73.8,696,253,"流東里",NULL
170,709,26,735,924,0,0,79.55,512,197,"珊湖里",NULL
171,700,23,723,872,0,0,82.91,463,237,"珊湖里",NULL
172,783,19,802,1019,0,0,78.7,502,281,"斗煥里",NULL
173,685,21,706,857,0,0,82.38,490,195,"斗煥里",NULL
174,746,18,764,973,0,0,78.52,528,218,"斗煥里",NULL
175,812,22,834,1021,0,0,81.68,536,276,"新華里",NULL
176,912,24,936,1173,0,0,79.8,644,268,"新華里",NULL
177,1012,36,1048,1291,0,0,81.18,753,259,"新華里",NULL
178,664,13,677,804,0,0,84.2,485,179,"興隆里",NULL
179,765,30,795,1013,0,0,78.48,475,290,"興隆里",NULL
180,853,28,881,1128,0,0,78.1,602,251,"興隆里",NULL
181,1140,38,1178,1389,0,0,84.81,838,302,"上埔里",NULL
182,816,22,838,1042,0,0,80.42,583,233,"上埔里",NULL
183,606,21,627,803,0,0,78.08,365,241,"土牛里",NULL
184,1182,27,1209,1520,0,0,79.54,871,311,"頭份里",NULL
185,971,36,1007,1255,0,0,80.24,658,313,"頭份里",NULL
186,792,13,805,1007,0,0,79.94,498,294,"忠孝里",NULL
187,936,13,949,1160,0,0,81.81,709,227,"忠孝里",NULL
188,862,28,890,1072,0,0,83.02,627,235,"忠孝里",NULL
189,920,12,932,1129,0,0,82.55,678,242,"忠孝里",NULL
190,677,11,688,872,0,0,78.9,461,216,"仁愛里",NULL
191,528,12,540,693,0,0,77.92,308,220,"仁愛里",NULL
192,611,5,616,766,0,0,80.42,405,206,"信義里",NULL
193,795,23,818,974,0,0,83.98,460,335,"和平里",NULL
194,988,16,1004,1272,0,0,78.93,672,316,"上興里",NULL
195,803,33,836,1061,0,0,78.79,513,290,"下興里",NULL
196,762,45,807,1036,0,0,77.9,523,239,"下興里",NULL
197,1108,23,1131,1413,0,0,80.04,812,296,"山下里",NULL
198,843,20,863,1059,0,0,81.49,565,278,"山下里",NULL
199,1009,21,1030,1242,0,0,82.93,681,328,"後庄里",NULL
200,994,24,1018,1275,0,0,79.84,670,324,"後庄里",NULL
201,927,21,948,1148,0,0,82.58,632,295,"後庄里",NULL
202,1233,34,1267,1550,0,0,81.74,791,442,"後庄里",NULL
203,1032,26,1058,1290,0,0,82.02,702,330,"建國里",NULL
204,1180,18,1198,1444,0,0,82.96,817,363,"建國里",NULL
205,1212,20,1232,1540,0,0,80,848,364,"成功里",NULL
206,1005,32,1037,1267,0,0,81.85,726,279,"成功里",NULL
207,933,21,954,1164,0,0,81.96,663,270,"蟠桃里",NULL
208,1021,27,1048,1349,0,0,77.69,733,288,"蟠桃里",NULL
209,835,24,859,1102,0,0,77.95,587,248,"東庄里",NULL
210,961,27,988,1289,0,0,76.65,654,307,"東庄里",NULL
211,661,12,673,859,0,0,78.35,495,166,"民族里",NULL
212,602,21,623,768,0,0,81.12,401,201,"民族里",NULL
213,630,17,647,800,0,0,80.88,411,219,"民權里",NULL
214,654,20,674,865,0,0,77.92,429,225,"民權里",NULL
215,668,34,702,907,0,0,77.4,474,194,"民生里",NULL
216,775,20,795,1024,0,0,77.64,503,272,"民生里",NULL
217,1117,32,1149,1433,0,0,80.18,735,382,"田寮里",NULL
218,1022,21,1043,1315,0,0,79.32,705,317,"田寮里",NULL
219,1037,46,1083,1322,0,0,81.92,559,478,"蘆竹里",NULL
220,1051,37,1088,1322,0,0,82.3,765,286,"尖山里",NULL
221,680,29,709,848,0,0,83.61,494,186,"廣興里",NULL
222,834,28,862,1095,0,0,78.72,606,228,"尖下里",NULL
223,1021,52,1073,1373,0,0,78.15,704,317,"尖下里",NULL
224,699,19,718,913,0,0,78.64,514,185,"濫坑里",NULL
225,803,29,832,1033,0,0,80.54,552,251,"濫坑里",NULL
226,494,25,519,644,0,0,80.59,263,231,"南龍里",NULL
227,576,26,602,769,0,0,78.28,328,248,"南龍里",NULL
228,788,8,796,949,0,0,83.88,416,372,"中龍里",NULL
229,1104,27,1131,1416,0,0,79.87,534,570,"北龍里",NULL
230,986,28,1014,1263,0,0,80.29,570,416,"大庄里",NULL
231,909,37,946,1195,0,0,79.16,517,392,"大庄里",NULL
232,763,19,782,970,0,0,80.62,417,346,"大庄里",NULL
233,769,41,810,1073,0,0,75.49,413,356,"溪洲里",NULL
234,858,46,904,1152,0,0,78.47,473,385,"溪洲里",NULL
235,992,26,1018,1285,0,0,79.22,740,252,"豐富里",NULL
236,930,29,959,1188,0,0,80.72,533,397,"校椅里",NULL
237,790,42,832,1090,0,0,76.33,411,379,"埔頂里",NULL
238,935,43,978,1290,0,0,75.81,524,411,"埔頂里",NULL
239,1002,41,1043,1318,0,0,79.14,619,383,"新民里",NULL
240,511,6,517,649,0,0,79.66,265,246,"復興里",NULL
241,1013,70,1083,1383,0,0,78.31,501,512,"東明里",NULL
242,580,29,609,765,0,0,79.61,306,274,"大山里",NULL
243,574,32,606,798,0,0,75.94,283,291,"大山里",NULL
244,989,9,998,1314,0,0,75.95,410,579,"灣寶里",NULL
245,741,41,782,1017,0,0,76.89,347,394,"海寶里",NULL
246,796,48,844,1150,0,0,73.39,509,287,"外埔里",NULL
247,703,25,728,1017,0,0,71.58,329,374,"海埔里",NULL
248,558,31,589,727,0,0,81.02,279,279,"秀水里",NULL
249,811,47,858,1110,0,0,77.3,437,374,"水尾里",NULL
250,506,22,528,665,0,0,79.4,275,231,"龍津里",NULL
251,973,44,1017,1296,0,0,78.47,477,496,"龍坑里",NULL
252,616,5,621,824,0,0,75.36,316,300,"福寧里",NULL
253,813,74,887,1220,0,0,72.7,419,394,"中和里",NULL
254,907,72,979,1282,0,0,76.37,371,536,"南港里",NULL
255,829,38,867,1059,0,0,81.87,386,443,"老庄里",NULL
256,882,24,906,1096,0,0,82.66,422,460,"老庄里",NULL
257,954,23,977,1170,0,0,83.5,405,549,"新榮里",NULL
258,667,28,695,816,0,0,85.17,323,344,"中街里",NULL
259,665,15,680,834,0,0,81.53,334,331,"新厝里",NULL
260,618,29,647,793,0,0,81.59,294,324,"新厝里",NULL
261,783,46,829,1037,0,0,79.94,357,426,"豐田里",NULL
262,418,19,437,558,0,0,78.32,190,228,"西坪里",NULL
263,617,28,645,756,0,0,85.32,279,338,"苗豐里",NULL
264,609,21,630,785,0,0,80.25,257,352,"上新里",NULL
265,668,4,672,842,0,0,79.81,254,414,"上新里",NULL
266,343,11,354,433,0,0,81.76,176,167,"上新里",NULL
267,493,19,512,687,0,0,74.53,206,287,"內灣里",NULL
268,564,24,588,754,0,0,77.98,222,342,"內灣里",NULL
269,557,13,570,702,0,0,81.2,269,288,"內灣里",NULL
270,680,27,707,960,0,0,73.65,372,308,"坪林里",NULL
271,382,22,404,481,0,0,83.99,268,114,"坪林里",NULL
272,504,33,537,705,0,0,76.17,274,230,"景山里",NULL
273,629,15,644,804,0,0,80.1,452,177,"大湖村",NULL
274,721,21,742,907,0,0,81.81,520,201,"大湖村",NULL
275,558,18,576,694,0,0,83,429,129,"明湖村",NULL
276,933,31,964,1269,0,0,75.97,636,297,"大寮村",NULL
277,608,25,633,859,0,0,73.69,440,168,"靜湖村",NULL
278,668,16,684,850,0,0,80.47,451,217,"靜湖村",NULL
279,972,46,1018,1369,0,0,74.36,660,312,"富興村",NULL
280,433,30,463,643,0,0,72.01,318,115,"大南村",NULL
281,543,36,579,749,0,0,77.3,339,204,"南湖村",NULL
282,516,32,548,723,0,0,75.8,344,172,"東興村",NULL
283,388,2,390,518,0,0,75.29,264,124,"武榮村",NULL
284,512,27,539,713,0,0,75.6,317,195,"義和村",NULL
285,604,33,637,871,0,0,73.13,385,219,"義和村",NULL
286,669,42,711,929,0,0,76.53,408,261,"栗林村",NULL
287,631,29,660,845,0,0,78.11,347,284,"新開村",NULL
288,666,15,681,812,0,0,83.87,392,274,"館中村",NULL
289,577,15,592,730,0,0,81.1,359,218,"館中村",NULL
290,815,30,845,1024,0,0,82.52,519,296,"館東村",NULL
291,873,35,908,1124,0,0,80.78,499,374,"館東村",NULL
292,1050,39,1089,1337,0,0,81.45,686,364,"館南村",NULL
293,1143,27,1170,1475,0,0,79.32,723,420,"館南村",NULL
294,764,29,793,1031,0,0,76.92,489,275,"中義村",NULL
295,704,30,734,951,0,0,77.18,364,340,"中義村",NULL
296,812,26,838,1067,0,0,78.54,522,290,"玉泉村",NULL
297,506,22,528,696,0,0,75.86,294,212,"玉泉村",NULL
298,714,41,755,974,0,0,77.52,442,272,"大坑村",NULL
299,849,3,852,1073,0,0,79.4,587,262,"福基村",NULL
300,304,15,319,402,0,0,79.35,213,91,"福德村",NULL
301,561,19,580,733,0,0,79.13,317,244,"福星村",NULL
302,758,22,780,968,0,0,80.58,489,269,"福星村",NULL
303,535,33,568,737,0,0,77.07,341,194,"石墻村",NULL
304,524,12,536,705,0,0,76.03,340,184,"石墻村",NULL
305,249,10,259,320,0,0,80.94,156,93,"開礦村",NULL
306,724,22,746,920,0,0,81.09,441,283,"五穀村",NULL
307,684,19,703,862,0,0,81.55,383,301,"五穀村",NULL
308,880,14,894,1111,0,0,80.47,541,339,"玉穀村",NULL
309,1082,31,1113,1371,0,0,81.18,730,352,"鶴岡村",NULL
310,1052,38,1090,1370,0,0,79.56,680,372,"鶴山村",NULL
311,1050,39,1089,1394,0,0,78.12,692,358,"尖山村",NULL
312,888,40,928,1178,0,0,78.78,540,348,"仁安村",NULL
313,197,7,204,264,0,0,77.27,142,55,"南河村",NULL
314,252,14,266,315,0,0,84.44,170,82,"北河村",NULL
315,712,15,727,871,0,0,83.47,502,210,"銅鑼村",NULL
316,836,23,859,1033,0,0,83.16,564,272,"銅鑼村",NULL
317,986,31,1017,1278,0,0,79.58,691,295,"銅鑼村",NULL
318,752,31,783,1009,0,0,77.6,513,239,"銅鑼村",NULL
319,944,48,992,1263,0,0,78.54,578,366,"樟樹村",NULL
320,976,35,1011,1278,0,0,79.11,678,298,"九湖村",NULL
321,830,25,855,1065,0,0,80.28,658,172,"福興村",NULL
322,726,25,751,928,0,0,80.93,525,201,"朝陽村",NULL
323,623,23,646,803,0,0,80.45,417,206,"朝陽村",NULL
324,808,41,849,1089,0,0,77.96,586,222,"竹森村",NULL
325,817,31,848,1045,0,0,81.15,436,381,"中平村",NULL
326,618,37,655,823,0,0,79.59,356,262,"中平村",NULL
327,715,18,733,968,0,0,75.72,446,269,"中平村",NULL
328,490,4,494,622,0,0,79.42,312,178,"興隆村",NULL
329,358,22,380,500,0,0,76,213,145,"盛隆村",NULL
330,400,30,430,562,0,0,76.51,249,151,"新隆村",NULL
331,390,10,400,501,0,0,79.84,282,108,"東村",NULL
332,562,20,582,763,0,0,76.28,383,179,"東村",NULL
333,523,29,552,709,0,0,77.86,377,146,"西村",NULL
334,558,7,565,768,0,0,73.57,436,122,"南江村",NULL
335,421,31,452,634,0,0,71.29,297,124,"南江村",NULL
336,663,25,688,878,0,0,78.36,437,226,"田美村",NULL
337,741,32,773,990,0,0,78.08,500,241,"獅山村",NULL
338,815,40,855,1069,0,0,79.98,576,239,"南富村",NULL
339,788,39,827,1043,0,0,79.29,472,316,"員林村",NULL
340,618,31,649,893,0,0,72.68,493,125,"蓬萊村",NULL
341,649,19,668,958,0,0,69.73,587,62,"東河村",NULL
342,1055,34,1089,1328,0,0,82,781,274,"頭屋村",NULL
343,902,18,920,1116,0,0,82.44,645,257,"頭屋村",NULL
344,578,19,597,796,0,0,75,408,170,"獅潭村",NULL
345,642,16,658,800,0,0,82.25,432,210,"獅潭村",NULL
346,506,32,538,673,0,0,79.94,362,144,"北坑村",NULL
347,728,23,751,888,0,0,84.57,452,276,"曲洞村",NULL
348,283,11,294,358,0,0,82.12,170,113,"飛鳳村",NULL
349,666,7,673,877,0,0,76.74,434,232,"象山村",NULL
350,776,7,783,971,0,0,80.64,520,256,"象山村",NULL
351,692,27,719,913,0,0,78.75,479,213,"明德村",NULL
352,158,8,166,201,0,0,82.59,107,51,"明德村",NULL
353,268,10,278,352,0,0,78.98,169,99,"鳴鳳村",NULL
354,784,32,816,990,0,0,82.42,586,198,"廣盛村",NULL
355,778,20,798,959,0,0,83.21,474,304,"廣盛村",NULL
356,796,34,830,1048,0,0,79.2,549,247,"廣盛村",NULL
357,806,22,828,996,0,0,83.13,574,232,"廣盛村",NULL
358,762,31,793,964,0,0,82.26,539,223,"勝興村",NULL
359,789,26,815,1055,0,0,77.25,497,292,"勝興村",NULL
360,746,25,771,990,0,0,77.88,463,283,"勝興村",NULL
361,718,19,737,937,0,0,78.66,477,241,"雙湖村",NULL
362,616,16,632,754,0,0,83.82,417,199,"雙湖村",NULL
363,554,16,570,693,0,0,82.25,364,190,"雙潭村",NULL
364,533,19,552,690,0,0,80,354,179,"雙潭村",NULL
365,461,22,483,567,0,0,85.19,364,97,"西湖村",NULL
366,609,23,632,777,0,0,81.34,395,214,"西湖村",NULL
367,318,15,333,399,0,0,83.46,229,89,"龍騰村",NULL
368,597,30,627,739,0,0,84.84,247,350,"鯉魚潭村",NULL
369,360,14,374,434,0,0,86.18,166,194,"鯉魚潭村",NULL
370,469,7,476,607,0,0,78.42,345,124,"高埔村",NULL
371,438,23,461,561,0,0,82.17,326,112,"下埔村",NULL
372,686,28,714,895,0,0,79.78,517,169,"五湖村",NULL
373,491,21,512,652,0,0,78.53,391,100,"四湖村",NULL
374,697,22,719,956,0,0,75.21,464,233,"三湖村",NULL
375,373,25,398,517,0,0,76.98,253,120,"龍洞村",NULL
376,414,3,417,524,0,0,79.58,290,124,"金獅村",NULL
377,849,41,890,1139,0,0,78.14,568,281,"湖東村",NULL
378,480,29,509,694,0,0,73.34,308,172,"二湖村",NULL
379,1368,45,1413,1759,0,0,80.33,1025,343,"造橋村",NULL
380,367,20,387,487,0,0,79.47,272,95,"平興村",NULL
381,747,27,774,982,0,0,78.82,508,239,"豐湖村",NULL
382,1312,45,1357,1673,0,0,81.11,896,416,"大西村",NULL
383,1086,42,1128,1404,0,0,80.34,796,290,"大西村",NULL
384,430,9,439,537,0,0,81.75,291,139,"錦水村",NULL
385,400,5,405,505,0,0,80.2,288,112,"大龍村",NULL
386,1064,55,1119,1387,0,0,80.68,593,471,"朝陽村",NULL
387,555,39,594,720,0,0,82.5,315,240,"談文村",NULL
388,725,55,780,1017,0,0,76.7,377,348,"龍昇村",NULL
389,848,26,874,1031,0,0,84.77,573,275,"三灣村",NULL
390,846,36,882,1121,0,0,78.68,538,308,"三灣村",NULL
391,462,24,486,576,0,0,84.38,328,134,"內灣村",NULL
392,644,24,668,842,0,0,79.33,414,230,"銅鏡村",NULL
393,178,9,187,231,0,0,80.95,130,48,"頂寮村",NULL
394,406,20,426,522,0,0,81.61,245,161,"北埔村",NULL
395,481,29,510,620,0,0,82.26,312,169,"大河村",NULL
396,339,27,366,467,0,0,78.37,195,144,"大坪村",NULL
397,274,17,291,366,0,0,79.51,185,89,"永和村",NULL
398,273,18,291,389,0,0,74.81,228,45,"百壽村",NULL
399,447,33,480,634,0,0,75.71,280,167,"永興村",NULL
400,702,49,751,945,0,0,79.47,477,225,"新店村",NULL
401,465,23,488,616,0,0,79.22,313,152,"和興村",NULL
402,460,28,488,644,0,0,75.78,333,127,"豐林村",NULL
403,254,14,268,368,0,0,72.83,165,89,"新豐村",NULL
404,566,28,594,761,0,0,78.06,396,170,"竹木村",NULL
405,187,10,197,270,0,0,72.96,157,30,"八卦村",NULL
406,675,24,699,930,0,0,75.16,577,98,"錦水村",NULL
407,203,7,210,288,0,0,72.92,148,55,"清安村",NULL
408,404,18,422,541,0,0,78,320,84,"清安村",NULL
409,325,8,333,421,0,0,79.1,296,29,"大興村",NULL
410,319,13,332,411,0,0,80.78,249,70,"中興村",NULL
411,283,6,289,372,0,0,77.69,245,38,"梅園村",NULL
412,465,8,473,569,0,0,83.13,352,113,"象鼻村",NULL
413,403,2,405,465,0,0,87.1,394,9,"士林村",NULL
1,685,24,709,896,0,0,79.13,342,343,"豐原里",NULL
2,864,20,884,1029,0,0,85.91,509,355,"豐原里",NULL
3,819,9,828,1028,0,0,80.54,324,495,"豐榮里",NULL
4,731,12,743,904,0,0,82.19,286,445,"頂街里",NULL
5,759,11,770,924,0,0,83.33,318,441,"中山里",NULL
6,667,14,681,824,0,0,82.65,301,366,"下街里",NULL
7,1197,17,1214,1484,0,0,81.81,517,680,"中陽里",NULL
8,1106,26,1132,1347,0,0,84.04,500,606,"中陽里",NULL
9,1394,31,1425,1716,0,0,83.04,623,771,"中陽里",NULL
10,911,26,937,1115,0,0,84.04,363,548,"大湳里",NULL
11,965,11,976,1142,0,0,85.46,433,532,"大湳里",NULL
12,1080,4,1084,1326,0,0,81.75,542,538,"北湳里",NULL
13,949,35,984,1189,0,0,82.76,448,501,"北湳里",NULL
14,1050,34,1084,1267,0,0,85.56,352,698,"東湳里",NULL
15,1071,14,1085,1349,0,0,80.43,409,662,"東湳里",NULL
16,918,31,949,1119,0,0,84.81,353,565,"東湳里",NULL
17,1135,23,1158,1404,0,0,82.48,456,679,"西湳里",NULL
18,1151,26,1177,1430,0,0,82.31,443,708,"西湳里",NULL
19,984,19,1003,1201,0,0,83.51,378,606,"西湳里",NULL
20,964,23,987,1187,0,0,83.15,363,601,"西湳里",NULL
21,1186,21,1207,1431,0,0,84.35,494,692,"西湳里",NULL
22,1398,31,1429,1746,0,0,81.84,704,694,"豐西里",NULL
23,936,25,961,1140,0,0,84.3,389,547,"圳寮里",NULL
24,1032,20,1052,1256,0,0,83.76,548,484,"豐圳里",NULL
25,1173,26,1199,1483,0,0,80.85,562,611,"豐圳里",NULL
26,718,9,727,833,0,0,87.27,326,392,"富春里",NULL
27,667,15,682,810,0,0,84.2,336,331,"葫蘆里",NULL
28,1227,23,1250,1488,0,0,84.01,565,662,"西安里",NULL
29,1380,19,1399,1699,0,0,82.34,626,754,"西安里",NULL
30,1340,28,1368,1613,0,0,84.81,627,713,"西安里",NULL
31,938,11,949,1279,0,0,74.2,452,486,"西勢里",NULL
32,829,16,845,990,0,0,85.35,421,408,"西勢里",NULL
33,977,17,994,1240,0,0,80.16,477,500,"中興里",NULL
34,1199,29,1228,1510,0,0,81.32,691,508,"中興里",NULL
35,1187,39,1226,1494,0,0,82.06,499,688,"社皮里",NULL
36,1156,39,1195,1452,0,0,82.3,662,494,"社皮里",NULL
37,1222,16,1238,1511,0,0,81.93,566,656,"社皮里",NULL
38,1108,9,1117,1403,0,0,79.62,556,552,"社皮里",NULL
39,1462,24,1486,1792,0,0,82.92,682,780,"社皮里",NULL
40,1298,41,1339,1630,0,0,82.15,605,693,"三村里",NULL
41,1180,31,1211,1488,0,0,81.38,524,656,"三村里",NULL
42,1465,24,1489,1802,0,0,82.63,565,900,"三村里",NULL
43,1153,23,1176,1403,0,0,83.82,472,681,"東勢里",NULL
44,856,13,869,1044,0,0,83.24,348,508,"民生里",NULL
45,1494,25,1519,1831,0,0,82.96,720,774,"田心里",NULL
46,1170,19,1189,1450,0,0,82,574,596,"田心里",NULL
47,1136,29,1165,1403,0,0,83.04,459,677,"田心里",NULL
48,1454,21,1475,1787,0,0,82.54,675,779,"豐田里",NULL
49,1365,42,1407,1737,0,0,81,529,836,"豐田里",NULL
50,1379,50,1429,1737,0,0,82.27,513,866,"豐田里",NULL
51,1399,46,1445,1730,0,0,83.53,608,791,"豐田里",NULL
52,1429,42,1471,1800,0,0,81.72,620,809,"豐田里",NULL
53,917,27,944,1140,0,0,82.81,408,509,"鎌村里",NULL
54,918,26,944,1143,0,0,82.59,430,488,"鎌村里",NULL
55,993,31,1024,1242,0,0,82.45,478,515,"鎌村里",NULL
56,979,19,998,1223,0,0,81.6,476,503,"陽明里",NULL
57,995,15,1010,1230,0,0,82.11,497,498,"陽明里",NULL
58,1212,25,1237,1517,0,0,81.54,550,662,"南陽里",NULL
59,1410,32,1442,1778,0,0,81.1,652,758,"南陽里",NULL
60,1115,20,1135,1357,0,0,83.64,585,530,"南陽里",NULL
61,1218,19,1237,1456,0,0,84.96,527,691,"南陽里",NULL
62,1087,23,1110,1382,0,0,80.32,545,542,"南陽里",NULL
63,1245,13,1258,1541,0,0,81.64,583,662,"北陽里",NULL
64,1365,31,1396,1660,0,0,84.1,580,785,"北陽里",NULL
65,1610,22,1632,1962,0,0,83.18,801,809,"北陽里",NULL
66,1296,23,1319,1553,0,0,84.93,609,687,"北陽里",NULL
67,1231,25,1256,1518,0,0,82.74,554,677,"北陽里",NULL
68,1355,26,1381,1645,0,0,83.95,612,743,"北陽里",NULL
69,1265,36,1301,1509,0,0,86.22,438,827,"東陽里",NULL
70,977,27,1004,1204,0,0,83.39,349,628,"南村里",NULL
71,1037,26,1063,1296,0,0,82.02,421,616,"南村里",NULL
72,1206,15,1221,1495,0,0,81.67,595,611,"南村里",NULL
73,1281,27,1308,1585,0,0,82.52,547,734,"南田里",NULL
74,1146,36,1182,1396,0,0,84.67,455,691,"南田里",NULL
75,1240,26,1266,1523,0,0,83.13,427,813,"南嵩里",NULL
76,1028,42,1070,1314,0,0,81.43,420,608,"南嵩里",NULL
77,1415,34,1449,1727,0,0,83.9,646,769,"翁明里",NULL
78,997,28,1025,1220,0,0,84.02,352,645,"翁子里",NULL
79,962,30,992,1168,0,0,84.93,431,531,"翁子里",NULL
80,624,20,644,756,0,0,85.19,229,395,"翁社里",NULL
81,890,21,911,1078,0,0,84.51,373,517,"翁社里",NULL
82,807,18,825,1002,0,0,82.34,272,535,"朴子里",NULL
83,824,16,840,1012,0,0,83,284,540,"朴子里",NULL
84,765,22,787,933,0,0,84.35,276,489,"朴子里",NULL
85,1271,30,1301,1564,0,0,83.18,579,692,"大里里",NULL
86,1101,43,1144,1395,0,0,82.01,489,612,"大里里",NULL
87,1190,23,1213,1487,0,0,81.57,503,687,"新里里",NULL
88,1469,31,1500,2094,0,0,71.63,672,797,"新里里",NULL
89,1345,14,1359,1602,0,0,84.83,696,649,"新里里",NULL
90,1176,17,1193,1458,0,0,81.82,560,616,"新里里",NULL
91,1557,25,1582,1906,0,0,83,826,731,"國光里",NULL
92,1466,22,1488,1821,0,0,81.71,693,773,"國光里",NULL
93,1147,26,1173,1408,0,0,83.31,442,705,"樹王里",NULL
94,1148,18,1166,1410,0,0,82.7,419,729,"樹王里",NULL
95,746,15,761,964,0,0,78.94,357,389,"祥興里",NULL
96,890,22,912,1154,0,0,79.03,389,501,"祥興里",NULL
97,1004,14,1018,1266,0,0,80.41,463,541,"祥興里",NULL
98,969,17,986,1227,0,0,80.36,480,489,"祥興里",NULL
99,759,14,773,930,0,0,83.12,348,411,"祥興里",NULL
100,1279,27,1306,1640,0,0,79.63,720,559,"內新里",NULL
101,816,23,839,1043,0,0,80.44,391,425,"內新里",NULL
102,1104,25,1129,1399,0,0,80.7,628,476,"內新里",NULL
103,1020,19,1039,1298,0,0,80.05,583,437,"內新里",NULL
104,844,29,873,1093,0,0,79.87,431,413,"中新里",NULL
105,877,23,900,1090,0,0,82.57,450,427,"中新里",NULL
106,1136,9,1145,1416,0,0,80.86,631,505,"中新里",NULL
107,919,35,954,1179,0,0,80.92,354,565,"東昇里",NULL
108,1200,17,1217,1455,0,0,83.64,622,578,"東昇里",NULL
109,709,16,725,839,0,0,86.41,323,386,"大元里",NULL
110,1186,14,1200,1429,0,0,83.97,437,749,"大元里",NULL
111,904,19,923,1106,0,0,83.45,440,464,"大元里",NULL
112,899,22,921,1088,0,0,84.65,377,522,"西湖里",NULL
113,883,13,896,1069,0,0,83.82,381,502,"西湖里",NULL
114,760,21,781,929,0,0,84.07,285,475,"夏田里",NULL
115,1386,19,1405,1750,0,0,80.29,620,766,"仁化里",NULL
116,1533,18,1551,1908,0,0,81.29,624,909,"仁化里",NULL
117,1444,15,1459,1827,0,0,79.86,639,805,"仁化里",NULL
118,1277,10,1287,1557,0,0,82.66,605,672,"仁德里",NULL
119,1360,19,1379,1687,0,0,81.74,620,740,"仁德里",NULL
120,1213,26,1239,1512,0,0,81.94,567,646,"仁德里",NULL
121,1157,27,1184,1490,0,0,79.46,531,626,"健民里",NULL
122,1148,23,1171,1466,0,0,79.88,736,412,"健民里",NULL
123,1032,28,1060,1350,0,0,78.52,531,501,"健民里",NULL
124,1364,29,1393,1762,0,0,79.06,655,709,"塗城里",NULL
125,1237,19,1256,1529,0,0,82.15,523,714,"塗城里",NULL
126,1306,22,1328,1675,0,0,79.28,581,725,"塗城里",NULL
127,1333,44,1377,1723,0,0,79.92,596,737,"塗城里",NULL
128,1119,23,1142,1469,0,0,77.74,534,585,"東湖里",NULL
129,1071,21,1092,1361,0,0,80.24,535,536,"東湖里",NULL
130,982,15,997,1234,0,0,80.79,506,476,"東湖里",NULL
131,823,21,844,1052,0,0,80.23,422,401,"東湖里",NULL
132,940,25,965,1218,0,0,79.23,435,505,"東湖里",NULL
133,1175,26,1201,1459,0,0,82.32,581,594,"東興里",NULL
134,1045,24,1069,1292,0,0,82.74,534,511,"東興里",NULL
135,1389,20,1409,1663,0,0,84.73,648,741,"東興里",NULL
136,1072,12,1084,1311,0,0,82.68,498,574,"東興里",NULL
137,912,18,930,1117,0,0,83.26,431,481,"大明里",NULL
138,794,12,806,984,0,0,81.91,335,459,"大明里",NULL
139,941,25,966,1203,0,0,80.3,456,485,"大明里",NULL
140,1759,16,1775,2118,0,0,83.81,900,859,"永隆里",NULL
141,1705,15,1720,1990,0,0,86.43,923,782,"永隆里",NULL
142,1421,27,1448,1762,0,0,82.18,731,690,"日新里",NULL
143,1214,31,1245,1504,0,0,82.78,547,667,"日新里",NULL
144,1288,34,1322,1694,0,0,78.04,618,670,"西榮里",NULL
145,1216,6,1222,1467,0,0,83.3,679,537,"西榮里",NULL
146,1189,30,1219,1492,0,0,81.7,538,651,"西榮里",NULL
147,1125,20,1145,1423,0,0,80.46,564,561,"長榮里",NULL
148,1174,17,1191,1476,0,0,80.69,621,553,"長榮里",NULL
149,1321,15,1336,1608,0,0,83.08,705,616,"長榮里",NULL
150,1088,19,1107,1324,0,0,83.61,587,501,"長榮里",NULL
151,1328,20,1348,1677,0,0,80.38,683,645,"金城里",NULL
152,1101,12,1113,1453,0,0,76.6,556,545,"金城里",NULL
153,1331,20,1351,1640,0,0,82.38,652,679,"金城里",NULL
154,1239,19,1258,1602,0,0,78.53,628,611,"金城里",NULL
155,1212,22,1234,1550,0,0,79.61,580,632,"金城里",NULL
156,919,16,935,1133,0,0,82.52,390,529,"立仁里",NULL
157,1003,21,1024,1276,0,0,80.25,493,510,"立仁里",NULL
158,1105,32,1137,1450,0,0,78.41,484,621,"立仁里",NULL
159,1163,18,1181,1444,0,0,81.79,519,644,"立德里",NULL
160,998,26,1024,1241,0,0,82.51,462,536,"立德里",NULL
161,1086,20,1106,1379,0,0,80.2,510,576,"立德里",NULL
162,1185,19,1204,1454,0,0,82.81,562,623,"新仁里",NULL
163,1326,30,1356,1712,0,0,79.21,625,701,"新仁里",NULL
164,1280,23,1303,1551,0,0,84.01,558,722,"新仁里",NULL
165,1143,17,1160,1427,0,0,81.29,546,597,"新仁里",NULL
166,1267,27,1294,1630,0,0,79.39,585,682,"瑞城里",NULL
167,1127,24,1151,1392,0,0,82.69,540,587,"瑞城里",NULL
168,1216,16,1232,1499,0,0,82.19,588,628,"瑞城里",NULL
169,1084,16,1100,1371,0,0,80.23,542,542,"瑞城里",NULL
170,1202,7,1209,1515,0,0,79.8,578,624,"瑞城里",NULL
171,1166,7,1173,1450,0,0,80.9,548,618,"瑞城里",NULL
172,1613,40,1653,1967,0,0,84.04,651,962,"太平里",NULL
173,1266,32,1298,1589,0,0,81.69,540,726,"太平里",NULL
174,1303,56,1359,1658,0,0,81.97,529,774,"太平里",NULL
175,1323,30,1353,1674,0,0,80.82,566,757,"長億里",NULL
176,1091,28,1119,1430,0,0,78.25,596,495,"長億里",NULL
177,894,10,904,1150,0,0,78.61,474,420,"長億里",NULL
178,1587,20,1607,1961,0,0,81.95,764,823,"長億里",NULL
179,1431,33,1464,1766,0,0,82.9,703,728,"長億里",NULL
180,1215,25,1240,1537,0,0,80.68,546,669,"中平里",NULL
181,1155,17,1172,1429,0,0,82.02,462,693,"中平里",NULL
182,1274,28,1302,1624,0,0,80.17,606,668,"中平里",NULL
183,1203,33,1236,1574,0,0,78.53,587,616,"中平里",NULL
184,1776,31,1807,2604,0,0,69.39,895,881,"中興里",NULL
185,1173,26,1199,1474,0,0,81.34,589,584,"中興里",NULL
186,1184,28,1212,1516,0,0,79.95,507,677,"中興里",NULL
187,1339,23,1362,1639,0,0,83.1,578,761,"中興里",NULL
188,1474,42,1516,1846,0,0,82.12,662,812,"東平里",NULL
189,1434,30,1464,1813,0,0,80.75,670,764,"東平里",NULL
190,1404,15,1419,1751,0,0,81.04,619,785,"東平里",NULL
191,1381,35,1416,1750,0,0,80.91,618,763,"東平里",NULL
192,1599,42,1641,2054,0,0,79.89,766,833,"東平里",NULL
193,1244,31,1275,1612,0,0,79.09,678,566,"建國里",NULL
194,1143,32,1175,1487,0,0,79.02,727,416,"建國里",NULL
195,1589,35,1624,1975,0,0,82.23,789,800,"建國里",NULL
196,908,25,933,1127,0,0,82.79,367,541,"坪林里",NULL
197,697,8,705,859,0,0,82.07,387,310,"坪林里",NULL
198,1008,22,1030,1239,0,0,83.13,579,429,"坪林里",NULL
199,1016,19,1035,1242,0,0,83.33,655,361,"坪林里",NULL
200,978,24,1002,1173,0,0,85.42,719,259,"坪林里",NULL
201,1445,34,1479,1820,0,0,81.26,907,538,"坪林里",NULL
202,1210,37,1247,1535,0,0,81.24,983,227,"光華里",NULL
203,1620,33,1653,2024,0,0,81.67,1003,617,"光華里",NULL
204,1482,40,1522,1854,0,0,82.09,809,673,"光華里",NULL
205,1587,36,1623,1975,0,0,82.18,787,800,"光華里",NULL
206,1267,23,1290,1566,0,0,82.38,707,560,"中山里",NULL
207,949,22,971,1209,0,0,80.31,706,243,"中山里",NULL
208,1285,29,1314,1548,0,0,84.88,727,558,"中山里",NULL
209,1532,42,1574,1930,0,0,81.55,909,623,"中山里",NULL
210,1140,22,1162,1491,0,0,77.93,615,525,"宜欣里",NULL
211,1441,41,1482,1855,0,0,79.89,652,789,"宜欣里",NULL
212,1658,41,1699,2183,0,0,77.83,841,817,"宜欣里",NULL
213,1533,13,1546,1905,0,0,81.15,915,618,"宜欣里",NULL
214,1538,26,1564,1908,0,0,81.97,776,762,"宜欣里",NULL
215,1209,33,1242,1525,0,0,81.44,543,666,"宜欣里",NULL
216,1300,24,1324,1668,0,0,79.38,659,641,"宜欣里",NULL
217,965,12,977,1239,0,0,78.85,518,447,"新坪里",NULL
218,1144,21,1165,1435,0,0,81.18,543,601,"新坪里",NULL
219,979,17,996,1246,0,0,79.94,517,462,"新坪里",NULL
220,841,33,874,1080,0,0,80.93,447,394,"新坪里",NULL
221,1178,25,1203,1515,0,0,79.41,627,551,"新坪里",NULL
222,869,16,885,1101,0,0,80.38,513,356,"新坪里",NULL
223,884,14,898,1245,0,0,72.13,493,391,"新坪里",NULL
224,1027,21,1048,1342,0,0,78.09,604,423,"新坪里",NULL
225,1087,13,1100,1368,0,0,80.41,604,483,"新坪里",NULL
226,1576,53,1629,1955,0,0,83.32,592,984,"新光里",NULL
227,1518,33,1551,1968,0,0,78.81,635,883,"新光里",NULL
228,1526,29,1555,1886,0,0,82.45,743,783,"新光里",NULL
229,1446,16,1462,1808,0,0,80.86,751,695,"新光里",NULL
230,1267,27,1294,1611,0,0,80.32,709,558,"新光里",NULL
231,1471,25,1496,1748,0,0,85.58,756,715,"新福里",NULL
232,845,17,862,1050,0,0,82.1,440,405,"新福里",NULL
233,1163,25,1188,1475,0,0,80.54,645,518,"新福里",NULL
234,866,35,901,1102,0,0,81.76,338,528,"頭汴里",NULL
235,854,36,890,1124,0,0,79.18,375,479,"頭汴里",NULL
236,816,42,858,1069,0,0,80.26,354,462,"頭汴里",NULL
237,875,41,916,1198,0,0,76.46,346,529,"東汴里",NULL
238,1306,41,1347,1617,0,0,83.3,538,768,"興隆里",NULL
239,1212,27,1239,1579,0,0,78.47,712,500,"興隆里",NULL
240,1209,8,1217,1485,0,0,81.95,603,606,"興隆里",NULL
241,967,17,984,1190,0,0,82.69,473,494,"興隆里",NULL
242,648,22,670,822,0,0,81.51,280,368,"黃竹里",NULL
243,1233,40,1273,1586,0,0,80.26,523,710,"光隆里",NULL
244,1454,32,1486,1813,0,0,81.96,622,832,"光隆里",NULL
245,1033,19,1052,1325,0,0,79.4,510,523,"光隆里",NULL
246,1479,34,1513,1862,0,0,81.26,678,801,"德隆里",NULL
247,1324,44,1368,1733,0,0,78.94,565,759,"德隆里",NULL
248,929,22,951,1190,0,0,79.92,586,343,"北興里",NULL
249,673,13,686,825,0,0,83.15,414,259,"中寧里",NULL
250,997,24,1021,1286,0,0,79.39,594,403,"東安里",NULL
251,635,17,652,794,0,0,82.12,389,246,"南平里",NULL
252,814,25,839,1059,0,0,79.23,481,333,"南平里",NULL
253,874,20,894,1115,0,0,80.18,423,451,"延平里",NULL
254,851,25,876,1087,0,0,80.59,474,377,"延平里",NULL
255,764,30,794,954,0,0,83.23,466,298,"上新里",NULL
256,1172,36,1208,1515,0,0,79.74,691,481,"廣興里",NULL
257,1109,29,1138,1401,0,0,81.23,594,515,"泰昌里",NULL
258,847,14,861,1037,0,0,83.03,547,300,"泰昌里",NULL
259,602,20,622,794,0,0,78.34,390,212,"泰昌里",NULL
260,724,26,750,926,0,0,80.99,364,360,"中嵙里",NULL
261,696,34,730,918,0,0,79.52,391,305,"中嵙里",NULL
262,984,45,1029,1294,0,0,79.52,549,435,"福隆里",NULL
263,1495,34,1529,1884,0,0,81.16,856,639,"福隆里",NULL
264,1042,40,1082,1426,0,0,75.88,498,544,"隆興里",NULL
265,1085,42,1127,1397,0,0,80.67,498,587,"新盛里",NULL
266,1253,42,1295,1641,0,0,78.92,680,573,"新盛里",NULL
267,1290,54,1344,1593,0,0,84.37,644,646,"新盛里",NULL
268,1133,47,1180,1448,0,0,81.49,485,648,"詒福里",NULL
269,759,32,791,975,0,0,81.13,333,426,"上城里",NULL
270,680,38,718,898,0,0,79.96,292,388,"下城里",NULL
271,799,33,832,1047,0,0,79.47,318,481,"慶東里",NULL
272,681,19,700,881,0,0,79.46,309,372,"慶東里",NULL
273,978,48,1026,1389,0,0,73.87,385,593,"慶福里",NULL
274,708,14,722,875,0,0,82.51,395,313,"東新里",NULL
275,804,27,831,1061,0,0,78.32,494,310,"東新里",NULL
276,883,30,913,1116,0,0,81.81,401,482,"粵寧里",NULL
277,492,13,505,644,0,0,78.42,276,216,"粵寧里",NULL
278,1330,24,1354,1647,0,0,82.21,568,762,"下新里",NULL
279,976,43,1019,1240,0,0,82.18,380,596,"興隆里",NULL
280,1349,61,1410,1750,0,0,80.57,659,690,"茂興里",NULL
281,580,24,604,755,0,0,80,240,340,"泰興里",NULL
282,555,25,580,663,0,0,87.48,248,307,"埤頭里",NULL
283,988,70,1058,1395,0,0,75.84,395,593,"明正里",NULL
284,1010,22,1032,1271,0,0,81.2,451,559,"朝陽里",NULL
285,897,23,920,1177,0,0,78.16,419,478,"大甲里",NULL
286,643,14,657,799,0,0,82.23,278,365,"順天里",NULL
287,661,15,676,860,0,0,78.6,330,331,"順天里",NULL
288,632,16,648,786,0,0,82.44,326,306,"孔門里",NULL
289,693,19,712,870,0,0,81.84,311,382,"平安里",NULL
290,874,12,886,1090,0,0,81.28,401,473,"平安里",NULL
291,730,19,749,928,0,0,80.71,311,419,"庄美里",NULL
292,835,25,860,1038,0,0,82.85,396,439,"庄美里",NULL
293,770,31,801,1014,0,0,78.99,395,375,"新美里",NULL
294,853,22,875,1051,0,0,83.25,417,436,"新美里",NULL
295,831,24,855,1037,0,0,82.45,387,444,"新美里",NULL
296,737,6,743,896,0,0,82.92,367,370,"岷山里",NULL
297,742,17,759,967,0,0,78.49,384,358,"岷山里",NULL
298,854,26,880,1086,0,0,81.03,426,428,"中山里",NULL
299,932,33,965,1189,0,0,81.16,538,394,"中山里",NULL
300,919,28,947,1164,0,0,81.36,486,433,"中山里",NULL
301,682,17,699,880,0,0,79.43,336,346,"南陽里",NULL
302,746,17,763,934,0,0,81.69,359,387,"薰風里",NULL
303,977,33,1010,1297,0,0,77.87,471,506,"義和里",NULL
304,1056,31,1087,1352,0,0,80.4,542,514,"義和里",NULL
305,849,36,885,1106,0,0,80.02,474,375,"武陵里",NULL
306,802,37,839,1095,0,0,76.62,364,438,"文曲里",NULL
307,652,26,678,812,0,0,83.5,337,315,"武曲里",NULL
308,576,28,604,748,0,0,80.75,270,306,"武曲里",NULL
309,929,21,950,1158,0,0,82.04,477,452,"文武里",NULL
310,867,28,895,1090,0,0,82.11,421,446,"文武里",NULL
311,903,9,912,1115,0,0,81.79,427,476,"文武里",NULL
312,909,25,934,1189,0,0,78.55,463,446,"文武里",NULL
313,1116,32,1148,1445,0,0,79.45,591,525,"奉化里",NULL
314,610,15,625,801,0,0,78.03,196,414,"德化里",NULL
315,636,17,653,806,0,0,81.02,268,368,"德化里",NULL
316,830,12,842,1028,0,0,81.91,369,461,"江南里",NULL
317,781,23,804,1021,0,0,78.75,337,444,"頂店里",NULL
318,818,29,847,1069,0,0,79.23,353,465,"頂店里",NULL
319,1017,28,1045,1286,0,0,81.26,474,543,"頂店里",NULL
320,952,31,983,1246,0,0,78.89,398,554,"太白里",NULL
321,903,25,928,1145,0,0,81.05,452,451,"孟春里",NULL
322,842,21,863,1063,0,0,81.19,333,509,"孟春里",NULL
323,754,21,775,998,0,0,77.66,321,433,"孟春里",NULL
324,854,42,896,1097,0,0,81.68,279,575,"幸福里",NULL
325,942,41,983,1243,0,0,79.08,391,551,"幸福里",NULL
326,788,16,804,1018,0,0,78.98,383,405,"日南里",NULL
327,715,17,732,936,0,0,78.21,339,376,"日南里",NULL
328,796,26,822,1037,0,0,79.27,345,451,"日南里",NULL
329,896,18,914,1109,0,0,82.42,467,429,"日南里",NULL
330,467,23,490,609,0,0,80.46,267,200,"龍泉里",NULL
331,610,30,640,783,0,0,81.74,240,370,"龍泉里",NULL
332,614,21,635,781,0,0,81.31,312,302,"西岐里",NULL
333,551,19,570,713,0,0,79.94,275,276,"西岐里",NULL
334,955,45,1000,1242,0,0,80.52,438,517,"銅安里",NULL
335,862,21,883,1067,0,0,82.76,473,389,"福德里",NULL
336,1042,45,1087,1329,0,0,81.79,443,599,"建興里",NULL
337,954,17,971,1200,0,0,80.92,460,494,"鰲峰里",NULL
338,872,14,886,1071,0,0,82.73,452,420,"靈泉里",NULL
339,762,11,773,968,0,0,79.86,291,471,"清水里",NULL
340,859,16,875,1058,0,0,82.7,364,495,"清水里",NULL
341,593,8,601,730,0,0,82.33,251,342,"文昌里",NULL
342,682,18,700,842,0,0,83.14,351,331,"南寧里",NULL
343,760,3,763,936,0,0,81.52,339,421,"南寧里",NULL
344,1165,36,1201,1466,0,0,81.92,458,707,"西寧里",NULL
345,601,20,621,744,0,0,83.47,246,355,"北寧里",NULL
346,376,11,387,459,0,0,84.31,157,219,"中興里",NULL
347,1179,13,1192,1426,0,0,83.59,513,666,"西社里",NULL
348,792,18,810,988,0,0,81.98,564,228,"西社里",NULL
349,913,17,930,1154,0,0,80.59,391,522,"南社里",NULL
350,1120,26,1146,1437,0,0,79.75,444,676,"南社里",NULL
351,1077,33,1110,1368,0,0,81.14,447,630,"南社里",NULL
352,1147,31,1178,1400,0,0,84.14,549,598,"南社里",NULL
353,975,25,1000,1272,0,0,78.62,431,544,"裕嘉里",NULL
354,1138,47,1185,1484,0,0,79.85,582,556,"臨江里",NULL
355,900,25,925,1231,0,0,75.14,367,533,"秀水里",NULL
356,939,23,962,1181,0,0,81.46,437,502,"秀水里",NULL
357,922,19,941,1147,0,0,82.04,433,489,"秀水里",NULL
358,1039,37,1076,1372,0,0,78.43,433,606,"武鹿里",NULL
359,1083,33,1116,1397,0,0,79.89,463,620,"武鹿里",NULL
360,842,33,875,1092,0,0,80.13,390,452,"海濱里",NULL
361,610,11,621,770,0,0,80.65,289,321,"海濱里",NULL
362,1085,23,1108,1349,0,0,82.13,439,646,"康榔里",NULL
363,788,17,805,1015,0,0,79.31,273,515,"康榔里",NULL
364,958,24,982,1234,0,0,79.58,380,578,"康榔里",NULL
365,589,13,602,723,0,0,83.26,535,54,"中社里",NULL
366,630,14,644,804,0,0,80.1,417,213,"中社里",NULL
367,995,53,1048,1325,0,0,79.09,576,419,"高西里",NULL
368,1057,33,1090,1305,0,0,83.52,476,581,"高南里",NULL
369,973,47,1020,1285,0,0,79.38,320,653,"高東里",NULL
370,827,28,855,1101,0,0,77.66,492,335,"高北里",NULL
371,990,26,1016,1270,0,0,80,502,488,"高美里",NULL
372,814,26,840,1099,0,0,76.43,290,524,"國姓里",NULL
373,728,24,752,909,0,0,82.73,242,486,"國姓里",NULL
374,809,27,836,1047,0,0,79.85,346,463,"菁埔里",NULL
375,839,28,867,1136,0,0,76.32,321,518,"菁埔里",NULL
376,648,24,672,842,0,0,79.81,314,334,"頂湳里",NULL
377,697,31,728,917,0,0,79.39,259,438,"頂湳里",NULL
378,889,12,901,1148,0,0,78.48,360,529,"田寮里",NULL
379,725,22,747,977,0,0,76.46,275,450,"田寮里",NULL
380,1232,13,1245,1572,0,0,79.2,497,735,"橋頭里",NULL
381,1410,27,1437,1742,0,0,82.49,611,799,"橋頭里",NULL
382,1008,17,1025,1270,0,0,80.71,429,579,"橋頭里",NULL
383,974,8,982,1217,0,0,80.69,410,564,"橋頭里",NULL
384,622,20,642,810,0,0,79.26,281,341,"下湳里",NULL
385,607,22,629,792,0,0,79.42,253,354,"下湳里",NULL
386,1017,16,1033,1259,0,0,82.05,421,596,"下湳里",NULL
387,864,31,895,1112,0,0,80.49,432,432,"東山里",NULL
388,1049,42,1091,1332,0,0,81.91,532,517,"吳厝里",NULL
389,811,42,853,1037,0,0,82.26,284,527,"楊厝里",NULL
390,918,42,960,1207,0,0,79.54,330,588,"海風里",NULL
391,1099,12,1111,1355,0,0,81.99,520,579,"居仁里",NULL
392,763,20,783,964,0,0,81.22,361,402,"洛泉里",NULL
393,1011,16,1027,1234,0,0,83.23,515,496,"洛泉里",NULL
394,942,21,963,1174,0,0,82.03,366,576,"沙鹿里",NULL
395,452,8,460,547,0,0,84.1,219,233,"美仁里",NULL
396,1063,20,1083,1335,0,0,81.12,513,550,"興仁里",NULL
397,858,14,872,1046,0,0,83.37,433,425,"興仁里",NULL
398,746,24,770,954,0,0,80.71,332,414,"興安里",NULL
399,1345,23,1368,1639,0,0,83.47,626,719,"興安里",NULL
400,840,12,852,1024,0,0,83.2,446,394,"斗抵里",NULL
401,1027,32,1059,1267,0,0,83.58,484,543,"斗抵里",NULL
402,1141,22,1163,1393,0,0,83.49,540,601,"斗抵里",NULL
403,971,26,997,1247,0,0,79.95,372,599,"鹿峰里",NULL
404,1031,23,1054,1298,0,0,81.2,435,596,"鹿峰里",NULL
405,1040,29,1069,1328,0,0,80.5,461,579,"鹿峰里",NULL
406,1270,39,1309,1626,0,0,80.5,487,783,"鹿寮里",NULL
407,865,20,885,1087,0,0,81.42,363,502,"鹿寮里",NULL
408,843,16,859,1079,0,0,79.61,295,548,"鹿寮里",NULL
409,1132,20,1152,1357,0,0,84.89,492,640,"鹿寮里",NULL
410,1037,31,1068,1287,0,0,82.98,553,484,"竹林里",NULL
411,1113,29,1142,1411,0,0,80.94,607,506,"竹林里",NULL
412,1112,28,1140,1434,0,0,79.5,472,640,"竹林里",NULL
413,1134,17,1151,1369,0,0,84.08,570,564,"竹林里",NULL
414,646,35,681,840,0,0,81.07,275,371,"犁分里",NULL
415,1097,26,1123,1427,0,0,78.7,564,533,"福興里",NULL
416,607,17,624,809,0,0,77.13,356,251,"福興里",NULL
417,818,17,835,1040,0,0,80.29,419,399,"北勢里",NULL
418,781,35,816,1058,0,0,77.13,382,399,"北勢里",NULL
419,943,29,972,1226,0,0,79.28,464,479,"北勢里",NULL
420,980,42,1022,1254,0,0,81.5,439,541,"晉江里",NULL
421,810,19,829,1042,0,0,79.56,389,421,"六路里",NULL
422,1001,24,1025,1262,0,0,81.22,466,535,"六路里",NULL
423,755,23,778,971,0,0,80.12,310,445,"南勢里",NULL
424,672,30,702,879,0,0,79.86,323,349,"南勢里",NULL
425,1600,43,1643,2061,0,0,79.72,792,808,"埔子里",NULL
426,866,25,891,1123,0,0,79.34,503,363,"三鹿里",NULL
427,949,27,976,1271,0,0,76.79,538,411,"三鹿里",NULL
428,1034,29,1063,1323,0,0,80.35,628,406,"公明里",NULL
429,675,16,691,868,0,0,79.61,582,93,"公明里",NULL
430,1070,25,1095,1287,0,0,85.08,608,462,"公明里",NULL
431,861,10,871,1094,0,0,79.62,511,350,"清泉里",NULL
432,653,19,672,791,0,0,84.96,473,180,"清泉里",NULL
433,825,12,837,1040,0,0,80.48,408,417,"西勢里",NULL
434,762,11,773,944,0,0,81.89,401,361,"西勢里",NULL
435,812,23,835,1060,0,0,78.77,407,405,"頂寮里",NULL
436,1212,18,1230,1510,0,0,81.46,690,522,"頂寮里",NULL
437,744,22,766,913,0,0,83.9,456,288,"下寮里",NULL
438,912,15,927,1102,0,0,84.12,453,459,"下寮里",NULL
439,836,21,857,1076,0,0,79.65,390,446,"中正里",NULL
440,849,18,867,1118,0,0,77.55,448,401,"中正里",NULL
441,907,13,920,1149,0,0,80.07,496,411,"中正里",NULL
442,441,3,444,566,0,0,78.45,198,243,"中和里",NULL
443,930,24,954,1148,0,0,83.1,484,446,"文化里",NULL
444,588,19,607,741,0,0,81.92,307,281,"安仁里",NULL
445,865,27,892,1115,0,0,80,463,402,"草湳里",NULL
446,1144,28,1172,1444,0,0,81.16,580,564,"草湳里",NULL
447,978,26,1004,1260,0,0,79.68,463,515,"草湳里",NULL
448,1133,19,1152,1405,0,0,81.99,540,593,"草湳里",NULL
449,995,26,1021,1215,0,0,84.03,377,618,"南簡里",NULL
450,1109,27,1136,1405,0,0,80.85,469,640,"南簡里",NULL
451,1132,20,1152,1404,0,0,82.05,479,653,"福德里",NULL
452,1172,30,1202,1496,0,0,80.35,548,624,"福德里",NULL
453,861,17,878,1096,0,0,80.11,364,497,"大庄里",NULL
454,858,14,872,1050,0,0,83.05,408,450,"大庄里",NULL
455,1080,11,1091,1368,0,0,79.75,575,505,"大庄里",NULL
456,596,21,617,766,0,0,80.55,293,303,"大庄里",NULL
457,637,11,648,803,0,0,80.7,310,327,"大庄里",NULL
458,1012,23,1035,1311,0,0,78.95,481,531,"大村里",NULL
459,1044,25,1069,1336,0,0,80.01,511,533,"大村里",NULL
460,866,17,883,1088,0,0,81.16,448,418,"大村里",NULL
461,801,29,830,1030,0,0,80.58,351,450,"興農里",NULL
462,625,20,645,774,0,0,83.33,213,412,"興農里",NULL
463,832,5,837,1013,0,0,82.63,356,476,"永寧里",NULL
464,937,19,956,1155,0,0,82.77,428,509,"永寧里",NULL
465,912,29,941,1148,0,0,81.97,455,457,"永安里",NULL
466,860,10,870,1091,0,0,79.74,358,502,"永安里",NULL
467,625,27,652,772,0,0,84.46,347,278,"廣福村",NULL
468,908,27,935,1159,0,0,80.67,701,207,"廣福村",NULL
469,730,14,744,915,0,0,81.31,331,399,"仁里村",NULL
470,1118,32,1150,1394,0,0,82.5,1070,48,"仁里村",NULL
471,1014,33,1047,1275,0,0,82.12,577,437,"義里村",NULL
472,1083,16,1099,1351,0,0,81.35,653,430,"義里村",NULL
473,1018,23,1041,1288,0,0,80.82,620,398,"義德村",NULL
474,995,24,1019,1236,0,0,82.44,568,427,"義德村",NULL
475,989,12,1001,1208,0,0,82.86,502,487,"后里村",NULL
476,1007,24,1031,1212,0,0,85.07,539,468,"后里村",NULL
477,730,11,741,897,0,0,82.61,368,362,"后里村",NULL
478,719,21,740,896,0,0,82.59,322,397,"厚里村",NULL
479,815,31,846,1000,0,0,84.6,364,451,"厚里村",NULL
480,1198,28,1226,1515,0,0,80.92,629,569,"墩東村",NULL
481,1038,30,1068,1328,0,0,80.42,484,554,"墩東村",NULL
482,1044,32,1076,1250,0,0,86.08,477,567,"墩東村",NULL
483,684,26,710,862,0,0,82.37,315,369,"墩西村",NULL
484,766,21,787,935,0,0,84.17,302,464,"墩西村",NULL
485,974,20,994,1205,0,0,82.49,469,505,"墩南村",NULL
486,1141,31,1172,1394,0,0,84.07,452,689,"墩南村",NULL
487,1030,33,1063,1262,0,0,84.23,491,539,"墩北村",NULL
488,1270,35,1305,1573,0,0,82.96,525,745,"墩北村",NULL
489,776,25,801,961,0,0,83.35,275,501,"中和村",NULL
490,872,25,897,1065,0,0,84.23,376,496,"中和村",NULL
491,1057,39,1096,1331,0,0,82.34,387,670,"舊社村",NULL
492,1173,42,1215,1499,0,0,81.05,459,714,"聯合村",NULL
493,695,34,729,913,0,0,79.85,308,387,"太平村",NULL
494,867,29,896,1103,0,0,81.23,410,457,"太平村",NULL
495,1141,25,1166,1441,0,0,80.92,526,615,"眉山村",NULL
496,1074,34,1108,1384,0,0,80.06,556,518,"眉山村",NULL
497,1251,30,1281,1543,0,0,83.02,480,771,"月眉村",NULL
498,1388,47,1435,1769,0,0,81.12,579,809,"公館村",NULL
499,989,38,1027,1268,0,0,80.99,397,592,"泰安村",NULL
500,1027,22,1049,1263,0,0,83.06,425,602,"神岡村",NULL
501,1007,20,1027,1250,0,0,82.16,513,494,"神岡村",NULL
502,1257,29,1286,1586,0,0,81.08,537,720,"庄前村",NULL
503,778,28,806,947,0,0,85.11,301,477,"北庄村",NULL
504,951,29,980,1208,0,0,81.13,396,555,"北庄村",NULL
505,923,37,960,1141,0,0,84.14,326,597,"庄後村",NULL
506,706,20,726,870,0,0,83.45,248,458,"庄後村",NULL
507,960,26,986,1182,0,0,83.42,412,548,"圳前村",NULL
508,735,18,753,935,0,0,80.53,485,250,"圳前村",NULL
509,687,21,708,807,0,0,87.73,316,371,"圳堵村",NULL
510,914,19,933,1144,0,0,81.56,513,401,"圳堵村",NULL
511,976,43,1019,1219,0,0,83.59,364,612,"新庄村",NULL
512,941,34,975,1200,0,0,81.25,349,592,"新庄村",NULL
513,864,31,895,1165,0,0,76.82,438,426,"新庄村",NULL
514,731,31,762,917,0,0,83.1,302,429,"山皮村",NULL
515,1142,35,1177,1417,0,0,83.06,469,673,"社口村",NULL
516,1055,22,1077,1293,0,0,83.29,464,591,"社口村",NULL
517,1067,22,1089,1337,0,0,81.45,437,630,"社口村",NULL
518,1146,11,1157,1371,0,0,84.39,466,680,"社口村",NULL
519,1125,36,1161,1403,0,0,82.75,432,693,"社南村",NULL
520,1063,31,1094,1308,0,0,83.64,388,675,"社南村",NULL
521,1060,31,1091,1329,0,0,82.09,447,613,"社南村",NULL
522,1075,32,1107,1319,0,0,83.93,345,730,"三角村",NULL
523,650,20,670,802,0,0,83.54,230,420,"三角村",NULL
524,993,30,1023,1219,0,0,83.92,405,588,"大社村",NULL
525,945,22,967,1216,0,0,79.52,474,471,"大社村",NULL
526,606,13,619,812,0,0,76.23,340,266,"大社村",NULL
527,1075,24,1099,1279,0,0,85.93,392,683,"岸裡村",NULL
528,1033,33,1066,1271,0,0,83.87,352,681,"岸裡村",NULL
529,1183,45,1228,1521,0,0,80.74,465,718,"豐洲村",NULL
530,1310,44,1354,1630,0,0,83.07,484,826,"豐洲村",NULL
531,1241,36,1277,1571,0,0,81.29,497,744,"豐洲村",NULL
532,1165,33,1198,1438,0,0,83.31,431,734,"豐洲村",NULL
533,922,44,966,1115,0,0,86.64,283,639,"神洲村",NULL
534,958,28,986,1161,0,0,84.93,332,626,"神洲村",NULL
535,1066,12,1078,1288,0,0,83.7,439,627,"溪洲村",NULL
536,997,33,1030,1210,0,0,85.12,311,686,"溪洲村",NULL
537,1137,18,1155,1377,0,0,83.88,414,723,"潭秀村",NULL
538,1698,29,1727,2095,0,0,82.43,876,822,"潭北村",NULL
539,1246,29,1275,1541,0,0,82.74,598,648,"潭陽村",NULL
540,1723,22,1745,2074,0,0,84.14,912,811,"潭陽村",NULL
541,1390,28,1418,1898,0,0,74.71,731,659,"潭陽村",NULL
542,1597,32,1629,1981,0,0,82.23,688,909,"潭陽村",NULL
543,1121,29,1150,1358,0,0,84.68,553,568,"潭陽村",NULL
544,1498,46,1544,1872,0,0,82.48,749,749,"福仁村",NULL
545,1557,27,1584,1988,0,0,79.68,876,681,"福仁村",NULL
546,1237,33,1270,1582,0,0,80.28,635,602,"福仁村",NULL
547,1485,27,1512,1846,0,0,81.91,832,653,"福仁村",NULL
548,840,18,858,1011,0,0,84.87,454,386,"頭家村",NULL
549,1485,33,1518,1896,0,0,80.06,903,582,"頭家村",NULL
550,720,11,731,882,0,0,82.88,345,375,"頭家村",NULL
551,1368,24,1392,1664,0,0,83.65,784,584,"頭家東村",NULL
552,1022,22,1044,1259,0,0,82.92,487,535,"頭家東村",NULL
553,1464,30,1494,1916,0,0,77.97,884,580,"家興村",NULL
554,1503,24,1527,1906,0,0,80.12,795,708,"家興村",NULL
555,1168,29,1197,1482,0,0,80.77,539,629,"家福村",NULL
556,1060,17,1077,1315,0,0,81.9,531,529,"家福村",NULL
557,1821,33,1854,2237,0,0,82.88,917,904,"甘蔗村",NULL
558,1647,19,1666,2034,0,0,81.91,814,833,"甘蔗村",NULL
559,1803,29,1832,2237,0,0,81.9,1036,767,"甘蔗村",NULL
560,950,33,983,1171,0,0,83.95,333,617,"東寶村",NULL
561,914,27,941,1141,0,0,82.47,459,455,"東寶村",NULL
562,1001,15,1016,1239,0,0,82,563,438,"東寶村",NULL
563,1504,32,1536,1799,0,0,85.38,700,804,"東寶村",NULL
564,1769,49,1818,2186,0,0,83.17,701,1068,"東寶村",NULL
565,1170,31,1201,1459,0,0,82.32,586,584,"東寶村",NULL
566,1457,35,1492,1770,0,0,84.29,502,955,"大富村",NULL
567,1466,23,1489,1788,0,0,83.28,628,838,"大豐村",NULL
568,1293,28,1321,1570,0,0,84.14,506,787,"大豐村",NULL
569,1359,35,1394,1676,0,0,83.17,667,692,"栗林村",NULL
570,1017,32,1049,1272,0,0,82.47,371,646,"栗林村",NULL
571,956,25,981,1173,0,0,83.63,397,559,"栗林村",NULL
572,1393,54,1447,1688,0,0,85.72,538,855,"嘉仁村",NULL
573,1399,15,1414,1680,0,0,84.17,773,626,"嘉仁村",NULL
574,1154,27,1181,1453,0,0,81.28,451,703,"新田村",NULL
575,1155,46,1201,1444,0,0,83.17,422,733,"聚興村",NULL
576,1088,38,1126,1423,0,0,79.13,530,558,"聚興村",NULL
577,1526,20,1546,1949,0,0,79.32,797,729,"上雅村",NULL
578,1488,32,1520,1857,0,0,81.85,689,799,"上雅村",NULL
579,1516,33,1549,1881,0,0,82.35,828,688,"大雅村",NULL
580,1488,20,1508,1931,0,0,78.09,716,772,"大雅村",NULL
581,1312,32,1344,1711,0,0,78.55,808,504,"文雅村",NULL
582,1239,21,1260,1498,0,0,84.11,693,546,"文雅村",NULL
583,971,24,995,1271,0,0,78.28,476,495,"文雅村",NULL
584,1718,34,1752,2146,0,0,81.64,746,972,"三和村",NULL
585,1341,26,1367,1678,0,0,81.47,661,680,"三和村",NULL
586,1418,22,1440,1785,0,0,80.67,679,739,"二和村",NULL
587,1536,31,1567,1923,0,0,81.49,801,735,"二和村",NULL
588,1087,10,1097,1347,0,0,81.44,612,475,"四德村",NULL
589,1388,25,1413,1751,0,0,80.7,655,733,"四德村",NULL
590,1019,24,1043,1253,0,0,83.24,413,606,"西寶村",NULL
591,1421,37,1458,1816,0,0,80.29,559,862,"西寶村",NULL
592,1418,19,1437,1744,0,0,82.4,651,767,"上楓村",NULL
593,1381,30,1411,1790,0,0,78.83,666,715,"上楓村",NULL
594,968,24,992,1279,0,0,77.56,457,511,"上楓村",NULL
595,1215,50,1265,1532,0,0,82.57,516,699,"上楓村",NULL
596,1061,31,1092,1355,0,0,80.59,456,605,"上楓村",NULL
597,1025,16,1041,1234,0,0,84.36,543,482,"上楓村",NULL
598,935,21,956,1235,0,0,77.41,545,390,"上楓村",NULL
599,1412,23,1435,1750,0,0,82,577,835,"員林村",NULL
600,1668,35,1703,2069,0,0,82.31,764,904,"員林村",NULL
601,1800,47,1847,2278,0,0,81.08,938,862,"員林村",NULL
602,1124,24,1148,1380,0,0,83.19,516,608,"六寶村",NULL
603,1160,22,1182,1470,0,0,80.41,891,269,"六寶村",NULL
604,889,24,913,1147,0,0,79.6,610,279,"六寶村",NULL
605,1084,23,1107,1349,0,0,82.06,457,627,"六寶村",NULL
606,1349,30,1379,1641,0,0,84.03,559,790,"秀山村",NULL
607,845,29,874,1045,0,0,83.64,365,480,"秀山村",NULL
608,1419,40,1459,1800,0,0,81.06,635,784,"橫山村",NULL
609,1242,42,1284,1581,0,0,81.21,581,661,"橫山村",NULL
610,1312,35,1347,1629,0,0,82.69,1147,165,"忠義村",NULL
611,1313,45,1358,1690,0,0,80.36,1049,264,"忠義村",NULL
612,1086,33,1119,1330,0,0,84.14,553,533,"新社村",NULL
613,1198,29,1227,1484,0,0,82.68,669,529,"新社村",NULL
614,1309,66,1375,1747,0,0,78.71,735,574,"復盛村",NULL
615,991,46,1037,1236,0,0,83.9,467,524,"中正村",NULL
616,730,27,757,911,0,0,83.1,316,414,"月湖村",NULL
617,951,36,987,1205,0,0,81.91,331,620,"崑山村",NULL
618,1519,53,1572,1948,0,0,80.7,767,752,"大南村",NULL
619,1543,57,1600,1939,0,0,82.52,670,873,"永源村",NULL
620,576,18,594,707,0,0,84.02,150,426,"永源村",NULL
621,640,26,666,809,0,0,82.32,549,91,"中興村",NULL
622,965,36,1001,1216,0,0,82.32,421,544,"協成村",NULL
623,1070,56,1126,1380,0,0,81.59,428,642,"協成村",NULL
624,1009,45,1054,1274,0,0,82.73,534,475,"東興村",NULL
625,204,10,214,251,0,0,85.26,122,82,"慶西村",NULL
626,488,27,515,641,0,0,80.34,166,322,"慶西村",NULL
627,457,17,474,587,0,0,80.75,297,160,"中和村",NULL
628,726,55,781,1005,0,0,77.71,317,409,"福興村",NULL
629,208,2,210,262,0,0,80.15,132,76,"福興村",NULL
630,854,30,884,1058,0,0,83.55,404,450,"石岡村",NULL
631,982,26,1008,1160,0,0,86.9,457,525,"萬安村",NULL
632,825,29,854,1047,0,0,81.57,451,374,"九房村",NULL
633,951,47,998,1212,0,0,82.34,424,527,"金星村",NULL
634,547,13,560,679,0,0,82.47,259,288,"龍興村",NULL
635,1111,31,1142,1351,0,0,84.53,547,564,"萬興村",NULL
636,1347,47,1394,1724,0,0,80.86,635,712,"梅子村",NULL
637,726,28,754,929,0,0,81.16,403,323,"土牛村",NULL
638,1003,37,1040,1268,0,0,82.02,588,415,"德興村",NULL
639,979,19,998,1210,0,0,82.48,638,341,"和盛村",NULL
640,799,10,809,993,0,0,81.47,413,386,"永豐村",NULL
641,1220,33,1253,1531,0,0,81.84,707,513,"六分村",NULL
642,955,20,975,1192,0,0,81.8,537,418,"大同村",NULL
643,883,26,909,1131,0,0,80.37,465,418,"大同村",NULL
644,931,23,954,1183,0,0,80.64,555,376,"大同村",NULL
645,1075,39,1114,1407,0,0,79.18,615,460,"大東村",NULL
646,1252,40,1292,1596,0,0,80.95,692,560,"大東村",NULL
647,1275,33,1308,1656,0,0,78.99,677,598,"大東村",NULL
648,1281,51,1332,1694,0,0,78.63,698,583,"三崁村",NULL
649,1302,31,1333,1686,0,0,79.06,720,582,"水美村",NULL
650,925,24,949,1189,0,0,79.81,496,429,"水美村",NULL
651,704,31,735,952,0,0,77.21,400,304,"鐵山村",NULL
652,830,54,884,1105,0,0,80,442,388,"鐵山村",NULL
653,797,24,821,1038,0,0,79.09,456,341,"中山村",NULL
654,1034,40,1074,1339,0,0,80.21,551,483,"馬鳴村",NULL
655,1251,57,1308,1571,0,0,83.26,527,724,"土城村",NULL
656,906,40,946,1205,0,0,78.51,434,472,"廍子村",NULL
657,855,26,881,1077,0,0,81.8,332,523,"南埔村",NULL
658,874,26,900,1114,0,0,80.79,335,539,"南庄村",NULL
659,847,28,875,1138,0,0,76.89,397,450,"中庄村",NULL
660,963,13,976,1250,0,0,78.08,462,501,"中庄村",NULL
661,964,23,987,1200,0,0,82.25,491,473,"東安村",NULL
662,861,42,903,1157,0,0,78.05,342,519,"福興村",NULL
663,686,21,707,835,0,0,84.67,355,331,"龜殼村",NULL
664,564,28,592,739,0,0,80.11,264,300,"龜殼村",NULL
665,671,30,701,875,0,0,80.11,294,377,"頂安村",NULL
666,881,29,910,1119,0,0,81.32,385,496,"永安村",NULL
667,432,17,449,530,0,0,84.72,253,179,"永安村",NULL
668,771,35,806,989,0,0,81.5,378,393,"福住村",NULL
669,1032,33,1065,1362,0,0,78.19,623,409,"海墘村",NULL
670,1052,58,1110,1378,0,0,80.55,445,607,"西安村",NULL
671,628,11,639,768,0,0,83.2,261,367,"松雅村",NULL
672,1160,22,1182,1390,0,0,85.04,512,648,"烏日村",NULL
673,1232,19,1251,1516,0,0,82.52,530,702,"烏日村",NULL
674,1063,24,1087,1395,0,0,77.92,489,574,"烏日村",NULL
675,1290,34,1324,1527,0,0,86.71,687,603,"烏日村",NULL
676,936,26,962,1160,0,0,82.93,388,548,"湖日村",NULL
677,753,13,766,980,0,0,78.16,380,373,"湖日村",NULL
678,1310,43,1353,1638,0,0,82.6,611,699,"三和村",NULL
679,1380,62,1442,1724,0,0,83.64,995,385,"三和村",NULL
680,1217,29,1246,1459,0,0,85.4,655,562,"榮泉村",NULL
681,857,22,879,1064,0,0,82.61,481,376,"榮泉村",NULL
682,826,27,853,1040,0,0,82.02,455,371,"學田村",NULL
683,751,33,784,938,0,0,83.58,412,339,"學田村",NULL
684,1467,28,1495,1791,0,0,83.47,791,676,"九德村",NULL
685,1351,27,1378,1695,0,0,81.3,684,667,"九德村",NULL
686,1241,18,1259,1557,0,0,80.86,621,620,"九德村",NULL
687,1285,22,1307,1543,0,0,84.71,573,712,"九德村",NULL
688,1270,12,1282,1503,0,0,85.3,584,686,"九德村",NULL
689,1158,21,1179,1482,0,0,79.55,528,630,"九德村",NULL
690,1379,26,1405,1723,0,0,81.54,673,706,"仁德村",NULL
691,1358,27,1385,1673,0,0,82.79,727,631,"仁德村",NULL
692,1541,22,1563,1887,0,0,82.83,848,693,"仁德村",NULL
693,838,23,861,1016,0,0,84.74,326,512,"前竹村",NULL
694,883,22,905,1056,0,0,85.7,319,564,"前竹村",NULL
695,1168,37,1205,1473,0,0,81.81,556,612,"五光村",NULL
696,724,21,745,883,0,0,84.37,285,439,"光明村",NULL
697,914,25,939,1128,0,0,83.24,408,506,"光明村",NULL
698,1324,46,1370,1672,0,0,81.94,576,748,"東園村",NULL
699,1480,25,1505,1774,0,0,84.84,735,745,"溪埧村",NULL
700,1475,35,1510,1827,0,0,82.65,637,838,"溪埧村",NULL
701,1247,45,1292,1532,0,0,84.33,545,702,"螺潭村",NULL
702,1115,46,1161,1406,0,0,82.57,450,665,"北里村",NULL
703,876,21,897,1081,0,0,82.98,385,491,"南里村",NULL
704,594,30,624,812,0,0,76.85,255,339,"溪尾村",NULL
705,1457,40,1497,1831,0,0,81.76,620,837,"王田村",NULL
706,1441,38,1479,1829,0,0,80.86,658,783,"王田村",NULL
707,662,19,681,798,0,0,85.34,275,387,"中和村",NULL
708,842,27,869,1051,0,0,82.68,367,475,"福山村",NULL
709,921,19,940,1123,0,0,83.7,453,468,"福山村",NULL
710,891,23,914,1080,0,0,84.63,448,443,"福山村",NULL
711,1051,29,1080,1292,0,0,83.59,525,526,"營埔村",NULL
712,912,27,939,1092,0,0,85.99,511,401,"社腳村",NULL
713,925,18,943,1166,0,0,80.87,485,440,"社腳村",NULL
714,930,16,946,1176,0,0,80.44,505,425,"新興村",NULL
715,870,18,888,1130,0,0,78.58,473,397,"新興村",NULL
716,1107,20,1127,1364,0,0,82.62,588,519,"大東村",NULL
717,1007,23,1030,1225,0,0,84.08,508,499,"大東村",NULL
718,671,15,686,827,0,0,82.95,371,300,"大肚村",NULL
719,820,9,829,1000,0,0,82.9,455,365,"大肚村",NULL
720,676,11,687,845,0,0,81.3,338,338,"永和村",NULL
721,1046,33,1079,1329,0,0,81.19,559,487,"磺溪村",NULL
722,1197,42,1239,1476,0,0,83.94,534,663,"永順村",NULL
723,709,28,737,891,0,0,82.72,353,356,"成功村",NULL
724,1070,42,1112,1344,0,0,82.74,487,583,"山陽村",NULL
725,1206,34,1240,1576,0,0,78.68,586,620,"頂街村",NULL
726,1358,20,1378,1696,0,0,81.25,734,624,"頂街村",NULL
727,1355,20,1375,1605,0,0,85.67,768,587,"頂街村",NULL
728,1047,24,1071,1330,0,0,80.53,442,605,"瑞井村",NULL
729,1082,26,1108,1364,0,0,81.23,516,566,"瑞井村",NULL
730,923,14,937,1200,0,0,78.08,504,419,"瑞井村",NULL
731,1317,39,1356,1685,0,0,80.47,506,811,"蔗廍村",NULL
732,1405,37,1442,1825,0,0,79.01,664,741,"蔗廍村",NULL
733,1038,21,1059,1291,0,0,82.03,470,568,"自強村",NULL
734,1359,27,1386,1664,0,0,83.29,1016,343,"自強村",NULL
735,1037,25,1062,1312,0,0,80.95,504,533,"竹坑村",NULL
736,737,10,747,932,0,0,80.15,396,341,"竹坑村",NULL
737,988,25,1013,1270,0,0,79.76,477,511,"龍東村",NULL
738,921,23,944,1159,0,0,81.45,479,442,"龍東村",NULL
739,1327,42,1369,1643,0,0,83.32,714,613,"龍西村",NULL
740,1085,37,1122,1370,0,0,81.9,500,585,"田中村",NULL
741,959,16,975,1210,0,0,80.58,436,523,"田中村",NULL
742,736,31,767,998,0,0,76.85,391,345,"福田村",NULL
743,872,31,903,1138,0,0,79.35,528,344,"麗水村",NULL
744,655,15,670,826,0,0,81.11,323,332,"麗水村",NULL
745,1108,27,1135,1427,0,0,79.54,541,567,"龍津村",NULL
746,1015,41,1056,1282,0,0,82.37,512,503,"龍津村",NULL
747,554,14,568,712,0,0,79.78,243,311,"龍津村",NULL
748,641,15,656,845,0,0,77.63,139,502,"龍津村",NULL
749,1090,35,1125,1433,0,0,78.51,498,592,"三德村",NULL
750,824,21,845,1067,0,0,79.19,306,518,"三德村",NULL
751,940,28,968,1183,0,0,81.83,378,562,"忠和村",NULL
752,1060,33,1093,1392,0,0,78.52,493,567,"忠和村",NULL
753,1034,33,1067,1292,0,0,82.59,372,662,"忠和村",NULL
754,779,21,800,1017,0,0,78.66,371,408,"山腳村",NULL
755,1144,34,1178,1516,0,0,77.7,529,615,"山腳村",NULL
756,1093,18,1111,1393,0,0,79.76,481,612,"山腳村",NULL
757,929,20,949,1170,0,0,81.11,491,438,"龍泉村",NULL
758,970,25,995,1279,0,0,77.8,402,568,"龍泉村",NULL
759,896,21,917,1140,0,0,80.44,504,392,"龍泉村",NULL
760,585,22,607,791,0,0,76.74,352,233,"龍泉村",NULL
761,1003,26,1029,1305,0,0,78.85,449,554,"龍崗村",NULL
762,638,13,651,781,0,0,83.35,287,351,"龍崗村",NULL
763,1131,43,1174,1485,0,0,79.06,495,636,"新庄村",NULL
764,1180,32,1212,1558,0,0,77.79,577,603,"新庄村",NULL
765,1265,36,1301,1616,0,0,80.51,636,629,"新庄村",NULL
766,1109,51,1160,1362,0,0,85.17,469,640,"南寮村",NULL
767,1329,19,1348,1692,0,0,79.67,869,460,"東海村",NULL
768,1087,22,1109,1341,0,0,82.7,586,501,"東海村",NULL
769,1383,13,1396,1739,0,0,80.28,848,535,"東海村",NULL
770,693,9,702,879,0,0,79.86,434,259,"東海村",NULL
771,1231,28,1259,1584,0,0,79.48,613,618,"新東村",NULL
772,1289,24,1313,1654,0,0,79.38,683,606,"新東村",NULL
773,912,27,939,1143,0,0,82.15,401,511,"桐林村",NULL
774,1341,13,1354,1658,0,0,81.66,662,679,"吉峰村",NULL
775,1158,24,1182,1498,0,0,78.91,534,624,"吉峰村",NULL
776,978,22,1000,1239,0,0,80.71,522,456,"吉峰村",NULL
777,1257,27,1284,1598,0,0,80.35,680,577,"吉峰村",NULL
778,1186,24,1210,1483,0,0,81.59,598,588,"吉峰村",NULL
779,1192,23,1215,1465,0,0,82.94,598,594,"甲寅村",NULL
780,1099,24,1123,1401,0,0,80.16,600,499,"甲寅村",NULL
781,894,25,919,1140,0,0,80.61,441,453,"甲寅村",NULL
782,1489,27,1516,1826,0,0,83.02,710,779,"本鄉村",NULL
783,1278,23,1301,1546,0,0,84.15,687,591,"中正村",NULL
784,784,16,800,942,0,0,84.93,410,374,"錦榮村",NULL
785,865,21,886,1071,0,0,82.73,437,428,"萊園村",NULL
786,1305,26,1331,1660,0,0,80.18,731,574,"本堂村",NULL
787,1341,39,1380,1733,0,0,79.63,731,610,"本堂村",NULL
788,1198,25,1223,1476,0,0,82.86,635,563,"本堂村",NULL
789,1238,35,1273,1499,0,0,84.92,643,595,"北柳村",NULL
790,1272,29,1301,1554,0,0,83.72,542,730,"北柳村",NULL
791,1153,41,1194,1428,0,0,83.61,525,628,"南柳村",NULL
792,827,34,861,1020,0,0,84.41,334,493,"四德村",NULL
793,808,7,815,984,0,0,82.83,316,492,"四德村",NULL
794,926,34,960,1147,0,0,83.7,466,460,"五福村",NULL
795,1005,38,1043,1237,0,0,84.32,440,565,"五福村",NULL
796,861,27,888,1015,0,0,87.49,314,547,"丁臺村",NULL
797,751,35,786,922,0,0,85.25,258,493,"丁臺村",NULL
798,1335,51,1386,1662,0,0,83.39,672,663,"北勢村",NULL
799,923,26,949,1162,0,0,81.67,422,501,"南勢村",NULL
800,992,31,1023,1238,0,0,82.63,390,602,"萬豐村",NULL
801,916,22,938,1165,0,0,80.52,403,513,"萬豐村",NULL
802,850,35,885,1074,0,0,82.4,402,448,"舊正村",NULL
803,727,27,754,926,0,0,81.43,301,426,"舊正村",NULL
804,851,16,867,1021,0,0,84.92,522,329,"坑口村",NULL
805,714,29,743,950,0,0,78.21,324,390,"坑口村",NULL
806,732,14,746,904,0,0,82.52,514,218,"坑口村",NULL
807,805,21,826,1036,0,0,79.73,336,469,"峰谷村",NULL
808,1007,38,1045,1239,0,0,84.34,362,645,"六股村",NULL
809,778,24,802,951,0,0,84.33,314,464,"六股村",NULL
810,112,4,116,153,0,0,75.82,42,70,"南勢村",NULL
811,574,25,599,791,0,0,75.73,299,275,"南勢村",NULL
812,598,22,620,795,0,0,77.99,409,189,"南勢村",NULL
813,342,17,359,485,0,0,74.02,198,144,"天輪村",NULL
814,807,10,817,1067,0,0,76.57,578,229,"博愛村",NULL
815,450,10,460,572,0,0,80.42,308,142,"博愛村",NULL
816,168,6,174,229,0,0,75.98,119,49,"自由村",NULL
817,310,6,316,408,0,0,77.45,242,68,"自由村",NULL
818,225,10,235,310,0,0,75.81,181,44,"自由村",NULL
819,521,15,536,694,0,0,77.23,357,164,"達觀村",NULL
820,246,2,248,294,0,0,84.35,210,36,"達觀村",NULL
821,298,8,306,376,0,0,81.38,172,126,"中坑村",NULL
822,183,2,185,325,0,0,56.92,133,50,"梨山村",NULL
823,655,20,675,1082,0,0,62.38,481,174,"梨山村",NULL
824,124,5,129,257,0,0,50.19,112,12,"梨山村",NULL
825,160,0,160,251,0,0,63.75,131,29,"梨山村",NULL
826,120,1,121,206,0,0,58.74,105,15,"平等村",NULL
827,406,3,409,577,0,0,70.88,328,78,"平等村",NULL
1,980,39,1019,1248,0,0,81.65,483,497,"桃源里",NULL
2,1140,36,1176,1509,0,0,77.93,708,432,"桃源里",NULL
3,1301,22,1323,1599,0,0,82.74,647,654,"東興里",NULL
4,1210,18,1228,1528,0,0,80.37,614,596,"華北里",NULL
5,806,21,827,1010,0,0,81.88,535,271,"華陽里",NULL
6,854,22,876,1109,0,0,78.99,453,401,"華陽里",NULL
7,830,19,849,1032,0,0,82.27,348,482,"大同里",NULL
8,1112,33,1145,1392,0,0,82.26,523,589,"永生里",NULL
9,852,19,871,1044,0,0,83.43,448,404,"卦山里",NULL
10,1072,16,1088,1308,0,0,83.18,699,373,"卦山里",NULL
11,611,14,625,760,0,0,82.24,272,339,"光復里",NULL
12,762,26,788,933,0,0,84.46,338,424,"永福里",NULL
13,671,9,680,808,0,0,84.16,287,384,"光華里",NULL
14,1173,15,1188,1429,0,0,83.14,565,608,"中正里",NULL
15,668,14,682,810,0,0,84.2,382,286,"中山里",NULL
16,905,23,928,1103,0,0,84.13,559,346,"龍山里",NULL
17,922,14,936,1126,0,0,83.13,533,389,"龍山里",NULL
18,878,11,889,1068,0,0,83.24,541,337,"建寶里",NULL
19,1061,18,1079,1263,0,0,85.43,647,414,"建寶里",NULL
20,1134,28,1162,1395,0,0,83.3,567,567,"光南里",NULL
21,832,19,851,1021,0,0,83.35,580,252,"介壽里",NULL
22,688,19,707,1111,0,0,63.64,369,319,"介壽里",NULL
23,1230,24,1254,1497,0,0,83.77,634,596,"延平里",NULL
24,1295,23,1318,1614,0,0,81.66,713,582,"延平里",NULL
25,1252,24,1276,1563,0,0,81.64,611,641,"延平里",NULL
26,1195,29,1224,1509,0,0,81.11,649,546,"延平里",NULL
27,1464,13,1477,1788,0,0,82.61,717,747,"延和里",NULL
28,1500,27,1527,1805,0,0,84.6,682,818,"延和里",NULL
29,1430,17,1447,1724,0,0,83.93,713,717,"南興里",NULL
30,1344,27,1371,1713,0,0,80.04,713,631,"南興里",NULL
31,1381,31,1412,1706,0,0,82.77,692,689,"南興里",NULL
32,1320,27,1347,1580,0,0,85.25,602,718,"南瑤里",NULL
33,1348,21,1369,1694,0,0,80.81,670,678,"南瑤里",NULL
34,1329,24,1353,1694,0,0,79.87,699,630,"南瑤里",NULL
35,1227,19,1246,1526,0,0,81.65,620,607,"南瑤里",NULL
36,1213,34,1247,1478,0,0,84.37,614,599,"成功里",NULL
37,891,15,906,1063,0,0,85.23,445,446,"福安里",NULL
38,1094,21,1115,1365,0,0,81.68,544,550,"西安里",NULL
39,1118,31,1149,1402,0,0,81.95,512,606,"西安里",NULL
40,1172,23,1195,1441,0,0,82.93,546,626,"彰安里",NULL
41,1275,29,1304,1579,0,0,82.58,613,662,"彰安里",NULL
42,740,11,751,909,0,0,82.62,312,428,"中央里",NULL
43,804,16,820,992,0,0,82.66,360,444,"富貴里",NULL
44,1012,22,1034,1226,0,0,84.34,493,519,"民權里",NULL
45,795,9,804,982,0,0,81.87,327,468,"萬壽里",NULL
46,705,18,723,871,0,0,83.01,306,399,"西興里",NULL
47,1190,27,1217,1501,0,0,81.08,631,559,"西興里",NULL
48,1016,28,1044,1209,0,0,86.35,428,588,"長樂里",NULL
49,1012,19,1031,1256,0,0,82.09,549,463,"西勢里",NULL
50,1068,18,1086,1308,0,0,83.03,530,538,"西勢里",NULL
51,1005,14,1019,1270,0,0,80.24,556,449,"忠權里",NULL
52,1126,19,1145,1376,0,0,83.21,632,494,"忠權里",NULL
53,938,16,954,1162,0,0,82.1,453,485,"忠孝里",NULL
54,1355,25,1380,1704,0,0,80.99,681,674,"五權里",NULL
55,1241,23,1264,1590,0,0,79.5,638,603,"五權里",NULL
56,1330,32,1362,1674,0,0,81.36,680,650,"平和里",NULL
57,1488,32,1520,1865,0,0,81.5,758,730,"平和里",NULL
58,1224,17,1241,1491,0,0,83.23,657,567,"崙平里",NULL
59,1017,27,1044,1270,0,0,82.2,505,512,"崙平里",NULL
60,1349,25,1374,1664,0,0,82.57,672,677,"崙平里",NULL
61,1317,19,1336,1601,0,0,83.45,775,542,"向陽里",NULL
62,1070,27,1097,1360,0,0,80.66,550,520,"向陽里",NULL
63,971,21,992,1211,0,0,81.92,506,465,"莿桐里",NULL
64,1065,20,1085,1294,0,0,83.85,538,527,"莿桐里",NULL
65,1191,33,1224,1501,0,0,81.55,562,629,"南美里",NULL
66,1413,43,1456,1779,0,0,81.84,691,722,"南安里",NULL
67,1035,25,1060,1313,0,0,80.73,532,503,"東芳里",NULL
68,1214,30,1244,1554,0,0,80.05,580,634,"東芳里",NULL
69,924,20,944,1188,0,0,79.46,443,481,"磚窯里",NULL
70,1213,41,1254,1530,0,0,81.96,592,621,"磚窯里",NULL
71,994,22,1016,1241,0,0,81.87,494,500,"新興里",NULL
72,1235,30,1265,1516,0,0,83.44,627,608,"新興里",NULL
73,1080,17,1097,1305,0,0,84.06,559,521,"新興里",NULL
74,683,20,703,853,0,0,82.42,344,339,"新華里",NULL
75,774,16,790,960,0,0,82.29,389,385,"新華里",NULL
76,1246,22,1268,1540,0,0,82.34,575,671,"興北里",NULL
77,755,19,774,944,0,0,81.99,347,408,"信義里",NULL
78,1171,15,1186,1448,0,0,81.91,593,578,"民生里",NULL
79,1169,32,1201,1452,0,0,82.71,607,562,"文化里",NULL
80,676,12,688,830,0,0,82.89,323,353,"陽明里",NULL
81,726,24,750,910,0,0,82.42,365,361,"陽明里",NULL
82,1461,31,1492,1765,0,0,84.53,777,684,"萬安里",NULL
83,1535,26,1561,1939,0,0,80.51,783,752,"萬安里",NULL
84,1970,33,2003,2439,0,0,82.12,1038,932,"下廍里",NULL
85,1008,24,1032,1247,0,0,82.76,524,484,"下廍里",NULL
86,645,29,674,810,0,0,83.21,285,360,"茄苳里",NULL
87,891,33,924,1162,0,0,79.52,457,434,"茄南里",NULL
88,857,14,871,1036,0,0,84.07,431,426,"茄南里",NULL
89,801,26,827,1035,0,0,79.9,407,394,"寶廍里",NULL
90,832,29,861,1054,0,0,81.69,384,448,"古夷里",NULL
91,917,23,940,1200,0,0,78.33,436,481,"古夷里",NULL
92,1377,34,1411,1751,0,0,80.58,720,657,"阿夷里",NULL
93,1628,52,1680,2012,0,0,83.5,793,835,"阿夷里",NULL
94,1513,28,1541,1912,0,0,80.6,850,663,"阿夷里",NULL
95,854,31,885,1077,0,0,82.17,444,410,"和調里",NULL
96,951,18,969,1208,0,0,80.22,501,450,"和調里",NULL
97,1388,31,1419,1751,0,0,81.04,659,729,"復興里",NULL
98,1256,14,1270,1553,0,0,81.78,658,598,"復興里",NULL
99,542,9,551,668,0,0,82.49,343,199,"復興里",NULL
100,1009,10,1019,1246,0,0,81.78,385,624,"中庄里",NULL
101,698,22,720,904,0,0,79.65,329,369,"中庄里",NULL
102,1219,50,1269,1621,0,0,78.29,573,646,"竹中里",NULL
103,1203,30,1233,1498,0,0,82.31,593,610,"香山里",NULL
104,885,28,913,1088,0,0,83.92,374,511,"香山里",NULL
105,1316,36,1352,1598,0,0,84.61,543,773,"牛埔里",NULL
106,1005,23,1028,1263,0,0,81.39,551,454,"牛埔里",NULL
107,1625,21,1646,2053,0,0,80.18,919,706,"台鳳里",NULL
108,1230,25,1255,1612,0,0,77.85,680,550,"台鳳里",NULL
109,1115,35,1150,1394,0,0,82.5,519,596,"國聖里",NULL
110,698,27,725,863,0,0,84.01,345,353,"國聖里",NULL
111,1088,30,1118,1356,0,0,82.45,491,597,"福山里",NULL
112,1201,28,1229,1522,0,0,80.75,534,667,"福山里",NULL
113,1201,31,1232,1552,0,0,79.38,512,689,"福山里",NULL
114,1276,41,1317,1585,0,0,83.09,556,720,"福山里",NULL
115,837,18,855,1049,0,0,81.51,353,484,"安溪里",NULL
116,779,33,812,993,0,0,81.77,285,494,"三村里",NULL
117,1004,22,1026,1225,0,0,83.76,448,556,"大竹里",NULL
118,1210,29,1239,1507,0,0,82.22,611,599,"大竹里",NULL
119,641,21,662,813,0,0,81.43,258,383,"田中里",NULL
120,780,28,808,994,0,0,81.29,345,435,"快官里",NULL
121,654,16,670,804,0,0,83.33,299,355,"竹巷里",NULL
122,948,25,973,1197,0,0,81.29,401,547,"福田里",NULL
123,898,23,921,1135,0,0,81.15,355,543,"石牌里",NULL
124,926,21,947,1197,0,0,79.11,503,423,"花壇村",NULL
125,1311,33,1344,1594,0,0,84.32,665,646,"花壇村",NULL
126,1264,29,1293,1626,0,0,79.52,590,674,"金墩村",NULL
127,784,15,799,964,0,0,82.88,375,409,"中庄村",NULL
128,1049,34,1083,1293,0,0,83.76,565,484,"中庄村",NULL
129,840,23,863,1035,0,0,83.38,300,540,"劉厝村",NULL
130,1056,42,1098,1338,0,0,82.06,413,643,"崙雅村",NULL
131,1166,22,1188,1461,0,0,81.31,581,585,"南口村",NULL
132,570,10,580,705,0,0,82.27,227,343,"中口村",NULL
133,704,23,727,885,0,0,82.15,319,385,"北口村",NULL
134,555,15,570,694,0,0,82.13,250,305,"北口村",NULL
135,967,28,995,1225,0,0,81.22,499,468,"長沙村",NULL
136,1104,17,1121,1351,0,0,82.98,595,509,"長沙村",NULL
137,1049,18,1067,1300,0,0,82.08,534,515,"長沙村",NULL
138,976,43,1019,1253,0,0,81.32,480,496,"文德村",NULL
139,878,17,895,1118,0,0,80.05,485,393,"文德村",NULL
140,1312,25,1337,1654,0,0,80.83,750,562,"白沙村",NULL
141,1593,34,1627,2037,0,0,79.87,802,791,"白沙村",NULL
142,996,37,1033,1304,0,0,79.22,483,513,"岩竹村",NULL
143,1377,44,1421,1827,0,0,77.78,740,637,"橋頭村",NULL
144,862,30,892,1097,0,0,81.31,457,405,"橋頭村",NULL
145,659,23,682,841,0,0,81.09,358,301,"灣雅村",NULL
146,693,32,725,947,0,0,76.56,367,326,"灣東村",NULL
147,1259,33,1292,1635,0,0,79.02,670,589,"三春村",NULL
148,1106,36,1142,1467,0,0,77.85,573,533,"永春村",NULL
149,1121,45,1166,1461,0,0,79.81,598,523,"長春村",NULL
150,1231,68,1299,1695,0,0,76.64,574,657,"舊社村",NULL
151,983,57,1040,1321,0,0,78.73,448,535,"大埔村",NULL
152,1223,59,1282,1620,0,0,79.14,578,645,"竹林村",NULL
153,446,17,463,570,0,0,81.23,208,238,"楓坑村",NULL
154,891,22,913,1124,0,0,81.23,412,479,"社口村",NULL
155,856,30,886,1139,0,0,77.79,373,483,"社口村",NULL
156,877,39,916,1129,0,0,81.13,395,482,"茄荖村",NULL
157,860,20,880,1042,0,0,84.45,353,507,"茄荖村",NULL
158,1191,41,1232,1531,0,0,80.47,505,686,"嘉興村",NULL
159,677,36,713,872,0,0,81.77,269,408,"芬園村",NULL
160,703,37,740,938,0,0,78.89,304,399,"進芬村",NULL
161,840,40,880,1072,0,0,82.09,271,569,"縣庄村",NULL
162,539,33,572,682,0,0,83.87,172,367,"圳墘村",NULL
163,1144,52,1196,1484,0,0,80.59,418,726,"溪頭村",NULL
164,942,74,1016,1254,0,0,81.02,318,624,"同安村",NULL
165,715,35,750,986,0,0,76.06,286,429,"中崙村",NULL
166,751,49,800,1066,0,0,75.05,245,506,"大竹村",NULL
167,900,33,933,1152,0,0,80.99,335,565,"大有里",NULL
168,451,12,463,565,0,0,81.95,161,290,"中興里",NULL
169,792,20,812,994,0,0,81.69,304,488,"洛津里",NULL
170,698,9,707,863,0,0,81.92,295,403,"順興里",NULL
171,780,30,810,981,0,0,82.57,233,547,"菜園里",NULL
172,1534,37,1571,1921,0,0,81.78,597,937,"街尾里",NULL
173,927,32,959,1180,0,0,81.27,441,486,"泰興里",NULL
174,240,16,256,322,0,0,79.5,109,131,"長興里",NULL
175,519,18,537,656,0,0,81.86,236,283,"興化里",NULL
176,589,12,601,755,0,0,79.6,232,357,"龍山里",NULL
177,881,35,916,1123,0,0,81.57,406,475,"景福里",NULL
178,435,16,451,593,0,0,76.05,157,278,"郭厝里",NULL
179,769,17,786,952,0,0,82.56,230,539,"新宮里",NULL
180,1008,39,1047,1267,0,0,82.64,369,639,"玉順里",NULL
181,1145,29,1174,1482,0,0,79.22,405,740,"東石里",NULL
182,1476,30,1506,1816,0,0,82.93,506,970,"東石里",NULL
183,1440,44,1484,1794,0,0,82.72,646,794,"永安里",NULL
184,1443,47,1490,1865,0,0,79.89,601,842,"永安里",NULL
185,1375,39,1414,1719,0,0,82.26,501,874,"埔崙里",NULL
186,1261,37,1298,1603,0,0,80.97,477,784,"埔崙里",NULL
187,1463,51,1514,1912,0,0,79.18,515,948,"頂厝里",NULL
188,1238,24,1262,1544,0,0,81.74,562,676,"頂厝里",NULL
189,1590,50,1640,1992,0,0,82.33,653,937,"頂厝里",NULL
190,1399,67,1466,1821,0,0,80.51,695,704,"東崎里",NULL
191,987,58,1045,1262,0,0,82.81,345,642,"東崎里",NULL
192,817,20,837,1106,0,0,75.68,415,402,"東崎里",NULL
193,1164,32,1196,1514,0,0,79,552,612,"廖厝里",NULL
194,1294,51,1345,1659,0,0,81.07,684,610,"廖厝里",NULL
195,1196,59,1255,1627,0,0,77.14,497,699,"詔安里",NULL
196,1163,33,1196,1506,0,0,79.42,524,639,"海埔里",NULL
197,1060,26,1086,1364,0,0,79.62,434,626,"海埔里",NULL
198,650,32,682,877,0,0,77.77,303,347,"洋厝里",NULL
199,1154,37,1191,1469,0,0,81.08,333,821,"洋厝里",NULL
200,1157,35,1192,1517,0,0,78.58,602,555,"草中里",NULL
201,1051,34,1085,1338,0,0,81.09,549,502,"草中里",NULL
202,811,24,835,1030,0,0,81.07,268,543,"山崙里",NULL
203,1515,49,1564,1887,0,0,82.88,654,861,"山崙里",NULL
204,1367,60,1427,1787,0,0,79.85,714,653,"頭南里",NULL
205,1075,51,1126,1415,0,0,79.58,553,522,"頭崙里",NULL
206,664,16,680,837,0,0,81.24,295,369,"頭崙里",NULL
207,1067,30,1097,1352,0,0,81.14,550,517,"頂番里",NULL
208,1335,45,1380,1742,0,0,79.22,724,611,"頂番里",NULL
209,1050,32,1082,1357,0,0,79.73,558,492,"溝墘里",NULL
210,1024,29,1053,1338,0,0,78.7,547,477,"溝墘里",NULL
211,594,28,622,763,0,0,81.52,332,262,"溝墘里",NULL
212,887,25,912,1169,0,0,78.02,386,501,"番婆村",NULL
213,658,31,689,909,0,0,75.8,297,361,"番婆村",NULL
214,845,29,874,1097,0,0,79.67,400,445,"大崙村",NULL
215,827,55,882,1075,0,0,82.05,289,538,"外埔村",NULL
216,982,35,1017,1228,0,0,82.82,352,630,"三汴村",NULL
217,588,25,613,741,0,0,82.73,257,331,"萬豐村",NULL
218,895,44,939,1163,0,0,80.74,311,584,"外中村",NULL
219,859,42,901,1075,0,0,83.81,399,460,"元中村",NULL
220,744,33,777,953,0,0,81.53,302,442,"橋頭村",NULL
221,958,25,983,1211,0,0,81.17,485,473,"橋頭村",NULL
222,962,56,1018,1329,0,0,76.6,411,551,"社尾村",NULL
223,1008,40,1048,1275,0,0,82.2,252,756,"番社村",NULL
224,805,32,837,1001,0,0,83.62,364,441,"同安村",NULL
225,866,23,889,1088,0,0,81.71,371,495,"同安村",NULL
226,779,22,801,950,0,0,84.32,382,397,"西勢村",NULL
227,572,18,590,715,0,0,82.52,240,332,"西勢村",NULL
228,698,25,723,895,0,0,80.78,310,388,"秀厝村",NULL
229,906,30,936,1174,0,0,79.73,407,499,"秀厝村",NULL
230,817,39,856,1091,0,0,78.46,358,459,"鎮平村",NULL
231,797,37,834,1021,0,0,81.68,256,541,"三和村",NULL
232,761,38,799,1036,0,0,77.12,298,463,"麥厝村",NULL
233,791,40,831,1071,0,0,77.59,303,488,"麥厝村",NULL
234,683,29,712,881,0,0,80.82,330,353,"廈粘村",NULL
235,713,25,738,943,0,0,78.26,351,362,"廈粘村",NULL
236,687,35,722,904,0,0,79.87,341,346,"頂粘村",NULL
237,858,44,902,1149,0,0,78.5,421,437,"頂粘村",NULL
238,881,39,920,1174,0,0,78.36,471,410,"福寶村",NULL
239,969,41,1010,1257,0,0,80.35,488,481,"二港村",NULL
240,1215,31,1246,1564,0,0,79.67,554,661,"福興村",NULL
241,975,37,1012,1249,0,0,81.02,405,570,"福興村",NULL
242,779,35,814,1013,0,0,80.36,355,424,"福南村",NULL
243,894,24,918,1151,0,0,79.76,434,460,"福南村",NULL
244,819,21,840,1019,0,0,82.43,345,474,"秀水村",NULL
245,492,19,511,604,0,0,84.6,202,290,"秀水村",NULL
246,1198,45,1243,1491,0,0,83.37,501,697,"安溪村",NULL
247,866,39,905,1137,0,0,79.6,422,444,"莊雅村",NULL
248,785,11,796,920,0,0,86.52,402,383,"莊雅村",NULL
249,958,37,995,1194,0,0,83.33,490,468,"陝西村",NULL
250,695,26,721,863,0,0,83.55,358,337,"金興村",NULL
251,644,27,671,797,0,0,84.19,289,355,"金興村",NULL
252,935,25,960,1181,0,0,81.29,511,424,"安東村",NULL
253,744,17,761,928,0,0,82,315,429,"安東村",NULL
254,864,34,898,1118,0,0,80.32,372,492,"安東村",NULL
255,1193,45,1238,1487,0,0,83.25,486,707,"鶴鳴村",NULL
256,923,30,953,1165,0,0,81.8,423,500,"鶴鳴村",NULL
257,944,10,954,1156,0,0,82.53,374,570,"馬興村",NULL
258,655,43,698,849,0,0,82.21,240,415,"馬興村",NULL
259,893,27,920,1116,0,0,82.44,396,497,"義興村",NULL
260,976,35,1011,1255,0,0,80.56,442,534,"福安村",NULL
261,887,31,918,1114,0,0,82.41,458,429,"福安村",NULL
262,872,21,893,1118,0,0,79.87,393,479,"福安村",NULL
263,518,10,528,643,0,0,82.12,219,299,"埔崙村",NULL
264,872,24,896,1104,0,0,81.16,366,506,"埔崙村",NULL
265,1078,40,1118,1365,0,0,81.9,454,624,"曾厝村",NULL
266,1177,26,1203,1439,0,0,83.6,413,764,"金陵村",NULL
267,896,44,940,1146,0,0,82.02,423,473,"下崙村",NULL
268,615,25,640,750,0,0,85.33,189,426,"下崙村",NULL
269,1441,39,1480,1848,0,0,80.09,650,791,"竹營里",NULL
270,1757,34,1791,2227,0,0,80.42,899,858,"竹營里",NULL
271,1595,25,1620,1962,0,0,82.57,788,807,"和東里",NULL
272,1230,28,1258,1553,0,0,81,655,575,"和東里",NULL
273,395,2,397,457,0,0,86.87,227,168,"和南里",NULL
274,1105,29,1134,1389,0,0,81.64,581,524,"和北里",NULL
275,1140,34,1174,1440,0,0,81.53,606,534,"和西里",NULL
276,1316,37,1353,1669,0,0,81.07,699,617,"和西里",NULL
277,862,28,890,1086,0,0,81.95,367,495,"四張里",NULL
278,999,28,1027,1281,0,0,80.17,519,480,"四張里",NULL
279,1072,36,1108,1364,0,0,81.23,561,511,"頭前里",NULL
280,636,22,658,776,0,0,84.79,300,336,"還社里",NULL
281,441,21,462,573,0,0,80.63,221,220,"面前里",NULL
282,911,16,927,1132,0,0,81.89,426,485,"面前里",NULL
283,979,20,999,1179,0,0,84.73,444,535,"鎮平里",NULL
284,988,27,1015,1272,0,0,79.8,416,572,"鎮平里",NULL
285,994,22,1016,1238,0,0,82.07,562,432,"大霞里",NULL
286,1197,41,1238,1556,0,0,79.56,589,608,"源埤里",NULL
287,1346,56,1402,1755,0,0,79.89,618,728,"南佃里",NULL
288,971,16,987,1248,0,0,79.09,427,544,"雅溝里",NULL
289,1411,32,1443,1779,0,0,81.11,686,725,"山犁里",NULL
290,1369,43,1412,1731,0,0,81.57,711,658,"山犁里",NULL
291,1571,39,1610,2023,0,0,79.58,795,776,"山犁里",NULL
292,1218,28,1246,1570,0,0,79.36,666,552,"嘉犁里",NULL
293,1294,34,1328,1670,0,0,79.52,638,656,"詔安里",NULL
294,1043,27,1070,1324,0,0,80.82,547,496,"鐵山里",NULL
295,862,15,877,1064,0,0,82.42,403,459,"鐵山里",NULL
296,1067,40,1107,1340,0,0,82.61,505,562,"柑井里",NULL
297,1085,30,1115,1311,0,0,85.05,522,563,"柑井里",NULL
298,663,21,684,814,0,0,84.03,218,445,"竹園里",NULL
299,925,28,953,1201,0,0,79.35,446,479,"新庄里",NULL
300,871,27,898,1087,0,0,82.61,450,421,"新庄里",NULL
301,846,23,869,1066,0,0,81.52,381,465,"犁盛里",NULL
302,783,21,804,994,0,0,80.89,386,397,"犁盛里",NULL
303,841,29,870,1093,0,0,79.6,349,492,"中寮里",NULL
304,785,36,821,1013,0,0,81.05,306,479,"中圍里",NULL
305,1181,38,1219,1562,0,0,78.04,528,653,"中圍里",NULL
306,1235,26,1261,1538,0,0,81.99,654,581,"糖友里",NULL
307,975,14,989,1182,0,0,83.67,548,427,"糖友里",NULL
308,1284,41,1325,1665,0,0,79.58,701,583,"塗厝里",NULL
309,670,25,695,842,0,0,82.54,326,344,"地潭里",NULL
310,943,52,995,1204,0,0,82.64,272,671,"湖內里",NULL
311,1304,43,1347,1714,0,0,78.59,642,662,"嘉寶里",NULL
312,1279,35,1314,1651,0,0,79.59,564,715,"月眉里",NULL
313,941,26,967,1181,0,0,81.88,430,511,"月眉里",NULL
314,706,34,740,939,0,0,78.81,327,379,"好修里",NULL
315,537,28,565,706,0,0,80.03,260,277,"好修里",NULL
316,1488,48,1536,1917,0,0,80.13,944,544,"線西村",NULL
317,890,44,934,1136,0,0,82.22,549,341,"頂庄村",NULL
318,1527,20,1547,1996,0,0,77.51,760,767,"寓埔村",NULL
319,917,23,940,1155,0,0,81.39,494,423,"塭仔村",NULL
320,777,34,811,1037,0,0,78.21,448,329,"溝內村",NULL
321,1269,42,1311,1676,0,0,78.22,660,609,"下犁村",NULL
322,768,39,807,990,0,0,81.52,465,303,"頂犁村",NULL
323,882,34,916,1173,0,0,78.09,514,368,"頂犁村",NULL
324,860,34,894,1094,0,0,81.72,500,360,"德興村",NULL
325,979,20,999,1232,0,0,81.09,511,468,"新港村",NULL
326,1145,26,1171,1473,0,0,79.5,597,548,"新港村",NULL
327,1182,33,1215,1519,0,0,79.99,578,604,"新港村",NULL
328,1174,50,1224,1539,0,0,79.53,721,453,"什股村",NULL
329,991,25,1016,1239,0,0,82,452,539,"大同村",NULL
330,1289,40,1329,1621,0,0,81.99,630,659,"海尾村",NULL
331,1135,52,1187,1532,0,0,77.48,721,414,"全興村",NULL
332,1218,66,1284,1575,0,0,81.52,541,677,"溪底村",NULL
333,796,23,819,1025,0,0,79.9,461,335,"定興村",NULL
334,866,42,908,1171,0,0,77.54,429,437,"定興村",NULL
335,1298,44,1342,1663,0,0,80.7,695,603,"泉州村",NULL
336,927,43,970,1197,0,0,81.04,438,489,"泉厝村",NULL
337,1128,56,1184,1486,0,0,79.68,491,637,"曾家村",NULL
338,883,43,926,1145,0,0,80.87,249,634,"蚵寮村",NULL
339,777,22,799,960,0,0,83.23,358,419,"埤墘村",NULL
340,1494,49,1543,1934,0,0,79.78,793,701,"七嘉村",NULL
341,1574,45,1619,1986,0,0,81.52,821,753,"汴頭村",NULL
342,856,9,865,1077,0,0,80.32,480,376,"東和里",NULL
343,826,29,855,1063,0,0,80.43,350,476,"民生里",NULL
344,1220,31,1251,1558,0,0,80.3,671,549,"民生里",NULL
345,1137,22,1159,1410,0,0,82.2,587,550,"中正里",NULL
346,1208,11,1219,1526,0,0,79.88,638,570,"中正里",NULL
347,1096,19,1115,1369,0,0,81.45,563,533,"仁美里",NULL
348,1094,21,1115,1356,0,0,82.23,603,491,"仁美里",NULL
349,647,13,660,819,0,0,80.59,314,333,"新興里",NULL
350,833,19,852,1061,0,0,80.3,419,414,"和平里",NULL
351,1291,33,1324,1625,0,0,81.48,682,609,"和平里",NULL
352,781,15,796,960,0,0,82.92,371,410,"光明里",NULL
353,583,15,598,711,0,0,84.11,283,300,"中山里",NULL
354,677,19,696,860,0,0,80.93,362,315,"黎明里",NULL
355,704,22,726,893,0,0,81.3,348,356,"黎明里",NULL
356,1399,22,1421,1748,0,0,81.29,687,712,"惠來里",NULL
357,1053,25,1078,1380,0,0,78.12,505,548,"惠來里",NULL
358,1093,35,1128,1380,0,0,81.74,576,517,"惠來里",NULL
359,809,13,822,990,0,0,83.03,393,416,"三義里",NULL
360,1023,30,1053,1271,0,0,82.85,551,472,"三義里",NULL
361,863,20,883,1097,0,0,80.49,453,410,"新生里",NULL
362,825,21,846,1047,0,0,80.8,412,413,"新生里",NULL
363,667,8,675,795,0,0,84.91,351,316,"新生里",NULL
364,673,18,691,837,0,0,82.56,362,311,"新生里",NULL
365,795,20,815,1018,0,0,80.06,443,352,"南平里",NULL
366,972,18,990,1200,0,0,82.5,460,512,"南平里",NULL
367,1089,31,1120,1345,0,0,83.27,545,544,"南平里",NULL
368,1193,38,1231,1515,0,0,81.25,595,598,"南興里",NULL
369,1094,36,1130,1379,0,0,81.94,632,462,"南興里",NULL
370,1009,21,1030,1283,0,0,80.28,611,398,"南興里",NULL
371,1184,58,1242,1523,0,0,81.55,471,713,"源潭里",NULL
372,1387,61,1448,1778,0,0,81.44,657,730,"大埔里",NULL
373,1065,23,1088,1279,0,0,85.07,557,508,"仁愛里",NULL
374,802,22,824,1004,0,0,82.07,382,420,"忠孝里",NULL
375,663,10,673,825,0,0,81.58,386,277,"忠孝里",NULL
376,828,24,852,1052,0,0,80.99,369,459,"三條里",NULL
377,799,20,819,1016,0,0,80.61,433,366,"三條里",NULL
378,1401,39,1440,1838,0,0,78.35,776,625,"三和里",NULL
379,1193,25,1218,1557,0,0,78.23,640,553,"三和里",NULL
380,1265,26,1291,1593,0,0,81.04,680,585,"三和里",NULL
381,929,28,957,1166,0,0,82.08,438,491,"三橋里",NULL
382,1068,33,1101,1367,0,0,80.54,536,532,"三橋里",NULL
383,1048,22,1070,1324,0,0,80.82,544,504,"三愛里",NULL
384,900,24,924,1122,0,0,82.35,475,425,"三愛里",NULL
385,743,11,754,934,0,0,80.73,405,338,"三信里",NULL
386,769,20,789,967,0,0,81.59,402,367,"三信里",NULL
387,873,12,885,1111,0,0,79.66,508,365,"三多里",NULL
388,727,19,746,896,0,0,83.26,346,381,"三多里",NULL
389,1223,42,1265,1561,0,0,81.04,593,630,"中央里",NULL
390,895,18,913,1108,0,0,82.4,470,425,"溝皂里",NULL
391,769,25,794,984,0,0,80.69,335,434,"溝皂里",NULL
392,953,27,980,1187,0,0,82.56,469,484,"大饒里",NULL
393,1025,27,1052,1323,0,0,79.52,549,476,"大饒里",NULL
394,857,37,894,1086,0,0,82.32,339,518,"大明里",NULL
395,720,26,746,920,0,0,81.09,341,379,"大明里",NULL
396,657,25,682,836,0,0,81.58,268,389,"萬年里",NULL
397,779,30,809,993,0,0,81.47,427,352,"萬年里",NULL
398,1026,9,1035,1227,0,0,84.35,608,418,"萬年里",NULL
399,828,33,861,1046,0,0,82.31,539,289,"崙雅里",NULL
400,953,36,989,1191,0,0,83.04,495,458,"崙雅里",NULL
401,871,25,896,1114,0,0,80.43,403,468,"振興里",NULL
402,890,30,920,1145,0,0,80.35,504,386,"振興里",NULL
403,799,32,831,1042,0,0,79.75,370,429,"林厝里",NULL
404,966,41,1007,1225,0,0,82.2,411,555,"林厝里",NULL
405,1298,58,1356,1679,0,0,80.76,562,736,"出水里",NULL
406,956,32,988,1288,0,0,76.71,368,588,"湖水里",NULL
407,562,19,581,737,0,0,78.83,289,273,"大峰里",NULL
408,775,29,804,1006,0,0,79.92,369,406,"鎮興里",NULL
409,637,20,657,818,0,0,80.32,324,313,"鎮興里",NULL
410,878,19,897,1117,0,0,80.3,401,477,"浮圳里",NULL
411,714,20,734,917,0,0,80.04,378,336,"浮圳里",NULL
412,1303,36,1339,1682,0,0,79.61,507,796,"西東里",NULL
413,726,27,753,954,0,0,78.93,339,387,"南東里",NULL
414,532,21,553,692,0,0,79.91,234,298,"南東里",NULL
415,1133,46,1179,1507,0,0,78.23,545,588,"中東里",NULL
416,833,15,848,1000,0,0,84.8,376,457,"東北里",NULL
417,800,21,821,1024,0,0,80.18,394,406,"東北里",NULL
418,914,5,919,1106,0,0,83.09,442,472,"大村村",NULL
419,735,27,762,960,0,0,79.38,378,357,"大村村",NULL
420,1229,47,1276,1552,0,0,82.22,556,673,"茄苳村",NULL
421,706,31,737,912,0,0,80.81,344,362,"田洋村",NULL
422,1051,41,1092,1359,0,0,80.35,503,548,"貢旗村",NULL
423,972,47,1019,1256,0,0,81.13,489,483,"加錫村",NULL
424,1090,73,1163,1449,0,0,80.26,481,609,"大崙村",NULL
425,840,29,869,1115,0,0,77.94,339,501,"新興村",NULL
426,946,30,976,1196,0,0,81.61,393,553,"南勢村",NULL
427,996,43,1039,1263,0,0,82.26,445,551,"擺塘村",NULL
428,688,24,712,893,0,0,79.73,331,357,"擺塘村",NULL
429,833,17,850,1021,0,0,83.25,453,380,"過溝村",NULL
430,874,14,888,1090,0,0,81.47,483,391,"過溝村",NULL
431,1386,53,1439,1804,0,0,79.77,748,638,"大橋村",NULL
432,1003,34,1037,1247,0,0,83.16,506,497,"村上村",NULL
433,1136,28,1164,1425,0,0,81.68,523,613,"美港村",NULL
434,883,27,910,1093,0,0,83.26,467,416,"美港村",NULL
435,1403,54,1457,1794,0,0,81.22,735,668,"黃厝村",NULL
436,1350,43,1393,1753,0,0,79.46,596,754,"福興村",NULL
437,902,40,942,1130,0,0,83.36,413,489,"平和村",NULL
438,658,42,700,879,0,0,79.64,321,337,"平和村",NULL
439,670,10,680,815,0,0,83.44,333,337,"永東村",NULL
440,1176,34,1210,1459,0,0,82.93,581,595,"永西村",NULL
441,1445,57,1502,1841,0,0,81.59,712,733,"永南村",NULL
442,1456,41,1497,1901,0,0,78.75,689,767,"永北村",NULL
443,1283,50,1333,1645,0,0,81.03,657,626,"港西村",NULL
444,1073,36,1109,1367,0,0,81.13,497,576,"五福村",NULL
445,746,30,776,949,0,0,81.77,294,452,"湳港村",NULL
446,697,26,723,867,0,0,83.39,419,278,"新莊村",NULL
447,821,25,846,1050,0,0,80.57,390,431,"瑚璉村",NULL
448,810,25,835,1003,0,0,83.25,396,414,"瑚璉村",NULL
449,1068,31,1099,1345,0,0,81.71,469,599,"五汴村",NULL
450,854,41,895,1076,0,0,83.18,438,416,"浮圳村",NULL
451,1220,61,1281,1551,0,0,82.59,495,725,"光雲村",NULL
452,1259,53,1312,1645,0,0,79.76,594,665,"東寧村",NULL
453,1195,52,1247,1518,0,0,82.15,612,583,"永興村",NULL
454,924,30,954,1176,0,0,81.12,359,565,"崙子村",NULL
455,642,40,682,846,0,0,80.61,285,357,"獨鰲村",NULL
456,556,23,579,717,0,0,80.75,283,273,"敦厚村",NULL
457,604,23,627,748,0,0,83.82,269,335,"崙美村",NULL
458,544,20,564,682,0,0,82.7,292,252,"同安村",NULL
459,721,28,749,945,0,0,79.26,371,350,"同仁村",NULL
460,635,34,669,832,0,0,80.41,342,293,"湳墘村",NULL
461,513,32,545,680,0,0,80.15,263,250,"四芳村",NULL
462,895,39,934,1143,0,0,81.71,501,394,"福興村",NULL
463,1078,12,1090,1349,0,0,80.8,370,708,"竹子村",NULL
464,979,29,1008,1221,0,0,82.56,489,490,"光平里",NULL
465,640,12,652,754,0,0,86.47,327,313,"平和里",NULL
466,1105,23,1128,1391,0,0,81.09,564,541,"太平里",NULL
467,400,8,408,491,0,0,83.1,219,181,"光華里",NULL
468,1039,26,1065,1338,0,0,79.6,580,459,"東寮里",NULL
469,1150,28,1178,1484,0,0,79.38,656,494,"東寮里",NULL
470,660,16,676,875,0,0,77.26,346,314,"西寮里",NULL
471,763,33,796,978,0,0,81.39,440,323,"西寮里",NULL
472,861,20,881,1105,0,0,79.73,463,398,"大突里",NULL
473,835,25,860,1082,0,0,79.48,427,408,"大突里",NULL
474,981,43,1024,1254,0,0,81.66,404,577,"北勢里",NULL
475,982,37,1019,1282,0,0,79.49,428,554,"汴頭里",NULL
476,833,18,851,1051,0,0,80.97,410,423,"汴頭里",NULL
477,963,18,981,1201,0,0,81.68,549,414,"大竹里",NULL
478,837,30,867,1064,0,0,81.48,427,410,"大竹里",NULL
479,706,16,722,918,0,0,78.65,379,327,"湖西里",NULL
480,776,23,799,1001,0,0,79.82,398,378,"湖西里",NULL
481,610,33,643,769,0,0,83.62,277,333,"田中里",NULL
482,1305,65,1370,1631,0,0,84,638,667,"河東里",NULL
483,867,30,897,1109,0,0,80.88,424,443,"中山里",NULL
484,842,33,875,1113,0,0,78.62,387,455,"中山里",NULL
485,622,26,648,783,0,0,82.76,291,331,"中竹里",NULL
486,998,34,1032,1262,0,0,81.77,350,648,"東溪里",NULL
487,1179,43,1222,1527,0,0,80.03,596,583,"西溪里",NULL
488,969,35,1004,1226,0,0,81.89,444,525,"湖東里",NULL
489,935,39,974,1251,0,0,77.86,433,502,"湖東里",NULL
490,910,33,943,1133,0,0,83.23,443,467,"湖東里",NULL
491,493,21,514,649,0,0,79.2,270,223,"頂庄里",NULL
492,946,45,991,1224,0,0,80.96,500,446,"忠覺里",NULL
493,563,27,590,734,0,0,80.38,258,305,"湳底里",NULL
494,980,34,1014,1264,0,0,80.22,573,407,"大庭里",NULL
495,1009,51,1060,1323,0,0,80.12,442,567,"媽厝里",NULL
496,586,23,609,741,0,0,82.19,259,327,"西勢里",NULL
497,897,27,924,1169,0,0,79.04,425,472,"西勢里",NULL
498,1138,45,1183,1519,0,0,77.88,547,591,"番婆里",NULL
499,1162,55,1217,1525,0,0,79.8,581,581,"埔鹽村",NULL
500,1119,53,1172,1473,0,0,79.57,560,559,"埔南村",NULL
501,916,33,949,1155,0,0,82.16,519,397,"廍子村",NULL
502,628,18,646,806,0,0,80.15,345,283,"出水村",NULL
503,1309,39,1348,1627,0,0,82.85,576,733,"南港村",NULL
504,746,38,784,931,0,0,84.21,341,405,"打廉村",NULL
505,1016,35,1051,1290,0,0,81.47,454,562,"豐澤村",NULL
506,769,40,809,1034,0,0,78.24,401,368,"崑崙村",NULL
507,572,25,597,711,0,0,83.97,315,257,"角樹村",NULL
508,908,14,922,1164,0,0,79.21,469,439,"瓦窯村",NULL
509,1030,26,1056,1334,0,0,79.16,635,395,"好修村",NULL
510,1485,67,1552,1955,0,0,79.39,744,741,"西湖村",NULL
511,971,43,1014,1252,0,0,80.99,491,480,"大有村",NULL
512,306,7,313,396,0,0,79.04,185,121,"新興村",NULL
513,795,40,835,1041,0,0,80.21,405,390,"永平村",NULL
514,610,26,636,766,0,0,83.03,306,304,"永樂村",NULL
515,949,83,1032,1307,0,0,78.96,422,527,"石埤村",NULL
516,615,29,644,834,0,0,77.22,383,232,"天盛村",NULL
517,1074,61,1135,1460,0,0,77.74,570,504,"太平村",NULL
518,1098,30,1128,1379,0,0,81.8,718,380,"新水村",NULL
519,963,42,1005,1269,0,0,79.2,561,402,"三省村",NULL
520,944,42,986,1245,0,0,79.2,599,345,"南新村",NULL
521,963,21,984,1198,0,0,82.14,431,532,"東門村",NULL
522,1129,36,1165,1437,0,0,81.07,526,603,"東門村",NULL
523,882,34,916,1188,0,0,77.1,373,509,"埔心村",NULL
524,1162,38,1200,1437,0,0,83.51,585,577,"義民村",NULL
525,895,30,925,1131,0,0,81.79,437,458,"油車村",NULL
526,1246,37,1283,1588,0,0,80.79,571,675,"瓦北村",NULL
527,1379,48,1427,1723,0,0,82.82,637,742,"瓦中村",NULL
528,1069,42,1111,1327,0,0,83.72,465,604,"瓦南村",NULL
529,1302,56,1358,1673,0,0,81.17,494,808,"經口村",NULL
530,1400,75,1475,1769,0,0,83.38,564,836,"太平村",NULL
531,483,17,500,601,0,0,83.19,221,262,"大華村",NULL
532,811,38,849,1068,0,0,79.49,393,418,"仁里村",NULL
533,897,36,933,1150,0,0,81.13,389,508,"舊館村",NULL
534,622,29,651,790,0,0,82.41,249,373,"南館村",NULL
535,696,33,729,898,0,0,81.18,311,385,"新館村",NULL
536,1348,15,1363,1678,0,0,81.23,513,835,"芎蕉村",NULL
537,999,53,1052,1329,0,0,79.16,418,581,"羅厝村",NULL
538,677,29,706,873,0,0,80.87,319,358,"梧鳳村",NULL
539,1001,11,1012,1203,0,0,84.12,394,607,"二重村",NULL
540,603,31,634,766,0,0,82.77,278,325,"埤霞村",NULL
541,677,36,713,846,0,0,84.28,320,357,"埤腳村",NULL
542,661,35,696,870,0,0,80,270,391,"香山里",NULL
543,679,51,730,1025,0,0,71.22,383,296,"碧峰里",NULL
544,497,62,559,1118,0,0,50,481,16,"碧峰里",NULL
545,484,29,513,649,0,0,79.04,234,250,"東源里",NULL
546,1161,28,1189,1494,0,0,79.59,625,536,"復興里",NULL
547,1148,43,1191,1472,0,0,80.91,573,575,"平和里",NULL
548,948,38,986,1232,0,0,80.03,418,530,"頂潭里",NULL
549,1286,45,1331,1696,0,0,78.48,568,718,"中潭里",NULL
550,501,21,522,654,0,0,79.82,210,291,"龍潭里",NULL
551,1274,46,1320,1670,0,0,79.04,684,590,"北路里",NULL
552,930,14,944,1128,0,0,83.69,473,457,"北路里",NULL
553,681,14,695,864,0,0,80.44,302,379,"西路里",NULL
554,1021,28,1049,1267,0,0,82.79,514,507,"西路里",NULL
555,884,15,899,1094,0,0,82.18,399,485,"東路里",NULL
556,1036,21,1057,1278,0,0,82.71,490,546,"南路里",NULL
557,701,9,710,898,0,0,79.06,337,364,"中路里",NULL
558,852,24,876,1095,0,0,80,447,405,"中路里",NULL
559,731,23,754,967,0,0,77.97,361,370,"新庄里",NULL
560,859,22,881,1081,0,0,81.5,449,410,"新庄里",NULL
561,1214,39,1253,1616,0,0,77.54,458,756,"三安里",NULL
562,979,49,1028,1316,0,0,78.12,425,554,"大崙里",NULL
563,1237,63,1300,1643,0,0,79.12,595,642,"沙崙里",NULL
564,1359,36,1395,1707,0,0,81.72,698,661,"新民里",NULL
565,1302,34,1336,1702,0,0,78.5,655,647,"新民里",NULL
566,1007,41,1048,1323,0,0,79.21,403,604,"梅州里",NULL
567,1154,50,1204,1523,0,0,79.05,591,563,"三民里",NULL
568,693,29,722,888,0,0,81.31,309,384,"三光里",NULL
569,645,21,666,817,0,0,81.52,262,383,"大社里",NULL
570,1010,25,1035,1271,0,0,81.43,437,573,"社頭村",NULL
571,1082,19,1101,1304,0,0,84.43,488,594,"社頭村",NULL
572,911,28,939,1151,0,0,81.58,371,540,"廣興村",NULL
573,1082,42,1124,1373,0,0,81.86,434,648,"廣興村",NULL
574,1012,18,1030,1245,0,0,82.73,439,573,"廣興村",NULL
575,799,21,820,1011,0,0,81.11,382,417,"仁雅村",NULL
576,1169,31,1200,1459,0,0,82.25,543,626,"仁雅村",NULL
577,634,15,649,803,0,0,80.82,315,319,"崙雅村",NULL
578,830,28,858,1037,0,0,82.74,397,433,"美雅村",NULL
579,846,33,879,1075,0,0,81.77,421,425,"里仁村",NULL
580,1111,35,1146,1410,0,0,81.28,445,666,"舊社村",NULL
581,741,37,778,944,0,0,82.42,317,424,"松竹村",NULL
582,973,46,1019,1242,0,0,82.05,435,538,"東興村",NULL
583,672,27,699,824,0,0,84.83,310,362,"廣福村",NULL
584,1534,60,1594,1903,0,0,83.76,641,893,"橋頭村",NULL
585,1173,36,1209,1476,0,0,81.91,463,710,"湳底村",NULL
586,1086,53,1139,1401,0,0,81.3,456,630,"新厝村",NULL
587,894,18,912,1113,0,0,81.94,379,515,"張厝村",NULL
588,765,30,795,991,0,0,80.22,343,422,"埤斗村",NULL
589,839,35,874,1062,0,0,82.3,441,398,"清水村",NULL
590,816,31,847,992,0,0,85.38,268,548,"山湖村",NULL
591,813,38,851,1021,0,0,83.35,400,413,"朝興村",NULL
592,507,28,535,685,0,0,78.1,249,258,"仁和村",NULL
593,704,28,732,892,0,0,82.06,367,337,"泰安村",NULL
594,766,31,797,947,0,0,84.16,357,409,"平和村",NULL
595,626,27,653,800,0,0,81.63,267,359,"龍井村",NULL
596,1070,50,1120,1377,0,0,81.34,461,609,"湳雅村",NULL
597,1530,64,1594,1935,0,0,82.38,681,849,"協和村",NULL
598,811,34,845,1038,0,0,81.41,278,533,"復興村",NULL
599,542,30,572,732,0,0,78.14,227,315,"十五村",NULL
600,659,33,692,877,0,0,78.91,313,346,"合和村",NULL
601,803,32,835,1033,0,0,80.83,336,467,"上豊村",NULL
602,523,17,540,650,0,0,83.08,264,259,"過圳村",NULL
603,543,30,573,669,0,0,85.65,243,300,"五伯村",NULL
604,783,22,805,979,0,0,82.23,377,406,"光化村",NULL
605,826,21,847,1026,0,0,82.55,439,387,"文化村",NULL
606,689,25,714,888,0,0,80.41,353,336,"二水村",NULL
607,396,8,404,503,0,0,80.32,225,171,"聖化村",NULL
608,708,28,736,951,0,0,77.39,302,406,"裕民村",NULL
609,667,29,696,870,0,0,80,258,409,"惠民村",NULL
610,633,24,657,786,0,0,83.59,222,411,"大園村",NULL
611,625,36,661,803,0,0,82.32,301,324,"修仁村",NULL
612,574,29,603,745,0,0,80.94,205,369,"合興村",NULL
613,499,21,520,669,0,0,77.73,251,248,"源泉村",NULL
614,483,14,497,634,0,0,78.39,232,251,"倡和村",NULL
615,897,31,928,1160,0,0,80,413,484,"中寮里",NULL
616,902,41,943,1175,0,0,80.26,368,534,"中寮里",NULL
617,1393,63,1456,1734,0,0,83.97,537,856,"大道里",NULL
618,1070,25,1095,1303,0,0,84.04,513,557,"西德里",NULL
619,954,17,971,1164,0,0,83.42,471,483,"西德里",NULL
620,1090,33,1123,1391,0,0,80.73,516,574,"西德里",NULL
621,1212,44,1256,1580,0,0,79.49,564,648,"西安里",NULL
622,1100,25,1125,1391,0,0,80.88,591,509,"光復里",NULL
623,649,12,661,802,0,0,82.42,325,324,"新政里",NULL
624,503,15,518,627,0,0,82.62,211,292,"重慶里",NULL
625,602,19,621,749,0,0,82.91,296,306,"五權里",NULL
626,1061,39,1100,1390,0,0,79.14,422,639,"七星里",NULL
627,1055,26,1081,1324,0,0,81.65,556,499,"居仁里",NULL
628,1370,33,1403,1726,0,0,81.29,608,762,"東光里",NULL
629,749,39,788,995,0,0,79.2,401,348,"文昌里",NULL
630,964,38,1002,1308,0,0,76.61,457,507,"文昌里",NULL
631,803,30,833,1045,0,0,79.71,349,454,"中和里",NULL
632,1256,75,1331,1735,0,0,76.71,632,624,"新生里",NULL
633,1129,53,1182,1546,0,0,76.46,557,572,"大新里",NULL
634,561,41,602,770,0,0,78.18,167,394,"溪厝村",NULL
635,673,43,716,986,0,0,72.62,235,438,"溪厝村",NULL
636,506,33,539,676,0,0,79.73,150,356,"坑厝村",NULL
637,746,26,772,959,0,0,80.5,246,500,"瓦厝村",NULL
638,578,18,596,760,0,0,78.42,242,336,"溪州村",NULL
639,648,26,674,858,0,0,78.55,308,340,"溪州村",NULL
640,1052,37,1089,1395,0,0,78.06,444,608,"尾厝村",NULL
641,601,43,644,818,0,0,78.73,234,367,"東州村",NULL
642,682,43,725,890,0,0,81.46,247,435,"東州村",NULL
643,1013,39,1052,1314,0,0,80.06,331,682,"舊眉村",NULL
644,1028,52,1080,1469,0,0,73.52,435,593,"圳寮村",NULL
645,843,42,885,1124,0,0,78.74,311,532,"西畔村",NULL
646,675,47,722,921,0,0,78.39,222,453,"西畔村",NULL
647,705,47,752,943,0,0,79.75,281,424,"成功村",NULL
648,660,21,681,885,0,0,76.95,279,381,"成功村",NULL
649,681,40,721,933,0,0,77.28,286,395,"大庄村",NULL
650,691,48,739,971,0,0,76.11,229,462,"大庄村",NULL
651,612,28,640,801,0,0,79.9,410,202,"榮光村",NULL
652,822,58,880,1124,0,0,78.29,407,415,"柑園村",NULL
653,661,60,721,966,0,0,74.64,212,449,"潮洋村",NULL
654,514,42,556,740,0,0,75.14,194,320,"張厝村",NULL
655,671,39,710,895,0,0,79.33,255,416,"菜公村",NULL
656,898,52,950,1203,0,0,78.97,309,589,"三圳村",NULL
657,705,36,741,886,0,0,83.63,188,517,"三條村",NULL
658,946,37,983,1283,0,0,76.62,240,706,"水尾村",NULL
659,898,42,940,1231,0,0,76.36,432,466,"田尾村",NULL
660,550,20,570,680,0,0,83.82,294,256,"豐田村",NULL
661,1562,45,1607,2026,0,0,79.32,773,789,"饒平村",NULL
662,985,42,1027,1274,0,0,80.61,444,541,"北曾村",NULL
663,908,45,953,1200,0,0,79.42,379,529,"南曾村",NULL
664,753,37,790,1020,0,0,77.45,391,362,"睦宜村",NULL
665,919,35,954,1159,0,0,82.31,428,491,"新生村",NULL
666,771,39,810,1014,0,0,79.88,365,406,"北鎮村",NULL
667,489,28,517,655,0,0,78.93,223,266,"南鎮村",NULL
668,655,36,691,855,0,0,80.82,303,352,"福田村",NULL
669,793,30,823,1007,0,0,81.73,366,427,"新興村",NULL
670,940,40,980,1232,0,0,79.55,397,543,"溪畔村",NULL
671,1296,62,1358,1694,0,0,80.17,576,720,"打簾村",NULL
672,648,39,687,811,0,0,84.71,357,291,"柳鳳村",NULL
673,682,34,716,873,0,0,82.02,341,341,"陸豐村",NULL
674,1072,54,1126,1459,0,0,77.18,499,573,"海豐村",NULL
675,1182,58,1240,1554,0,0,79.79,607,575,"仁里村",NULL
676,227,6,233,294,0,0,79.25,126,101,"新厝村",NULL
677,476,29,505,636,0,0,79.4,201,275,"溪頂村",NULL
678,588,23,611,731,0,0,83.58,289,299,"正義村",NULL
679,742,41,783,1004,0,0,77.99,295,447,"和豊村",NULL
680,940,49,989,1296,0,0,76.31,469,471,"和豊村",NULL
681,1163,65,1228,1567,0,0,78.37,532,631,"興農村",NULL
682,1180,59,1239,1589,0,0,77.97,440,740,"埤頭村",NULL
683,681,55,736,956,0,0,76.99,379,302,"豊崙村",NULL
684,836,44,880,1192,0,0,73.83,474,362,"豊崙村",NULL
685,849,52,901,1159,0,0,77.74,396,453,"崙子村",NULL
686,1047,86,1133,1467,0,0,77.23,457,590,"永豊村",NULL
687,1041,40,1081,1353,0,0,79.9,581,460,"合興村",NULL
688,1229,57,1286,1610,0,0,79.88,590,639,"合興村",NULL
689,1204,59,1263,1635,0,0,77.25,591,613,"平原村",NULL
690,507,42,549,695,0,0,78.99,193,314,"崙腳村",NULL
691,452,26,478,598,0,0,79.93,208,244,"元埔村",NULL
692,1147,72,1219,1645,0,0,74.1,559,588,"芙朝村",NULL
693,852,50,902,1167,0,0,77.29,238,614,"新庄村",NULL
694,572,50,622,820,0,0,75.85,197,375,"陸嘉村",NULL
695,663,37,700,906,0,0,77.26,224,439,"竹圍村",NULL
696,983,51,1034,1336,0,0,77.4,321,662,"中和村",NULL
697,697,52,749,961,0,0,77.94,193,504,"庄內村",NULL
698,722,38,760,990,0,0,76.77,218,504,"大湖村",NULL
699,679,18,697,851,0,0,81.9,346,333,"東和里",NULL
700,931,36,967,1226,0,0,78.87,474,457,"東和里",NULL
701,1024,38,1062,1333,0,0,79.67,562,462,"南光里",NULL
702,1190,29,1219,1539,0,0,79.21,725,465,"南光里",NULL
703,990,37,1027,1328,0,0,77.33,521,469,"西平里",NULL
704,919,41,960,1244,0,0,77.17,465,454,"北平里",NULL
705,1059,64,1123,1467,0,0,76.55,576,483,"北平里",NULL
706,1130,84,1214,1648,0,0,73.67,682,448,"中西里",NULL
707,1045,84,1129,1481,0,0,76.23,430,615,"廣興里",NULL
708,855,54,909,1192,0,0,76.26,317,538,"香田里",NULL
709,810,37,847,1083,0,0,78.21,457,353,"外竹里",NULL
710,811,56,867,1115,0,0,77.76,519,292,"興華里",NULL
711,899,36,935,1214,0,0,77.02,478,421,"東興里",NULL
712,865,60,925,1253,0,0,73.82,440,425,"後厝里",NULL
713,904,20,924,1177,0,0,78.5,524,380,"後厝里",NULL
714,490,34,524,709,0,0,73.91,238,252,"豐田里",NULL
715,1025,38,1063,1383,0,0,76.86,573,452,"豐田里",NULL
716,974,64,1038,1403,0,0,73.98,500,474,"頂厝里",NULL
717,1180,82,1262,1669,0,0,75.61,662,518,"趙甲里",NULL
718,926,47,973,1294,0,0,75.19,512,414,"振興里",NULL
719,610,29,639,813,0,0,78.6,349,261,"萬興里",NULL
720,1162,57,1219,1566,0,0,77.84,573,589,"永興里",NULL
721,937,49,986,1265,0,0,77.94,362,575,"西庄里",NULL
722,817,57,874,1101,0,0,79.38,398,419,"梅芳里",NULL
723,887,43,930,1196,0,0,77.76,580,307,"華崙里",NULL
724,858,33,891,1167,0,0,76.35,460,398,"華崙里",NULL
725,844,53,897,1184,0,0,75.76,500,344,"華崙里",NULL
726,952,62,1014,1336,0,0,75.9,575,377,"萬合里",NULL
727,702,63,765,1004,0,0,76.2,373,329,"東勢里",NULL
728,634,48,682,890,0,0,76.63,333,301,"大永里",NULL
729,918,48,966,1237,0,0,78.09,452,466,"原斗里",NULL
730,758,46,804,1059,0,0,75.92,397,361,"西斗里",NULL
731,730,47,777,1021,0,0,76.1,353,377,"東華里",NULL
732,553,41,594,742,0,0,80.05,286,267,"復豐里",NULL
733,698,42,740,1024,0,0,72.27,313,385,"芳苑村",NULL
734,354,27,381,529,0,0,72.02,149,205,"芳中村",NULL
735,603,43,646,885,0,0,72.99,305,298,"仁愛村",NULL
736,411,31,442,647,0,0,68.32,223,188,"信義村",NULL
737,662,48,710,969,0,0,73.27,396,266,"後寮村",NULL
738,1352,63,1415,1873,0,0,75.55,691,661,"三合村",NULL
739,925,93,1018,1399,0,0,72.77,408,517,"永興村",NULL
740,588,74,662,1013,0,0,65.35,171,417,"新街村",NULL
741,500,45,545,748,0,0,72.86,238,262,"路上村",NULL
742,533,22,555,742,0,0,74.8,325,208,"路平村",NULL
743,692,66,758,1002,0,0,75.65,304,388,"三成村",NULL
744,459,27,486,691,0,0,70.33,210,249,"福榮村",NULL
745,383,40,423,602,0,0,70.27,190,193,"頂廍村",NULL
746,818,47,865,1184,0,0,73.06,238,580,"王功村",NULL
747,592,51,643,911,0,0,70.58,198,394,"王功村",NULL
748,577,42,619,800,0,0,77.38,200,377,"博愛村",NULL
749,541,40,581,817,0,0,71.11,185,356,"和平村",NULL
750,873,84,957,1395,0,0,68.6,265,608,"興仁村",NULL
751,518,33,551,779,0,0,70.73,146,372,"民生村",NULL
752,1056,66,1122,1470,0,0,76.33,459,597,"新寶村",NULL
753,343,19,362,561,0,0,64.53,162,181,"五俊村",NULL
754,1001,49,1050,1428,0,0,73.53,507,494,"草湖村",NULL
755,656,43,699,920,0,0,75.98,318,338,"建平村",NULL
756,866,45,911,1176,0,0,77.47,411,455,"建平村",NULL
757,497,23,520,720,0,0,72.22,283,214,"崙腳村",NULL
758,705,39,744,1041,0,0,71.47,350,355,"文津村",NULL
759,887,66,953,1362,0,0,69.97,325,562,"新生村",NULL
760,1148,63,1211,1584,0,0,76.45,476,672,"漢寶村",NULL
761,939,63,1002,1333,0,0,75.17,402,537,"漢寶村",NULL
762,887,67,954,1334,0,0,71.51,331,556,"潭墘村",NULL
763,916,80,996,1447,0,0,68.83,481,435,"山腳村",NULL
764,586,48,634,864,0,0,73.38,303,283,"西城村",NULL
765,868,41,909,1269,0,0,71.63,444,424,"東城村",NULL
766,761,31,792,1070,0,0,74.02,420,341,"大城村",NULL
767,433,17,450,653,0,0,68.91,232,201,"上山村",NULL
768,379,24,403,574,0,0,70.21,200,179,"上山村",NULL
769,525,7,532,757,0,0,70.28,292,233,"永和村",NULL
770,308,21,329,466,0,0,70.6,161,147,"公館村",NULL
771,505,32,537,775,0,0,69.29,301,204,"公館村",NULL
772,614,67,681,923,0,0,73.78,279,335,"豐美村",NULL
773,452,40,492,749,0,0,65.69,239,213,"三豐村",NULL
774,770,60,830,1196,0,0,69.4,472,298,"菜寮村",NULL
775,847,66,913,1350,0,0,67.63,513,334,"東港村",NULL
776,703,49,752,1096,0,0,68.61,414,289,"西港村",NULL
777,514,49,563,811,0,0,69.42,226,288,"頂庄村",NULL
778,679,67,746,1012,0,0,73.72,283,396,"臺西村",NULL
779,803,27,830,1105,0,0,75.11,345,458,"竹元村",NULL
780,1314,26,1340,1689,0,0,79.34,661,653,"竹塘村",NULL
781,606,30,636,815,0,0,78.04,308,298,"小西村",NULL
782,560,33,593,808,0,0,73.39,303,257,"民靖村",NULL
783,1101,66,1167,1530,0,0,76.27,342,759,"五庄村",NULL
784,508,21,529,653,0,0,81.01,173,335,"樹腳村",NULL
785,693,37,730,992,0,0,73.59,254,439,"田頭村",NULL
786,865,53,918,1181,0,0,77.73,311,554,"新廣村",NULL
787,394,33,427,563,0,0,75.84,151,243,"溪墘村",NULL
788,631,25,656,894,0,0,73.38,266,365,"竹林村",NULL
789,511,35,546,734,0,0,74.39,186,325,"土庫村",NULL
790,461,34,495,674,0,0,73.44,147,314,"內新村",NULL
791,542,35,577,788,0,0,73.22,192,350,"長安村",NULL
792,478,28,506,692,0,0,73.12,167,311,"永安村",NULL
1,749,10,759,946,0,0,80.23,347,402,"龍泉里",NULL
2,1069,20,1089,1369,0,0,79.55,545,524,"康壽里",NULL
3,654,15,669,797,0,0,83.94,380,274,"三民里",NULL
4,456,17,473,547,0,0,86.47,195,261,"仁和里",NULL
5,547,11,558,690,0,0,80.87,244,303,"南投里",NULL
6,370,6,376,445,0,0,84.49,154,216,"彰仁里",NULL
7,845,21,866,1056,0,0,82.01,415,430,"崇文里",NULL
8,817,31,848,1089,0,0,77.87,381,436,"三興里",NULL
9,1398,8,1406,1744,0,0,80.62,848,550,"三興里",NULL
10,1171,28,1199,1512,0,0,79.3,697,474,"三興里",NULL
11,1034,11,1045,1319,0,0,79.23,545,489,"三和里",NULL
12,1185,20,1205,1432,0,0,84.15,642,543,"三和里",NULL
13,1388,33,1421,1780,0,0,79.83,543,845,"嘉興里",NULL
14,1343,27,1370,1679,0,0,81.6,723,620,"嘉和里",NULL
15,1185,19,1204,1503,0,0,80.11,562,623,"嘉和里",NULL
16,857,23,880,1173,0,0,75.02,433,424,"平和里",NULL
17,1031,20,1051,1311,0,0,80.17,573,458,"平和里",NULL
18,1012,29,1041,1284,0,0,81.07,503,509,"平和里",NULL
19,1103,11,1114,1366,0,0,81.55,641,462,"平和里",NULL
20,416,17,433,550,0,0,78.73,178,238,"振興里",NULL
21,1116,22,1138,1438,0,0,79.14,426,690,"振興里",NULL
22,650,12,662,881,0,0,75.14,292,358,"千秋里",NULL
23,1338,36,1374,1731,0,0,79.38,784,554,"軍功里",NULL
24,1285,24,1309,1712,0,0,76.46,680,605,"軍功里",NULL
25,287,6,293,340,0,0,86.18,161,126,"軍功里",NULL
26,318,8,326,411,0,0,79.32,165,153,"東山里",NULL
27,858,22,880,1075,0,0,81.86,492,366,"營南里",NULL
28,737,18,755,909,0,0,83.06,435,302,"營南里",NULL
29,1267,28,1295,1573,0,0,82.33,778,489,"營北里",NULL
30,1437,21,1458,1698,0,0,85.87,1059,378,"營北里",NULL
31,1314,20,1334,1560,0,0,85.51,994,320,"營北里",NULL
32,896,31,927,1120,0,0,82.77,441,455,"內興里",NULL
33,1148,35,1183,1439,0,0,82.21,723,425,"內興里",NULL
34,1528,21,1549,1860,0,0,83.28,998,530,"內興里",NULL
35,454,12,466,585,0,0,79.66,252,202,"內興里",NULL
36,1085,30,1115,1352,0,0,82.47,494,591,"內新里",NULL
37,503,2,505,593,0,0,85.16,358,145,"光輝里",NULL
38,613,11,624,763,0,0,81.78,521,92,"光榮里",NULL
39,821,17,838,1057,0,0,79.28,687,134,"光榮里",NULL
40,768,10,778,906,0,0,85.87,679,89,"光明里",NULL
41,800,8,808,953,0,0,84.78,696,104,"光明里",NULL
42,575,4,579,696,0,0,83.19,502,73,"光華里",NULL
43,651,16,667,789,0,0,84.54,564,87,"光華里",NULL
44,853,16,869,1083,0,0,80.24,407,446,"漳興里",NULL
45,1021,18,1039,1273,0,0,81.62,507,514,"漳興里",NULL
46,987,24,1011,1279,0,0,79.05,573,414,"漳和里",NULL
47,1428,35,1463,1815,0,0,80.61,725,703,"漳和里",NULL
48,958,25,983,1216,0,0,80.84,529,429,"漳和里",NULL
49,1232,33,1265,1573,0,0,80.42,650,582,"漳和里",NULL
50,1199,24,1223,1588,0,0,77.02,649,550,"平山里",NULL
51,1022,7,1029,1303,0,0,78.97,514,508,"平山里",NULL
52,984,16,1000,1253,0,0,79.81,539,445,"平山里",NULL
53,1469,45,1514,1937,0,0,78.16,699,770,"新興里",NULL
54,1488,34,1522,1911,0,0,79.64,714,774,"新興里",NULL
55,1000,26,1026,1264,0,0,81.17,503,497,"永豐里",NULL
56,933,22,955,1170,0,0,81.62,474,459,"永豐里",NULL
57,1066,26,1092,1333,0,0,81.92,527,539,"福興里",NULL
58,931,25,956,1225,0,0,78.04,452,479,"福興里",NULL
59,923,42,965,1251,0,0,77.14,372,551,"鳳山里",NULL
60,579,27,606,756,0,0,80.16,252,327,"永興里",NULL
61,540,32,572,729,0,0,78.46,207,333,"鳳鳴里",NULL
62,1351,49,1400,1788,0,0,78.3,698,653,"福山里",NULL
63,633,27,660,886,0,0,74.49,331,302,"東門里",NULL
64,669,28,697,904,0,0,77.1,368,301,"東門里",NULL
65,881,21,902,1168,0,0,77.23,421,460,"東門里",NULL
66,749,10,759,1025,0,0,74.05,372,377,"西門里",NULL
67,775,20,795,1038,0,0,76.59,369,406,"西門里",NULL
68,829,15,844,1069,0,0,78.95,505,324,"西門里",NULL
69,713,13,726,939,0,0,77.32,341,372,"南門里",NULL
70,898,14,912,1189,0,0,76.7,554,344,"北門里",NULL
71,877,17,894,1177,0,0,75.96,500,377,"北門里",NULL
72,1309,22,1331,1767,0,0,75.33,787,522,"北安里",NULL
73,1138,35,1173,1481,0,0,79.2,620,518,"北安里",NULL
74,801,23,824,1017,0,0,81.02,473,328,"泰安里",NULL
75,754,13,767,986,0,0,77.79,416,338,"泰安里",NULL
76,807,10,817,1067,0,0,76.57,492,315,"北梅里",NULL
77,860,31,891,1181,0,0,75.44,408,452,"北梅里",NULL
78,909,24,933,1192,0,0,78.27,484,425,"同聲里",NULL
79,793,31,824,1093,0,0,75.39,428,365,"同聲里",NULL
80,755,13,768,1048,0,0,73.28,407,348,"清新里",NULL
81,735,28,763,1029,0,0,74.15,396,339,"清新里",NULL
82,1053,31,1084,1475,0,0,73.49,574,479,"清新里",NULL
83,948,20,968,1191,0,0,81.28,524,424,"薰化里",NULL
84,1040,35,1075,1412,0,0,76.13,619,421,"大城里",NULL
85,1100,28,1128,1431,0,0,78.83,606,494,"大城里",NULL
86,931,4,935,1260,0,0,74.21,491,440,"大城里",NULL
87,1188,18,1206,1610,0,0,74.91,681,507,"大城里",NULL
88,735,17,752,978,0,0,76.89,324,411,"籃城里",NULL
89,861,28,889,1123,0,0,79.16,406,455,"杷城里",NULL
90,879,28,907,1196,0,0,75.84,451,428,"杷城里",NULL
91,962,31,993,1302,0,0,76.27,494,468,"枇杷里",NULL
92,506,26,532,736,0,0,72.28,264,242,"枇杷里",NULL
93,891,33,924,1270,0,0,72.76,463,428,"枇杷里",NULL
94,1232,5,1237,1587,0,0,77.95,733,499,"枇杷里",NULL
95,755,20,775,1059,0,0,73.18,413,342,"枇杷里",NULL
96,655,29,684,962,0,0,71.1,337,318,"水頭里",NULL
97,711,23,734,1002,0,0,73.25,385,326,"水頭里",NULL
98,845,22,867,1176,0,0,73.72,387,458,"水頭里",NULL
99,719,23,742,1006,0,0,73.76,343,376,"麒麟里",NULL
100,712,31,743,991,0,0,74.97,337,375,"珠格里",NULL
101,716,17,733,916,0,0,80.02,413,303,"溪南里",NULL
102,755,29,784,1031,0,0,76.04,401,354,"桃米里",NULL
103,276,10,286,384,0,0,74.48,172,104,"成功里",NULL
104,951,28,979,1313,0,0,74.56,480,471,"南村里",NULL
105,1028,29,1057,1360,0,0,77.72,576,452,"愛蘭里",NULL
106,1200,42,1242,1649,0,0,75.32,692,508,"鐵山里",NULL
107,642,39,681,898,0,0,75.84,335,307,"房里里",NULL
108,256,7,263,347,0,0,75.79,115,141,"房里里",NULL
109,505,19,524,655,0,0,80,223,282,"向善里",NULL
110,606,3,609,809,0,0,75.28,322,284,"一新里",NULL
111,938,31,969,1292,0,0,75,415,523,"合成里",NULL
112,183,1,184,257,0,0,71.6,108,75,"合成里",NULL
113,884,14,898,1225,0,0,73.31,423,461,"廣成里",NULL
114,505,15,520,669,0,0,77.73,274,231,"史港里",NULL
115,701,28,729,989,0,0,73.71,259,442,"福興里",NULL
116,804,23,827,1100,0,0,75.18,338,466,"牛眠里",NULL
117,988,41,1029,1330,0,0,77.37,386,602,"牛眠里",NULL
118,909,33,942,1206,0,0,78.11,396,513,"大湳里",NULL
119,784,19,803,1066,0,0,75.33,523,261,"蜈蚣里",NULL
120,706,11,717,934,0,0,76.77,365,341,"蜈蚣里",NULL
121,395,16,411,561,0,0,73.26,134,261,"蜈蚣里",NULL
122,688,20,708,879,0,0,80.55,358,330,"玉峰里",NULL
123,882,19,901,1108,0,0,81.32,490,392,"玉峰里",NULL
124,1333,26,1359,1699,0,0,79.99,701,632,"明正里",NULL
125,1379,32,1411,1759,0,0,80.22,780,599,"明正里",NULL
126,737,24,761,934,0,0,81.48,401,336,"炎峰里",NULL
127,891,14,905,1122,0,0,80.66,493,398,"炎峰里",NULL
128,586,16,602,731,0,0,82.35,337,249,"中正里",NULL
129,1032,24,1056,1249,0,0,84.55,547,485,"和平里",NULL
130,733,17,750,909,0,0,82.51,405,328,"中山里",NULL
131,1042,20,1062,1311,0,0,81.01,506,536,"中山里",NULL
132,908,32,940,1202,0,0,78.2,455,453,"敦和里",NULL
133,1061,31,1092,1375,0,0,79.42,532,529,"敦和里",NULL
134,1004,20,1024,1300,0,0,78.77,574,430,"敦和里",NULL
135,1222,38,1260,1555,0,0,81.03,685,537,"敦和里",NULL
136,1289,23,1312,1638,0,0,80.1,755,534,"山腳里",NULL
137,1314,19,1333,1626,0,0,81.98,747,567,"山腳里",NULL
138,1081,14,1095,1316,0,0,83.21,699,382,"山腳里",NULL
139,1234,30,1264,1571,0,0,80.46,736,498,"山腳里",NULL
140,1098,35,1133,1380,0,0,82.1,650,448,"新厝里",NULL
141,1115,17,1132,1370,0,0,82.63,583,532,"新厝里",NULL
142,1205,16,1221,1484,0,0,82.28,707,498,"上林里",NULL
143,762,24,786,975,0,0,80.62,411,351,"上林里",NULL
144,842,22,864,1099,0,0,78.62,414,428,"碧峰里",NULL
145,962,32,994,1198,0,0,82.97,411,551,"碧峰里",NULL
146,925,18,943,1179,0,0,79.98,471,454,"碧峰里",NULL
147,884,24,908,1078,0,0,84.23,460,424,"碧洲里",NULL
148,552,9,561,679,0,0,82.62,330,222,"碧洲里",NULL
149,987,41,1028,1259,0,0,81.65,422,565,"復興里",NULL
150,1164,36,1200,1531,0,0,78.38,598,566,"復興里",NULL
151,1094,32,1126,1408,0,0,79.97,577,517,"御史里",NULL
152,1291,33,1324,1667,0,0,79.42,672,619,"御史里",NULL
153,586,27,613,820,0,0,74.76,311,275,"御史里",NULL
154,935,7,942,1221,0,0,77.15,406,529,"御史里",NULL
155,988,34,1022,1302,0,0,78.49,384,604,"新豐里",NULL
156,878,23,901,1112,0,0,81.03,452,426,"新豐里",NULL
157,763,29,792,981,0,0,80.73,353,410,"新豐里",NULL
158,1148,37,1185,1494,0,0,79.32,637,511,"新庄里",NULL
159,1078,43,1121,1434,0,0,78.17,575,503,"新庄里",NULL
160,576,20,596,722,0,0,82.55,227,349,"加老里",NULL
161,1065,29,1094,1307,0,0,83.7,499,566,"加老里",NULL
162,992,38,1030,1247,0,0,82.6,439,553,"石川里",NULL
163,954,23,977,1177,0,0,83.01,403,551,"北投里",NULL
164,969,28,997,1242,0,0,80.27,461,508,"北投里",NULL
165,1195,28,1223,1512,0,0,80.89,566,629,"富寮里",NULL
166,1075,28,1103,1453,0,0,75.91,510,565,"富寮里",NULL
167,806,5,811,1018,0,0,79.67,476,330,"富寮里",NULL
168,371,13,384,500,0,0,76.8,167,204,"富寮里",NULL
169,1077,53,1130,1421,0,0,79.52,509,568,"北勢里",NULL
170,372,12,384,485,0,0,79.18,153,219,"北勢里",NULL
171,833,10,843,1052,0,0,80.13,346,487,"中原里",NULL
172,617,25,642,820,0,0,78.29,235,382,"中原里",NULL
173,1112,12,1124,1415,0,0,79.43,477,635,"南埔里",NULL
174,815,19,834,1053,0,0,79.2,327,488,"南埔里",NULL
175,753,19,772,941,0,0,82.04,387,366,"南埔里",NULL
176,731,9,740,937,0,0,78.98,392,339,"坪頂里",NULL
177,486,17,503,641,0,0,78.47,276,210,"土城里",NULL
178,781,28,809,1044,0,0,77.49,420,361,"土城里",NULL
179,793,1,794,1031,0,0,77.01,406,387,"平林里",NULL
180,814,29,843,1135,0,0,74.27,353,461,"雙冬里",NULL
181,856,40,896,1183,0,0,75.74,442,414,"雙冬里",NULL
182,936,20,956,1211,0,0,78.94,485,451,"竹山里",NULL
183,729,7,736,896,0,0,82.14,345,384,"竹山里",NULL
184,564,5,569,691,0,0,82.34,278,286,"中正里",NULL
185,799,21,820,1102,0,0,74.41,388,411,"中山里",NULL
186,1083,33,1116,1442,0,0,77.39,435,648,"中山里",NULL
187,1376,41,1417,1853,0,0,76.47,646,730,"中山里",NULL
188,1060,16,1076,1369,0,0,78.6,485,575,"雲林里",NULL
189,1390,32,1422,1817,0,0,78.26,646,744,"雲林里",NULL
190,542,17,559,688,0,0,81.25,253,289,"竹圍里",NULL
191,1125,30,1155,1538,0,0,75.1,544,581,"竹圍里",NULL
192,1319,16,1335,1760,0,0,75.85,609,710,"桂林里",NULL
193,1226,31,1257,1634,0,0,76.93,538,688,"桂林里",NULL
194,375,24,399,503,0,0,79.32,138,237,"下坪里",NULL
195,425,10,435,546,0,0,79.67,208,217,"下坪里",NULL
196,817,33,850,1070,0,0,79.44,215,602,"中和里",NULL
197,1007,32,1039,1292,0,0,80.42,498,509,"中崎里",NULL
198,182,6,188,245,0,0,76.73,68,114,"秀林里",NULL
199,376,18,394,516,0,0,76.36,131,245,"秀林里",NULL
200,311,11,322,435,0,0,74.02,131,180,"大鞍里",NULL
201,1095,22,1117,1458,0,0,76.61,551,544,"延和里",NULL
202,1187,22,1209,1539,0,0,78.56,548,639,"延和里",NULL
203,940,22,962,1254,0,0,76.71,475,465,"延和里",NULL
204,1358,35,1393,1795,0,0,77.6,555,803,"延祥里",NULL
205,1116,37,1153,1495,0,0,77.12,498,618,"延祥里",NULL
206,522,21,543,685,0,0,79.27,161,361,"延正里",NULL
207,732,40,772,990,0,0,77.98,293,439,"延正里",NULL
208,866,32,898,1226,0,0,73.25,369,497,"延平里",NULL
209,719,24,743,924,0,0,80.41,276,443,"延平里",NULL
210,444,19,463,567,0,0,81.66,132,312,"延平里",NULL
211,518,24,542,671,0,0,80.77,213,305,"延山里",NULL
212,871,25,896,1178,0,0,76.06,329,542,"山崇里",NULL
213,488,26,514,665,0,0,77.29,218,270,"山崇里",NULL
214,742,27,769,965,0,0,79.69,313,429,"社寮里",NULL
215,993,41,1034,1344,0,0,76.93,345,648,"中央里",NULL
216,528,23,551,722,0,0,76.32,237,291,"富州里",NULL
217,353,4,357,447,0,0,79.87,146,207,"田子里",NULL
218,125,7,132,190,0,0,69.47,54,71,"田子里",NULL
219,1116,29,1145,1460,0,0,78.42,463,653,"硘磘里",NULL
220,295,15,310,392,0,0,79.08,109,186,"德興里",NULL
221,399,19,418,507,0,0,82.45,185,214,"德興里",NULL
222,151,3,154,204,0,0,75.49,85,66,"福興里",NULL
223,279,14,293,378,0,0,77.51,144,135,"福興里",NULL
224,352,21,373,523,0,0,71.32,146,206,"鯉魚里",NULL
225,246,12,258,348,0,0,74.14,105,141,"鯉魚里",NULL
226,378,28,406,534,0,0,76.03,135,243,"坪頂里",NULL
227,534,18,552,725,0,0,76.14,210,324,"瑞竹里",NULL
228,403,22,425,600,0,0,70.83,125,278,"桶頭里",NULL
229,320,13,333,461,0,0,72.23,154,166,"桶頭里",NULL
230,721,17,738,962,0,0,76.72,404,317,"集集里",NULL
231,706,23,729,945,0,0,77.14,376,330,"和平里",NULL
232,420,11,431,564,0,0,76.42,181,239,"林尾里",NULL
233,932,56,988,1254,0,0,78.79,497,435,"田寮里",NULL
234,429,16,445,561,0,0,79.32,188,241,"隘寮里",NULL
235,350,13,363,452,0,0,80.31,154,196,"玉映里",NULL
236,724,19,743,898,0,0,82.74,401,323,"吳厝里",NULL
237,1031,32,1063,1413,0,0,75.23,479,552,"八張里",NULL
238,701,16,717,915,0,0,78.36,349,352,"永昌里",NULL
239,456,18,474,624,0,0,75.96,226,230,"廣明里",NULL
240,307,14,321,435,0,0,73.79,142,165,"廣明里",NULL
241,313,2,315,423,0,0,74.47,180,133,"富山里",NULL
242,772,29,801,1017,0,0,78.76,344,428,"南雅村",NULL
243,938,31,969,1262,0,0,76.78,391,547,"中正村",NULL
244,1241,32,1273,1648,0,0,77.25,558,683,"中正村",NULL
245,589,17,606,768,0,0,78.91,278,311,"中山村",NULL
246,985,40,1025,1274,0,0,80.46,428,557,"中山村",NULL
247,1177,47,1224,1551,0,0,78.92,504,673,"濁水村",NULL
248,789,48,837,1041,0,0,80.4,332,457,"新民村",NULL
249,782,30,812,1010,0,0,80.4,332,450,"炭寮村",NULL
250,1287,35,1322,1617,0,0,81.76,520,767,"新街村",NULL
251,740,11,751,926,0,0,81.1,238,502,"新街村",NULL
252,842,19,861,1093,0,0,78.77,376,466,"新街村",NULL
253,596,6,602,785,0,0,76.69,198,398,"東湖村",NULL
254,651,14,665,843,0,0,78.88,279,372,"東湖村",NULL
255,637,28,665,857,0,0,77.6,348,289,"仁和村",NULL
256,777,36,813,995,0,0,81.71,287,490,"萬丹村",NULL
257,790,42,832,1040,0,0,80,255,535,"田仔村",NULL
258,652,19,671,842,0,0,79.69,188,464,"田仔村、大坑村",NULL
259,804,31,835,1026,0,0,81.38,233,571,"大庄村",NULL
260,708,34,742,920,0,0,80.65,231,477,"大庄村、廍下村、大坑村",NULL
261,584,31,615,770,0,0,79.87,236,348,"廍下村",NULL
262,558,16,574,701,0,0,81.88,206,352,"赤水村",NULL
263,445,10,455,569,0,0,79.96,167,278,"赤水村",NULL
264,722,25,747,926,0,0,80.67,195,527,"竹圍村",NULL
265,805,37,842,1030,0,0,81.75,329,476,"三崙村",NULL
266,370,9,379,453,0,0,83.66,116,254,"三崙村",NULL
267,1155,29,1184,1482,0,0,79.89,506,649,"松山村",NULL
268,905,24,929,1141,0,0,81.42,355,550,"松柏村",NULL
269,638,6,644,802,0,0,80.3,305,333,"崁腳村",NULL
270,707,14,721,878,0,0,82.12,276,431,"埔中村",NULL
271,626,27,653,817,0,0,79.93,245,381,"新厝村",NULL
272,585,25,610,774,0,0,78.81,215,370,"新光村",NULL
273,665,31,696,866,0,0,80.37,290,375,"新光村",NULL
274,1088,64,1152,1597,0,0,72.14,521,567,"初鄉村",NULL
275,1296,14,1310,1668,0,0,78.54,626,670,"鹿谷村",NULL
276,605,17,622,757,0,0,82.17,304,301,"彰雅村",NULL
277,310,13,323,418,0,0,77.27,134,176,"彰雅村",NULL
278,575,26,601,780,0,0,77.05,331,244,"廣興村",NULL
279,854,23,877,1092,0,0,80.31,423,431,"廣興村",NULL
280,406,13,419,568,0,0,73.77,200,206,"內湖村",NULL
281,344,11,355,449,0,0,79.06,153,191,"內湖村",NULL
282,463,23,486,609,0,0,79.8,255,208,"和雅村",NULL
283,1128,34,1162,1522,0,0,76.35,535,593,"竹林村",NULL
284,687,20,707,892,0,0,79.26,372,315,"竹豐村",NULL
285,1023,48,1071,1359,0,0,78.81,445,578,"鳳凰村",NULL
286,1059,30,1089,1331,0,0,81.82,507,552,"永隆村",NULL
287,467,4,471,643,0,0,73.25,163,304,"秀峰村",NULL
288,306,13,319,437,0,0,73,99,207,"永隆村",NULL
289,527,23,550,731,0,0,75.24,211,316,"清水村",NULL
290,520,35,555,778,0,0,71.34,238,282,"瑞田村",NULL
291,619,38,657,853,0,0,77.02,210,409,"廣興村",NULL
292,210,3,213,266,0,0,80.08,85,125,"崁頂村",NULL
293,181,13,194,251,0,0,77.29,66,115,"崁頂村",NULL
294,287,12,299,386,0,0,77.46,127,160,"八仙村",NULL
295,276,5,281,368,0,0,76.36,105,171,"八仙村",NULL
296,331,19,350,429,0,0,81.59,139,192,"福盛村",NULL
297,252,15,267,369,0,0,72.36,132,120,"福盛村",NULL
298,489,30,519,698,0,0,74.36,190,299,"和興村",NULL
299,753,25,778,979,0,0,79.47,405,348,"永平村",NULL
300,600,20,620,786,0,0,78.88,289,311,"永平村",NULL
301,195,6,201,273,0,0,73.63,86,109,"復興村",NULL
302,528,1,529,709,0,0,74.61,293,235,"中寮村",NULL
303,411,22,433,548,0,0,79.01,142,269,"廣福村",NULL
304,298,8,306,379,0,0,80.74,111,187,"永福村",NULL
305,613,13,626,768,0,0,81.51,310,303,"永福村",NULL
306,362,14,376,468,0,0,80.34,164,198,"義和村",NULL
307,492,16,508,645,0,0,78.76,195,297,"義和村",NULL
308,663,42,705,959,0,0,73.51,301,362,"清水村",NULL
309,322,16,338,468,0,0,72.22,158,164,"內城村",NULL
310,513,21,534,700,0,0,76.29,203,310,"龍安村",NULL
311,412,6,418,543,0,0,76.98,207,205,"爽文村",NULL
312,538,16,554,686,0,0,80.76,264,274,"龍岩村",NULL
313,336,11,347,437,0,0,79.41,171,165,"永芳村",NULL
314,405,20,425,549,0,0,77.41,198,207,"永和村",NULL
315,1346,35,1381,1909,0,0,72.34,652,694,"魚池村",NULL
316,1049,45,1094,1529,0,0,71.55,445,604,"東池村",NULL
317,350,10,360,501,0,0,71.86,103,247,"大林村",NULL
318,400,17,417,564,0,0,73.94,201,199,"大林村",NULL
319,828,35,863,1242,0,0,69.48,294,534,"東光村",NULL
320,173,11,184,235,0,0,78.3,55,118,"共和村",NULL
321,377,6,383,539,0,0,71.06,161,216,"共和村",NULL
322,141,10,151,207,0,0,72.95,76,65,"共和村",NULL
323,558,6,564,740,0,0,76.22,264,294,"新城村",NULL
324,207,6,213,292,0,0,72.95,77,130,"新城村",NULL
325,209,2,211,285,0,0,74.04,92,117,"新城村",NULL
326,231,1,232,290,0,0,80,110,121,"大雁村",NULL
327,264,17,281,380,0,0,73.95,106,158,"大雁村",NULL
328,397,23,420,562,0,0,74.73,217,180,"五城村",NULL
329,118,9,127,166,0,0,76.51,47,71,"五城村",NULL
330,448,20,468,641,0,0,73.01,198,250,"中明村",NULL
331,273,7,280,384,0,0,72.92,116,157,"中明村",NULL
332,593,8,601,807,0,0,74.47,323,270,"水社村",NULL
333,526,20,546,722,0,0,75.62,283,243,"日月村",NULL
334,287,11,298,420,0,0,70.95,141,146,"頭社村",NULL
335,373,22,395,541,0,0,73.01,170,203,"頭社村",NULL
336,307,4,311,438,0,0,71,166,141,"武登村",NULL
337,219,7,226,311,0,0,72.67,102,117,"武登村",NULL
338,651,14,665,880,0,0,75.57,336,315,"國姓村",NULL
339,544,20,564,760,0,0,74.21,276,268,"國姓村",NULL
340,630,27,657,892,0,0,73.65,351,279,"石門村",NULL
341,547,27,574,792,0,0,72.47,327,220,"石門村",NULL
342,535,16,551,755,0,0,72.98,238,297,"大旗村",NULL
343,1063,34,1097,1512,0,0,72.55,611,452,"長流村",NULL
344,494,29,523,703,0,0,74.4,265,229,"長福村",NULL
345,582,8,590,841,0,0,70.15,313,269,"長豐村",NULL
346,755,42,797,1095,0,0,72.79,404,351,"北港村",NULL
347,634,31,665,922,0,0,72.13,303,331,"北港村",NULL
348,680,24,704,906,0,0,77.7,391,289,"福龜村",NULL
349,709,22,731,946,0,0,77.27,379,330,"福龜村",NULL
350,613,17,630,866,0,0,72.75,324,289,"乾溝村",NULL
351,846,50,896,1205,0,0,74.36,455,391,"柑林村",NULL
352,542,28,570,759,0,0,75.1,258,284,"大石村",NULL
353,774,32,806,1027,0,0,78.48,383,391,"北山村",NULL
354,413,12,425,588,0,0,72.28,172,241,"北山村",NULL
355,792,57,849,1226,0,0,69.25,454,338,"南港村",NULL
356,492,22,514,700,0,0,73.43,262,230,"南港村",NULL
357,636,27,663,908,0,0,73.02,364,272,"水里村",NULL
358,427,2,429,574,0,0,74.74,215,212,"新城村",NULL
359,783,22,805,1090,0,0,73.85,363,420,"新城村",NULL
360,567,5,572,736,0,0,77.72,277,290,"中央村",NULL
361,772,18,790,1043,0,0,75.74,425,347,"城中村",NULL
362,401,7,408,525,0,0,77.71,192,209,"農富村",NULL
363,727,19,746,1004,0,0,74.3,413,314,"北埔村",NULL
364,1047,11,1058,1379,0,0,76.72,553,494,"南光村",NULL
365,853,29,882,1078,0,0,81.82,532,321,"鉅工村",NULL
366,1043,35,1078,1398,0,0,77.11,505,538,"永豐村",NULL
367,740,31,771,1049,0,0,73.5,232,508,"民和村",NULL
368,831,27,858,1181,0,0,72.65,446,385,"頂崁村",NULL
369,267,12,279,379,0,0,73.61,142,125,"新山村",NULL
370,253,11,264,368,0,0,71.74,135,118,"郡坑村",NULL
371,835,31,866,1171,0,0,73.95,451,384,"上安村",NULL
372,242,0,242,353,0,0,68.56,91,151,"興隆村",NULL
373,250,11,261,368,0,0,70.92,103,147,"永興村",NULL
374,695,24,719,920,0,0,78.15,228,467,"玉峰村",NULL
375,376,26,402,557,0,0,72.17,208,168,"車埕村",NULL
376,476,18,494,689,0,0,71.7,273,203,"新興村",NULL
377,413,11,424,557,0,0,76.12,332,81,"雙龍村",NULL
378,592,13,605,763,0,0,79.29,496,96,"地利村",NULL
379,333,16,349,463,0,0,75.38,305,28,"潭南村",NULL
380,568,25,593,799,0,0,74.22,490,78,"人和村",NULL
381,167,16,183,268,0,0,68.28,96,71,"人和村",NULL
382,829,10,839,1107,0,0,75.79,499,330,"明德村",NULL
383,277,5,282,389,0,0,72.49,123,154,"明德村",NULL
384,238,13,251,338,0,0,74.26,108,130,"自強村",NULL
385,303,21,324,415,0,0,78.07,154,149,"自強村",NULL
386,385,21,406,541,0,0,75.05,209,176,"愛國村",NULL
387,425,27,452,583,0,0,77.53,239,186,"豐丘村",NULL
388,363,11,374,470,0,0,79.57,289,74,"新鄉村",NULL
389,828,44,872,1164,0,0,74.91,688,140,"羅娜村",NULL
390,338,15,353,475,0,0,74.32,182,156,"望美村",NULL
391,608,14,622,824,0,0,75.49,428,180,"望美村",NULL
392,671,28,699,952,0,0,73.42,299,372,"同富村",NULL
393,305,12,317,451,0,0,70.29,133,172,"同富村",NULL
394,333,16,349,484,0,0,72.11,163,170,"神木村",NULL
395,183,12,195,272,0,0,71.69,125,58,"神木村",NULL
396,593,10,603,809,0,0,74.54,403,190,"東埔村",NULL
397,172,3,175,267,0,0,65.54,153,19,"發祥村",NULL
398,234,12,246,341,0,0,72.14,208,26,"發祥村",NULL
399,66,1,67,113,0,0,59.29,58,8,"發祥村",NULL
400,424,12,436,588,0,0,74.15,409,15,"精英村",NULL
401,510,9,519,651,0,0,79.72,437,73,"精英村",NULL
402,440,13,453,627,0,0,72.25,414,26,"親愛村",NULL
403,256,9,265,330,0,0,80.3,209,47,"親愛村",NULL
404,86,0,86,114,0,0,75.44,75,11,"親愛村",NULL
405,380,8,388,531,0,0,73.07,333,47,"萬豐村",NULL
406,261,10,271,327,0,0,82.87,234,27,"新生村",NULL
407,592,14,606,810,0,0,74.81,408,184,"大同村",NULL
408,297,12,309,399,0,0,77.44,253,44,"大同村",NULL
409,190,10,200,255,0,0,78.43,155,35,"大同村",NULL
410,671,8,679,844,0,0,80.45,575,96,"春陽村",NULL
411,425,6,431,603,0,0,71.48,373,52,"法治村",NULL
412,113,11,124,191,0,0,64.92,89,24,"翠華村",NULL
413,229,12,241,354,0,0,68.08,174,55,"翠華村",NULL
414,335,13,348,478,0,0,72.8,271,64,"力行村",NULL
415,601,27,628,810,0,0,77.53,517,84,"南豐村",NULL
416,209,13,222,310,0,0,71.61,109,100,"南豐村",NULL
417,539,4,543,710,0,0,76.48,501,38,"中正村",NULL
418,61,1,62,83,0,0,74.7,53,8,"榮興村",NULL
419,390,18,408,537,0,0,75.98,332,58,"合作村",NULL
420,419,15,434,574,0,0,75.61,376,43,"互助村",NULL
421,318,9,327,385,0,0,84.94,295,23,"互助村",NULL
1,623,13,636,787,0,0,80.81,278,345,"信義里",NULL
2,587,14,601,720,0,0,83.47,275,312,"四維里",NULL
3,612,17,629,771,0,0,81.58,296,316,"太平里",NULL
4,762,20,782,937,0,0,83.46,317,445,"中和里",NULL
5,697,18,715,918,0,0,77.89,311,386,"光興里",NULL
6,969,31,1000,1231,0,0,81.23,515,454,"鎮西里",NULL
7,1248,25,1273,1690,0,0,75.33,577,671,"鎮西里",NULL
8,888,26,914,1105,0,0,82.71,504,384,"鎮東里",NULL
9,919,22,941,1152,0,0,81.68,430,489,"鎮東里",NULL
10,1066,20,1086,1334,0,0,81.41,594,472,"鎮東里",NULL
11,1073,28,1101,1388,0,0,79.32,580,493,"三平里",NULL
12,1310,28,1338,1631,0,0,82.04,745,565,"三平里",NULL
13,886,6,892,1107,0,0,80.58,437,449,"明德里",NULL
14,951,10,961,1224,0,0,78.51,469,482,"明德里",NULL
15,916,22,938,1140,0,0,82.28,374,542,"鎮北里",NULL
16,979,16,995,1202,0,0,82.78,559,420,"鎮北里",NULL
17,1373,32,1405,1773,0,0,79.24,698,675,"公誠里",NULL
18,628,13,641,795,0,0,80.63,291,337,"忠孝里",NULL
19,551,13,564,677,0,0,83.31,258,293,"忠孝里",NULL
20,937,9,946,1156,0,0,81.83,426,511,"仁愛里",NULL
21,1072,35,1107,1350,0,0,82,474,598,"八德里",NULL
22,1022,19,1041,1273,0,0,81.78,509,513,"八德里",NULL
23,949,19,968,1228,0,0,78.83,624,325,"公正里",NULL
24,938,22,960,1174,0,0,81.77,518,420,"公正里",NULL
25,730,25,755,903,0,0,83.61,297,433,"重光里",NULL
26,817,29,846,1117,0,0,75.74,323,494,"重光里",NULL
27,1188,15,1203,1480,0,0,81.28,544,644,"林頭里",NULL
28,849,24,873,1123,0,0,77.74,465,384,"林頭里",NULL
29,687,6,693,915,0,0,75.74,541,146,"林頭里",NULL
30,757,5,762,940,0,0,81.06,371,386,"成功里",NULL
31,854,14,868,1065,0,0,81.5,439,415,"成功里",NULL
32,888,18,906,1111,0,0,81.55,475,413,"鎮南里",NULL
33,872,15,887,1082,0,0,81.98,474,398,"鎮南里",NULL
34,818,21,839,1057,0,0,79.38,484,334,"鎮南里",NULL
35,738,9,747,930,0,0,80.32,404,334,"社口里",NULL
36,940,19,959,1161,0,0,82.6,492,448,"社口里",NULL
37,894,21,915,1092,0,0,83.79,383,511,"龍潭里",NULL
38,593,28,621,747,0,0,83.13,227,366,"嘉東里",NULL
39,859,10,869,1070,0,0,81.21,507,352,"崙峰里",NULL
40,542,14,556,678,0,0,82.01,279,263,"崙峰里",NULL
41,470,16,486,594,0,0,81.82,248,222,"溝埧里",NULL
42,1175,47,1222,1553,0,0,78.69,493,682,"江厝里",NULL
43,444,17,461,564,0,0,81.74,160,284,"三光里",NULL
44,970,41,1011,1211,0,0,83.48,455,515,"久安里",NULL
45,562,9,571,705,0,0,80.99,245,317,"久安里",NULL
46,1069,20,1089,1315,0,0,82.81,597,472,"虎溪里",NULL
47,1217,20,1237,1577,0,0,78.44,613,604,"虎溪里",NULL
48,1210,34,1244,1575,0,0,78.98,519,691,"虎溪里",NULL
49,1327,57,1384,1685,0,0,82.14,487,840,"保庄里",NULL
50,1106,34,1140,1425,0,0,80,574,532,"保庄里",NULL
51,1214,55,1269,1566,0,0,81.03,476,738,"長平里",NULL
52,918,38,956,1196,0,0,79.93,315,603,"榴中里",NULL
53,967,30,997,1224,0,0,81.45,353,614,"榴中里",NULL
54,1034,34,1068,1356,0,0,78.76,471,563,"榴中里",NULL
55,764,26,790,964,0,0,81.95,273,491,"榴北里",NULL
56,924,31,955,1180,0,0,80.93,395,529,"榴南里",NULL
57,603,22,625,747,0,0,83.67,259,344,"梅林里",NULL
58,737,42,779,973,0,0,80.06,331,406,"梅林里",NULL
59,1023,22,1045,1269,0,0,82.35,393,630,"湖山里",NULL
60,810,40,850,1050,0,0,80.95,301,509,"長安里",NULL
61,1137,39,1176,1483,0,0,79.3,470,667,"長安里",NULL
62,739,31,770,978,0,0,78.73,280,459,"溪洲里",NULL
63,1147,40,1187,1493,0,0,79.5,510,637,"溪洲里",NULL
64,909,40,949,1142,0,0,83.1,293,616,"十三里",NULL
65,886,21,907,1131,0,0,80.19,388,498,"東仁里",NULL
66,1257,12,1269,1574,0,0,80.62,603,654,"西岐里",NULL
67,1209,20,1229,1506,0,0,81.61,631,578,"西岐里",NULL
68,1091,7,1098,1415,0,0,77.6,542,549,"西岐里",NULL
69,857,18,875,1106,0,0,79.11,417,440,"南昌里",NULL
70,732,24,756,928,0,0,81.47,312,420,"南昌里",NULL
71,1055,9,1064,1322,0,0,80.48,551,504,"北銘里",NULL
72,977,20,997,1256,0,0,79.38,434,543,"中天里",NULL
73,958,30,988,1252,0,0,78.91,330,628,"林子里",NULL
74,693,24,717,888,0,0,80.74,291,402,"石龜里",NULL
75,727,33,760,924,0,0,82.25,238,489,"石溪里",NULL
76,693,29,722,903,0,0,79.96,274,419,"靖興里",NULL
77,539,25,564,744,0,0,75.81,164,375,"新南里",NULL
78,960,42,1002,1177,0,0,85.13,366,594,"阿丹里",NULL
79,1128,58,1186,1483,0,0,79.97,468,660,"將軍里",NULL
80,1050,18,1068,1356,0,0,78.76,441,609,"舊社里",NULL
81,449,17,466,621,0,0,75.04,159,290,"舊社里",NULL
82,1131,30,1161,1430,0,0,81.19,560,571,"明昌里",NULL
83,1102,43,1145,1408,0,0,81.32,404,698,"明昌里",NULL
84,1184,29,1213,1512,0,0,80.22,579,605,"明昌里",NULL
85,696,40,736,933,0,0,78.89,291,405,"大東里",NULL
86,613,35,648,831,0,0,77.98,318,295,"埤麻里",NULL
87,718,26,744,938,0,0,79.32,308,410,"西伯里",NULL
88,619,36,655,841,0,0,77.88,240,379,"新崙里",NULL
89,550,29,579,742,0,0,78.03,187,363,"新崙里",NULL
90,757,29,786,994,0,0,79.07,317,440,"東明里",NULL
91,806,48,854,1050,0,0,81.33,290,516,"新光里",NULL
92,1073,45,1118,1364,0,0,81.96,419,654,"新光里",NULL
93,835,37,872,1034,0,0,84.33,342,493,"田頭里",NULL
94,785,46,831,1024,0,0,81.15,275,510,"田頭里",NULL
95,1235,38,1273,1596,0,0,79.76,336,899,"小東里",NULL
96,891,19,910,1109,0,0,82.06,482,409,"東仁里",NULL
97,903,19,922,1155,0,0,79.83,479,424,"東仁里",NULL
98,537,7,544,690,0,0,78.84,258,279,"新興里",NULL
99,770,20,790,1014,0,0,77.91,400,370,"新興里",NULL
100,976,16,992,1233,0,0,80.45,492,484,"公安里",NULL
101,1158,13,1171,1443,0,0,81.15,623,535,"公安里",NULL
102,770,6,776,1009,0,0,76.91,365,405,"德興里",NULL
103,1070,28,1098,1424,0,0,77.11,607,463,"德興里",NULL
104,814,24,838,1071,0,0,78.24,424,390,"中山里",NULL
105,1147,15,1162,1432,0,0,81.15,593,554,"西安里",NULL
106,1168,31,1199,1545,0,0,77.61,620,548,"西安里",NULL
107,1315,11,1326,1619,0,0,81.9,749,566,"立仁里",NULL
108,1418,30,1448,1900,0,0,76.21,741,677,"立仁里",NULL
109,1081,23,1104,1366,0,0,80.82,625,456,"安慶里",NULL
110,1068,23,1091,1423,0,0,76.67,550,518,"平和里",NULL
111,1356,33,1389,1764,0,0,78.74,663,693,"興南里",NULL
112,1136,23,1159,1473,0,0,78.68,528,608,"新吉里",NULL
113,788,18,806,1023,0,0,78.79,363,425,"新吉里",NULL
114,1273,41,1314,1682,0,0,78.12,544,729,"穎川里",NULL
115,694,32,726,945,0,0,76.83,292,402,"延平里",NULL
116,525,28,553,758,0,0,72.96,383,142,"建國里",NULL
117,979,13,992,1255,0,0,79.04,382,597,"埒內里",NULL
118,864,24,888,1104,0,0,80.43,271,593,"埒內里",NULL
119,615,8,623,778,0,0,80.08,216,399,"堀頭里",NULL
120,1331,63,1394,1715,0,0,81.28,550,781,"安溪里",NULL
121,1203,55,1258,1589,0,0,79.17,495,708,"興中里",NULL
122,1070,37,1107,1398,0,0,79.18,404,666,"廉使里",NULL
123,1119,33,1152,1483,0,0,77.68,452,667,"廉使里",NULL
124,927,9,936,1244,0,0,75.24,505,422,"惠來里",NULL
125,776,50,826,1044,0,0,79.12,290,486,"惠來里",NULL
126,952,39,991,1216,0,0,81.5,341,611,"頂溪里",NULL
127,934,44,978,1248,0,0,78.37,330,604,"頂溪里",NULL
128,999,39,1038,1299,0,0,79.91,408,591,"中溪里",NULL
129,1014,52,1066,1307,0,0,81.56,473,541,"下溪里",NULL
130,852,35,887,1161,0,0,76.4,359,493,"東屯里",NULL
131,1073,55,1128,1515,0,0,74.46,481,592,"西屯里",NULL
132,620,42,662,870,0,0,76.09,161,459,"芳草里",NULL
133,708,37,745,979,0,0,76.1,216,492,"墾地里",NULL
134,612,4,616,781,0,0,78.87,246,366,"北溪里",NULL
135,733,28,761,1029,0,0,73.96,334,399,"三合里",NULL
136,1237,49,1286,1595,0,0,80.63,353,884,"振興里",NULL
137,1153,46,1199,1505,0,0,79.67,411,742,"大園里",NULL
138,1284,42,1326,1642,0,0,80.76,558,726,"廣福里",NULL
139,989,23,1012,1289,0,0,78.51,466,523,"正興里",NULL
140,1253,37,1290,1610,0,0,80.12,577,676,"正興里",NULL
141,352,8,360,458,0,0,78.6,151,201,"永安里",NULL
142,553,11,564,703,0,0,80.23,232,321,"中和里",NULL
143,479,16,495,645,0,0,76.74,185,294,"福興里",NULL
144,765,18,783,990,0,0,79.09,292,473,"光華里",NULL
145,815,8,823,1052,0,0,78.23,335,480,"中興里",NULL
146,937,29,966,1184,0,0,81.59,324,613,"中興里",NULL
147,1273,37,1310,1714,0,0,76.43,493,780,"漢光里",NULL
148,1309,40,1349,1737,0,0,77.66,460,849,"漢光里",NULL
149,1015,48,1063,1295,0,0,82.08,227,788,"新安里",NULL
150,1146,24,1170,1482,0,0,78.95,293,853,"新豐里",NULL
151,666,51,717,934,0,0,76.77,206,460,"大新里",NULL
152,614,38,652,821,0,0,79.42,200,414,"大新里",NULL
153,717,32,749,908,0,0,82.49,181,536,"埤頭里",NULL
154,855,39,894,1111,0,0,80.47,198,657,"東興里",NULL
155,1142,51,1193,1506,0,0,79.22,332,810,"鹿場里",NULL
156,637,38,675,869,0,0,77.68,280,357,"廣興里",NULL
157,736,40,776,978,0,0,79.35,223,513,"頂湳里",NULL
158,1019,47,1066,1359,0,0,78.44,286,733,"吳厝里",NULL
159,591,31,622,763,0,0,81.52,187,404,"九隆里",NULL
160,594,28,622,813,0,0,76.51,341,253,"下湳里",NULL
161,709,56,765,966,0,0,79.19,171,538,"七座里",NULL
162,994,51,1045,1390,0,0,75.18,257,737,"公館里",NULL
163,732,44,776,982,0,0,79.02,267,465,"詔安里",NULL
164,703,25,728,924,0,0,78.79,246,457,"河南里",NULL
165,706,45,751,935,0,0,80.32,140,566,"安定里",NULL
166,617,45,662,870,0,0,76.09,122,495,"安定里",NULL
167,1108,58,1166,1422,0,0,82,288,820,"福田里",NULL
168,704,13,717,937,0,0,76.52,313,391,"忠正里",NULL
169,807,20,827,1017,0,0,81.32,384,423,"順天里",NULL
170,1027,39,1066,1400,0,0,76.14,482,545,"宮北里",NULL
171,679,21,700,921,0,0,76,332,347,"越港里",NULL
172,521,27,548,726,0,0,75.48,210,311,"溪邊里",NULL
173,326,18,344,444,0,0,77.48,136,190,"溪邊里",NULL
174,1155,46,1201,1599,0,0,75.11,481,674,"石廟里",NULL
175,448,32,480,621,0,0,77.29,173,275,"興新里",NULL
176,517,15,532,712,0,0,74.72,193,324,"興新里",NULL
177,540,19,559,829,0,0,67.43,149,391,"奮起里",NULL
178,420,23,443,607,0,0,72.98,201,219,"奮起里",NULL
179,600,38,638,886,0,0,72.01,170,430,"埤腳里",NULL
180,397,19,416,560,0,0,74.29,182,215,"埤腳里",NULL
181,911,46,957,1325,0,0,72.23,321,590,"後埔里",NULL
182,734,38,772,1022,0,0,75.54,280,454,"後埔里",NULL
183,562,35,597,832,0,0,71.75,184,378,"崙內里",NULL
184,478,19,497,716,0,0,69.41,187,291,"崙內里",NULL
185,635,23,658,875,0,0,75.2,274,361,"大荖里",NULL
186,750,18,768,1044,0,0,73.56,229,521,"東平里",NULL
187,620,28,648,848,0,0,76.42,161,459,"東平里",NULL
188,738,39,777,972,0,0,79.94,225,513,"南平里",NULL
189,599,32,631,845,0,0,74.67,182,417,"南平里",NULL
190,700,31,731,923,0,0,79.2,264,436,"西平里",NULL
191,593,29,622,863,0,0,72.07,189,404,"西平里",NULL
192,737,34,771,1003,0,0,76.87,168,569,"北平里",NULL
193,1060,69,1129,1486,0,0,75.98,363,697,"新庄里",NULL
194,618,30,648,823,0,0,78.74,196,422,"東陽里",NULL
195,604,32,636,783,0,0,81.23,203,401,"光民里",NULL
196,398,8,406,518,0,0,78.38,124,274,"東華里",NULL
197,811,20,831,1021,0,0,81.39,233,578,"南安里",NULL
198,318,12,330,424,0,0,77.83,126,192,"中和里",NULL
199,355,8,363,449,0,0,80.85,140,215,"義民里",NULL
200,348,10,358,436,0,0,82.11,110,238,"共榮里",NULL
201,737,11,748,947,0,0,78.99,304,433,"西勢里",NULL
202,444,14,458,548,0,0,83.58,178,266,"仁和里",NULL
203,315,8,323,408,0,0,79.17,111,204,"賜福里",NULL
204,510,11,521,668,0,0,77.99,158,352,"公館里",NULL
205,428,7,435,538,0,0,80.86,138,290,"大同里",NULL
206,604,20,624,801,0,0,77.9,226,378,"大同里",NULL
207,421,14,435,530,0,0,82.08,202,219,"仁安里",NULL
208,809,10,819,1026,0,0,79.82,338,471,"華勝里",NULL
209,1101,29,1130,1425,0,0,79.3,396,705,"華勝里",NULL
210,817,35,852,1062,0,0,80.23,307,510,"華勝里",NULL
211,1033,21,1054,1356,0,0,77.73,393,640,"華勝里",NULL
212,994,24,1018,1339,0,0,76.03,456,538,"光復里",NULL
213,1110,30,1140,1487,0,0,76.66,413,697,"新街里",NULL
214,830,13,843,1054,0,0,79.98,313,517,"新街里",NULL
215,1131,16,1147,1404,0,0,81.7,544,587,"新街里",NULL
216,810,28,838,1070,0,0,78.32,355,455,"新街里",NULL
217,898,7,905,1195,0,0,75.73,301,597,"劉厝里",NULL
218,413,17,430,584,0,0,73.63,127,286,"後溝里",NULL
219,314,10,324,397,0,0,81.61,84,230,"後溝里",NULL
220,331,17,348,436,0,0,79.82,106,225,"新厝里",NULL
221,583,27,610,855,0,0,71.35,231,352,"府番里",NULL
222,1053,47,1100,1438,0,0,76.5,284,769,"草湖里",NULL
223,810,61,871,1216,0,0,71.63,261,549,"溝皂里",NULL
224,721,10,731,1035,0,0,70.63,195,526,"番溝里",NULL
225,412,22,434,642,0,0,67.6,113,299,"大北里",NULL
226,755,45,800,1044,0,0,76.63,274,481,"好收里",NULL
227,437,24,461,608,0,0,75.82,168,269,"好收里",NULL
228,878,63,941,1217,0,0,77.32,143,735,"樹腳里",NULL
229,1169,21,1190,1553,0,0,76.63,475,694,"樹腳里",NULL
230,752,41,793,1030,0,0,76.99,107,645,"扶朝里",NULL
231,411,20,431,581,0,0,74.18,95,316,"水埔里",NULL
232,841,64,905,1139,0,0,79.46,254,587,"棋盤村",NULL
233,745,30,775,952,0,0,81.41,206,539,"棋盤村",NULL
234,1158,61,1219,1560,0,0,78.14,331,827,"新庄村",NULL
235,1016,8,1024,1298,0,0,78.89,398,618,"東和村",NULL
236,1159,52,1211,1549,0,0,78.18,458,701,"東和村",NULL
237,863,44,907,1133,0,0,80.05,294,569,"荷苞村",NULL
238,216,20,236,316,0,0,74.68,75,141,"荷苞村",NULL
239,889,36,925,1176,0,0,78.66,288,601,"高林村",NULL
240,909,38,947,1215,0,0,77.94,346,563,"水碓村",NULL
241,757,20,777,979,0,0,79.37,287,470,"田心村",NULL
242,714,17,731,925,0,0,79.03,291,423,"古坑村",NULL
243,829,34,863,1126,0,0,76.64,327,502,"古坑村",NULL
244,696,27,723,922,0,0,78.42,282,414,"朝陽村",NULL
245,817,8,825,1041,0,0,79.25,363,454,"朝陽村",NULL
246,1114,30,1144,1419,0,0,80.62,437,677,"西平村",NULL
247,516,26,542,682,0,0,79.47,168,348,"湳仔村",NULL
248,724,35,759,996,0,0,76.2,265,459,"永光村",NULL
249,692,38,730,921,0,0,79.26,263,429,"永光村",NULL
250,782,25,807,1063,0,0,75.92,261,521,"永昌村",NULL
251,692,29,721,954,0,0,75.58,276,416,"永昌村",NULL
252,504,15,519,660,0,0,78.64,111,393,"麻園村",NULL
253,927,39,966,1288,0,0,75,354,573,"崁腳村",NULL
254,254,16,270,326,0,0,82.82,97,157,"華南村",NULL
255,552,22,574,781,0,0,73.5,178,374,"華山村",NULL
256,859,44,903,1176,0,0,76.79,224,635,"桂林村",NULL
257,390,29,419,534,0,0,78.46,124,266,"樟湖村",NULL
258,548,23,571,692,0,0,82.51,172,376,"草嶺村",NULL
259,569,34,603,787,0,0,76.62,206,363,"北和村",NULL
260,1147,46,1193,1512,0,0,78.9,448,699,"南和村",NULL
261,447,13,460,590,0,0,77.97,171,276,"南和村",NULL
262,807,29,836,1104,0,0,75.72,301,506,"大德村",NULL
263,715,44,759,1000,0,0,75.9,194,521,"松竹村",NULL
264,1055,36,1091,1399,0,0,77.98,340,715,"尚義村",NULL
265,346,25,371,484,0,0,76.65,127,219,"尚義村",NULL
266,1015,44,1059,1327,0,0,79.8,371,644,"嘉興村",NULL
267,384,2,386,495,0,0,77.98,127,257,"嘉興村",NULL
268,1042,27,1069,1372,0,0,77.92,433,609,"豐田村",NULL
269,915,47,962,1262,0,0,76.23,286,629,"三結村",NULL
270,610,28,638,823,0,0,77.52,175,435,"吉田村",NULL
271,506,31,537,691,0,0,77.71,223,283,"豐岡村",NULL
272,847,62,909,1238,0,0,73.42,311,536,"聯美村",NULL
273,629,36,665,847,0,0,78.51,269,360,"怡然村",NULL
274,522,27,549,721,0,0,76.14,161,361,"北鎮村",NULL
275,562,34,596,804,0,0,74.13,201,361,"興安村",NULL
276,558,40,598,794,0,0,75.31,251,307,"西鎮村",NULL
277,1010,34,1044,1313,0,0,79.51,389,621,"莿桐村",NULL
278,929,13,942,1156,0,0,81.49,359,570,"莿桐村",NULL
279,845,17,862,1071,0,0,80.49,281,564,"莿桐村",NULL
280,731,37,768,934,0,0,82.23,163,568,"甘厝村",NULL
281,1216,51,1267,1625,0,0,77.97,266,950,"甘西村",NULL
282,454,24,478,580,0,0,82.41,142,312,"興桐村",NULL
283,549,33,582,691,0,0,84.23,186,363,"興桐村",NULL
284,895,41,936,1160,0,0,80.69,198,697,"義和村",NULL
285,692,22,714,849,0,0,84.1,239,453,"埔子村",NULL
286,735,23,758,918,0,0,82.57,199,536,"埔子村",NULL
287,1038,39,1077,1351,0,0,79.72,386,652,"大美村",NULL
288,921,38,959,1161,0,0,82.6,390,531,"大美村",NULL
289,1010,49,1059,1271,0,0,83.32,424,586,"埔尾村",NULL
290,692,32,724,894,0,0,80.98,294,398,"興貴村",NULL
291,780,27,807,1010,0,0,79.9,232,548,"興貴村",NULL
292,867,32,899,1168,0,0,76.97,290,577,"饒平村",NULL
293,1325,59,1384,1775,0,0,77.97,476,849,"四合村",NULL
294,1204,63,1267,1587,0,0,79.84,372,832,"麻園村",NULL
295,1033,40,1073,1347,0,0,79.66,310,723,"五華村",NULL
296,874,39,913,1162,0,0,78.57,232,642,"六合村",NULL
297,464,18,482,609,0,0,79.15,173,291,"六合村",NULL
298,809,29,838,1049,0,0,79.89,452,357,"林南村",NULL
299,1373,41,1414,1743,0,0,81.12,530,843,"林中村",NULL
300,1281,31,1312,1686,0,0,77.82,646,635,"林中村",NULL
301,1063,39,1102,1422,0,0,77.5,478,585,"林北村",NULL
302,541,28,569,734,0,0,77.52,154,387,"林北村",NULL
303,455,28,483,611,0,0,79.05,215,240,"坪頂村",NULL
304,708,15,723,932,0,0,77.58,259,449,"林茂村",NULL
305,826,23,849,1040,0,0,81.63,334,492,"九芎村",NULL
306,1137,30,1167,1497,0,0,77.96,439,698,"九芎村",NULL
307,486,23,509,652,0,0,78.07,154,332,"湖本村",NULL
308,893,10,903,1115,0,0,80.99,381,512,"烏塗村",NULL
309,829,24,853,1038,0,0,82.18,392,437,"烏麻村",NULL
310,697,31,728,919,0,0,79.22,235,462,"重興村",NULL
311,655,43,698,863,0,0,80.88,217,438,"重興村",NULL
312,1077,45,1122,1435,0,0,78.19,440,637,"崙東村",NULL
313,1263,56,1319,1662,0,0,79.36,447,816,"崙西村",NULL
314,508,30,538,709,0,0,75.88,159,349,"來惠村",NULL
315,777,45,822,1081,0,0,76.04,184,593,"來惠村",NULL
316,398,11,409,498,0,0,82.13,112,286,"三和村",NULL
317,809,36,845,1134,0,0,74.51,205,604,"三和村",NULL
318,933,34,967,1256,0,0,76.99,334,599,"湳仔村",NULL
319,771,27,798,1040,0,0,76.73,284,487,"田尾村",NULL
320,736,32,768,976,0,0,78.69,272,464,"田尾村",NULL
321,731,35,766,968,0,0,79.13,183,548,"定安村",NULL
322,1013,56,1069,1366,0,0,78.26,234,779,"永定村",NULL
323,663,52,715,930,0,0,76.88,153,510,"大華村",NULL
324,599,31,630,792,0,0,79.55,125,474,"義庄村",NULL
325,1121,76,1197,1537,0,0,77.88,274,847,"楊賢村",NULL
326,900,53,953,1242,0,0,76.73,171,729,"港後村",NULL
327,562,22,584,731,0,0,79.89,204,358,"港後村",NULL
328,687,39,726,934,0,0,77.73,180,507,"大義村",NULL
329,839,30,869,1105,0,0,78.64,302,537,"油車村",NULL
330,511,23,534,690,0,0,77.39,137,374,"油車村",NULL
331,1045,51,1096,1432,0,0,76.54,305,740,"大庄村",NULL
332,711,50,761,1012,0,0,75.2,227,484,"庄西村",NULL
333,626,35,661,860,0,0,76.86,200,426,"大同村",NULL
334,749,50,799,1062,0,0,75.24,249,500,"復興村",NULL
335,963,43,1006,1293,0,0,77.8,461,502,"東明村",NULL
336,1065,43,1108,1435,0,0,77.21,448,617,"西榮村",NULL
337,741,33,774,993,0,0,77.95,316,425,"南陽村",NULL
338,948,38,986,1277,0,0,77.21,441,507,"南陽村",NULL
339,846,8,854,1085,0,0,78.71,257,589,"崙前村",NULL
340,671,43,714,973,0,0,73.38,190,481,"崙前村",NULL
341,691,36,727,972,0,0,74.79,267,424,"羅厝村",NULL
342,847,32,879,1084,0,0,81.09,281,566,"羅厝村",NULL
343,982,64,1046,1378,0,0,75.91,296,686,"港尾村",NULL
344,767,52,819,1078,0,0,75.97,356,411,"阿勸村",NULL
345,760,8,768,981,0,0,78.29,236,524,"阿勸村",NULL
346,681,12,693,922,0,0,75.16,465,216,"五魁村",NULL
347,570,35,605,815,0,0,74.23,228,342,"大有村",NULL
348,659,41,700,963,0,0,72.69,257,402,"大有村",NULL
349,673,28,701,992,0,0,70.67,253,420,"豐榮村",NULL
350,709,28,737,1088,0,0,67.74,277,432,"豐榮村",NULL
351,1054,54,1108,1504,0,0,73.67,452,602,"草湖村",NULL
352,854,49,903,1216,0,0,74.26,329,525,"舊庄村",NULL
353,985,36,1021,1296,0,0,78.78,308,677,"水尾村",NULL
354,636,39,675,851,0,0,79.32,242,394,"枋南村",NULL
355,447,16,463,644,0,0,71.89,226,221,"麥豐村",NULL
356,1154,34,1188,1621,0,0,73.29,640,514,"麥豐村",NULL
357,853,27,880,1170,0,0,75.21,553,300,"麥豐村",NULL
358,880,31,911,1247,0,0,73.06,462,418,"麥津村",NULL
359,972,34,1006,1385,0,0,72.64,540,432,"麥津村",NULL
360,309,12,321,509,0,0,63.06,130,179,"瓦磘村",NULL
361,582,27,609,866,0,0,70.32,243,339,"瓦磘村",NULL
362,497,28,525,729,0,0,72.02,208,289,"興華村",NULL
363,733,30,763,1114,0,0,68.49,364,369,"興華村",NULL
364,577,7,584,856,0,0,68.22,333,244,"海豐村",NULL
365,409,17,426,621,0,0,68.6,220,189,"海豐村",NULL
366,702,24,726,1015,0,0,71.53,449,253,"後安村",NULL
367,754,26,780,1140,0,0,68.42,510,244,"後安村",NULL
368,665,39,704,984,0,0,71.54,318,347,"三盛村",NULL
369,829,41,870,1301,0,0,66.87,328,501,"三盛村",NULL
370,589,33,622,913,0,0,68.13,363,226,"崙後村",NULL
371,644,35,679,957,0,0,70.95,352,292,"崙後村",NULL
372,675,37,712,1012,0,0,70.36,315,360,"橋頭村",NULL
373,1123,54,1177,1599,0,0,73.61,520,603,"橋頭村",NULL
374,533,31,564,794,0,0,71.03,206,327,"新吉村",NULL
375,867,42,909,1251,0,0,72.66,328,539,"施厝村",NULL
376,715,4,719,1023,0,0,70.28,291,424,"施厝村",NULL
377,948,58,1006,1483,0,0,67.84,408,540,"雷厝村",NULL
378,822,49,871,1297,0,0,67.15,284,538,"月眉村",NULL
379,347,21,368,494,0,0,74.49,161,186,"復興村",NULL
380,645,45,690,1034,0,0,66.73,196,449,"嘉隆村",NULL
381,497,30,527,760,0,0,69.34,239,258,"嘉隆村",NULL
382,1069,36,1105,1457,0,0,75.84,537,532,"東南村",NULL
383,831,30,861,1209,0,0,71.22,396,435,"東北村",NULL
384,670,63,733,1017,0,0,72.07,242,428,"龍潭村",NULL
385,390,29,419,604,0,0,69.37,166,224,"程海村",NULL
386,642,39,681,951,0,0,71.61,244,398,"昌南村",NULL
387,582,54,636,934,0,0,68.09,217,365,"安南村",NULL
388,616,40,656,1036,0,0,63.32,302,314,"同安村",NULL
389,760,43,803,1159,0,0,69.28,355,405,"同安村",NULL
390,529,8,537,840,0,0,63.93,332,197,"四美村",NULL
391,312,20,332,471,0,0,70.49,74,238,"四美村",NULL
392,780,37,817,1268,0,0,64.43,334,446,"新坤村",NULL
393,670,42,712,965,0,0,73.78,274,396,"中民村",NULL
394,660,32,692,933,0,0,74.17,316,344,"中民村",NULL
395,977,50,1027,1407,0,0,72.99,497,480,"埔姜村",NULL
396,1031,44,1075,1444,0,0,74.45,446,585,"中勝村",NULL
397,305,23,328,435,0,0,75.4,115,190,"馬鳴村",NULL
398,664,51,715,981,0,0,72.88,217,447,"馬鳴村",NULL
399,384,21,405,528,0,0,76.7,189,195,"新湖村",NULL
400,528,38,566,783,0,0,72.29,131,397,"新湖村",NULL
401,642,43,685,969,0,0,70.69,213,429,"有才村",NULL
402,584,33,617,814,0,0,75.8,227,357,"田洋村",NULL
403,887,49,936,1286,0,0,72.78,419,468,"龍岩村",NULL
404,684,44,728,989,0,0,73.61,201,483,"潮厝村",NULL
405,898,31,929,1257,0,0,73.91,574,324,"臺西村",NULL
406,718,5,723,1056,0,0,68.47,422,296,"海南村",NULL
407,661,34,695,1070,0,0,64.95,366,295,"海北村",NULL
408,633,34,667,1021,0,0,65.33,336,297,"海口村",NULL
409,588,29,617,964,0,0,64,361,227,"海口村",NULL
410,546,52,598,928,0,0,64.44,228,318,"山寮村",NULL
411,900,53,953,1550,0,0,61.48,323,577,"溪頂村",NULL
412,749,89,838,1273,0,0,65.83,244,505,"牛厝村",NULL
413,435,9,444,710,0,0,62.54,208,227,"牛厝村",NULL
414,390,26,416,653,0,0,63.71,175,215,"泉州村",NULL
415,331,2,333,504,0,0,66.07,99,232,"五榔村",NULL
416,453,24,477,699,0,0,68.24,212,241,"光華村",NULL
417,840,52,892,1371,0,0,65.06,361,479,"五港村",NULL
418,364,32,396,575,0,0,68.87,216,148,"五港村",NULL
419,734,8,742,1059,0,0,70.07,370,364,"富琦村",NULL
420,337,19,356,512,0,0,69.53,246,91,"富琦村",NULL
421,942,48,990,1472,0,0,67.26,511,431,"永豐村",NULL
422,670,46,716,1065,0,0,67.23,349,321,"和豐村",NULL
423,682,37,719,1068,0,0,67.32,337,345,"和豐村",NULL
424,651,60,711,1153,0,0,61.67,345,306,"和豐村",NULL
425,880,71,951,1341,0,0,70.92,428,452,"蚊港村",NULL
426,454,25,479,728,0,0,65.8,328,126,"蚊港村",NULL
427,1313,65,1378,1820,0,0,75.71,571,742,"長南村",NULL
428,930,50,980,1383,0,0,70.86,293,637,"長南村",NULL
429,593,44,637,847,0,0,75.21,183,410,"長北村",NULL
430,582,5,587,834,0,0,70.38,208,374,"長北村",NULL
431,1021,46,1067,1513,0,0,70.52,362,659,"子茂村",NULL
432,604,10,614,814,0,0,75.43,207,397,"後湖村",NULL
433,702,53,755,1061,0,0,71.16,356,346,"山內村",NULL
434,854,5,859,1221,0,0,70.35,258,596,"合和村",NULL
435,691,32,723,1067,0,0,67.76,326,365,"五塊村",NULL
436,542,41,583,926,0,0,62.96,146,396,"潭西村",NULL
437,447,27,474,692,0,0,68.5,233,214,"潭東村",NULL
438,607,46,653,883,0,0,73.95,212,395,"客厝村",NULL
439,291,27,318,464,0,0,68.53,51,240,"卓運村",NULL
440,791,43,834,1248,0,0,66.83,255,536,"頂寮村",NULL
441,1037,64,1101,1533,0,0,71.82,395,642,"下寮村",NULL
442,722,65,787,1107,0,0,71.09,165,557,"龍岩村",NULL
443,623,49,672,927,0,0,72.49,179,444,"西莊村",NULL
444,892,53,945,1348,0,0,70.1,294,598,"鹿北村",NULL
445,675,54,729,1049,0,0,69.49,200,475,"鹿南村",NULL
446,516,33,549,775,0,0,70.84,137,379,"瓦窯村",NULL
447,616,41,657,885,0,0,74.24,191,425,"瓦窯村",NULL
448,464,36,500,672,0,0,74.4,129,335,"內寮村",NULL
449,605,51,656,935,0,0,70.16,213,392,"崙仔村",NULL
450,517,37,554,739,0,0,74.97,198,319,"新吉村",NULL
451,714,4,718,1029,0,0,69.78,267,447,"四湖村",NULL
452,519,21,540,736,0,0,73.37,220,299,"四湖村",NULL
453,1158,46,1204,1568,0,0,76.79,605,553,"湖西村",NULL
454,373,38,411,568,0,0,72.36,75,298,"湖西村",NULL
455,474,36,510,717,0,0,71.13,162,312,"新庄村",NULL
456,709,42,751,1086,0,0,69.15,243,466,"溪底村",NULL
457,692,55,747,1119,0,0,66.76,296,396,"鹿場村",NULL
458,617,42,659,978,0,0,67.38,208,409,"蔡厝村",NULL
459,558,18,576,884,0,0,65.16,181,377,"湖寮村",NULL
460,727,61,788,1228,0,0,64.17,318,409,"施湖村",NULL
461,682,65,747,1152,0,0,64.84,299,383,"羊調村",NULL
462,532,38,570,969,0,0,58.82,188,344,"內湖村",NULL
463,390,27,417,654,0,0,63.76,174,216,"飛東村",NULL
464,563,5,568,995,0,0,57.09,308,255,"飛沙村",NULL
465,230,23,253,423,0,0,59.81,111,119,"三姓村",NULL
466,584,10,594,981,0,0,60.55,242,342,"崙北村",NULL
467,529,46,575,841,0,0,68.37,255,274,"崙北村",NULL
468,531,44,575,928,0,0,61.96,228,303,"崙南村",NULL
469,491,24,515,816,0,0,63.11,290,201,"廣溝村",NULL
470,612,35,647,1050,0,0,61.62,165,447,"箔子村",NULL
471,703,45,748,1175,0,0,63.66,155,548,"箔東村",NULL
472,810,70,880,1301,0,0,67.64,333,477,"林厝村",NULL
473,609,69,678,1096,0,0,61.86,280,329,"林東村",NULL
474,493,45,538,852,0,0,63.15,270,223,"溪尾村",NULL
475,757,35,792,1082,0,0,73.2,319,438,"口湖村",NULL
476,912,44,956,1306,0,0,73.2,437,475,"湖東村",NULL
477,439,27,466,706,0,0,66.01,195,244,"頂湖村",NULL
478,487,26,513,682,0,0,75.22,174,313,"埔南村",NULL
479,519,43,562,934,0,0,60.17,155,364,"埔北村",NULL
480,694,41,735,1018,0,0,72.2,203,491,"謝厝村",NULL
481,977,75,1052,1467,0,0,71.71,257,720,"蚵寮村",NULL
482,526,33,559,906,0,0,61.7,156,370,"下崙村",NULL
483,755,38,793,1210,0,0,65.54,255,500,"下崙村",NULL
484,520,28,548,880,0,0,62.27,173,347,"崙中村",NULL
485,535,29,564,887,0,0,63.59,173,362,"崙中村",NULL
486,982,46,1028,1564,0,0,65.73,344,638,"崙東村",NULL
487,381,23,404,580,0,0,69.66,111,270,"青蚶村",NULL
488,1070,11,1081,1517,0,0,71.26,426,644,"港東村",NULL
489,532,24,556,817,0,0,68.05,286,246,"港西村",NULL
490,263,11,274,355,0,0,77.18,73,190,"臺子村",NULL
491,993,35,1028,1341,0,0,76.66,150,843,"臺子村",NULL
492,717,34,751,1045,0,0,71.87,297,420,"成龍村",NULL
493,661,40,701,918,0,0,76.36,208,453,"梧南村",NULL
494,667,34,701,962,0,0,72.87,271,396,"梧南村",NULL
495,929,57,986,1325,0,0,74.42,165,764,"梧北村",NULL
496,680,60,740,1060,0,0,69.81,236,444,"水井村",NULL
497,569,24,593,805,0,0,73.66,132,437,"後厝村",NULL
498,711,48,759,1072,0,0,70.8,195,516,"湖口村",NULL
499,491,17,508,753,0,0,67.46,170,321,"過港村",NULL
500,961,45,1006,1387,0,0,72.53,326,635,"水北村",NULL
501,712,15,727,931,0,0,78.09,243,469,"水北村",NULL
502,858,28,886,1139,0,0,77.79,258,600,"水南村",NULL
503,580,24,604,802,0,0,75.31,155,425,"水南村",NULL
504,540,34,574,770,0,0,74.55,139,401,"萬興村",NULL
505,502,31,533,752,0,0,70.88,144,358,"尖山村",NULL
506,720,39,759,1081,0,0,70.21,227,493,"大溝村",NULL
507,650,37,687,933,0,0,73.63,129,521,"順興村",NULL
508,786,50,836,1174,0,0,71.21,181,605,"大山村",NULL
509,506,41,547,804,0,0,68.03,134,372,"後寮村",NULL
510,733,46,779,1076,0,0,72.4,183,550,"春埔村",NULL
511,476,35,511,763,0,0,66.97,167,309,"西井村",NULL
512,461,33,494,693,0,0,71.28,94,367,"車港村",NULL
513,797,62,859,1227,0,0,70.01,199,598,"蘇秦村",NULL
514,452,35,487,761,0,0,63.99,197,255,"灣東村",NULL
515,676,47,723,1075,0,0,67.26,255,421,"灣西村",NULL
516,753,52,805,1065,0,0,75.59,186,567,"蕃薯村",NULL
517,622,41,663,916,0,0,72.38,124,498,"山腳村",NULL
518,893,9,902,1230,0,0,73.33,288,605,"松北村",NULL
519,476,3,479,611,0,0,78.4,126,350,"松中村",NULL
520,556,37,593,802,0,0,73.94,98,458,"松西村",NULL
521,563,33,596,867,0,0,68.74,105,458,"舊埔村",NULL
522,514,48,562,847,0,0,66.35,124,390,"塭底村",NULL
523,740,44,784,1082,0,0,72.46,148,592,"海埔村",NULL
524,917,32,949,1254,0,0,75.68,199,718,"土厝村",NULL
525,578,39,617,842,0,0,73.28,170,408,"溪墘村",NULL
1,1347,31,1378,1791,0,0,76.94,649,698,"太保里",NULL
2,380,17,397,498,0,0,79.72,119,261,"後庄里",NULL
3,1115,12,1127,1402,0,0,80.39,321,794,"前潭里",NULL
4,1174,31,1205,1528,0,0,78.86,427,747,"後潭里",NULL
5,555,20,575,721,0,0,79.75,224,331,"梅埔里",NULL
6,302,11,313,379,0,0,82.59,128,174,"梅埔里",NULL
7,680,24,704,870,0,0,80.92,214,466,"春珠里",NULL
8,634,27,661,825,0,0,80.12,309,325,"崙頂里",NULL
9,161,13,174,215,0,0,80.93,66,95,"安仁里",NULL
10,376,17,393,489,0,0,80.37,100,276,"安仁里",NULL
11,391,8,399,489,0,0,81.6,212,179,"安仁里",NULL
12,686,24,710,911,0,0,77.94,229,457,"東勢里",NULL
13,917,36,953,1206,0,0,79.02,245,672,"新埤里",NULL
14,682,34,716,899,0,0,79.64,221,461,"舊埤里",NULL
15,718,5,723,937,0,0,77.16,284,434,"舊埤里",NULL
16,382,18,400,502,0,0,79.68,119,263,"田尾里",NULL
17,166,8,174,219,0,0,79.45,81,85,"田尾里",NULL
18,249,9,258,307,0,0,84.04,70,179,"港尾里",NULL
19,190,11,201,261,0,0,77.01,73,117,"港尾里",NULL
20,461,12,473,608,0,0,77.8,190,271,"過溝里",NULL
21,1230,21,1251,1529,0,0,81.82,415,815,"過溝里",NULL
22,1162,43,1205,1524,0,0,79.07,476,686,"麻寮里",NULL
23,1157,13,1170,1440,0,0,81.25,469,688,"麻寮里",NULL
24,1401,53,1454,1746,0,0,83.28,464,937,"南新里",NULL
25,869,10,879,1067,0,0,82.38,236,633,"北新里",NULL
26,927,35,962,1201,0,0,80.1,370,557,"北新里",NULL
27,548,20,568,725,0,0,78.34,209,339,"埤鄉里",NULL
28,753,19,772,995,0,0,77.59,361,392,"安福里",NULL
29,656,11,667,832,0,0,80.17,262,394,"安福里",NULL
30,1445,35,1480,1855,0,0,79.78,636,809,"平和里",NULL
31,847,23,870,1114,0,0,78.1,221,626,"內厝里",NULL
32,397,6,403,492,0,0,81.91,142,255,"開元里",NULL
33,549,13,562,725,0,0,77.52,203,346,"順天里",NULL
34,566,9,575,719,0,0,79.97,211,355,"中正里",NULL
35,599,20,619,766,0,0,80.81,190,409,"博厚里",NULL
36,691,14,705,864,0,0,81.6,254,437,"文化里",NULL
37,795,21,816,989,0,0,82.51,337,458,"文化里",NULL
38,705,18,723,917,0,0,78.84,277,428,"永和里",NULL
39,1191,23,1214,1527,0,0,79.5,380,811,"永和里",NULL
40,1639,37,1676,2104,0,0,79.66,695,944,"竹圍里",NULL
41,1315,19,1334,1679,0,0,79.45,532,783,"竹圍里",NULL
42,497,29,526,681,0,0,77.24,170,327,"新寮里",NULL
43,515,13,528,685,0,0,77.08,146,369,"雙溪里",NULL
44,624,22,646,827,0,0,78.11,217,407,"溪口里",NULL
45,877,14,891,1077,0,0,82.73,211,666,"德興里",NULL
46,476,25,501,637,0,0,78.65,167,309,"仁和里",NULL
47,1060,37,1097,1383,0,0,79.32,322,738,"大鄉里",NULL
48,930,41,971,1271,0,0,76.4,376,554,"大鄉里",NULL
49,1358,51,1409,1810,0,0,77.85,479,879,"大葛里",NULL
50,457,21,478,598,0,0,79.93,150,307,"佳禾里",NULL
51,733,24,757,1000,0,0,75.7,250,483,"竹村里",NULL
52,697,49,746,972,0,0,76.75,156,541,"崁前里",NULL
53,592,31,623,841,0,0,74.08,155,437,"崁後里",NULL
54,230,3,233,291,0,0,80.07,94,136,"順安里",NULL
55,574,35,609,803,0,0,75.84,158,416,"德家里",NULL
56,473,3,476,616,0,0,77.27,157,316,"新庄里",NULL
57,847,45,892,1135,0,0,78.59,160,687,"梅華里",NULL
58,1014,62,1076,1445,0,0,74.46,194,820,"松華里",NULL
59,423,13,436,565,0,0,77.17,76,347,"南竹里",NULL
60,510,31,541,728,0,0,74.31,209,301,"岱江里",NULL
61,312,11,323,444,0,0,72.75,127,185,"九龍里",NULL
62,281,10,291,406,0,0,71.67,128,153,"岑海里",NULL
63,976,21,997,1353,0,0,73.69,429,547,"岑海里",NULL
64,892,26,918,1213,0,0,75.68,373,519,"興中里",NULL
65,835,19,854,1106,0,0,77.22,311,524,"光復里",NULL
66,524,25,549,713,0,0,77,227,297,"光復里",NULL
67,711,15,726,979,0,0,74.16,226,485,"見龍里",NULL
68,549,19,568,795,0,0,71.45,262,287,"新厝里",NULL
69,596,27,623,837,0,0,74.43,240,356,"龍江里",NULL
70,982,44,1026,1382,0,0,74.24,399,583,"西安里",NULL
71,1155,57,1212,1622,0,0,74.72,385,770,"中安里",NULL
72,1136,54,1190,1553,0,0,76.63,359,777,"東安里",NULL
73,233,7,240,299,0,0,80.27,81,152,"樹林里",NULL
74,192,4,196,269,0,0,72.86,62,130,"樹林里",NULL
75,370,13,383,496,0,0,77.22,118,252,"貴舍里",NULL
76,191,9,200,273,0,0,73.26,87,104,"貴舍里",NULL
77,824,30,854,1179,0,0,72.43,371,453,"永安里",NULL
78,690,36,726,970,0,0,74.85,256,434,"東港里",NULL
79,746,19,765,991,0,0,77.19,339,407,"東港里",NULL
80,249,9,258,342,0,0,75.44,110,139,"江山里",NULL
81,125,11,136,202,0,0,67.33,71,54,"菜舖里",NULL
82,166,14,180,244,0,0,73.77,97,69,"菜舖里",NULL
83,99,7,106,141,0,0,75.18,42,57,"考試里",NULL
84,147,7,154,210,0,0,73.33,55,92,"考試里",NULL
85,592,8,600,824,0,0,72.82,295,297,"振寮里",NULL
86,750,21,771,1048,0,0,73.57,247,503,"新岑里",NULL
87,914,21,935,1246,0,0,75.04,353,561,"新民里",NULL
88,870,18,888,1156,0,0,76.82,358,512,"復興里",NULL
89,981,24,1005,1288,0,0,78.03,428,553,"復興里",NULL
90,774,33,807,1118,0,0,72.18,308,466,"好美里",NULL
91,391,15,406,493,0,0,82.35,173,218,"東林里",NULL
92,1585,30,1615,1986,0,0,81.32,690,895,"西林里",NULL
93,766,21,787,1013,0,0,77.69,367,399,"吉林里",NULL
94,1452,25,1477,1855,0,0,79.62,658,794,"平林里",NULL
95,1021,28,1049,1348,0,0,77.82,505,516,"平林里",NULL
96,1392,40,1432,1810,0,0,79.12,624,768,"平林里",NULL
97,904,6,910,1151,0,0,79.06,362,542,"明華里",NULL
98,1089,27,1116,1398,0,0,79.83,441,648,"明和里",NULL
99,527,21,548,690,0,0,79.42,123,404,"排路里",NULL
100,561,40,601,819,0,0,73.38,142,419,"西結里",NULL
101,482,30,512,681,0,0,75.18,173,309,"湖北里",NULL
102,226,6,232,314,0,0,73.89,137,89,"大糖里",NULL
103,1350,56,1406,1770,0,0,79.44,634,716,"大美里",NULL
104,1102,60,1162,1486,0,0,78.2,432,670,"過溪里",NULL
105,838,42,880,1109,0,0,79.35,365,473,"中坑里",NULL
106,296,10,306,405,0,0,75.56,95,201,"中坑里",NULL
107,628,30,658,848,0,0,77.59,242,386,"上林里",NULL
108,1143,70,1213,1529,0,0,79.33,291,852,"中林里",NULL
109,1498,36,1534,1915,0,0,80.1,665,833,"三和里",NULL
110,750,41,791,984,0,0,80.39,232,518,"溝背里",NULL
111,528,20,548,677,0,0,80.95,247,281,"義和里",NULL
112,565,19,584,730,0,0,80,249,316,"內林里",NULL
113,658,5,663,863,0,0,76.83,283,375,"三角里",NULL
114,600,14,614,768,0,0,79.95,224,376,"三村里",NULL
115,873,31,904,1101,0,0,82.11,369,504,"東榮村",NULL
116,730,22,752,970,0,0,77.53,303,427,"東榮村",NULL
117,1310,28,1338,1637,0,0,81.73,590,720,"中樂村",NULL
118,1134,51,1185,1496,0,0,79.21,387,747,"西安村",NULL
119,1224,24,1248,1499,0,0,83.26,472,752,"西安村",NULL
120,802,14,816,974,0,0,83.78,232,570,"寮頂村",NULL
121,825,16,841,1070,0,0,78.6,362,463,"寮頂村",NULL
122,1069,34,1103,1357,0,0,81.28,283,786,"福權村",NULL
123,1378,57,1435,1806,0,0,79.46,593,785,"東湖村",NULL
124,1018,36,1054,1366,0,0,77.16,397,621,"頂崙村",NULL
125,1295,57,1352,1684,0,0,80.29,261,1034,"菁埔村",NULL
126,580,26,606,755,0,0,80.26,207,373,"中和村",NULL
127,566,18,584,738,0,0,79.13,197,369,"平和村",NULL
128,614,26,640,776,0,0,82.47,170,444,"西昌村",NULL
129,1151,45,1196,1494,0,0,80.05,468,683,"豊收村",NULL
130,305,26,331,408,0,0,81.13,98,207,"豊收村",NULL
131,688,27,715,864,0,0,82.75,235,453,"三興村",NULL
132,406,28,434,572,0,0,75.87,117,289,"東興村",NULL
133,730,23,753,926,0,0,81.32,300,430,"鎮北村",NULL
134,1537,39,1576,1993,0,0,79.08,596,941,"北斗村",NULL
135,578,5,583,729,0,0,79.97,214,364,"北斗村",NULL
136,652,20,672,843,0,0,79.72,234,418,"北斗村",NULL
137,1328,40,1368,1680,0,0,81.43,623,705,"雙福村",NULL
138,1180,12,1192,1445,0,0,82.49,571,609,"福樂村",NULL
139,1019,20,1039,1292,0,0,80.42,504,515,"福樂村",NULL
140,1218,35,1253,1581,0,0,79.25,447,771,"福樂村",NULL
141,775,28,803,1022,0,0,78.57,258,517,"大崎村",NULL
142,883,24,907,1126,0,0,80.55,424,459,"大崎村",NULL
143,1066,39,1105,1377,0,0,80.25,359,707,"秀林村",NULL
144,639,13,652,838,0,0,77.8,257,382,"秀林村",NULL
145,1202,56,1258,1640,0,0,76.71,460,742,"松山村",NULL
146,1362,39,1401,1744,0,0,80.33,563,799,"興中村",NULL
147,926,26,952,1171,0,0,81.3,380,546,"興南村",NULL
148,786,21,807,1060,0,0,76.13,313,473,"興南村",NULL
149,954,27,981,1225,0,0,80.08,425,529,"金興村",NULL
150,1042,22,1064,1377,0,0,77.27,473,569,"金興村",NULL
151,1392,41,1433,1758,0,0,81.51,537,855,"福興村",NULL
152,1590,50,1640,2006,0,0,81.75,672,918,"文隆村",NULL
153,1288,52,1340,1614,0,0,83.02,378,910,"山中村",NULL
154,1441,45,1486,1878,0,0,79.13,588,853,"山中村",NULL
155,973,28,1001,1243,0,0,80.53,253,720,"中央村",NULL
156,1099,42,1141,1420,0,0,80.35,358,741,"溪東村",NULL
157,550,24,574,735,0,0,78.1,169,381,"溪西村",NULL
158,293,6,299,400,0,0,74.75,90,203,"溪北村",NULL
159,233,2,235,299,0,0,78.6,75,158,"溪北村",NULL
160,617,5,622,821,0,0,75.76,153,464,"柴林村",NULL
161,634,38,672,880,0,0,76.36,131,503,"林腳村",NULL
162,935,45,980,1235,0,0,79.35,229,706,"美南村",NULL
163,689,38,727,946,0,0,76.85,208,481,"美北村",NULL
164,432,24,456,598,0,0,76.25,105,327,"本厝村",NULL
165,302,16,318,399,0,0,79.7,81,221,"本厝村",NULL
166,834,40,874,1101,0,0,79.38,186,648,"游東村",NULL
167,558,34,592,783,0,0,75.61,112,446,"游西村",NULL
168,667,34,701,895,0,0,78.32,193,474,"柳溝村",NULL
169,287,11,298,378,0,0,78.84,79,208,"柳溝村",NULL
170,800,17,817,1015,0,0,80.49,205,595,"疊溪村",NULL
171,521,34,555,743,0,0,74.7,148,373,"妙崙村",NULL
172,713,8,721,888,0,0,81.19,184,529,"坪頂村",NULL
173,680,12,692,840,0,0,82.38,242,438,"宮前村",NULL
174,753,20,773,917,0,0,84.3,286,467,"宮前村",NULL
175,623,14,637,823,0,0,77.4,205,418,"宮後村",NULL
176,647,25,672,859,0,0,78.23,211,436,"宮後村",NULL
177,1127,18,1145,1440,0,0,79.51,339,788,"大興村",NULL
178,1172,40,1212,1529,0,0,79.27,433,739,"福德村",NULL
179,891,32,923,1188,0,0,77.69,203,688,"古民村",NULL
180,591,24,615,789,0,0,77.95,125,466,"中庄村",NULL
181,549,22,571,738,0,0,77.37,134,415,"中庄村",NULL
182,553,5,558,728,0,0,76.65,123,430,"大潭村",NULL
183,712,11,723,900,0,0,80.33,172,540,"大潭村",NULL
184,703,34,737,974,0,0,75.67,261,442,"西庄村",NULL
185,656,17,673,887,0,0,75.87,187,469,"月眉村",NULL
186,660,20,680,832,0,0,81.73,189,471,"月眉村",NULL
187,1098,40,1138,1437,0,0,79.19,319,779,"月潭村",NULL
188,1102,57,1159,1437,0,0,80.65,306,796,"溪北村",NULL
189,725,30,755,950,0,0,79.47,237,488,"菜公村",NULL
190,759,30,789,998,0,0,79.06,252,507,"中洋村",NULL
191,795,20,815,975,0,0,83.59,245,550,"三間村",NULL
192,799,50,849,1131,0,0,75.07,244,555,"安和村",NULL
193,865,43,908,1162,0,0,78.14,226,639,"潭大村",NULL
194,823,50,873,1119,0,0,78.02,226,597,"南港村",NULL
195,487,8,495,606,0,0,81.68,121,366,"板頭村",NULL
196,647,31,678,857,0,0,79.11,180,467,"共和村",NULL
197,456,25,481,602,0,0,79.9,98,358,"埤子村",NULL
198,724,30,754,938,0,0,80.38,96,628,"南崙村",NULL
199,411,25,436,601,0,0,72.55,83,328,"北崙村",NULL
200,382,22,404,507,0,0,79.68,111,271,"海瀛村",NULL
201,953,29,982,1284,0,0,76.48,386,567,"蒜頭村",NULL
202,651,31,682,945,0,0,72.17,212,439,"蒜東村",NULL
203,664,28,692,900,0,0,76.89,218,446,"蒜南村",NULL
204,237,8,245,305,0,0,80.33,155,82,"工廠村",NULL
205,882,43,925,1239,0,0,74.66,277,605,"灣南村",NULL
206,895,44,939,1306,0,0,71.9,347,548,"灣北村",NULL
207,655,29,684,914,0,0,74.84,174,481,"雙涵村",NULL
208,532,21,553,740,0,0,74.73,103,429,"塗師村",NULL
209,424,19,443,591,0,0,74.96,116,308,"三義村",NULL
210,137,6,143,196,0,0,72.96,40,97,"三義村",NULL
211,188,6,194,252,0,0,76.98,31,157,"正義村",NULL
212,214,11,225,289,0,0,77.85,32,182,"正義村",NULL
213,288,13,301,381,0,0,79,67,221,"正義村",NULL
214,398,6,404,506,0,0,79.84,95,303,"正義村",NULL
215,443,13,456,628,0,0,72.61,144,299,"溪厝村",NULL
216,577,23,600,777,0,0,77.22,99,478,"港美村",NULL
217,775,40,815,1096,0,0,74.36,209,566,"豐美村",NULL
218,659,29,688,921,0,0,74.7,187,472,"六斗村",NULL
219,774,25,799,1014,0,0,78.8,205,569,"崙陽村",NULL
220,1075,41,1116,1460,0,0,76.44,306,769,"蘇厝村",NULL
221,513,29,542,735,0,0,73.74,128,385,"竹本村",NULL
222,386,27,413,558,0,0,74.01,88,298,"永賢村",NULL
223,522,34,556,766,0,0,72.58,119,403,"魚寮村",NULL
224,656,41,697,980,0,0,71.12,247,409,"潭墘村",NULL
225,626,33,659,893,0,0,73.8,231,395,"六腳村",NULL
226,407,36,443,629,0,0,70.43,102,305,"六南村",NULL
227,567,51,618,796,0,0,77.64,129,438,"崩山村",NULL
228,609,32,641,842,0,0,76.13,128,481,"古林村",NULL
229,309,18,327,434,0,0,75.35,75,234,"更寮村",NULL
230,119,3,122,190,0,0,64.21,53,66,"更寮村",NULL
231,1292,45,1337,1827,0,0,73.18,457,835,"東石村",NULL
232,704,30,734,1003,0,0,73.18,300,404,"猿樹村",NULL
233,1180,59,1239,1636,0,0,75.73,528,652,"塭港村",NULL
234,1027,40,1067,1481,0,0,72.05,391,636,"型厝村",NULL
235,868,45,913,1261,0,0,72.4,369,499,"三家村",NULL
236,528,18,546,728,0,0,75,224,304,"永屯村",NULL
237,318,19,337,456,0,0,73.9,102,216,"海埔村",NULL
238,693,37,730,988,0,0,73.89,331,362,"龍港村",NULL
239,791,55,846,1157,0,0,73.12,228,563,"副瀨村",NULL
240,627,35,662,878,0,0,75.4,181,446,"下揖村",NULL
241,126,8,134,192,0,0,69.79,30,96,"頂揖村",NULL
242,158,6,164,243,0,0,67.49,42,116,"頂揖村",NULL
243,717,47,764,1104,0,0,69.2,314,403,"溪下村",NULL
244,257,10,267,388,0,0,68.81,125,132,"港口村",NULL
245,797,8,805,1085,0,0,74.19,282,515,"鰲鼓村",NULL
246,207,13,220,291,0,0,75.6,70,137,"鰲鼓村",NULL
247,1014,46,1060,1325,0,0,80,364,650,"港墘村",NULL
248,685,37,722,917,0,0,78.74,243,442,"蔦松村",NULL
249,546,19,565,788,0,0,71.7,181,365,"圍潭村",NULL
250,668,43,711,961,0,0,73.99,256,412,"洲仔村",NULL
251,268,19,287,407,0,0,70.52,93,175,"東崙村",NULL
252,288,9,297,413,0,0,71.91,113,175,"東崙村",NULL
253,797,39,836,1139,0,0,73.4,294,503,"西崙村",NULL
254,732,38,770,1008,0,0,76.39,263,469,"塭仔村",NULL
255,908,32,940,1316,0,0,71.43,362,546,"網寮村",NULL
256,324,14,338,446,0,0,75.78,97,227,"掌潭村",NULL
257,273,3,276,370,0,0,74.59,170,103,"掌潭村",NULL
258,411,27,438,580,0,0,75.52,152,259,"岸腳村",NULL
259,174,10,184,224,0,0,82.14,55,119,"岸腳村",NULL
260,1193,42,1235,1543,0,0,80.04,421,772,"義竹村",NULL
261,961,47,1008,1317,0,0,76.54,390,571,"六桂村",NULL
262,700,33,733,903,0,0,81.17,294,406,"仁里村",NULL
263,533,23,556,739,0,0,75.24,203,330,"傳芳村",NULL
264,982,52,1034,1308,0,0,79.05,342,640,"頭竹村",NULL
265,317,9,326,437,0,0,74.6,104,213,"五厝村",NULL
266,269,18,287,351,0,0,81.77,106,163,"中平村",NULL
267,94,3,97,131,0,0,74.05,59,35,"中平村",NULL
268,587,40,627,802,0,0,78.18,274,313,"埤前村",NULL
269,333,13,346,449,0,0,77.06,107,226,"平溪村",NULL
270,357,20,377,491,0,0,76.78,138,219,"後鎮村",NULL
271,433,16,449,598,0,0,75.08,125,308,"北華村",NULL
272,1135,54,1189,1547,0,0,76.86,387,748,"新店村",NULL
273,637,18,655,867,0,0,75.55,266,371,"東過村",NULL
274,600,29,629,890,0,0,70.67,176,424,"西過村",NULL
275,638,25,663,874,0,0,75.86,151,487,"官和村",NULL
276,377,12,389,536,0,0,72.57,124,253,"官順村",NULL
277,419,21,440,577,0,0,76.26,176,243,"新富村",NULL
278,533,29,562,689,0,0,81.57,180,353,"東光村",NULL
279,110,9,119,166,0,0,71.69,22,88,"東光村",NULL
280,338,19,357,480,0,0,74.38,94,244,"東榮村",NULL
281,468,27,495,680,0,0,72.79,168,300,"龍蛟村",NULL
282,560,31,591,748,0,0,79.01,120,440,"溪洲村",NULL
283,361,23,384,511,0,0,75.15,102,259,"後寮村",NULL
284,503,23,526,659,0,0,79.82,128,375,"鹿東村",NULL
285,997,49,1046,1346,0,0,77.71,366,631,"鹿草村",NULL
286,853,44,897,1151,0,0,77.93,335,518,"西井村",NULL
287,222,10,232,301,0,0,77.08,85,137,"豊稠村",NULL
288,105,2,107,144,0,0,74.31,55,50,"豊稠村",NULL
289,831,45,876,1154,0,0,75.91,217,614,"重寮村",NULL
290,377,18,395,508,0,0,77.76,119,258,"施家村",NULL
291,657,44,701,901,0,0,77.8,146,511,"下潭村",NULL
292,827,40,867,1141,0,0,75.99,208,619,"光潭村",NULL
293,761,60,821,1098,0,0,74.77,304,457,"碧潭村",NULL
294,635,38,673,930,0,0,72.37,276,359,"松竹村",NULL
295,495,31,526,712,0,0,73.88,146,349,"竹山村",NULL
296,168,8,176,231,0,0,76.19,34,134,"竹山村",NULL
297,740,28,768,970,0,0,79.18,246,494,"後堀村",NULL
298,256,6,262,329,0,0,79.64,97,159,"後堀村",NULL
299,845,48,893,1146,0,0,77.92,212,633,"三角村",NULL
300,297,18,315,392,0,0,80.36,129,168,"三角村",NULL
301,235,10,245,286,0,0,85.66,89,146,"下麻村",NULL
302,195,16,211,283,0,0,74.56,81,114,"下麻村",NULL
303,466,14,480,612,0,0,78.43,223,243,"水上村",NULL
304,656,11,667,815,0,0,81.84,222,434,"水上村",NULL
305,1355,40,1395,1726,0,0,80.82,589,766,"水上村",NULL
306,1283,37,1320,1607,0,0,82.14,598,685,"水頭村",NULL
307,416,11,427,517,0,0,82.59,164,252,"水頭村",NULL
308,866,28,894,1145,0,0,78.08,338,528,"粗溪村",NULL
309,275,16,291,352,0,0,82.67,109,166,"粗溪村",NULL
310,369,14,383,488,0,0,78.48,133,236,"下寮村",NULL
311,910,27,937,1151,0,0,81.41,393,517,"下寮村",NULL
312,899,26,925,1163,0,0,79.54,545,354,"三和村",NULL
313,549,15,564,673,0,0,83.8,220,329,"三和村",NULL
314,501,18,519,654,0,0,79.36,344,157,"回歸村",NULL
315,445,3,448,537,0,0,83.43,153,292,"大堀村",NULL
316,482,9,491,582,0,0,84.36,134,348,"大堀村",NULL
317,281,12,293,360,0,0,81.39,62,219,"大堀村",NULL
318,1469,58,1527,1945,0,0,78.51,505,964,"大崙村",NULL
319,650,23,673,843,0,0,79.83,221,429,"塗溝村",NULL
320,1457,66,1523,1844,0,0,82.59,446,1011,"龍德村",NULL
321,858,24,882,1109,0,0,79.53,288,570,"溪洲村",NULL
322,517,23,540,678,0,0,79.65,270,247,"三鎮村",NULL
323,424,21,445,527,0,0,84.44,246,178,"靖和村",NULL
324,626,23,649,805,0,0,80.62,262,364,"南和村",NULL
325,371,19,390,489,0,0,79.75,151,220,"南和村",NULL
326,1088,30,1118,1401,0,0,79.8,753,335,"柳新村",NULL
327,622,24,646,841,0,0,76.81,371,251,"柳新村",NULL
328,1347,46,1393,1782,0,0,78.17,515,832,"柳林村",NULL
329,1470,44,1514,1862,0,0,81.31,473,997,"柳鄉村",NULL
330,743,41,784,993,0,0,78.95,281,462,"內溪村",NULL
331,1402,35,1437,1838,0,0,78.18,509,893,"寬士村",NULL
332,1410,38,1448,1871,0,0,77.39,597,813,"寬士村",NULL
333,1033,21,1054,1340,0,0,78.66,458,575,"民生村",NULL
334,1241,22,1263,1602,0,0,78.84,511,730,"民生村",NULL
335,630,5,635,761,0,0,83.44,255,375,"義興村",NULL
336,1394,52,1446,1856,0,0,77.91,694,700,"中庄村",NULL
337,1414,58,1472,1872,0,0,78.63,707,707,"忠和村",NULL
338,634,26,660,817,0,0,80.78,230,404,"南鄉村",NULL
339,765,39,804,1033,0,0,77.83,247,518,"三界村",NULL
340,970,43,1013,1305,0,0,77.62,284,686,"國姓村",NULL
341,1264,46,1310,1637,0,0,80.02,498,766,"中埔村",NULL
342,648,29,677,861,0,0,78.63,247,401,"塩舘村",NULL
343,565,18,583,749,0,0,77.84,296,269,"龍門村",NULL
344,681,28,709,890,0,0,79.66,145,536,"裕民村",NULL
345,1073,35,1108,1381,0,0,80.23,376,697,"金蘭村",NULL
346,823,37,860,1070,0,0,80.37,298,525,"富收村",NULL
347,1206,37,1243,1577,0,0,78.82,428,778,"富收村",NULL
348,1128,37,1165,1534,0,0,75.95,412,716,"和睦村",NULL
349,915,22,937,1180,0,0,79.41,373,542,"和睦村",NULL
350,1448,33,1481,1840,0,0,80.49,649,799,"和美村",NULL
351,1384,40,1424,1793,0,0,79.42,606,778,"和美村",NULL
352,1508,29,1537,2003,0,0,76.73,689,819,"和美村",NULL
353,1679,53,1732,2290,0,0,75.63,671,1008,"和興村",NULL
354,1193,37,1230,1577,0,0,78,523,670,"和興村",NULL
355,875,31,906,1153,0,0,78.58,325,550,"和興村",NULL
356,1309,46,1355,1701,0,0,79.66,520,789,"隆興村",NULL
357,1051,37,1088,1360,0,0,80,343,708,"義仁村",NULL
358,1187,36,1223,1610,0,0,75.96,482,705,"社口村",NULL
359,350,19,369,478,0,0,77.2,128,222,"社口村",NULL
360,814,31,845,1093,0,0,77.31,354,460,"灣潭村",NULL
361,685,23,708,899,0,0,78.75,291,394,"石硦村",NULL
362,229,12,241,303,0,0,79.54,101,128,"石硦村",NULL
363,733,23,756,945,0,0,80,242,491,"頂埔村",NULL
364,957,41,998,1295,0,0,77.07,309,648,"同仁村",NULL
365,471,24,495,677,0,0,73.12,120,351,"同仁村",NULL
366,584,22,606,737,0,0,82.23,208,376,"深坑村",NULL
367,476,13,489,632,0,0,77.37,161,315,"三層村",NULL
368,559,24,583,732,0,0,79.64,239,320,"瑞豐村",NULL
369,414,16,430,549,0,0,78.32,108,306,"沄水村",NULL
370,408,19,427,566,0,0,75.44,165,243,"沄水村",NULL
371,266,4,270,335,0,0,80.6,126,140,"東興村",NULL
372,254,15,269,329,0,0,81.76,118,136,"中崙村",NULL
373,928,25,953,1226,0,0,77.73,321,607,"竹崎村",NULL
374,854,28,882,1089,0,0,80.99,364,490,"竹崎村",NULL
375,1470,45,1515,1910,0,0,79.32,524,946,"和平村",NULL
376,571,29,600,775,0,0,77.42,197,374,"坑頭村",NULL
377,685,33,718,884,0,0,81.22,171,514,"沙坑村",NULL
378,1036,47,1083,1313,0,0,82.48,345,691,"獅埜村",NULL
379,450,21,471,558,0,0,84.41,167,283,"義和村",NULL
380,790,28,818,1056,0,0,77.46,267,523,"義仁村",NULL
381,924,26,950,1217,0,0,78.06,321,603,"灣橋村",NULL
382,1381,37,1418,1818,0,0,78,617,764,"灣橋村",NULL
383,1357,39,1396,1754,0,0,79.59,605,752,"灣橋村",NULL
384,981,30,1011,1281,0,0,78.92,345,636,"鹿滿村",NULL
385,1010,35,1045,1334,0,0,78.34,431,579,"紫雲村",NULL
386,1239,40,1279,1601,0,0,79.89,447,792,"內埔村",NULL
387,483,31,514,694,0,0,74.06,220,263,"昇平村",NULL
388,790,23,813,1060,0,0,76.7,269,521,"昇平村",NULL
389,552,17,569,711,0,0,80.03,211,341,"桃源村",NULL
390,255,13,268,353,0,0,75.92,87,168,"桃源村",NULL
391,546,26,572,779,0,0,73.43,246,300,"白杞村",NULL
392,407,11,418,523,0,0,79.92,180,227,"塘興村",NULL
393,299,14,313,407,0,0,76.9,155,144,"塘興村",NULL
394,431,14,445,562,0,0,79.18,193,238,"義隆村",NULL
395,185,2,187,240,0,0,77.92,56,129,"龍山村",NULL
396,1122,39,1161,1481,0,0,78.39,376,746,"灣橋村",NULL
397,564,40,604,762,0,0,79.27,164,400,"文峯村",NULL
398,353,23,376,478,0,0,78.66,143,210,"金獅村",NULL
399,700,36,736,954,0,0,77.15,191,509,"復金村",NULL
400,712,33,745,939,0,0,79.34,284,428,"復金村",NULL
401,646,29,675,896,0,0,75.33,258,388,"緞繻村",NULL
402,87,1,88,129,0,0,68.22,43,44,"緞繻村",NULL
403,194,10,204,298,0,0,68.46,57,137,"仁壽村",NULL
404,286,9,295,431,0,0,68.45,139,147,"中和村",NULL
405,311,10,321,394,0,0,81.47,109,202,"中和村",NULL
406,351,2,353,462,0,0,76.41,132,219,"光華村",NULL
407,218,2,220,301,0,0,73.09,110,108,"光華村",NULL
408,866,32,898,1127,0,0,79.68,369,497,"梅東村",NULL
409,912,37,949,1217,0,0,77.98,293,619,"梅東村",NULL
410,788,21,809,1028,0,0,78.7,345,443,"梅南村",NULL
411,912,26,938,1171,0,0,80.1,329,583,"梅北村",NULL
412,960,33,993,1245,0,0,79.76,341,619,"梅北村",NULL
413,1135,41,1176,1459,0,0,80.6,395,740,"梅北村",NULL
414,470,2,472,583,0,0,80.96,199,271,"過山村",NULL
415,385,17,402,512,0,0,78.52,124,261,"圳南村",NULL
416,518,18,536,679,0,0,78.94,238,280,"圳北村",NULL
417,460,11,471,565,0,0,83.36,184,276,"双溪村",NULL
418,1305,47,1352,1710,0,0,79.06,499,806,"大南村",NULL
419,693,31,724,948,0,0,76.37,279,414,"安靖村",NULL
420,385,25,410,521,0,0,78.69,137,248,"永興村",NULL
421,343,12,355,452,0,0,78.54,110,233,"半天村",NULL
422,352,14,366,496,0,0,73.79,145,207,"太平村",NULL
423,319,3,322,393,0,0,81.93,165,154,"太興村",NULL
424,359,10,369,475,0,0,77.68,94,265,"龍眼村",NULL
425,214,3,217,293,0,0,74.06,89,125,"碧湖村",NULL
426,544,18,562,760,0,0,73.95,157,387,"瑞峯村",NULL
427,559,29,588,736,0,0,79.89,256,303,"瑞里村",NULL
428,426,16,442,601,0,0,73.54,168,258,"太和村",NULL
429,332,14,346,454,0,0,76.21,137,195,"太和村",NULL
430,824,36,860,1047,0,0,82.14,330,494,"江西村",NULL
431,301,13,314,414,0,0,75.85,120,181,"內甕村",NULL
432,661,2,663,810,0,0,81.85,226,435,"新福村",NULL
433,1287,54,1341,1666,0,0,80.49,479,808,"下坑村",NULL
434,630,22,652,832,0,0,78.37,231,399,"番路村",NULL
435,587,39,626,803,0,0,77.96,223,364,"民和村",NULL
436,321,8,329,428,0,0,76.87,169,152,"觸口村",NULL
437,340,13,353,397,0,0,88.92,44,296,"觸口村",NULL
438,593,23,616,836,0,0,73.68,242,351,"大湖村",NULL
439,319,1,320,413,0,0,77.48,107,212,"公田村",NULL
440,402,10,412,546,0,0,75.46,161,241,"公田村",NULL
441,410,14,424,550,0,0,77.09,197,213,"公興村",NULL
442,131,5,136,171,0,0,79.53,67,64,"草山村",NULL
443,169,3,172,234,0,0,73.5,92,77,"草山村",NULL
444,651,25,676,999,0,0,67.67,328,323,"大埔村",NULL
445,155,5,160,237,0,0,67.51,105,50,"和平村",NULL
446,169,4,173,242,0,0,71.49,66,103,"和平村",NULL
447,100,3,103,159,0,0,64.78,57,43,"永樂村",NULL
448,116,0,116,154,0,0,75.32,73,43,"永樂村",NULL
449,215,9,224,325,0,0,68.92,117,98,"茄苳村",NULL
450,106,1,107,155,0,0,69.03,67,39,"茄苳村",NULL
451,123,8,131,231,0,0,56.71,84,39,"茄苳村",NULL
452,249,5,254,377,0,0,67.37,174,75,"西興村",NULL
453,238,6,244,353,0,0,69.12,116,122,"中山村",NULL
454,134,4,138,194,0,0,71.13,79,55,"中正村",NULL
455,144,2,146,232,0,0,62.93,100,44,"香林村",NULL
456,160,11,171,243,0,0,70.37,74,86,"十字村",NULL
457,48,0,48,78,0,0,61.54,29,19,"十字村",NULL
458,206,12,218,293,0,0,74.4,80,126,"豐山村",NULL
459,239,0,239,328,0,0,72.87,183,56,"來吉村",NULL
460,569,24,593,760,0,0,78.03,409,160,"樂野村",NULL
461,608,6,614,846,0,0,72.58,537,71,"達邦村",NULL
462,195,8,203,270,0,0,75.19,157,38,"里佳村",NULL
463,343,9,352,483,0,0,72.88,279,64,"山美村",NULL
464,211,9,220,301,0,0,73.09,181,30,"新美村",NULL
465,232,7,239,327,0,0,73.09,138,94,"茶山村",NULL
1,1174,8,1182,1520,0,0,77.76,612,562,"忠政里",NULL
2,1095,19,1114,1402,0,0,79.46,576,519,"忠政里",NULL
3,1215,20,1235,1548,0,0,79.78,591,624,"忠政里",NULL
4,962,19,981,1214,0,0,80.81,428,534,"民權里",NULL
5,956,24,980,1209,0,0,81.06,453,503,"民權里",NULL
6,1027,27,1054,1340,0,0,78.66,358,669,"三仙里",NULL
7,1060,28,1088,1348,0,0,80.71,524,536,"三仙里",NULL
8,650,28,678,863,0,0,78.56,230,420,"好平里",NULL
9,960,34,994,1269,0,0,78.33,336,624,"延平里",NULL
10,756,17,773,968,0,0,79.86,329,427,"永生里",NULL
11,776,30,806,1062,0,0,75.89,325,451,"大宏里",NULL
12,727,19,746,946,0,0,78.86,318,409,"大宏里",NULL
13,895,19,914,1173,0,0,77.92,379,516,"大宏里",NULL
14,906,25,931,1164,0,0,79.98,365,541,"王公里",NULL
15,921,25,946,1199,0,0,78.9,383,538,"王公里",NULL
16,908,28,936,1184,0,0,79.05,413,495,"王公里",NULL
17,1016,17,1033,1308,0,0,78.98,487,529,"王公里",NULL
18,1257,19,1276,1548,0,0,82.43,651,606,"王公里",NULL
19,846,16,862,1085,0,0,79.45,358,488,"中營里",NULL
20,1105,39,1144,1434,0,0,79.78,327,778,"土庫里",NULL
21,356,3,359,451,0,0,79.6,153,203,"興安里",NULL
22,922,25,947,1151,0,0,82.28,386,536,"南興里",NULL
23,955,23,978,1231,0,0,79.45,446,509,"南興里",NULL
24,1193,28,1221,1526,0,0,80.01,624,569,"興業里",NULL
25,1164,35,1199,1517,0,0,79.04,478,686,"民生里",NULL
26,1194,35,1229,1565,0,0,78.53,439,755,"民生里",NULL
27,1203,27,1230,1569,0,0,78.39,582,621,"新北里",NULL
28,1501,16,1517,1873,0,0,80.99,708,793,"新北里",NULL
29,1003,23,1026,1246,0,0,82.34,442,561,"新南里",NULL
30,1233,13,1246,1540,0,0,80.91,545,688,"新南里",NULL
31,800,30,830,1059,0,0,78.38,251,549,"民榮里",NULL
32,922,36,958,1212,0,0,79.04,394,528,"民榮里",NULL
33,1299,20,1319,1696,0,0,77.77,521,778,"民榮里",NULL
34,1266,36,1302,1616,0,0,80.57,442,824,"埤寮里",NULL
35,973,40,1013,1278,0,0,79.26,295,678,"護鎮里",NULL
36,1148,53,1201,1484,0,0,80.93,286,862,"太南里",NULL
37,1272,47,1319,1589,0,0,83.01,345,927,"太北里",NULL
38,1084,26,1110,1424,0,0,77.95,438,646,"南紙里",NULL
39,1294,31,1325,1707,0,0,77.62,621,673,"南紙里",NULL
40,1139,40,1179,1497,0,0,78.76,346,793,"嘉芳里",NULL
41,268,17,285,367,0,0,77.66,61,207,"舊埔里",NULL
42,334,19,353,441,0,0,80.05,106,228,"角帶里",NULL
43,589,24,613,741,0,0,82.73,160,429,"鐵線里",NULL
44,728,44,772,1009,0,0,76.51,186,542,"五興里",NULL
45,475,18,493,593,0,0,83.14,79,396,"姑爺里",NULL
46,718,14,732,934,0,0,78.37,174,544,"水秀里",NULL
47,364,8,372,466,0,0,79.83,141,223,"水秀里",NULL
48,471,17,488,622,0,0,78.46,156,315,"福得里",NULL
49,295,15,310,382,0,0,81.15,96,199,"三生里",NULL
50,438,9,447,551,0,0,81.13,136,302,"武廟里",NULL
51,428,6,434,534,0,0,81.27,210,218,"中境里",NULL
52,312,9,321,397,0,0,80.86,107,205,"水仙里",NULL
53,610,18,628,791,0,0,79.39,239,371,"水正里",NULL
54,578,21,599,772,0,0,77.59,231,347,"橋南里",NULL
55,877,30,907,1183,0,0,76.67,304,573,"橋南里",NULL
56,988,19,1007,1299,0,0,77.52,348,640,"橋南里",NULL
57,617,15,632,766,0,0,82.51,101,516,"舊營里",NULL
58,719,43,762,982,0,0,77.6,131,588,"汫水里",NULL
59,804,11,815,1060,0,0,76.89,315,489,"岸內里",NULL
60,933,30,963,1197,0,0,80.45,355,578,"岸內里",NULL
61,814,28,842,1028,0,0,81.91,308,506,"岸內里",NULL
62,555,19,574,772,0,0,74.35,158,397,"義稠里",NULL
63,597,31,628,780,0,0,80.51,140,457,"下中里",NULL
64,693,20,713,881,0,0,80.93,207,486,"歡雅里",NULL
65,572,33,605,754,0,0,80.24,136,436,"歡雅里",NULL
66,374,21,395,498,0,0,79.32,66,308,"大莊里",NULL
67,236,11,247,290,0,0,85.17,53,183,"桐寮里",NULL
68,505,32,537,687,0,0,78.17,129,376,"後宅里",NULL
69,338,20,358,475,0,0,75.37,93,245,"孫厝里",NULL
70,620,23,643,784,0,0,82.02,127,493,"竹埔里",NULL
71,312,21,333,431,0,0,77.26,61,251,"下林里",NULL
72,220,13,233,281,0,0,82.92,47,173,"田寮里",NULL
73,300,7,307,375,0,0,81.87,70,230,"大豐里",NULL
74,315,15,330,420,0,0,78.57,98,217,"飯店里",NULL
75,419,15,434,552,0,0,78.62,99,320,"河南里",NULL
76,737,36,773,947,0,0,81.63,192,545,"南港里",NULL
77,915,37,952,1216,0,0,78.29,310,605,"白河里",NULL
78,454,11,465,597,0,0,77.89,171,283,"白河里",NULL
79,598,18,616,789,0,0,78.07,202,396,"永安里",NULL
80,860,14,874,1091,0,0,80.11,331,529,"永安里",NULL
81,731,13,744,938,0,0,79.32,214,517,"永安里",NULL
82,1113,38,1151,1476,0,0,77.98,306,807,"外角里",NULL
83,579,27,606,744,0,0,81.45,161,418,"庄內里",NULL
84,621,25,646,830,0,0,77.83,219,402,"庄內里",NULL
85,644,44,688,866,0,0,79.45,215,429,"秀祐里",NULL
86,610,27,637,828,0,0,76.93,215,395,"河東里",NULL
87,382,15,397,543,0,0,73.11,103,279,"河東里",NULL
88,334,22,356,462,0,0,77.06,109,225,"虎山里",NULL
89,437,22,459,640,0,0,71.72,107,330,"大林里",NULL
90,336,29,365,458,0,0,79.69,92,244,"崁頭里",NULL
91,449,14,463,650,0,0,71.23,107,342,"六溪里",NULL
92,579,19,598,810,0,0,73.83,202,377,"關嶺里",NULL
93,327,3,330,439,0,0,75.17,112,215,"關嶺里",NULL
94,564,30,594,752,0,0,78.99,200,364,"仙草里",NULL
95,387,23,410,558,0,0,73.48,139,248,"仙草里",NULL
96,344,39,383,614,0,0,62.38,310,34,"仙草里",NULL
97,918,34,952,1235,0,0,77.09,304,614,"玉豐里",NULL
98,1051,52,1103,1396,0,0,79.01,328,723,"大竹里",NULL
99,678,30,708,882,0,0,80.27,166,512,"詔安里",NULL
100,527,16,543,683,0,0,79.5,141,386,"廣安里",NULL
101,667,35,702,890,0,0,78.88,208,459,"蓮潭里",NULL
102,718,24,742,952,0,0,77.94,220,498,"竹門里",NULL
103,591,8,599,785,0,0,76.31,248,343,"崎內里",NULL
104,957,51,1008,1270,0,0,79.37,271,686,"昇安里",NULL
105,545,29,574,708,0,0,81.07,127,418,"汴頭里",NULL
106,589,27,616,791,0,0,77.88,144,445,"內角里",NULL
107,682,20,702,918,0,0,76.47,274,408,"草店里",NULL
108,470,25,495,662,0,0,74.77,106,364,"甘宅里",NULL
109,615,3,618,796,0,0,77.64,183,432,"士林村",NULL
110,590,14,604,745,0,0,81.07,198,392,"士林村",NULL
111,647,25,672,819,0,0,82.05,237,410,"光福村",NULL
112,812,25,837,988,0,0,84.72,265,547,"光福村",NULL
113,554,17,571,712,0,0,80.2,185,369,"中埕村",NULL
114,948,44,992,1240,0,0,80,281,667,"東昇村",NULL
115,1008,32,1040,1300,0,0,80,353,655,"東昇村",NULL
116,1011,42,1053,1276,0,0,82.52,360,651,"八翁村",NULL
117,377,9,386,479,0,0,80.58,134,243,"人和村",NULL
118,241,12,253,315,0,0,80.32,94,147,"人和村",NULL
119,614,31,645,800,0,0,80.63,199,415,"太康村",NULL
120,561,27,588,708,0,0,83.05,138,423,"太康村",NULL
121,584,39,623,760,0,0,81.97,193,391,"重溪村",NULL
122,583,24,607,731,0,0,83.04,220,363,"重溪村",NULL
123,222,11,233,285,0,0,81.75,77,145,"重溪村",NULL
124,502,24,526,698,0,0,75.36,175,327,"篤農村",NULL
125,562,22,584,718,0,0,81.34,174,388,"篤農村",NULL
126,519,22,541,672,0,0,80.51,169,350,"大農村",NULL
127,889,39,928,1179,0,0,78.71,232,657,"神農村",NULL
128,166,11,177,217,0,0,81.57,36,130,"神農村",NULL
129,837,35,872,1095,0,0,79.63,209,628,"果毅村",NULL
130,118,4,122,156,0,0,78.21,28,90,"果毅村",NULL
131,702,29,731,975,0,0,74.97,270,432,"旭山村",NULL
132,376,15,391,514,0,0,76.07,122,254,"旭山村",NULL
133,165,3,168,200,0,0,84,51,114,"旭山村",NULL
134,539,13,552,684,0,0,80.7,210,329,"後壁村",NULL
135,669,20,689,831,0,0,82.91,260,409,"後壁村",NULL
136,595,22,617,761,0,0,81.08,162,433,"侯伯村",NULL
137,417,15,432,543,0,0,79.56,103,314,"侯伯村",NULL
138,785,32,817,1029,0,0,79.4,267,518,"嘉苳村",NULL
139,172,16,188,242,0,0,77.69,49,123,"嘉苳村",NULL
140,449,20,469,596,0,0,78.69,118,331,"土溝村",NULL
141,568,19,587,728,0,0,80.63,154,414,"土溝村",NULL
142,911,47,958,1179,0,0,81.26,223,688,"嘉田村",NULL
143,980,41,1021,1280,0,0,79.77,240,740,"嘉民村",NULL
144,621,20,641,815,0,0,78.65,185,436,"菁豊村",NULL
145,401,12,413,483,0,0,85.51,90,311,"崁頂村",NULL
146,356,28,384,555,0,0,69.19,94,262,"後廍村",NULL
147,584,41,625,791,0,0,79.01,184,400,"墨林村",NULL
148,338,19,357,450,0,0,79.33,105,233,"菁寮村",NULL
149,449,26,475,586,0,0,81.06,76,373,"新嘉村",NULL
150,416,26,442,555,0,0,79.64,89,327,"新嘉村",NULL
151,430,25,455,552,0,0,82.43,100,330,"頂長村",NULL
152,790,45,835,1060,0,0,78.77,205,585,"平安村",NULL
153,456,22,478,575,0,0,83.13,103,353,"仕安村",NULL
154,804,20,824,990,0,0,83.23,131,673,"竹新村",NULL
155,376,15,391,458,0,0,85.37,89,287,"竹新村",NULL
156,528,23,551,650,0,0,84.77,110,418,"新東村",NULL
157,675,15,690,880,0,0,78.41,181,494,"新東村",NULL
158,935,31,966,1215,0,0,79.51,364,571,"頂安村",NULL
159,522,18,540,680,0,0,79.41,196,326,"長安村",NULL
160,504,14,518,657,0,0,78.84,154,350,"長安村",NULL
161,913,19,932,1166,0,0,79.93,311,602,"福安村",NULL
162,620,27,647,817,0,0,79.19,151,469,"烏樹村",NULL
163,1038,47,1085,1485,0,0,73.06,409,629,"東山村",NULL
164,894,30,924,1169,0,0,79.04,360,534,"東中村",NULL
165,870,41,911,1165,0,0,78.2,311,559,"東中村",NULL
166,1077,71,1148,1552,0,0,73.97,337,740,"東正村",NULL
167,678,37,715,928,0,0,77.05,186,492,"三榮村",NULL
168,788,53,841,1162,0,0,72.38,288,500,"大客村",NULL
169,537,34,571,767,0,0,74.45,234,303,"科里村",NULL
170,458,32,490,594,0,0,82.49,131,327,"科里村",NULL
171,681,36,717,906,0,0,79.14,173,508,"東河村",NULL
172,613,13,626,778,0,0,80.46,159,454,"聖賢村",NULL
173,378,8,386,479,0,0,80.58,111,267,"聖賢村",NULL
174,482,25,507,639,0,0,79.34,144,338,"聖賢村",NULL
175,370,20,390,511,0,0,76.32,110,260,"南溪村",NULL
176,317,14,331,472,0,0,70.13,73,244,"水雲村",NULL
177,288,25,313,410,0,0,76.34,77,211,"林安村",NULL
178,673,47,720,1010,0,0,71.29,264,409,"東原村",NULL
179,854,52,906,1296,0,0,69.91,344,510,"東原村",NULL
180,514,28,542,790,0,0,68.61,170,344,"嶺南村",NULL
181,782,47,829,1151,0,0,72.02,312,470,"南勢村",NULL
182,787,36,823,1130,0,0,72.83,323,464,"青山村",NULL
183,664,47,711,965,0,0,73.68,308,356,"高原村",NULL
184,546,6,552,645,0,0,85.58,116,430,"穀興里",NULL
185,483,12,495,586,0,0,84.47,119,364,"保安里",NULL
186,983,20,1003,1188,0,0,84.43,325,658,"東角里",NULL
187,729,12,741,892,0,0,83.07,231,498,"東角里",NULL
188,943,20,963,1140,0,0,84.47,232,711,"晉江里",NULL
189,945,27,972,1187,0,0,81.89,250,695,"晉江里",NULL
190,1164,21,1185,1424,0,0,83.22,357,807,"巷口里",NULL
191,787,20,807,965,0,0,83.63,259,528,"中興里",NULL
192,763,12,775,933,0,0,83.07,216,547,"中興里",NULL
193,1092,31,1123,1322,0,0,84.95,243,849,"興農里",NULL
194,835,17,852,1009,0,0,84.44,186,649,"新建里",NULL
195,1183,29,1212,1459,0,0,83.07,264,919,"油車里",NULL
196,1210,25,1235,1472,0,0,83.9,273,937,"油車里",NULL
197,940,29,969,1161,0,0,83.46,111,829,"北勢里",NULL
198,1127,32,1159,1404,0,0,82.55,315,812,"大埕里",NULL
199,918,19,937,1107,0,0,84.64,223,695,"大埕里",NULL
200,526,20,546,660,0,0,82.73,168,358,"總榮里",NULL
201,607,14,621,735,0,0,84.49,89,518,"龍泉里",NULL
202,515,22,537,658,0,0,81.61,142,373,"南勢里",NULL
203,1294,17,1311,1598,0,0,82.04,460,834,"南勢里",NULL
204,1288,48,1336,1562,0,0,85.53,212,1076,"寮廍里",NULL
205,783,15,798,944,0,0,84.53,148,635,"小埤里",NULL
206,1106,28,1134,1325,0,0,85.58,210,896,"埤頭里",NULL
207,457,10,467,524,0,0,89.12,79,378,"大山里",NULL
208,793,33,826,972,0,0,84.98,169,624,"海埔里",NULL
209,418,21,439,528,0,0,83.14,61,357,"莊禮里",NULL
210,902,26,928,1101,0,0,84.29,152,750,"港尾里",NULL
211,856,15,871,1045,0,0,83.35,145,711,"麻口里",NULL
212,492,13,505,629,0,0,80.29,123,369,"安東里",NULL
213,550,15,565,674,0,0,83.83,104,446,"安業里",NULL
214,614,27,641,746,0,0,85.92,85,529,"安西里",NULL
215,779,16,795,927,0,0,85.76,143,636,"謝安里",NULL
216,716,6,722,846,0,0,85.34,85,631,"中民里",NULL
217,703,11,714,833,0,0,85.71,117,586,"安正里",NULL
218,942,24,966,1123,0,0,86.02,156,786,"磚井里",NULL
219,755,26,781,970,0,0,80.52,284,471,"下營村",NULL
220,1029,33,1062,1327,0,0,80.03,367,662,"仁里村",NULL
221,977,20,997,1292,0,0,77.17,415,562,"仁里村",NULL
222,852,37,889,1146,0,0,77.57,337,515,"宅內村",NULL
223,1209,15,1224,1534,0,0,79.79,490,719,"後街村",NULL
224,820,25,845,1072,0,0,78.82,329,491,"新興村",NULL
225,870,25,895,1108,0,0,80.78,283,587,"新興村",NULL
226,799,25,824,1049,0,0,78.55,325,474,"營前村",NULL
227,858,24,882,1085,0,0,81.29,305,553,"營前村",NULL
228,640,28,668,804,0,0,83.08,184,456,"大屯村",NULL
229,599,20,619,761,0,0,81.34,228,371,"大埤村",NULL
230,984,35,1019,1218,0,0,83.66,230,754,"茅港村",NULL
231,910,32,942,1140,0,0,82.63,196,714,"中營村",NULL
232,835,11,846,991,0,0,85.37,182,653,"開化村",NULL
233,674,23,697,866,0,0,80.48,177,497,"開化村",NULL
234,715,20,735,891,0,0,82.49,134,581,"西連村",NULL
235,1021,32,1053,1328,0,0,79.29,271,750,"賀建村",NULL
236,945,13,958,1185,0,0,80.84,189,756,"甲中村",NULL
237,986,47,1033,1254,0,0,82.38,170,816,"紅厝村",NULL
238,1174,29,1203,1466,0,0,82.06,399,775,"六甲村",NULL
239,1059,30,1089,1339,0,0,81.33,350,709,"六甲村",NULL
240,1043,36,1079,1350,0,0,79.93,343,700,"甲東村",NULL
241,909,35,944,1186,0,0,79.6,239,670,"甲東村",NULL
242,1040,21,1061,1323,0,0,80.2,298,742,"甲南村",NULL
243,818,12,830,1041,0,0,79.73,208,610,"龍湖村",NULL
244,721,22,743,883,0,0,84.14,166,555,"七甲村",NULL
245,721,20,741,910,0,0,81.43,198,523,"二甲村",NULL
246,798,10,808,997,0,0,81.04,242,556,"二甲村",NULL
247,820,30,850,1033,0,0,82.28,251,569,"二甲村",NULL
248,818,17,835,997,0,0,83.75,250,568,"水林村",NULL
249,747,13,760,945,0,0,80.42,258,489,"水林村",NULL
250,615,17,632,763,0,0,82.83,139,476,"中社村",NULL
251,639,26,665,817,0,0,81.4,234,405,"中社村",NULL
252,841,42,883,1093,0,0,80.79,263,578,"龜港村",NULL
253,483,15,498,597,0,0,83.42,159,324,"菁埔村",NULL
254,641,37,678,840,0,0,80.71,180,461,"王爺村",NULL
255,548,28,576,736,0,0,78.26,175,373,"大丘村",NULL
256,775,33,808,963,0,0,83.9,276,499,"官田村",NULL
257,771,28,799,975,0,0,81.95,181,590,"官田村",NULL
258,1032,30,1062,1281,0,0,82.9,180,852,"二鎮村",NULL
259,961,18,979,1167,0,0,83.89,192,769,"二鎮村",NULL
260,805,33,838,995,0,0,84.22,137,668,"湖山村",NULL
261,241,2,243,317,0,0,76.66,91,150,"嘉南村",NULL
262,392,18,410,482,0,0,85.06,114,278,"大崎村",NULL
263,729,29,758,917,0,0,82.66,306,423,"隆田村",NULL
264,753,19,772,918,0,0,84.1,334,419,"隆田村",NULL
265,652,26,678,826,0,0,82.08,271,381,"隆本村",NULL
266,874,25,899,1055,0,0,85.21,418,456,"隆本村",NULL
267,828,13,841,1022,0,0,82.29,417,411,"隆本村",NULL
268,869,28,897,1120,0,0,80.09,229,640,"南廍村",NULL
269,1200,62,1262,1392,0,0,90.66,66,1134,"東庄村",NULL
270,614,22,636,699,0,0,90.99,15,599,"西庄村",NULL
271,489,16,505,600,0,0,84.17,145,344,"拔林村",NULL
272,624,28,652,786,0,0,82.95,173,451,"渡頭村",NULL
273,684,24,708,832,0,0,85.1,170,514,"渡頭村",NULL
274,438,24,462,579,0,0,79.79,153,285,"渡頭村",NULL
275,736,32,768,923,0,0,83.21,116,620,"社子村",NULL
276,664,28,692,848,0,0,81.6,125,539,"石湖村",NULL
277,210,11,221,275,0,0,80.36,113,97,"石湖村",NULL
278,629,26,655,791,0,0,82.81,153,476,"石林村",NULL
279,1200,49,1249,1526,0,0,81.85,363,837,"石城村",NULL
280,878,37,915,1104,0,0,82.88,314,564,"內江村",NULL
281,708,18,726,846,0,0,85.82,254,454,"大內村",NULL
282,529,42,571,702,0,0,81.34,137,392,"內郭村",NULL
283,838,34,872,1070,0,0,81.5,268,570,"頭社村",NULL
284,705,27,732,917,0,0,79.83,314,391,"環湖村",NULL
285,709,39,748,945,0,0,79.15,242,467,"二溪村",NULL
286,529,25,554,647,0,0,85.63,163,366,"曲溪村",NULL
287,715,7,722,885,0,0,81.58,261,454,"東寧里",NULL
288,734,18,752,897,0,0,83.84,272,462,"東寧里",NULL
289,977,27,1004,1226,0,0,81.89,342,635,"忠仁里",NULL
290,1231,21,1252,1555,0,0,80.51,429,802,"忠仁里",NULL
291,863,22,885,1091,0,0,81.12,346,517,"鎮山里",NULL
292,960,22,982,1219,0,0,80.56,332,628,"鎮山里",NULL
293,878,25,903,1113,0,0,81.13,282,596,"鎮山里",NULL
294,1073,22,1095,1337,0,0,81.9,302,771,"鎮山里",NULL
295,1127,20,1147,1447,0,0,79.27,426,701,"建南里",NULL
296,1124,19,1143,1392,0,0,82.11,388,736,"建南里",NULL
297,993,27,1020,1265,0,0,80.63,331,662,"建南里",NULL
298,1475,31,1506,1863,0,0,80.84,433,1042,"建南里",NULL
299,993,16,1009,1252,0,0,80.59,379,614,"安西里",NULL
300,996,13,1009,1236,0,0,81.63,387,609,"安西里",NULL
301,1046,23,1069,1314,0,0,81.35,396,650,"安西里",NULL
302,1340,34,1374,1688,0,0,81.4,444,896,"安西里",NULL
303,968,5,973,1196,0,0,81.35,354,614,"安西里",NULL
304,1787,30,1817,2317,0,0,78.42,690,1097,"安西里",NULL
305,852,12,864,1065,0,0,81.13,257,595,"六安里",NULL
306,856,18,874,1089,0,0,80.26,327,529,"六安里",NULL
307,925,12,937,1162,0,0,80.64,422,503,"六安里",NULL
308,820,15,835,996,0,0,83.84,283,537,"佳化里",NULL
309,723,23,746,921,0,0,81,157,566,"佳化里",NULL
310,680,29,709,849,0,0,83.51,193,487,"禮化里",NULL
311,1072,37,1109,1335,0,0,83.07,285,787,"興化里",NULL
312,558,15,573,701,0,0,81.74,203,355,"營頂里",NULL
313,290,18,308,398,0,0,77.39,100,190,"溪洲里",NULL
314,1064,28,1092,1361,0,0,80.24,300,764,"海澄里",NULL
315,564,7,571,687,0,0,83.11,169,395,"漳洲里",NULL
316,669,17,686,850,0,0,80.71,243,426,"頂廍里",NULL
317,758,32,790,973,0,0,81.19,195,563,"嘉福里",NULL
318,842,37,879,1096,0,0,80.2,214,628,"通興里",NULL
319,668,22,690,828,0,0,83.33,133,535,"蚶寮里",NULL
320,828,29,857,981,0,0,87.36,231,597,"龍安里",NULL
321,1004,48,1052,1292,0,0,81.42,233,771,"民安里",NULL
322,589,28,617,765,0,0,80.65,121,468,"子龍里",NULL
323,625,16,641,773,0,0,82.92,148,477,"子龍里",NULL
324,715,15,730,879,0,0,83.05,168,547,"三協里",NULL
325,588,13,601,744,0,0,80.78,179,409,"一秀里",NULL
326,417,10,427,524,0,0,81.49,122,295,"一秀里",NULL
327,1043,6,1049,1306,0,0,80.32,237,806,"西明里",NULL
328,412,4,416,513,0,0,81.09,139,273,"宜民里",NULL
329,718,14,732,927,0,0,78.96,218,500,"煥昌里",NULL
330,477,13,490,602,0,0,81.4,191,286,"慈生里",NULL
331,957,20,977,1215,0,0,80.41,309,648,"仁得里",NULL
332,813,10,823,1009,0,0,81.57,259,554,"仁得里",NULL
333,1107,20,1127,1370,0,0,82.26,318,789,"仁得里",NULL
334,1156,11,1167,1482,0,0,78.74,422,734,"新生里",NULL
335,646,21,667,820,0,0,81.34,204,442,"百福里",NULL
336,427,14,441,562,0,0,78.47,132,295,"百福里",NULL
337,527,11,538,690,0,0,77.97,173,354,"新榮里",NULL
338,651,14,665,807,0,0,82.4,181,470,"新榮里",NULL
339,433,16,449,560,0,0,80.18,109,324,"文化里",NULL
340,418,12,430,536,0,0,80.22,120,298,"大安里",NULL
341,683,35,718,881,0,0,81.5,166,517,"美豐里",NULL
342,284,3,287,339,0,0,84.66,54,230,"美和里",NULL
343,515,15,530,651,0,0,81.41,95,420,"達明里",NULL
344,270,6,276,333,0,0,82.88,76,194,"光明里",NULL
345,344,8,352,431,0,0,81.67,105,239,"民吉里",NULL
346,349,23,372,482,0,0,77.18,71,278,"西進里",NULL
347,264,4,268,337,0,0,79.53,76,188,"白渚里",NULL
348,454,11,465,585,0,0,79.49,86,368,"光華里",NULL
349,250,6,256,317,0,0,80.76,59,191,"光華里",NULL
350,335,8,343,440,0,0,77.95,77,258,"頭港里",NULL
351,843,28,871,1093,0,0,79.69,174,669,"宅港里",NULL
352,377,16,393,479,0,0,82.05,53,324,"平東里",NULL
353,533,19,552,686,0,0,80.47,82,451,"平西里",NULL
354,533,10,543,675,0,0,80.44,166,367,"頂洲里",NULL
355,335,20,355,490,0,0,72.45,113,222,"紅茄里",NULL
356,354,18,372,452,0,0,82.3,80,274,"新芳里",NULL
357,712,11,723,864,0,0,83.68,259,453,"西港村",NULL
358,672,17,689,810,0,0,85.06,193,479,"西港村",NULL
359,880,21,901,1120,0,0,80.45,219,661,"西港村",NULL
360,1030,27,1057,1307,0,0,80.87,364,666,"慶安村",NULL
361,759,17,776,941,0,0,82.47,257,502,"慶安村",NULL
362,1106,17,1123,1387,0,0,80.97,361,745,"慶安村",NULL
363,1043,26,1069,1305,0,0,81.92,281,762,"南海村",NULL
364,553,4,557,647,0,0,86.09,83,470,"南海村",NULL
365,796,23,819,998,0,0,82.06,260,536,"港東村",NULL
366,317,9,326,391,0,0,83.38,71,246,"港東村",NULL
367,613,16,629,748,0,0,84.09,157,456,"檨林村",NULL
368,645,27,672,807,0,0,83.27,148,497,"檨林村",NULL
369,1076,38,1114,1354,0,0,82.27,269,807,"後營村",NULL
370,1031,39,1070,1324,0,0,80.82,296,735,"營西村",NULL
371,680,26,706,823,0,0,85.78,187,493,"金砂村",NULL
372,963,31,994,1184,0,0,83.95,242,721,"劉厝村",NULL
373,963,37,1000,1187,0,0,84.25,216,747,"竹林村",NULL
374,698,32,730,881,0,0,82.86,178,520,"永樂村",NULL
375,325,6,331,397,0,0,83.38,60,265,"新復村",NULL
376,576,20,596,751,0,0,79.36,255,321,"永樂村、南海村、新復村",NULL
377,452,5,457,559,0,0,81.75,121,331,"後港村",NULL
378,535,22,557,725,0,0,76.83,167,368,"大潭村",NULL
379,408,11,419,508,0,0,82.48,84,324,"城內村",NULL
380,670,23,693,854,0,0,81.15,168,502,"篤加村",NULL
381,759,20,779,944,0,0,82.52,198,561,"頂山村",NULL
382,475,14,489,616,0,0,79.38,182,293,"西寮村",NULL
383,347,10,357,443,0,0,80.59,136,211,"鹽埕村",NULL
384,588,25,613,789,0,0,77.69,212,376,"中寮村",NULL
385,632,26,658,806,0,0,81.64,147,485,"龍山村",NULL
386,724,27,751,915,0,0,82.08,161,563,"龍山村",NULL
387,283,3,286,348,0,0,82.18,110,173,"溪南村",NULL
388,682,22,704,883,0,0,79.73,137,545,"七股村",NULL
389,672,24,696,854,0,0,81.5,200,472,"玉成村",NULL
390,1086,32,1118,1408,0,0,79.4,339,747,"大埕村",NULL
391,748,30,778,959,0,0,81.13,190,558,"大寮村",NULL
392,494,16,510,620,0,0,82.26,101,393,"看坪村",NULL
393,830,26,856,1036,0,0,82.63,221,609,"樹林村",NULL
394,470,19,489,576,0,0,84.9,125,345,"竹港村",NULL
395,597,18,615,735,0,0,83.67,165,432,"竹橋村",NULL
396,831,37,868,1051,0,0,82.59,226,605,"義合村",NULL
397,546,15,561,682,0,0,82.26,144,402,"康榔村",NULL
398,678,41,719,923,0,0,77.9,246,432,"永吉村",NULL
399,1177,86,1263,1651,0,0,76.5,501,676,"三股村",NULL
400,1012,38,1050,1332,0,0,78.83,299,713,"十份村",NULL
401,760,31,791,962,0,0,82.22,246,514,"長榮村",NULL
402,1032,31,1063,1349,0,0,78.8,322,710,"西華村",NULL
403,806,7,813,1035,0,0,78.55,198,608,"西和村",NULL
404,399,13,412,506,0,0,81.42,147,252,"忠興村",NULL
405,769,25,794,990,0,0,80.2,249,520,"忠興村",NULL
406,466,18,484,578,0,0,83.74,97,369,"嘉昌村",NULL
407,263,10,273,330,0,0,82.73,73,190,"嘉昌村",NULL
408,462,11,473,590,0,0,80.17,136,326,"保源村",NULL
409,355,23,378,453,0,0,83.44,80,275,"保源村",NULL
410,505,21,526,668,0,0,78.74,159,346,"苓和村",NULL
411,314,8,322,406,0,0,79.31,82,232,"苓和村",NULL
412,570,23,593,764,0,0,77.62,118,452,"仁和村",NULL
413,520,22,542,631,0,0,85.9,111,409,"北埔村",NULL
414,531,19,550,713,0,0,77.14,129,402,"將富村",NULL
415,312,3,315,395,0,0,79.75,78,234,"將貴村",NULL
416,173,5,178,214,0,0,83.18,55,118,"將貴村",NULL
417,315,12,327,435,0,0,75.17,103,212,"三吉村",NULL
418,675,36,711,897,0,0,79.26,108,567,"玉山村",NULL
419,523,35,558,696,0,0,80.17,135,388,"廣山村",NULL
420,612,2,614,821,0,0,74.79,132,480,"長沙村",NULL
421,487,19,506,642,0,0,78.82,136,351,"長沙村",NULL
422,943,27,970,1286,0,0,75.43,193,750,"平沙村",NULL
423,638,25,663,880,0,0,75.34,144,494,"鯤鯓村",NULL
424,901,28,929,1176,0,0,79,260,641,"鯤鯓村",NULL
425,762,23,785,1018,0,0,77.11,172,590,"鯤溟村",NULL
426,430,5,435,532,0,0,81.77,140,290,"北門村",NULL
427,298,12,310,387,0,0,80.1,146,152,"北門村",NULL
428,397,13,410,528,0,0,77.65,235,162,"永隆村",NULL
429,317,8,325,395,0,0,82.28,110,207,"永華村",NULL
430,353,17,370,471,0,0,78.56,87,266,"玉港村",NULL
431,236,13,249,323,0,0,77.09,56,180,"玉港村",NULL
432,618,20,638,803,0,0,79.45,230,388,"保吉村",NULL
433,414,9,423,531,0,0,79.66,165,249,"保吉村",NULL
434,583,19,602,774,0,0,77.78,213,370,"東壁村",NULL
435,295,6,301,401,0,0,75.06,97,198,"鯤江村",NULL
436,293,3,296,373,0,0,79.36,65,228,"鯤江村",NULL
437,436,15,451,603,0,0,74.79,154,282,"雙春村",NULL
438,764,36,800,1069,0,0,74.84,221,543,"錦湖村",NULL
439,488,15,503,680,0,0,73.97,193,295,"慈安村",NULL
440,475,17,492,651,0,0,75.58,170,305,"三光村",NULL
441,407,3,410,517,0,0,79.3,75,332,"三光村",NULL
442,518,30,548,718,0,0,76.32,112,406,"中樞村",NULL
443,541,26,567,709,0,0,79.97,151,390,"仁里村",NULL
444,548,17,565,709,0,0,79.69,266,282,"武安里",NULL
445,757,25,782,936,0,0,83.55,347,410,"武安里",NULL
446,1071,6,1077,1368,0,0,78.73,451,620,"東榮里",NULL
447,1073,28,1101,1349,0,0,81.62,476,597,"東榮里",NULL
448,879,11,890,1114,0,0,79.89,414,465,"東榮里",NULL
449,639,14,653,801,0,0,81.52,324,315,"護國里",NULL
450,514,12,526,852,0,0,61.74,284,230,"護國里",NULL
451,853,15,868,1076,0,0,80.67,331,522,"太平里",NULL
452,664,19,683,862,0,0,79.23,308,356,"太平里",NULL
453,843,13,856,1055,0,0,81.14,289,554,"太平里",NULL
454,641,25,666,808,0,0,82.43,241,400,"太平里",NULL
455,352,7,359,436,0,0,82.34,155,197,"中央里",NULL
456,473,13,486,607,0,0,80.07,211,262,"觀音里",NULL
457,360,11,371,443,0,0,83.75,146,214,"竹林里",NULL
458,801,20,821,983,0,0,83.52,313,488,"清水里",NULL
459,646,27,673,845,0,0,79.64,229,417,"協興里",NULL
460,896,20,916,1115,0,0,82.15,406,490,"協興里",NULL
461,840,16,856,1057,0,0,80.98,381,459,"協興里",NULL
462,694,7,701,832,0,0,84.25,287,407,"唪口里",NULL
463,700,21,721,864,0,0,83.45,220,480,"唪口里",NULL
464,944,10,954,1175,0,0,81.19,367,577,"北勢里",NULL
465,740,23,763,924,0,0,82.58,338,402,"豐榮里",NULL
466,462,19,481,612,0,0,78.59,206,256,"豐榮里",NULL
467,736,15,751,930,0,0,80.75,316,420,"豐榮里",NULL
468,411,18,429,543,0,0,79.01,164,247,"全興里",NULL
469,452,12,464,547,0,0,84.83,162,290,"全興里",NULL
470,795,11,806,950,0,0,84.84,404,391,"全興里",NULL
471,772,36,808,935,0,0,86.42,265,507,"崙頂里",NULL
472,633,25,658,818,0,0,80.44,206,427,"崙頂里",NULL
473,879,32,911,1082,0,0,84.2,308,571,"知義里",NULL
474,782,37,819,1053,0,0,77.78,384,398,"知義里",NULL
475,1052,28,1080,1325,0,0,81.51,412,640,"山腳里",NULL
476,353,29,382,481,0,0,79.42,120,233,"大坑里",NULL
477,800,24,824,1027,0,0,80.23,315,485,"那拔里",NULL
478,812,32,844,1034,0,0,81.62,372,440,"那拔里",NULL
479,625,22,647,845,0,0,76.57,232,393,"羊林里",NULL
480,792,43,835,1041,0,0,80.21,174,618,"礁坑里",NULL
481,771,8,779,938,0,0,83.05,267,504,"東關里",NULL
482,1014,25,1039,1251,0,0,83.05,430,584,"坐駕里",NULL
483,1206,37,1243,1508,0,0,82.43,452,754,"坐駕里",NULL
484,887,23,910,1132,0,0,80.39,329,558,"光文里",NULL
485,1201,22,1223,1506,0,0,81.21,493,708,"光文里",NULL
486,1269,19,1288,1563,0,0,82.41,520,749,"光文里",NULL
487,778,16,794,984,0,0,80.69,283,495,"文昌里",NULL
488,905,18,923,1171,0,0,78.82,328,577,"文昌里",NULL
489,992,33,1025,1263,0,0,81.16,239,753,"南關里",NULL
490,528,23,551,682,0,0,80.79,204,324,"西關里",NULL
491,357,4,361,439,0,0,82.23,129,228,"北關里",NULL
492,901,34,935,1215,0,0,76.95,265,636,"文正里",NULL
493,968,46,1014,1247,0,0,81.32,154,814,"胡家里",NULL
494,1033,12,1045,1269,0,0,82.35,210,823,"胡厝里",NULL
495,481,27,508,624,0,0,81.41,416,65,"胡厝里",NULL
496,720,37,757,895,0,0,84.58,196,524,"什乃里",NULL
497,731,5,736,883,0,0,83.35,228,503,"溪美里",NULL
498,577,21,598,712,0,0,83.99,198,379,"溪美里",NULL
499,532,22,554,679,0,0,81.59,145,387,"六分里",NULL
500,829,16,845,1057,0,0,79.94,211,618,"六德里",NULL
501,578,18,596,729,0,0,81.76,134,444,"田寮里",NULL
502,836,30,866,1033,0,0,83.83,245,591,"田寮里",NULL
503,710,25,735,866,0,0,84.87,209,501,"東隆里",NULL
504,795,32,827,984,0,0,84.04,202,593,"東昌里",NULL
505,1092,52,1144,1379,0,0,82.96,357,735,"牛庄里",NULL
506,1138,49,1187,1388,0,0,85.52,268,870,"嘉北里",NULL
507,806,23,829,1028,0,0,80.64,199,607,"嘉南里",NULL
508,1038,33,1071,1295,0,0,82.7,303,735,"小新里",NULL
509,1184,37,1221,1515,0,0,80.59,458,726,"小新里",NULL
510,715,21,736,909,0,0,80.97,222,493,"新市村",NULL
511,598,6,604,718,0,0,84.12,224,374,"新市村",NULL
512,699,14,713,863,0,0,82.62,259,440,"新市村",NULL
513,826,22,848,1043,0,0,81.3,290,536,"新和村",NULL
514,918,18,936,1119,0,0,83.65,336,582,"新和村",NULL
515,663,12,675,807,0,0,83.64,277,386,"新和村",NULL
516,917,18,935,1121,0,0,83.41,336,581,"新和村",NULL
517,998,22,1020,1254,0,0,81.34,347,651,"新和村",NULL
518,680,19,699,852,0,0,82.04,196,484,"社內村",NULL
519,906,39,945,1107,0,0,85.37,197,709,"社內村",NULL
520,530,17,547,648,0,0,84.41,141,389,"大洲村",NULL
521,705,16,721,889,0,0,81.1,244,461,"豊華村",NULL
522,953,38,991,1162,0,0,85.28,288,665,"三舍村",NULL
523,859,28,887,1069,0,0,82.97,351,508,"大營村",NULL
524,538,18,556,666,0,0,83.48,187,351,"大營村",NULL
525,561,18,579,683,0,0,84.77,228,333,"大營村",NULL
526,859,26,885,1059,0,0,83.57,224,635,"大社村",NULL
527,906,7,913,1111,0,0,82.18,249,657,"大社村",NULL
528,977,39,1016,1225,0,0,82.94,261,716,"大社村",NULL
529,609,13,622,738,0,0,84.28,195,414,"潭頂村",NULL
530,631,31,662,788,0,0,84.01,217,414,"潭頂村",NULL
531,613,13,626,769,0,0,81.4,232,381,"港墘村",NULL
532,893,39,932,1117,0,0,83.44,272,621,"港墘村",NULL
533,833,32,865,1043,0,0,82.93,264,569,"港墘村",NULL
534,380,16,396,458,0,0,86.46,118,262,"永就村",NULL
535,745,7,752,948,0,0,79.32,266,479,"永就村",NULL
536,701,23,724,855,0,0,84.68,265,436,"永就村",NULL
537,947,34,981,1204,0,0,81.48,286,661,"蘇林村",NULL
538,669,23,692,858,0,0,80.65,201,468,"蘇林村",NULL
539,773,38,811,982,0,0,82.59,218,555,"蘇厝村",NULL
540,650,30,680,817,0,0,83.23,199,451,"蘇厝村",NULL
541,1102,35,1137,1355,0,0,83.91,342,760,"安定村",NULL
542,919,51,970,1138,0,0,85.24,237,682,"安加村",NULL
543,636,18,654,765,0,0,85.49,250,386,"保西村",NULL
544,614,23,637,763,0,0,83.49,190,424,"港尾村",NULL
545,566,26,592,723,0,0,81.88,216,350,"港尾村",NULL
546,800,42,842,1020,0,0,82.55,207,593,"中榮村",NULL
547,789,33,822,1025,0,0,80.2,319,470,"港口村",NULL
548,971,18,989,1183,0,0,83.6,300,671,"港口村",NULL
549,967,31,998,1228,0,0,81.27,318,649,"港南村",NULL
550,791,28,819,978,0,0,83.74,281,510,"港南村",NULL
551,511,15,526,634,0,0,82.97,202,309,"大同村",NULL
552,1147,41,1188,1388,0,0,85.59,311,836,"六嘉村",NULL
553,577,23,600,695,0,0,86.33,198,379,"中沙村",NULL
554,783,25,808,987,0,0,81.86,234,549,"新吉村",NULL
555,670,33,703,861,0,0,81.65,182,488,"新吉村",NULL
556,884,35,919,1112,0,0,82.64,334,550,"海寮村",NULL
557,874,41,915,1117,0,0,81.92,319,555,"海寮村",NULL
558,764,21,785,915,0,0,85.79,183,581,"管寮村",NULL
559,430,19,449,506,0,0,88.74,147,283,"南安村",NULL
560,736,8,744,870,0,0,85.52,216,520,"明和村",NULL
561,691,36,727,903,0,0,80.51,254,437,"明和村",NULL
562,617,26,643,751,0,0,85.62,256,361,"南洲村",NULL
563,656,33,689,800,0,0,86.13,176,480,"南洲村",NULL
564,644,28,672,866,0,0,77.6,219,425,"山上村",NULL
565,580,23,603,757,0,0,79.66,173,407,"新莊村",NULL
566,427,28,455,572,0,0,79.55,154,273,"玉峰村",NULL
567,277,13,290,359,0,0,80.78,129,148,"平陽村",NULL
568,304,8,312,379,0,0,82.32,95,209,"豐德村",NULL
569,718,20,738,912,0,0,80.92,415,303,"玉井村",NULL
570,1095,26,1121,1404,0,0,79.84,587,508,"玉田村",NULL
571,999,29,1028,1275,0,0,80.63,457,542,"玉田村",NULL
572,1083,60,1143,1424,0,0,80.27,525,558,"玉田村",NULL
573,989,41,1030,1275,0,0,80.78,412,577,"中正村",NULL
574,1051,42,1093,1405,0,0,77.79,471,580,"竹圍村",NULL
575,385,26,411,505,0,0,81.39,196,189,"沙田村",NULL
576,367,12,379,511,0,0,74.17,164,203,"三埔村",NULL
577,611,30,641,771,0,0,83.14,276,335,"三和村",NULL
578,528,20,548,681,0,0,80.47,258,270,"望明村",NULL
579,693,24,717,893,0,0,80.29,273,420,"望明村",NULL
580,559,17,576,694,0,0,83,277,282,"層林村",NULL
581,776,38,814,1002,0,0,81.24,353,423,"豐里村",NULL
582,713,25,738,965,0,0,76.48,385,328,"楠西村",NULL
583,707,30,737,938,0,0,78.57,416,291,"楠西村",NULL
584,936,50,986,1272,0,0,77.52,489,447,"灣丘村",NULL
585,621,20,641,837,0,0,76.58,361,260,"密枝村",NULL
586,766,46,812,1058,0,0,76.75,406,360,"照興村",NULL
587,785,24,809,1008,0,0,80.26,422,363,"鹿田村",NULL
588,569,18,587,719,0,0,81.64,276,293,"龜丹村",NULL
589,850,23,873,1069,0,0,81.67,504,346,"東勢村",NULL
590,889,25,914,1186,0,0,77.07,464,425,"東勢村",NULL
591,564,10,574,700,0,0,82,255,309,"南化村",NULL
592,528,20,548,676,0,0,81.07,233,295,"南化村",NULL
593,616,17,633,795,0,0,79.62,305,311,"小崙村",NULL
594,488,21,509,656,0,0,77.59,241,247,"東和村",NULL
595,398,15,413,502,0,0,82.27,182,216,"中坑村",NULL
596,485,14,499,595,0,0,83.87,193,292,"北平村",NULL
597,610,18,628,796,0,0,78.89,278,332,"西埔村",NULL
598,915,36,951,1199,0,0,79.32,515,400,"北寮村",NULL
599,667,31,698,893,0,0,78.16,305,362,"玉山村",NULL
600,378,3,381,549,0,0,69.4,177,201,"關山村",NULL
601,323,10,333,422,0,0,78.91,137,186,"光和村",NULL
602,536,23,559,693,0,0,80.66,168,368,"榮和村",NULL
603,418,13,431,523,0,0,82.41,152,266,"左鎮村",NULL
604,664,19,683,864,0,0,79.05,292,372,"中正村",NULL
605,304,5,309,379,0,0,81.53,115,189,"睦光村",NULL
606,347,32,379,469,0,0,80.81,158,189,"內庄村",NULL
607,318,22,340,443,0,0,76.75,99,219,"岡林村",NULL
608,242,6,248,320,0,0,77.5,94,148,"草山村",NULL
609,188,9,197,234,0,0,84.19,69,119,"二寮村",NULL
610,416,17,433,554,0,0,78.16,109,307,"澄山村",NULL
611,1226,30,1256,1498,0,0,83.85,308,918,"太子村",NULL
612,1102,24,1126,1313,0,0,85.76,358,744,"太子村",NULL
613,1045,29,1074,1291,0,0,83.19,290,755,"太子村",NULL
614,884,14,898,1051,0,0,85.44,228,656,"土庫村",NULL
615,1018,21,1039,1204,0,0,86.3,221,797,"土庫村",NULL
616,697,16,713,854,0,0,83.49,210,487,"一甲村",NULL
617,857,24,881,1075,0,0,81.95,262,595,"一甲村",NULL
618,1311,25,1336,1650,0,0,80.97,459,852,"仁德村",NULL
619,928,19,947,1190,0,0,79.58,405,523,"仁德村",NULL
620,1351,25,1376,1707,0,0,80.61,523,828,"仁德村",NULL
621,1221,25,1246,1488,0,0,83.74,506,715,"仁義村",NULL
622,1061,22,1083,1279,0,0,84.68,413,648,"仁義村",NULL
623,706,15,721,895,0,0,80.56,256,450,"仁義村",NULL
624,836,19,855,1072,0,0,79.76,343,493,"仁義村",NULL
625,690,21,711,854,0,0,83.26,241,449,"仁義村",NULL
626,1105,27,1132,1342,0,0,84.35,356,749,"仁義村",NULL
627,675,13,688,859,0,0,80.09,232,443,"新田村",NULL
628,568,8,576,672,0,0,85.71,211,357,"新田村",NULL
629,906,25,931,1114,0,0,83.57,381,525,"新田村",NULL
630,845,20,865,1036,0,0,83.49,297,548,"後壁村",NULL
631,954,29,983,1152,0,0,85.33,284,670,"後壁村",NULL
632,898,27,925,1117,0,0,82.81,315,583,"後壁村",NULL
633,873,12,885,1068,0,0,82.87,298,575,"後壁村",NULL
634,852,21,873,1119,0,0,78.02,341,511,"後壁村",NULL
635,846,24,870,1072,0,0,81.16,357,489,"後壁村",NULL
636,868,40,908,1129,0,0,80.43,290,578,"上崙村",NULL
637,906,21,927,1087,0,0,85.28,336,570,"上崙村",NULL
638,914,37,951,1134,0,0,83.86,242,672,"上崙村",NULL
639,586,26,612,763,0,0,80.21,193,393,"上崙村",NULL
640,1111,13,1124,1320,0,0,85.15,421,690,"田厝村",NULL
641,579,15,594,706,0,0,84.14,189,390,"三甲村",NULL
642,741,21,762,923,0,0,82.56,250,491,"保安村",NULL
643,1043,36,1079,1305,0,0,82.68,356,687,"保安村",NULL
644,1026,34,1060,1313,0,0,80.73,575,451,"成功村",NULL
645,873,10,883,1062,0,0,83.15,398,475,"成功村",NULL
646,799,23,822,987,0,0,83.28,520,279,"成功村",NULL
647,267,16,283,332,0,0,85.24,103,164,"成功村",NULL
648,889,40,929,1134,0,0,81.92,836,53,"仁和村",NULL
649,763,27,790,957,0,0,82.55,692,71,"仁愛村",NULL
650,892,23,915,1109,0,0,82.51,585,307,"仁愛村",NULL
651,959,19,978,1203,0,0,81.3,432,527,"二行村",NULL
652,666,16,682,844,0,0,80.81,213,453,"二行村",NULL
653,698,29,727,874,0,0,83.18,245,453,"大甲村",NULL
654,860,31,891,1107,0,0,80.49,293,567,"大甲村",NULL
655,1044,46,1090,1260,0,0,86.51,291,753,"中洲村",NULL
656,1114,41,1155,1403,0,0,82.32,403,711,"中生村",NULL
657,1165,27,1192,1407,0,0,84.72,442,723,"南保村",NULL
658,1220,35,1255,1499,0,0,83.72,426,794,"南保村",NULL
659,683,12,695,859,0,0,80.91,207,476,"南保村",NULL
660,849,16,865,1045,0,0,82.78,345,504,"南保村",NULL
661,1241,32,1273,1510,0,0,84.3,445,796,"南興村",NULL
662,1081,19,1100,1370,0,0,80.29,389,692,"南興村",NULL
663,796,26,822,1055,0,0,77.91,257,539,"六甲村",NULL
664,794,33,827,1041,0,0,79.44,243,551,"六甲村",NULL
665,818,29,847,1014,0,0,83.53,263,555,"六甲村",NULL
666,896,10,906,1088,0,0,83.27,354,542,"歸南村",NULL
667,782,11,793,981,0,0,80.84,296,486,"歸南村",NULL
668,1017,18,1035,1263,0,0,81.95,365,652,"後市村",NULL
669,718,21,739,876,0,0,84.36,294,424,"後市村",NULL
670,677,17,694,865,0,0,80.23,248,429,"後市村",NULL
671,1119,13,1132,1369,0,0,82.69,407,712,"文化村",NULL
672,812,14,826,1009,0,0,81.86,331,481,"文化村",NULL
673,651,14,665,846,0,0,78.61,249,402,"辜厝村",NULL
674,687,14,701,857,0,0,81.8,271,416,"辜厝村",NULL
675,845,23,868,1047,0,0,82.9,278,567,"辜厝村",NULL
676,826,20,846,1015,0,0,83.35,282,544,"新厝村",NULL
677,897,22,919,1097,0,0,83.77,260,637,"新厝村",NULL
678,776,17,793,940,0,0,84.36,255,521,"許厝村",NULL
679,749,14,763,951,0,0,80.23,245,504,"許厝村",NULL
680,730,10,740,898,0,0,82.41,233,497,"許厝村",NULL
681,1145,29,1174,1388,0,0,84.58,322,823,"看西村",NULL
682,1048,41,1089,1324,0,0,82.25,364,684,"看東村",NULL
683,919,26,945,1119,0,0,84.45,275,644,"崙頂村",NULL
684,720,18,738,872,0,0,84.63,250,470,"崙頂村",NULL
685,485,10,495,608,0,0,81.41,150,335,"沙崙村",NULL
686,627,23,650,774,0,0,83.98,190,437,"大潭村",NULL
687,764,27,791,920,0,0,85.98,176,588,"大潭村",NULL
688,895,34,929,1200,0,0,77.42,314,581,"武東村",NULL
689,865,16,881,1040,0,0,84.71,352,513,"歸仁村",NULL
690,740,16,756,944,0,0,80.08,298,442,"歸仁村",NULL
691,947,30,977,1169,0,0,83.58,336,611,"八甲村",NULL
692,755,18,773,929,0,0,83.21,231,524,"八甲村",NULL
693,929,22,951,1103,0,0,86.22,313,616,"七甲村",NULL
694,899,20,919,1090,0,0,84.31,278,621,"七甲村",NULL
695,831,22,853,1007,0,0,84.71,236,595,"媽廟村",NULL
696,704,20,724,870,0,0,83.22,241,463,"媽廟村",NULL
697,594,16,610,744,0,0,81.99,154,440,"西埔村",NULL
698,506,9,515,597,0,0,86.26,146,360,"西埔村",NULL
699,883,23,906,1117,0,0,81.11,283,600,"大廟村",NULL
700,883,33,916,1119,0,0,81.86,209,674,"大廟村",NULL
701,708,8,716,875,0,0,81.83,247,461,"關廟村",NULL
702,878,26,904,1080,0,0,83.7,347,531,"關廟村",NULL
703,669,9,678,831,0,0,81.59,230,439,"山西村",NULL
704,858,28,886,1046,0,0,84.7,286,572,"山西村",NULL
705,808,24,832,1022,0,0,81.41,305,503,"香洋村",NULL
706,853,33,886,1062,0,0,83.43,353,500,"香洋村",NULL
707,1063,48,1111,1314,0,0,84.55,354,709,"香洋村",NULL
708,988,35,1023,1210,0,0,84.55,305,683,"北勢村",NULL
709,996,30,1026,1267,0,0,80.98,333,663,"北勢村",NULL
710,701,26,727,877,0,0,82.9,240,461,"新埔村",NULL
711,591,26,617,752,0,0,82.05,159,432,"新光村",NULL
712,1115,20,1135,1399,0,0,81.13,425,690,"五甲村",NULL
713,1093,22,1115,1335,0,0,83.52,400,693,"五甲村",NULL
714,1167,37,1204,1459,0,0,82.52,368,799,"東勢村",NULL
715,1210,33,1243,1536,0,0,80.92,444,766,"東勢村",NULL
716,695,19,714,848,0,0,84.2,236,459,"松腳村",NULL
717,881,24,905,1067,0,0,84.82,287,594,"松腳村",NULL
718,1173,39,1212,1472,0,0,82.34,387,786,"南花村",NULL
719,794,38,832,1010,0,0,82.38,251,543,"北花村",NULL
720,903,30,933,1117,0,0,83.53,292,611,"北花村",NULL
721,610,16,626,756,0,0,82.8,198,412,"深坑村",NULL
722,627,24,651,789,0,0,82.51,197,430,"深坑村",NULL
723,987,43,1030,1217,0,0,84.63,278,709,"布袋村",NULL
724,630,25,655,753,0,0,86.99,180,450,"田中村",NULL
725,628,25,653,775,0,0,84.26,199,429,"龜洞村",NULL
726,638,23,661,803,0,0,82.32,201,437,"埤頭村",NULL
727,574,24,598,733,0,0,81.58,167,407,"埤頭村",NULL
728,317,17,334,397,0,0,84.13,106,211,"下湖村",NULL
729,924,51,975,1153,0,0,84.56,328,596,"崎頂村",NULL
730,538,28,566,702,0,0,80.63,191,347,"土崎村",NULL
731,132,9,141,199,0,0,70.85,44,88,"中坑村",NULL
732,245,14,259,308,0,0,84.09,104,141,"楠坑村",NULL
733,222,14,236,270,0,0,87.41,88,134,"牛埔村",NULL
734,231,18,249,305,0,0,81.64,91,140,"大坪村",NULL
735,348,16,364,429,0,0,84.85,176,172,"龍船村",NULL
736,296,23,319,381,0,0,83.73,130,166,"石曹村",NULL
737,1015,17,1032,1291,0,0,79.94,480,535,"五王里",NULL
738,1027,18,1045,1299,0,0,80.45,435,592,"五王里",NULL
739,1292,30,1322,1655,0,0,79.88,600,692,"五王里",NULL
740,1097,26,1123,1395,0,0,80.5,502,595,"三合里",NULL
741,1239,23,1262,1585,0,0,79.62,537,702,"三合里",NULL
742,589,6,595,720,0,0,82.64,222,367,"六合里",NULL
743,631,7,638,778,0,0,82.01,404,227,"六合里",NULL
744,885,20,905,1160,0,0,78.02,343,542,"六合里",NULL
745,779,13,792,1005,0,0,78.81,462,317,"六合里",NULL
746,1135,30,1165,1414,0,0,82.39,452,683,"網寮里",NULL
747,1055,18,1073,1313,0,0,81.72,422,633,"網寮里",NULL
748,1285,15,1300,1614,0,0,80.55,554,731,"網寮里",NULL
749,851,12,863,1122,0,0,76.92,360,491,"二王里",NULL
750,1336,17,1353,1730,0,0,78.21,649,687,"二王里",NULL
751,785,10,795,931,0,0,85.39,353,432,"二王里",NULL
752,806,12,818,1020,0,0,80.2,403,403,"二王里",NULL
753,954,18,972,1192,0,0,81.54,439,515,"二王里",NULL
754,830,23,853,1022,0,0,83.46,326,504,"永康里",NULL
755,893,18,911,1113,0,0,81.85,285,608,"永康里",NULL
756,927,20,947,1208,0,0,78.39,392,535,"永康里",NULL
757,1171,30,1201,1507,0,0,79.69,425,746,"永康里",NULL
758,910,16,926,1286,0,0,72.01,406,504,"永康里",NULL
759,1024,27,1051,1321,0,0,79.56,369,655,"埔園里",NULL
760,1157,19,1176,1430,0,0,82.24,425,732,"埔園里",NULL
761,1171,36,1207,1453,0,0,83.07,414,757,"埔園里",NULL
762,1263,21,1284,1584,0,0,81.06,426,837,"埔園里",NULL
763,1035,14,1049,1274,0,0,82.34,355,680,"正強里",NULL
764,985,32,1017,1247,0,0,81.56,389,596,"正強里",NULL
765,830,17,847,1022,0,0,82.88,280,550,"正強里",NULL
766,972,17,989,1210,0,0,81.74,374,598,"正強里",NULL
767,818,15,833,1056,0,0,78.88,400,418,"正強里",NULL
768,1201,24,1225,1530,0,0,80.07,490,711,"大橋里",NULL
769,1222,14,1236,1503,0,0,82.24,519,703,"大橋里",NULL
770,1058,25,1083,1339,0,0,80.88,501,557,"大橋里",NULL
771,641,11,652,794,0,0,82.12,293,348,"東橋里",NULL
772,560,9,569,682,0,0,83.43,254,306,"東橋里",NULL
773,553,10,563,702,0,0,80.2,203,350,"東橋里",NULL
774,1008,28,1036,1271,0,0,81.51,479,529,"西橋里",NULL
775,987,24,1011,1297,0,0,77.95,445,542,"西橋里",NULL
776,957,22,979,1219,0,0,80.31,431,526,"安康里",NULL
777,1064,25,1089,1331,0,0,81.82,466,598,"安康里",NULL
778,997,7,1004,1318,0,0,76.18,479,518,"安康里",NULL
779,696,17,713,858,0,0,83.1,237,459,"蔦松里",NULL
780,550,18,568,692,0,0,82.08,207,343,"蔦松里",NULL
781,520,15,535,644,0,0,83.07,199,321,"三民里",NULL
782,347,10,357,419,0,0,85.2,100,247,"三民里",NULL
783,1033,10,1043,1311,0,0,79.56,339,694,"鹽行里",NULL
784,1001,18,1019,1274,0,0,79.98,346,655,"鹽行里",NULL
785,1007,12,1019,1252,0,0,81.39,321,686,"鹽行里",NULL
786,1053,21,1074,1370,0,0,78.39,489,564,"鹽行里",NULL
787,958,21,979,1223,0,0,80.05,366,592,"鹽行里",NULL
788,768,19,787,949,0,0,82.93,320,448,"鹽洲里",NULL
789,970,7,977,1148,0,0,85.1,376,594,"鹽洲里",NULL
790,827,22,849,1035,0,0,82.03,270,557,"鹽洲里",NULL
791,1077,25,1102,1307,0,0,84.32,345,732,"鹽洲里",NULL
792,623,11,634,780,0,0,81.28,316,307,"甲頂里",NULL
793,782,6,788,940,0,0,83.83,231,551,"甲頂里",NULL
794,444,16,460,538,0,0,85.5,206,238,"甲頂里",NULL
795,957,19,976,1142,0,0,85.46,292,665,"尚頂里",NULL
796,903,23,926,1108,0,0,83.57,308,595,"尚頂里",NULL
797,962,17,979,1216,0,0,80.51,436,526,"尚頂里",NULL
798,801,32,833,1021,0,0,81.59,206,595,"龍潭里",NULL
799,751,27,778,956,0,0,81.38,202,549,"龍潭里",NULL
800,924,18,942,1173,0,0,80.31,282,642,"龍潭里",NULL
801,866,12,878,1080,0,0,81.3,308,558,"龍潭里",NULL
802,963,12,975,1213,0,0,80.38,385,578,"龍潭里",NULL
803,885,9,894,1089,0,0,82.09,409,476,"龍潭里",NULL
804,1086,25,1111,1323,0,0,83.98,278,808,"王行里",NULL
805,448,5,453,556,0,0,81.47,140,308,"王行里",NULL
806,660,19,679,817,0,0,83.11,181,479,"烏竹里",NULL
807,714,13,727,895,0,0,81.23,289,425,"烏竹里",NULL
808,771,21,792,944,0,0,83.9,252,519,"西勢里",NULL
809,871,26,897,1076,0,0,83.36,257,614,"西勢里",NULL
810,867,13,880,1056,0,0,83.33,329,538,"西勢里",NULL
811,910,17,927,1150,0,0,80.61,383,527,"西勢里",NULL
812,1004,29,1033,1290,0,0,80.08,255,749,"新樹里",NULL
813,817,35,852,1042,0,0,81.77,209,608,"大灣里",NULL
814,712,19,731,863,0,0,84.7,223,489,"大灣里",NULL
815,943,14,957,1120,0,0,85.45,324,619,"大灣里",NULL
816,829,24,853,985,0,0,86.6,206,623,"東灣里",NULL
817,954,21,975,1170,0,0,83.33,278,676,"東灣里",NULL
818,889,11,900,1069,0,0,84.19,370,519,"東灣里",NULL
819,982,39,1021,1247,0,0,81.88,250,732,"西灣里",NULL
820,1204,19,1223,1474,0,0,82.97,450,754,"西灣里",NULL
821,1129,15,1144,1343,0,0,85.18,400,729,"西灣里",NULL
822,1125,8,1133,1340,0,0,84.55,472,653,"西灣里",NULL
823,1093,28,1121,1369,0,0,81.88,379,714,"南灣里",NULL
824,984,27,1011,1187,0,0,85.17,229,755,"南灣里",NULL
825,801,25,826,985,0,0,83.86,185,616,"南灣里",NULL
826,953,16,969,1176,0,0,82.4,412,541,"崑山里",NULL
827,1123,11,1134,1359,0,0,83.44,384,739,"崑山里",NULL
828,1107,7,1114,1346,0,0,82.76,430,677,"崑山里",NULL
829,1217,16,1233,1500,0,0,82.2,399,818,"崑山里",NULL
830,911,21,932,1124,0,0,82.92,307,604,"北灣里",NULL
831,840,21,861,1038,0,0,82.95,278,562,"北灣里",NULL
832,1091,21,1112,1369,0,0,81.23,409,682,"北灣里",NULL
833,831,24,855,1045,0,0,81.82,308,523,"北灣里",NULL
834,992,16,1008,1232,0,0,81.82,339,653,"北灣里",NULL
835,595,26,621,805,0,0,77.14,448,147,"復興里",NULL
836,749,22,771,949,0,0,81.24,560,189,"復興里",NULL
837,876,31,907,1128,0,0,80.41,767,109,"光復里",NULL
838,752,9,761,996,0,0,76.41,663,89,"建國里",NULL
839,710,22,732,910,0,0,80.44,561,149,"建國里",NULL
840,848,10,858,1046,0,0,82.03,478,370,"復國里",NULL
841,900,21,921,1102,0,0,83.58,521,379,"復國里",NULL
842,894,21,915,1181,0,0,77.48,455,439,"復華里",NULL
843,1142,15,1157,1469,0,0,78.76,572,570,"復華里",NULL
844,895,18,913,1109,0,0,82.33,509,386,"復華里",NULL
845,893,11,904,1119,0,0,80.79,485,408,"復華里",NULL
846,906,10,916,1162,0,0,78.83,501,405,"復華里",NULL
847,909,27,936,1177,0,0,79.52,462,447,"復華里",NULL
848,785,10,795,1025,0,0,77.56,445,340,"復華里",NULL
849,717,12,729,891,0,0,81.82,431,286,"復華里",NULL
850,948,15,963,1201,0,0,80.18,569,379,"復華里",NULL
851,751,15,766,903,0,0,84.83,624,127,"神洲里",NULL
852,611,10,621,790,0,0,78.61,400,211,"神洲里",NULL
853,798,12,810,995,0,0,81.41,705,93,"成功里",NULL
854,862,8,870,1092,0,0,79.67,564,298,"成功里",NULL
855,837,15,852,1010,0,0,84.36,420,417,"中華里",NULL
856,853,9,862,1088,0,0,79.23,463,390,"中華里",NULL
857,1066,30,1096,1331,0,0,82.34,570,496,"中興里",NULL
858,1212,18,1230,1449,0,0,84.89,653,559,"中興里",NULL
859,867,13,880,1128,0,0,78.01,474,393,"勝利里",NULL
860,829,14,843,1087,0,0,77.55,393,436,"勝利里",NULL
861,757,17,774,980,0,0,78.98,388,369,"勝利里",NULL
862,889,19,908,1087,0,0,83.53,431,458,"勝利里",NULL
863,867,14,881,1100,0,0,80.09,483,384,"勝利里",NULL
1,503,18,521,621,0,0,83.9,246,257,"鳳崗里",NULL
2,531,8,539,657,0,0,82.04,299,232,"鳳崗里",NULL
3,659,10,669,855,0,0,78.25,346,313,"縣衙里",NULL
4,1047,26,1073,1363,0,0,78.72,455,592,"曹公里",NULL
5,773,15,788,956,0,0,82.43,395,378,"曹公里",NULL
6,1153,13,1166,1438,0,0,81.08,550,603,"鎮西里",NULL
7,986,17,1003,1262,0,0,79.48,411,575,"鎮西里",NULL
8,903,13,916,1141,0,0,80.28,397,506,"鎮西里",NULL
9,958,23,981,1204,0,0,81.48,424,534,"鎮西里",NULL
10,880,20,900,1082,0,0,83.18,389,491,"北門里",NULL
11,833,30,863,1080,0,0,79.91,361,472,"北門里",NULL
12,530,10,540,657,0,0,82.19,231,299,"北門里",NULL
13,906,24,930,1138,0,0,81.72,358,548,"北門里",NULL
14,860,16,876,1078,0,0,81.26,330,530,"鎮北里",NULL
15,1022,17,1039,1313,0,0,79.13,330,692,"鎮北里",NULL
16,656,7,663,826,0,0,80.27,318,338,"鎮北里",NULL
17,969,16,985,1172,0,0,84.04,438,531,"鎮北里",NULL
18,1058,19,1077,1336,0,0,80.61,408,650,"武松里",NULL
19,913,15,928,1093,0,0,84.9,384,529,"武松里",NULL
20,1083,36,1119,1386,0,0,80.74,589,494,"忠誠里",NULL
21,1314,27,1341,1659,0,0,80.83,485,829,"忠誠里",NULL
22,1053,15,1068,1257,0,0,84.96,432,621,"文英里",NULL
23,848,25,873,1071,0,0,81.51,369,479,"文英里",NULL
24,566,8,574,685,0,0,83.8,331,235,"文英里",NULL
25,1397,34,1431,1701,0,0,84.13,943,454,"文華里",NULL
26,792,14,806,994,0,0,81.09,389,403,"文華里",NULL
27,946,15,961,1173,0,0,81.93,401,545,"文華里",NULL
28,990,21,1011,1194,0,0,84.67,491,499,"文華里",NULL
29,829,7,836,995,0,0,84.02,289,540,"文山里",NULL
30,1198,21,1219,1478,0,0,82.48,487,711,"文山里",NULL
31,830,26,856,1056,0,0,81.06,298,532,"文山里",NULL
32,807,9,816,985,0,0,82.84,254,553,"文山里",NULL
33,648,14,662,807,0,0,82.03,360,288,"文山里",NULL
34,1136,19,1155,1378,0,0,83.82,620,516,"文德里",NULL
35,989,12,1001,1278,0,0,78.33,505,484,"文德里",NULL
36,990,13,1003,1224,0,0,81.94,499,491,"文德里",NULL
37,1340,17,1357,1655,0,0,81.99,673,667,"文德里",NULL
38,969,9,978,1172,0,0,83.45,389,580,"文衡里",NULL
39,945,8,953,1153,0,0,82.65,472,473,"文衡里",NULL
40,1007,20,1027,1256,0,0,81.77,564,443,"文福里",NULL
41,964,12,976,1205,0,0,81,464,500,"文福里",NULL
42,837,19,856,1044,0,0,81.99,426,411,"文福里",NULL
43,1013,16,1029,1300,0,0,79.15,508,505,"文福里",NULL
44,863,14,877,1060,0,0,82.74,434,429,"文福里",NULL
45,634,14,648,791,0,0,81.92,247,387,"成功里",NULL
46,394,5,399,483,0,0,82.61,199,195,"縣口里",NULL
47,408,6,414,524,0,0,79.01,161,247,"光明里",NULL
48,643,13,656,785,0,0,83.57,274,369,"光明里",NULL
49,724,10,734,849,0,0,86.45,359,365,"和德里",NULL
50,658,16,674,832,0,0,81.01,292,366,"和德里",NULL
51,1072,15,1087,1256,0,0,86.54,522,550,"和興里",NULL
52,1031,16,1047,1264,0,0,82.83,452,579,"和興里",NULL
53,986,22,1008,1177,0,0,85.64,506,480,"和興里",NULL
54,958,20,978,1186,0,0,82.46,413,545,"和興里",NULL
55,852,24,876,1068,0,0,82.02,362,490,"南興里",NULL
56,915,7,922,1097,0,0,84.05,416,499,"三民里",NULL
57,988,25,1013,1407,0,0,72,413,575,"新興里",NULL
58,929,14,943,1133,0,0,83.23,490,439,"興仁里",NULL
59,661,10,671,829,0,0,80.94,309,352,"興仁里",NULL
60,721,17,738,876,0,0,84.25,355,366,"興仁里",NULL
61,767,10,777,921,0,0,84.36,364,403,"興仁里",NULL
62,668,13,681,802,0,0,84.91,294,374,"興中里",NULL
63,1016,19,1035,1234,0,0,83.87,439,577,"協和里",NULL
64,1112,19,1131,1371,0,0,82.49,597,515,"協和里",NULL
65,933,16,949,1126,0,0,84.28,545,388,"協和里",NULL
66,754,20,774,946,0,0,81.82,400,354,"忠義里",NULL
67,740,11,751,918,0,0,81.81,396,344,"忠義里",NULL
68,773,4,777,969,0,0,80.19,434,339,"忠義里",NULL
69,1081,24,1105,1337,0,0,82.65,479,602,"忠義里",NULL
70,894,18,912,1140,0,0,80,388,506,"忠孝里",NULL
71,883,10,893,1073,0,0,83.22,493,390,"忠孝里",NULL
72,835,23,858,1075,0,0,79.81,439,396,"忠孝里",NULL
73,973,19,992,1181,0,0,84,462,511,"忠孝里",NULL
74,779,14,793,959,0,0,82.69,428,351,"忠孝里",NULL
75,931,11,942,1147,0,0,82.13,432,499,"中和里",NULL
76,779,30,809,995,0,0,81.31,496,283,"中和里",NULL
77,927,20,947,1132,0,0,83.66,546,381,"中和里",NULL
78,365,7,372,461,0,0,80.69,341,24,"誠正里",NULL
79,374,12,386,486,0,0,79.42,364,10,"誠正里",NULL
80,937,14,951,1141,0,0,83.35,698,239,"誠義里",NULL
81,1170,20,1190,1446,0,0,82.3,727,443,"生明里",NULL
82,876,26,902,1136,0,0,79.4,399,477,"鎮東里",NULL
83,747,18,765,958,0,0,79.85,341,406,"鎮東里",NULL
84,875,23,898,1039,0,0,86.43,411,464,"瑞竹里",NULL
85,817,19,836,987,0,0,84.7,507,310,"瑞竹里",NULL
86,836,22,858,1031,0,0,83.22,401,435,"瑞竹里",NULL
87,749,23,772,909,0,0,84.93,416,333,"瑞竹里",NULL
88,740,10,750,919,0,0,81.61,382,358,"瑞竹里",NULL
89,1029,24,1053,1254,0,0,83.97,535,494,"瑞興里",NULL
90,1098,11,1109,1330,0,0,83.38,695,403,"瑞興里",NULL
91,1083,20,1103,1302,0,0,84.72,574,509,"瑞興里",NULL
92,1044,19,1063,1313,0,0,80.96,512,532,"東門里",NULL
93,1536,36,1572,1854,0,0,84.79,1154,382,"東門里",NULL
94,1301,20,1321,1620,0,0,81.54,662,639,"東門里",NULL
95,798,19,817,975,0,0,83.79,531,267,"誠德里",NULL
96,872,18,890,1076,0,0,82.71,522,350,"誠德里",NULL
97,675,10,685,830,0,0,82.53,459,216,"誠信里",NULL
98,674,7,681,837,0,0,81.36,487,187,"誠信里",NULL
99,967,18,985,1225,0,0,80.41,578,389,"誠智里",NULL
100,804,25,829,1007,0,0,82.32,448,356,"誠智里",NULL
101,1122,27,1149,1376,0,0,83.5,505,617,"鳳東里",NULL
102,1044,21,1065,1256,0,0,84.79,460,584,"鳳東里",NULL
103,1129,16,1145,1402,0,0,81.67,524,605,"鳳東里",NULL
104,807,16,823,1006,0,0,81.81,338,469,"埤頂里",NULL
105,1016,23,1039,1248,0,0,83.25,496,520,"埤頂里",NULL
106,864,11,875,1061,0,0,82.47,544,320,"埤頂里",NULL
107,1050,13,1063,1295,0,0,82.08,616,434,"埤頂里",NULL
108,550,14,564,692,0,0,81.5,508,42,"美齡里",NULL
109,904,19,923,1169,0,0,78.96,624,280,"中正里",NULL
110,673,15,688,820,0,0,83.9,640,33,"海光里",NULL
111,484,7,491,618,0,0,79.45,453,31,"海光里",NULL
112,838,2,840,1005,0,0,83.58,536,302,"海光里",NULL
113,1074,13,1087,1326,0,0,81.98,694,380,"海光里",NULL
114,533,10,543,660,0,0,82.27,507,26,"海風里",NULL
115,617,11,628,751,0,0,83.62,581,36,"海風里",NULL
116,736,19,755,912,0,0,82.79,706,30,"海風里",NULL
117,781,11,792,969,0,0,81.73,357,424,"國泰里",NULL
118,684,12,696,850,0,0,81.88,356,328,"國泰里",NULL
119,764,18,782,929,0,0,84.18,277,487,"國泰里",NULL
120,1014,15,1029,1236,0,0,83.25,481,533,"國泰里",NULL
121,979,12,991,1235,0,0,80.24,400,579,"國光里",NULL
122,1021,13,1034,1279,0,0,80.84,435,586,"國光里",NULL
123,944,11,955,1152,0,0,82.9,462,482,"國光里",NULL
124,857,12,869,1063,0,0,81.75,270,587,"國隆里",NULL
125,744,15,759,924,0,0,82.14,300,444,"國隆里",NULL
126,578,13,591,718,0,0,82.31,184,394,"國隆里",NULL
127,936,11,947,1156,0,0,81.92,438,498,"國富里",NULL
128,855,11,866,1054,0,0,82.16,428,427,"國富里",NULL
129,832,10,842,1030,0,0,81.75,273,559,"武慶里",NULL
130,887,20,907,1113,0,0,81.49,414,473,"武慶里",NULL
131,693,17,710,866,0,0,81.99,261,432,"武漢里",NULL
132,840,17,857,1060,0,0,80.85,324,516,"武漢里",NULL
133,768,16,784,954,0,0,82.18,352,416,"武漢里",NULL
134,829,11,840,1025,0,0,81.95,369,460,"武漢里",NULL
135,779,7,786,908,0,0,86.56,287,492,"新甲里",NULL
136,589,5,594,775,0,0,76.65,212,377,"新甲里",NULL
137,574,9,583,705,0,0,82.7,227,347,"新甲里",NULL
138,810,21,831,1020,0,0,81.47,325,485,"新武里",NULL
139,745,13,758,932,0,0,81.33,252,493,"新武里",NULL
140,680,21,701,836,0,0,83.85,253,427,"新泰里",NULL
141,681,6,687,846,0,0,81.21,300,381,"新泰里",NULL
142,842,10,852,1046,0,0,81.45,461,381,"新泰里",NULL
143,769,14,783,946,0,0,82.77,289,480,"新樂里",NULL
144,901,21,922,1105,0,0,83.44,363,538,"新樂里",NULL
145,1083,17,1100,1307,0,0,84.16,538,545,"新樂里",NULL
146,1025,17,1042,1247,0,0,83.56,369,656,"新強里",NULL
147,1057,11,1068,1264,0,0,84.49,428,629,"新強里",NULL
148,1118,9,1127,1355,0,0,83.17,500,618,"新強里",NULL
149,725,8,733,851,0,0,86.13,211,514,"海洋里",NULL
150,771,9,780,969,0,0,80.5,340,431,"海洋里",NULL
151,1060,9,1069,1279,0,0,83.58,540,520,"海洋里",NULL
152,992,15,1007,1217,0,0,82.74,363,629,"新富里",NULL
153,941,20,961,1179,0,0,81.51,374,567,"新富里",NULL
154,987,9,996,1260,0,0,79.05,391,596,"新富里",NULL
155,1033,30,1063,1316,0,0,80.78,340,693,"老爺里",NULL
156,1097,28,1125,1346,0,0,83.58,373,724,"老爺里",NULL
157,1113,26,1139,1369,0,0,83.2,386,727,"老爺里",NULL
158,901,20,921,1145,0,0,80.44,309,592,"老爺里",NULL
159,796,14,810,990,0,0,81.82,264,532,"老爺里",NULL
160,751,12,763,937,0,0,81.43,282,469,"中民里",NULL
161,633,11,644,841,0,0,76.58,224,409,"中民里",NULL
162,643,15,658,831,0,0,79.18,250,393,"中民里",NULL
163,636,12,648,825,0,0,78.55,230,406,"中民里",NULL
164,732,12,744,917,0,0,81.13,366,366,"中崙里",NULL
165,866,21,887,1085,0,0,81.75,381,485,"中崙里",NULL
166,839,16,855,1060,0,0,80.66,341,498,"中榮里",NULL
167,756,21,777,943,0,0,82.4,395,361,"中榮里",NULL
168,814,9,823,1006,0,0,81.81,318,496,"中榮里",NULL
169,764,9,773,979,0,0,78.96,312,452,"中榮里",NULL
170,958,30,988,1203,0,0,82.13,485,473,"過埤里",NULL
171,760,16,776,967,0,0,80.25,264,496,"過埤里",NULL
172,936,23,959,1162,0,0,82.53,388,548,"過埤里",NULL
173,1099,26,1125,1404,0,0,80.13,413,686,"正義里",NULL
174,1306,28,1334,1627,0,0,81.99,455,851,"正義里",NULL
175,1169,35,1204,1481,0,0,81.3,377,792,"正義里",NULL
176,1028,18,1046,1285,0,0,81.4,373,655,"正義里",NULL
177,1126,20,1146,1399,0,0,81.92,419,707,"正義里",NULL
178,918,5,923,1143,0,0,80.75,358,560,"正義里",NULL
179,1033,30,1063,1308,0,0,81.27,366,667,"一甲里",NULL
180,800,27,827,989,0,0,83.62,259,541,"一甲里",NULL
181,714,16,730,921,0,0,79.26,226,488,"一甲里",NULL
182,1014,13,1027,1260,0,0,81.51,341,673,"二甲里",NULL
183,821,11,832,1030,0,0,80.78,333,488,"二甲里",NULL
184,1130,22,1152,1361,0,0,84.64,430,700,"二甲里",NULL
185,1208,21,1229,1505,0,0,81.66,454,754,"龍成里",NULL
186,947,29,976,1214,0,0,80.4,327,620,"龍成里",NULL
187,829,19,848,1005,0,0,84.38,332,497,"鎮南里",NULL
188,584,23,607,775,0,0,78.32,221,363,"鎮南里",NULL
189,907,20,927,1157,0,0,80.12,319,588,"鎮南里",NULL
190,811,21,832,1020,0,0,81.57,291,520,"鎮南里",NULL
191,543,5,548,876,0,0,62.56,210,333,"富甲里",NULL
192,501,18,519,615,0,0,84.39,188,313,"富甲里",NULL
193,461,22,483,582,0,0,82.99,173,288,"富甲里",NULL
194,878,15,893,1059,0,0,84.32,345,533,"善美里",NULL
195,843,19,862,1036,0,0,83.2,336,507,"善美里",NULL
196,916,20,936,1156,0,0,80.97,385,531,"善美里",NULL
197,1035,20,1055,1324,0,0,79.68,463,572,"善美里",NULL
198,763,22,785,969,0,0,81.01,275,488,"富榮里",NULL
199,792,13,805,1005,0,0,80.1,377,415,"富榮里",NULL
200,600,11,611,753,0,0,81.14,218,382,"南和里",NULL
201,652,10,662,805,0,0,82.24,213,439,"南成里",NULL
202,779,14,793,970,0,0,81.75,278,501,"南成里",NULL
203,785,10,795,962,0,0,82.64,295,490,"南成里",NULL
204,552,7,559,693,0,0,80.66,199,353,"南成里",NULL
205,880,28,908,1095,0,0,82.92,290,590,"南成里",NULL
206,887,16,903,1095,0,0,82.47,317,570,"南成里",NULL
207,635,18,653,795,0,0,82.14,236,399,"天興里",NULL
208,717,10,727,924,0,0,78.68,250,467,"天興里",NULL
209,730,15,745,928,0,0,80.28,286,444,"天興里",NULL
210,663,21,684,813,0,0,84.13,264,399,"天興里",NULL
211,998,20,1018,1279,0,0,79.59,359,639,"大德里",NULL
212,1001,24,1025,1249,0,0,82.07,321,680,"大德里",NULL
213,913,17,930,1125,0,0,82.67,331,582,"大德里",NULL
214,763,25,788,921,0,0,85.56,297,466,"五福里",NULL
215,826,19,845,1038,0,0,81.41,320,506,"五福里",NULL
216,878,12,890,1092,0,0,81.5,355,523,"五福里",NULL
217,879,19,898,1072,0,0,83.77,329,550,"福興里",NULL
218,852,18,870,1013,0,0,85.88,328,524,"福興里",NULL
219,894,22,916,1120,0,0,81.79,317,577,"福興里",NULL
220,748,15,763,960,0,0,79.48,281,467,"福興里",NULL
221,917,15,932,1150,0,0,81.04,326,591,"福興里",NULL
222,914,20,934,1133,0,0,82.44,280,634,"福祥里",NULL
223,1149,13,1162,1436,0,0,80.92,419,730,"福祥里",NULL
224,745,16,761,925,0,0,82.27,298,447,"福誠里",NULL
225,727,16,743,915,0,0,81.2,216,511,"福誠里",NULL
226,814,8,822,1008,0,0,81.55,321,493,"福誠里",NULL
227,1130,30,1160,1369,0,0,84.73,392,738,"仁愛村",NULL
228,994,36,1030,1250,0,0,82.4,380,614,"仁愛村",NULL
229,835,23,858,1043,0,0,82.26,346,489,"林園村",NULL
230,797,19,816,978,0,0,83.44,305,492,"林園村",NULL
231,772,5,777,974,0,0,79.77,336,436,"林園村",NULL
232,902,28,930,1110,0,0,83.78,386,516,"文賢村",NULL
233,736,21,757,946,0,0,80.02,267,469,"文賢村",NULL
234,951,31,982,1198,0,0,81.97,416,535,"東林村",NULL
235,991,36,1027,1313,0,0,78.22,419,572,"東林村",NULL
236,944,35,979,1176,0,0,83.25,294,650,"溪州村",NULL
237,842,35,877,1100,0,0,79.73,273,569,"溪州村",NULL
238,847,30,877,1093,0,0,80.24,316,531,"溪州村",NULL
239,780,26,806,1008,0,0,79.96,243,537,"五福村",NULL
240,622,3,625,843,0,0,74.14,189,433,"五福村",NULL
241,1030,30,1060,1294,0,0,81.92,390,640,"潭頭村",NULL
242,863,45,908,1132,0,0,80.21,376,487,"潭頭村",NULL
243,1132,43,1175,1440,0,0,81.6,323,809,"中厝村",NULL
244,898,52,950,1159,0,0,81.97,501,397,"中厝村",NULL
245,719,26,745,912,0,0,81.69,270,449,"林內村",NULL
246,644,33,677,843,0,0,80.31,459,185,"林內村",NULL
247,828,17,845,1030,0,0,82.04,367,461,"王公村",NULL
248,820,17,837,1008,0,0,83.04,321,499,"王公村",NULL
249,828,28,856,1030,0,0,83.11,276,552,"王公村",NULL
250,760,22,782,959,0,0,81.54,260,500,"廣應村",NULL
251,827,21,848,1048,0,0,80.92,306,521,"廣應村",NULL
252,685,29,714,874,0,0,81.69,270,415,"廣應村",NULL
253,916,42,958,1202,0,0,79.7,308,608,"林家村",NULL
254,654,22,676,846,0,0,79.91,249,405,"龔厝村",NULL
255,655,37,692,816,0,0,84.8,234,421,"龔厝村",NULL
256,643,27,670,816,0,0,82.11,232,411,"中門村",NULL
257,893,12,905,1147,0,0,78.9,306,587,"中門村",NULL
258,745,13,758,967,0,0,78.39,232,513,"頂厝村",NULL
259,835,19,854,1050,0,0,81.33,291,544,"頂厝村",NULL
260,1231,23,1254,1555,0,0,80.64,433,798,"頂厝村",NULL
261,693,22,715,876,0,0,81.62,196,497,"港埔村",NULL
262,609,18,627,777,0,0,80.69,211,398,"港埔村",NULL
263,1105,25,1130,1362,0,0,82.97,333,772,"港嘴村",NULL
264,715,25,740,909,0,0,81.41,257,458,"西溪村",NULL
265,720,16,736,912,0,0,80.7,217,503,"西溪村",NULL
266,792,28,820,996,0,0,82.33,219,573,"西溪村",NULL
267,722,26,748,946,0,0,79.07,165,557,"中芸村",NULL
268,595,22,617,754,0,0,81.83,163,432,"中芸村",NULL
269,603,8,611,745,0,0,82.01,137,466,"鳳芸村",NULL
270,722,29,751,930,0,0,80.75,244,478,"鳳芸村",NULL
271,699,27,726,908,0,0,79.96,215,484,"東汕村",NULL
272,568,20,588,757,0,0,77.68,138,430,"西汕村",NULL
273,858,34,892,1119,0,0,79.71,195,663,"中汕村",NULL
274,747,38,785,1029,0,0,76.29,186,561,"中汕村",NULL
275,430,21,451,616,0,0,73.21,284,146,"北汕村",NULL
276,614,21,635,854,0,0,74.36,207,407,"北汕村",NULL
277,780,21,801,954,0,0,83.96,217,563,"義和村",NULL
278,830,26,856,1069,0,0,80.07,271,559,"義和村",NULL
279,1153,43,1196,1418,0,0,84.34,356,797,"溪寮村",NULL
280,589,3,592,685,0,0,86.42,184,405,"江山村",NULL
281,713,13,726,842,0,0,86.22,254,459,"江山村",NULL
282,894,14,908,1109,0,0,81.88,347,547,"中庄村",NULL
283,802,20,822,1008,0,0,81.55,261,541,"中庄村",NULL
284,696,16,712,869,0,0,81.93,268,428,"中庄村",NULL
285,902,19,921,1127,0,0,81.72,359,543,"中庄村",NULL
286,750,12,762,963,0,0,79.13,237,513,"中庄村",NULL
287,938,9,947,1132,0,0,83.66,372,566,"中庄村",NULL
288,810,22,832,1039,0,0,80.08,359,451,"中庄村",NULL
289,902,17,919,1143,0,0,80.4,296,606,"中庄村",NULL
290,832,32,864,1113,0,0,77.63,323,509,"後庄村",NULL
291,1004,24,1028,1259,0,0,81.65,421,583,"後庄村",NULL
292,930,21,951,1192,0,0,79.78,315,615,"後庄村",NULL
293,1256,18,1274,1608,0,0,79.23,519,737,"後庄村",NULL
294,768,25,793,920,0,0,86.2,235,533,"前庄村",NULL
295,846,11,857,1070,0,0,80.09,394,452,"前庄村",NULL
296,1190,27,1217,1444,0,0,84.28,705,485,"中興村",NULL
297,963,24,987,1219,0,0,80.97,550,413,"中興村",NULL
298,880,16,896,1080,0,0,82.96,541,339,"中興村",NULL
299,794,26,820,954,0,0,85.95,585,209,"中興村",NULL
300,739,20,759,892,0,0,85.09,490,249,"中興村",NULL
301,655,17,672,814,0,0,82.56,562,93,"忠義村",NULL
302,908,22,930,1115,0,0,83.41,766,142,"忠義村",NULL
303,787,28,815,993,0,0,82.07,722,65,"光武村",NULL
304,789,26,815,1002,0,0,81.34,747,42,"光武村",NULL
305,643,22,665,796,0,0,83.54,624,19,"復興村",NULL
306,710,25,735,887,0,0,82.86,670,40,"復興村",NULL
307,798,18,816,976,0,0,83.61,759,39,"復興村",NULL
308,698,23,721,860,0,0,83.84,645,53,"復興村",NULL
309,1260,29,1289,1516,0,0,85.03,302,958,"翁園村",NULL
310,1099,32,1131,1333,0,0,84.85,252,847,"翁園村",NULL
311,669,37,706,833,0,0,84.75,151,518,"琉球村",NULL
312,813,4,817,986,0,0,82.86,230,583,"琉球村",NULL
313,1014,49,1063,1248,0,0,85.18,330,684,"琉球村",NULL
314,740,25,765,941,0,0,81.3,233,507,"永芳村",NULL
315,759,18,777,945,0,0,82.22,242,517,"永芳村",NULL
316,829,23,852,1029,0,0,82.8,245,584,"永芳村",NULL
317,714,23,737,907,0,0,81.26,299,415,"永芳村",NULL
318,954,17,971,1168,0,0,83.13,443,511,"永芳村",NULL
319,817,24,841,1004,0,0,83.76,354,463,"永芳村",NULL
320,934,28,962,1130,0,0,85.13,299,635,"山頂村",NULL
321,796,25,821,1014,0,0,80.97,435,361,"山頂村",NULL
322,679,6,685,935,0,0,73.26,404,275,"山頂村",NULL
323,958,23,981,1178,0,0,83.28,444,514,"山頂村",NULL
324,1212,28,1240,1481,0,0,83.73,644,568,"山頂村",NULL
325,712,25,737,1040,0,0,70.87,379,333,"會社村",NULL
326,888,19,907,1079,0,0,84.06,437,451,"會社村",NULL
327,1207,23,1230,1502,0,0,81.89,456,751,"會社村",NULL
328,825,20,845,1057,0,0,79.94,352,473,"會社村",NULL
329,1089,5,1094,1308,0,0,83.64,325,764,"三隆村",NULL
330,1102,25,1127,1381,0,0,81.61,369,733,"三隆村",NULL
331,981,32,1013,1265,0,0,80.08,327,654,"三隆村",NULL
332,881,29,910,1103,0,0,82.5,237,644,"上寮村",NULL
333,819,22,841,995,0,0,84.52,205,614,"上寮村",NULL
334,871,27,898,1131,0,0,79.4,276,595,"大寮村",NULL
335,939,23,962,1176,0,0,81.8,392,547,"大寮村",NULL
336,851,19,870,1087,0,0,80.04,296,555,"大寮村",NULL
337,917,11,928,1205,0,0,77.01,282,635,"大寮村",NULL
338,764,20,784,954,0,0,82.18,246,518,"大寮村",NULL
339,582,34,616,755,0,0,81.59,149,433,"拷潭村",NULL
340,462,16,478,600,0,0,79.67,136,326,"拷潭村",NULL
341,983,24,1007,1318,0,0,76.4,307,676,"內坑村",NULL
342,818,24,842,1034,0,0,81.43,300,518,"內坑村",NULL
343,796,11,807,1068,0,0,75.56,360,436,"內坑村",NULL
344,349,14,363,442,0,0,82.13,131,218,"內坑村",NULL
345,1088,51,1139,1429,0,0,79.71,307,781,"新厝村",NULL
346,855,29,884,1087,0,0,81.32,304,551,"過溪村",NULL
347,554,23,577,712,0,0,81.04,174,380,"過溪村",NULL
348,953,42,995,1266,0,0,78.59,262,691,"潮寮村",NULL
349,1084,37,1121,1307,0,0,85.77,305,779,"潮寮村",NULL
350,980,37,1017,1246,0,0,81.62,364,616,"會結村",NULL
351,890,21,911,1094,0,0,83.27,214,676,"昭明村",NULL
352,728,33,761,965,0,0,78.86,205,523,"昭明村",NULL
353,743,28,771,968,0,0,79.65,254,489,"昭明村",NULL
354,774,22,796,999,0,0,79.68,267,507,"義仁村",NULL
355,637,26,663,804,0,0,82.46,187,450,"義仁村",NULL
356,836,20,856,1036,0,0,82.63,295,541,"竹寮村",NULL
357,884,21,905,1093,0,0,82.8,435,449,"竹寮村",NULL
358,1352,28,1380,1770,0,0,77.97,539,813,"九曲村",NULL
359,1029,29,1058,1276,0,0,82.92,453,576,"九曲村",NULL
360,912,16,928,1136,0,0,81.69,496,416,"九曲村",NULL
361,1059,33,1092,1322,0,0,82.6,510,549,"久堂村",NULL
362,882,29,911,1076,0,0,84.67,395,487,"久堂村",NULL
363,1229,46,1275,1534,0,0,83.12,546,683,"久堂村",NULL
364,873,39,912,1090,0,0,83.67,213,660,"水安村",NULL
365,870,26,896,1076,0,0,83.27,334,536,"水安村",NULL
366,880,35,915,1102,0,0,83.03,285,595,"水寮村",NULL
367,963,29,992,1177,0,0,84.28,243,720,"水寮村",NULL
368,644,16,660,774,0,0,85.27,152,492,"井腳村",NULL
369,637,8,645,752,0,0,85.77,138,499,"井腳村",NULL
370,963,36,999,1222,0,0,81.75,334,629,"小坪村",NULL
371,589,20,609,717,0,0,84.94,121,468,"龍目村",NULL
372,732,29,761,865,0,0,87.98,149,583,"龍目村",NULL
373,917,28,945,1138,0,0,83.04,299,618,"大樹村",NULL
374,926,13,939,1120,0,0,83.84,288,638,"大樹村",NULL
375,927,31,958,1158,0,0,82.73,304,623,"檨腳村",NULL
376,757,23,780,968,0,0,80.58,272,485,"檨腳村",NULL
377,864,30,894,1091,0,0,81.94,251,613,"檨腳村",NULL
378,879,38,917,1087,0,0,84.36,197,682,"興山村",NULL
379,790,24,814,955,0,0,85.24,217,573,"和山村",NULL
380,767,37,804,976,0,0,82.38,203,564,"姑山村",NULL
381,630,32,662,822,0,0,80.54,194,436,"三和村",NULL
382,1098,30,1128,1338,0,0,84.3,288,810,"大坑村",NULL
383,619,28,647,768,0,0,84.24,133,486,"溪埔村",NULL
384,727,19,746,907,0,0,82.25,330,397,"溪埔村",NULL
385,793,28,821,1007,0,0,81.53,205,588,"興田村",NULL
386,774,21,795,913,0,0,87.08,547,227,"興田村",NULL
387,488,21,509,614,0,0,82.9,113,375,"統嶺村",NULL
388,725,46,771,944,0,0,81.67,266,459,"嘉誠村",NULL
389,898,41,939,1095,0,0,85.75,301,597,"保社村",NULL
390,711,25,736,887,0,0,82.98,314,397,"保社村",NULL
391,823,7,830,996,0,0,83.33,276,547,"大社村",NULL
392,740,32,772,960,0,0,80.42,203,537,"大社村",NULL
393,898,17,915,1069,0,0,85.59,332,566,"大社村",NULL
394,893,8,901,1064,0,0,84.68,344,549,"大社村",NULL
395,965,38,1003,1195,0,0,83.93,322,643,"保安村",NULL
396,1100,33,1133,1335,0,0,84.87,394,706,"保安村",NULL
397,1181,46,1227,1489,0,0,82.4,381,800,"三奶村",NULL
398,830,27,857,1017,0,0,84.27,347,483,"三奶村",NULL
399,752,39,791,906,0,0,87.31,246,506,"觀音村",NULL
400,1128,38,1166,1436,0,0,81.2,383,745,"觀音村",NULL
401,937,27,964,1150,0,0,83.83,350,587,"觀音村",NULL
402,891,15,906,1092,0,0,82.97,350,541,"觀音村",NULL
403,994,7,1001,1230,0,0,81.38,360,634,"神農村",NULL
404,914,37,951,1190,0,0,79.92,336,578,"神農村",NULL
405,900,45,945,1151,0,0,82.1,353,547,"神農村",NULL
406,1100,51,1151,1377,0,0,83.59,351,749,"中里村",NULL
407,1075,22,1097,1303,0,0,84.19,443,632,"中里村",NULL
408,1185,42,1227,1471,0,0,83.41,339,846,"翠屏村",NULL
409,1159,26,1185,1489,0,0,79.58,405,754,"仁武村",NULL
410,1074,27,1101,1315,0,0,83.73,364,710,"仁武村",NULL
411,1205,41,1246,1440,0,0,86.53,389,816,"仁武村",NULL
412,929,36,965,1162,0,0,83.05,250,679,"文武村",NULL
413,945,29,974,1180,0,0,82.54,354,591,"文武村",NULL
414,1096,42,1138,1368,0,0,83.19,350,746,"文武村",NULL
415,1261,21,1282,1534,0,0,83.57,532,729,"文武村",NULL
416,824,26,850,1029,0,0,82.6,208,616,"後安村",NULL
417,924,19,943,1138,0,0,82.86,290,634,"後安村",NULL
418,944,15,959,1110,0,0,86.4,226,718,"竹後村",NULL
419,871,27,898,1080,0,0,83.15,213,658,"竹後村",NULL
420,1039,35,1074,1362,0,0,78.85,384,655,"中華村",NULL
421,971,21,992,1190,0,0,83.36,294,677,"八卦村",NULL
422,927,11,938,1143,0,0,82.06,340,587,"八卦村",NULL
423,860,12,872,1071,0,0,81.42,361,499,"八卦村",NULL
424,1274,31,1305,1588,0,0,82.18,479,795,"八卦村",NULL
425,1384,24,1408,1707,0,0,82.48,638,746,"八卦村",NULL
426,954,25,979,1212,0,0,80.78,302,652,"五和村",NULL
427,874,25,899,1093,0,0,82.25,323,551,"五和村",NULL
428,729,20,749,897,0,0,83.5,229,500,"高楠村",NULL
429,692,31,723,830,0,0,87.11,226,466,"高楠村",NULL
430,984,27,1011,1195,0,0,84.6,311,673,"大灣村",NULL
431,573,13,586,720,0,0,81.39,223,350,"大灣村",NULL
432,943,21,964,1158,0,0,83.25,337,606,"赤山村",NULL
433,1094,21,1115,1299,0,0,85.84,400,694,"赤山村",NULL
434,911,18,929,1086,0,0,85.54,290,621,"仁和村",NULL
435,734,9,743,918,0,0,80.94,315,419,"仁和村",NULL
436,1243,32,1275,1550,0,0,82.26,419,824,"灣內村",NULL
437,1226,33,1259,1605,0,0,78.44,382,844,"灣內村",NULL
438,1089,17,1106,1307,0,0,84.62,446,643,"仁慈村",NULL
439,914,30,944,1170,0,0,80.68,417,497,"考潭村",NULL
440,959,30,989,1227,0,0,80.6,405,554,"考潭村",NULL
441,735,28,763,929,0,0,82.13,335,400,"烏林村",NULL
442,653,21,674,806,0,0,83.62,233,420,"烏林村",NULL
443,925,26,951,1177,0,0,80.8,379,546,"烏林村",NULL
444,475,20,495,600,0,0,82.5,148,327,"仁福村",NULL
445,1274,26,1300,1594,0,0,81.56,513,761,"鳥松村",NULL
446,1192,23,1215,1482,0,0,81.98,542,650,"鳥松村",NULL
447,1208,19,1227,1554,0,0,78.96,504,704,"鳥松村",NULL
448,1320,10,1330,1643,0,0,80.95,634,686,"鳥松村",NULL
449,1162,35,1197,1451,0,0,82.49,446,716,"鳥松村",NULL
450,999,29,1028,1225,0,0,83.92,380,619,"夢裡村",NULL
451,1300,32,1332,1607,0,0,82.89,560,740,"夢裡村",NULL
452,1254,8,1262,1501,0,0,84.08,463,791,"大華村",NULL
453,1266,26,1292,1579,0,0,81.82,612,654,"大華村",NULL
454,1211,16,1227,1495,0,0,82.07,554,657,"大華村",NULL
455,1370,14,1384,1656,0,0,83.57,614,756,"大華村",NULL
456,1142,20,1162,1406,0,0,82.65,530,612,"大華村",NULL
457,1169,27,1196,1434,0,0,83.4,344,825,"濫埔村",NULL
458,1244,29,1273,1510,0,0,84.3,437,807,"濫埔村",NULL
459,1029,33,1062,1270,0,0,83.62,319,710,"仁美村",NULL
460,1041,34,1075,1256,0,0,85.59,384,657,"仁美村",NULL
461,1341,27,1368,1653,0,0,82.76,449,892,"仁美村",NULL
462,1187,26,1213,1523,0,0,79.65,478,709,"仁美村",NULL
463,1237,41,1278,1574,0,0,81.19,528,709,"華美村",NULL
464,1352,23,1375,1661,0,0,82.78,542,810,"華美村",NULL
465,562,21,583,697,0,0,83.64,198,364,"大竹村",NULL
466,1133,24,1157,1376,0,0,84.08,553,580,"岡山里",NULL
467,927,20,947,1188,0,0,79.71,394,533,"岡山里",NULL
468,945,25,970,1220,0,0,79.51,362,583,"岡山里",NULL
469,973,25,998,1235,0,0,80.81,389,584,"平安里",NULL
470,1058,25,1083,1301,0,0,83.24,545,513,"壽天里",NULL
471,943,15,958,1168,0,0,82.02,504,439,"壽天里",NULL
472,520,9,529,655,0,0,80.76,178,342,"壽天里",NULL
473,466,15,481,590,0,0,81.53,183,283,"維仁里",NULL
474,473,21,494,608,0,0,81.25,177,296,"維仁里",NULL
475,1099,43,1142,1339,0,0,85.29,450,649,"灣裡里",NULL
476,1028,40,1068,1250,0,0,85.44,238,790,"大遼里",NULL
477,984,27,1011,1241,0,0,81.47,350,634,"後紅里",NULL
478,1454,18,1472,1806,0,0,81.51,827,627,"後紅里",NULL
479,1301,27,1328,1585,0,0,83.79,572,729,"碧紅里",NULL
480,1139,17,1156,1395,0,0,82.87,506,633,"碧紅里",NULL
481,1320,29,1349,1593,0,0,84.68,601,719,"程香里",NULL
482,1167,32,1199,1452,0,0,82.58,635,532,"程香里",NULL
483,1218,19,1237,1525,0,0,81.11,596,622,"竹圍里",NULL
484,1254,10,1264,1537,0,0,82.24,559,695,"竹圍里",NULL
485,1125,34,1159,1370,0,0,84.6,432,693,"竹圍里",NULL
486,1493,45,1538,1886,0,0,81.55,577,916,"臺上里",NULL
487,1510,42,1552,1842,0,0,84.26,626,884,"臺上里",NULL
488,482,37,519,596,0,0,87.08,128,354,"為隨里",NULL
489,917,36,953,1121,0,0,85.01,378,539,"前峰里",NULL
490,1050,38,1088,1322,0,0,82.3,499,551,"前峰里",NULL
491,836,21,857,1045,0,0,82.01,401,435,"壽峰里",NULL
492,749,9,758,889,0,0,85.26,368,381,"壽峰里",NULL
493,867,17,884,1049,0,0,84.27,346,521,"仁壽里",NULL
494,778,20,798,960,0,0,83.13,363,415,"仁壽里",NULL
495,1033,25,1058,1264,0,0,83.7,558,475,"仁壽里",NULL
496,1045,37,1082,1306,0,0,82.85,494,551,"協和里",NULL
497,1133,8,1141,1401,0,0,81.44,514,619,"協和里",NULL
498,422,11,433,509,0,0,85.07,387,35,"協和里",NULL
499,1166,47,1213,1449,0,0,83.71,398,768,"本洲里",NULL
500,889,27,916,1136,0,0,80.63,455,434,"後協里",NULL
501,868,19,887,1072,0,0,82.74,408,460,"後協里",NULL
502,894,18,912,1116,0,0,81.72,499,395,"後協里",NULL
503,1126,23,1149,1411,0,0,81.43,667,459,"後協里",NULL
504,930,36,966,1164,0,0,82.99,538,392,"協榮里",NULL
505,650,12,662,795,0,0,83.27,411,239,"協榮里",NULL
506,1082,43,1125,1326,0,0,84.84,298,784,"劉厝里",NULL
507,1035,27,1062,1229,0,0,86.41,465,570,"白米里",NULL
508,1013,39,1052,1246,0,0,84.43,259,754,"石潭里",NULL
509,826,33,859,1003,0,0,85.64,348,478,"福興里",NULL
510,876,40,916,1086,0,0,84.35,249,627,"嘉興里",NULL
511,807,38,845,1012,0,0,83.5,230,577,"嘉興里",NULL
512,858,32,890,1093,0,0,81.43,258,600,"嘉興里",NULL
513,1073,44,1117,1329,0,0,84.05,406,667,"嘉峰里",NULL
514,258,8,266,304,0,0,87.5,59,199,"嘉峰里",NULL
515,622,31,653,747,0,0,87.42,183,439,"潭底里",NULL
516,1105,63,1168,1352,0,0,86.39,199,906,"華崗里",NULL
517,632,4,636,772,0,0,82.38,136,496,"三和里",NULL
518,714,35,749,892,0,0,83.97,331,383,"大莊里",NULL
519,331,5,336,427,0,0,78.69,202,129,"忠孝里",NULL
520,743,16,759,924,0,0,82.14,626,117,"和平里",NULL
521,782,4,786,937,0,0,83.88,674,108,"信義里",NULL
522,966,22,988,1192,0,0,82.89,587,379,"信義里",NULL
523,484,11,495,584,0,0,84.76,466,18,"仁愛里",NULL
524,611,21,632,762,0,0,82.94,594,17,"仁愛里",NULL
525,444,7,451,533,0,0,84.62,430,14,"四維里",NULL
526,537,14,551,639,0,0,86.23,509,28,"四維里",NULL
527,357,8,365,445,0,0,82.02,348,9,"復興里",NULL
528,854,26,880,1036,0,0,84.94,314,540,"橋頭村",NULL
529,594,15,609,721,0,0,84.47,215,379,"橋頭村",NULL
530,923,21,944,1121,0,0,84.21,327,596,"橋南村",NULL
531,717,30,747,907,0,0,82.36,220,497,"仕隆村",NULL
532,992,36,1028,1225,0,0,83.92,324,668,"仕隆村",NULL
533,847,27,874,1064,0,0,82.14,328,519,"仕豐村",NULL
534,909,24,933,1130,0,0,82.57,316,593,"仕豐村",NULL
535,950,33,983,1148,0,0,85.63,286,664,"仕和村",NULL
536,950,25,975,1142,0,0,85.38,325,625,"仕和村",NULL
537,829,18,847,987,0,0,85.82,295,534,"仕和村",NULL
538,652,40,692,794,0,0,87.15,162,490,"新莊村",NULL
539,265,7,272,311,0,0,87.46,89,176,"新莊村",NULL
540,156,5,161,185,0,0,87.03,129,27,"新莊村",NULL
541,924,44,968,1114,0,0,86.89,272,652,"甲北村",NULL
542,675,23,698,848,0,0,82.31,264,411,"甲北村",NULL
543,873,33,906,1093,0,0,82.89,331,542,"甲南村",NULL
544,861,38,899,1045,0,0,86.03,301,560,"甲南村",NULL
545,875,31,906,1053,0,0,86.04,288,587,"頂鹽村",NULL
546,1281,37,1318,1608,0,0,81.97,451,830,"白樹村",NULL
547,721,13,734,873,0,0,84.08,245,476,"白樹村",NULL
548,216,10,226,269,0,0,84.01,212,4,"白樹村",NULL
549,915,44,959,1118,0,0,85.78,223,692,"芋寮村",NULL
550,619,20,639,740,0,0,86.35,141,478,"三德村",NULL
551,607,10,617,730,0,0,84.52,136,471,"西林村",NULL
552,617,23,640,759,0,0,84.32,193,424,"西林村",NULL
553,842,38,880,1059,0,0,83.1,237,605,"東林村",NULL
554,913,33,946,1104,0,0,85.69,237,676,"東林村",NULL
555,916,15,931,1096,0,0,84.95,280,636,"德松村",NULL
556,493,17,510,586,0,0,87.03,169,324,"筆秀村",NULL
557,725,31,756,902,0,0,83.81,184,541,"筆秀村",NULL
558,511,32,543,655,0,0,82.9,126,385,"中崎村",NULL
559,356,9,365,440,0,0,82.95,132,224,"金山村",NULL
560,860,47,907,1119,0,0,81.05,239,621,"尖山村",NULL
561,1087,60,1147,1354,0,0,84.71,337,750,"東燕村",NULL
562,712,33,745,882,0,0,84.47,294,418,"東燕村",NULL
563,860,49,909,1076,0,0,84.48,364,496,"西燕村",NULL
564,716,26,742,920,0,0,80.65,275,441,"西燕村",NULL
565,837,31,868,1057,0,0,82.12,330,507,"西燕村",NULL
566,1071,50,1121,1372,0,0,81.71,513,558,"南燕村",NULL
567,1079,39,1118,1341,0,0,83.37,479,600,"南燕村",NULL
568,625,29,654,799,0,0,81.85,222,403,"瓊林村",NULL
569,803,38,841,994,0,0,84.61,258,545,"瓊林村",NULL
570,1130,40,1170,1414,0,0,82.74,364,766,"安招村",NULL
571,1107,65,1172,1409,0,0,83.18,430,677,"安招村",NULL
572,291,43,334,542,0,0,61.62,281,10,"安招村",NULL
573,268,64,332,573,0,0,57.94,257,11,"安招村",NULL
574,704,27,731,868,0,0,84.22,284,420,"角宿村",NULL
575,440,24,464,560,0,0,82.86,93,347,"角宿村",NULL
576,642,18,660,808,0,0,81.68,266,376,"角宿村",NULL
577,862,32,894,1058,0,0,84.5,325,537,"鳳雄村",NULL
578,1035,30,1065,1238,0,0,86.03,509,526,"鳳雄村",NULL
579,747,28,775,939,0,0,82.53,281,466,"橫山村",NULL
580,657,29,686,857,0,0,80.05,241,416,"橫山村",NULL
581,975,49,1024,1237,0,0,82.78,368,607,"深水村",NULL
582,866,44,910,1175,0,0,77.45,372,494,"深水村",NULL
583,286,16,302,368,0,0,82.07,121,165,"鹿埔村",NULL
584,475,44,519,672,0,0,77.23,162,313,"古亭村",NULL
585,755,32,787,965,0,0,81.55,308,447,"崇德村",NULL
586,292,28,320,416,0,0,76.92,128,164,"三和村",NULL
587,720,7,727,888,0,0,81.87,227,493,"西德村",NULL
588,604,32,636,790,0,0,80.51,212,392,"南安村",NULL
589,422,27,449,545,0,0,82.39,95,327,"南安村",NULL
590,336,2,338,421,0,0,80.29,67,269,"大同村",NULL
591,303,23,326,430,0,0,75.81,101,202,"田寮村",NULL
592,683,49,732,886,0,0,82.62,176,507,"七星村",NULL
593,1027,73,1100,1315,0,0,83.65,302,725,"新興村",NULL
594,828,8,836,1013,0,0,82.53,297,531,"阿蓮村",NULL
595,873,41,914,1125,0,0,81.24,329,544,"阿蓮村",NULL
596,868,23,891,1086,0,0,82.04,311,557,"阿蓮村",NULL
597,769,17,786,973,0,0,80.78,297,472,"阿蓮村",NULL
598,1138,40,1178,1452,0,0,81.13,477,661,"南蓮村",NULL
599,1037,31,1068,1254,0,0,85.17,460,577,"南蓮村",NULL
600,1180,47,1227,1473,0,0,83.3,398,782,"清蓮村",NULL
601,878,40,918,1096,0,0,83.76,343,535,"清蓮村",NULL
602,767,37,804,949,0,0,84.72,221,546,"和蓮村",NULL
603,860,52,912,1108,0,0,82.31,256,604,"和蓮村",NULL
604,1042,51,1093,1346,0,0,81.2,415,627,"青旗村",NULL
605,1024,60,1084,1295,0,0,83.71,250,774,"石安村",NULL
606,794,37,831,1007,0,0,82.52,193,601,"中路村",NULL
607,737,37,774,934,0,0,82.87,178,559,"中路村",NULL
608,886,46,932,1119,0,0,83.29,308,578,"峰山村",NULL
609,1041,61,1102,1337,0,0,82.42,448,593,"港後村",NULL
610,415,13,428,512,0,0,83.59,161,254,"港後村",NULL
611,565,37,602,733,0,0,82.13,206,359,"崗山村",NULL
612,655,37,692,819,0,0,84.49,214,441,"復安村",NULL
613,603,24,627,769,0,0,81.53,291,312,"復安村",NULL
614,784,42,826,987,0,0,83.69,212,572,"玉庫村",NULL
615,657,6,663,795,0,0,83.4,314,343,"竹園村",NULL
616,714,56,770,915,0,0,84.15,216,498,"竹園村",NULL
617,983,46,1029,1223,0,0,84.14,427,556,"下坑村",NULL
618,1017,51,1068,1292,0,0,82.66,410,607,"下坑村",NULL
619,774,35,809,952,0,0,84.98,323,451,"甲南村",NULL
620,764,28,792,914,0,0,86.65,405,359,"甲南村",NULL
621,836,51,887,1077,0,0,82.36,462,374,"甲南村",NULL
622,763,30,793,947,0,0,83.74,271,492,"甲北村",NULL
623,809,33,842,1017,0,0,82.79,333,476,"甲北村",NULL
624,609,28,637,781,0,0,81.56,226,383,"社東村",NULL
625,631,36,667,799,0,0,83.48,227,404,"社東村",NULL
626,693,41,734,890,0,0,82.47,289,404,"社中村",NULL
627,845,46,891,1064,0,0,83.74,382,463,"社西村",NULL
628,926,43,969,1153,0,0,84.04,360,566,"社西村",NULL
629,884,41,925,1123,0,0,82.37,349,535,"社南村",NULL
630,927,18,945,1161,0,0,81.4,404,523,"社南村",NULL
631,988,42,1030,1253,0,0,82.2,418,570,"社南村",NULL
632,1204,28,1232,1490,0,0,82.68,544,660,"竹東村",NULL
633,1123,27,1150,1369,0,0,84,485,638,"竹東村",NULL
634,1168,32,1200,1453,0,0,82.59,477,691,"竹南村",NULL
635,978,22,1000,1224,0,0,81.7,477,501,"竹南村",NULL
636,850,39,889,1037,0,0,85.73,361,489,"竹西村",NULL
637,905,26,931,1107,0,0,84.1,432,473,"竹西村",NULL
638,924,34,958,1133,0,0,84.55,395,529,"文南村",NULL
639,861,31,892,1043,0,0,85.52,398,463,"文南村",NULL
640,981,53,1034,1253,0,0,82.52,403,578,"文北村",NULL
641,1141,46,1187,1474,0,0,80.53,460,681,"文北村",NULL
642,955,34,989,1264,0,0,78.24,357,598,"竹滬村",NULL
643,1020,52,1072,1339,0,0,80.06,386,634,"竹滬村",NULL
644,908,48,956,1171,0,0,81.64,315,593,"頂寮村",NULL
645,936,58,994,1196,0,0,83.11,409,527,"新達村",NULL
646,759,31,790,933,0,0,84.67,285,474,"後鄉村",NULL
647,912,35,947,1118,0,0,84.7,360,552,"北嶺村",NULL
648,699,50,749,882,0,0,84.92,239,460,"三爺村",NULL
649,1249,44,1293,1550,0,0,83.42,518,731,"鴨寮村",NULL
650,547,23,570,670,0,0,85.07,246,301,"大湖村",NULL
651,638,23,661,781,0,0,84.64,233,405,"大湖村",NULL
652,925,28,953,1113,0,0,85.62,438,487,"大湖村",NULL
653,834,34,868,1063,0,0,81.66,336,498,"田尾村",NULL
654,582,21,603,727,0,0,82.94,226,356,"湖內村",NULL
655,644,19,663,786,0,0,84.35,180,464,"湖內村",NULL
656,988,10,998,1247,0,0,80.03,498,490,"湖內村",NULL
657,802,26,828,1026,0,0,80.7,428,374,"湖東村",NULL
658,733,20,753,942,0,0,79.94,368,365,"湖東村",NULL
659,638,24,662,802,0,0,82.54,161,477,"海埔村",NULL
660,759,30,789,952,0,0,82.88,250,509,"海埔村",NULL
661,950,50,1000,1171,0,0,85.4,326,624,"海山村",NULL
662,862,39,901,1080,0,0,83.43,229,633,"劉家村",NULL
663,655,26,681,835,0,0,81.56,220,435,"太爺村",NULL
664,559,18,577,686,0,0,84.11,186,373,"公館村",NULL
665,804,14,818,993,0,0,82.38,325,479,"公館村",NULL
666,724,28,752,904,0,0,83.19,226,498,"葉厝村",NULL
667,778,25,803,975,0,0,82.36,252,526,"葉厝村",NULL
668,968,39,1007,1196,0,0,84.2,266,702,"文賢村",NULL
669,714,12,726,917,0,0,79.17,259,455,"中賢村",NULL
670,866,34,900,1115,0,0,80.72,294,572,"葉厝村",NULL
671,792,4,796,991,0,0,80.32,237,555,"逸賢村",NULL
672,612,23,635,751,0,0,84.55,209,403,"忠興村",NULL
673,879,8,887,1042,0,0,85.12,227,652,"福德村",NULL
674,716,19,735,900,0,0,81.67,285,431,"萬福村",NULL
675,1239,50,1289,1604,0,0,80.36,494,745,"白雲村",NULL
676,1039,43,1082,1378,0,0,78.52,370,669,"嘉賜村",NULL
677,1199,20,1219,1466,0,0,83.15,453,746,"嘉賜村",NULL
678,1142,38,1180,1452,0,0,81.27,462,680,"嘉安村",NULL
679,1484,53,1537,1878,0,0,81.84,490,994,"嘉樂村",NULL
680,923,43,966,1190,0,0,81.18,322,601,"嘉泰村",NULL
681,758,23,781,987,0,0,79.13,270,488,"嘉福村",NULL
682,960,32,992,1215,0,0,81.65,319,641,"和協村",NULL
683,981,36,1017,1298,0,0,78.35,365,616,"嘉定村",NULL
684,983,35,1018,1275,0,0,79.84,333,650,"保定村",NULL
685,1353,8,1361,1700,0,0,80.06,489,864,"保定村",NULL
686,946,33,979,1197,0,0,81.79,401,545,"大定村",NULL
687,815,39,854,1064,0,0,80.26,308,507,"光定村",NULL
688,1001,36,1037,1261,0,0,82.24,308,693,"吉定村",NULL
689,1280,58,1338,1720,0,0,77.79,515,765,"崎漏村",NULL
690,1427,17,1444,1908,0,0,75.68,598,829,"崎漏村",NULL
691,539,30,569,708,0,0,80.37,281,258,"永安村",NULL
692,612,31,643,789,0,0,81.5,297,315,"永安村",NULL
693,654,25,679,840,0,0,80.83,316,338,"永華村",NULL
694,702,9,711,881,0,0,80.7,308,394,"永華村",NULL
695,780,25,805,960,0,0,83.85,352,428,"新港村",NULL
696,537,18,555,718,0,0,77.3,164,373,"新港村",NULL
697,544,16,560,706,0,0,79.32,242,302,"新港村",NULL
698,284,9,293,385,0,0,76.1,87,197,"鹽田村",NULL
699,834,46,880,1042,0,0,84.45,418,416,"保寧村",NULL
700,783,14,797,998,0,0,79.86,357,426,"保寧村",NULL
701,1052,49,1101,1281,0,0,85.95,388,664,"維新村",NULL
702,1065,45,1110,1353,0,0,82.04,419,646,"維新村",NULL
703,1188,60,1248,1516,0,0,82.32,505,683,"舊港村",NULL
704,1415,66,1481,1813,0,0,81.69,561,854,"文安村",NULL
705,1545,75,1620,1917,0,0,84.51,630,915,"鹽埕村",NULL
706,788,50,838,998,0,0,83.97,333,455,"過港村",NULL
707,886,32,918,1083,0,0,84.76,377,509,"光和村",NULL
708,1477,40,1517,1842,0,0,82.36,642,835,"彌靖村",NULL
709,489,21,510,597,0,0,85.43,227,262,"彌仁村",NULL
710,591,22,613,728,0,0,84.2,298,293,"彌壽村",NULL
711,1270,47,1317,1552,0,0,84.86,617,653,"彌陀村",NULL
712,634,35,669,846,0,0,79.08,315,319,"海尾村",NULL
713,832,49,881,1010,0,0,87.23,360,472,"漯底村",NULL
714,1611,54,1665,2014,0,0,82.67,697,914,"南寮村",NULL
715,814,33,847,1028,0,0,82.39,222,592,"梓信村",NULL
716,791,17,808,974,0,0,82.96,259,532,"梓信村",NULL
717,768,23,791,950,0,0,83.26,245,523,"梓義村",NULL
718,837,29,866,1076,0,0,80.48,302,535,"梓義村",NULL
719,653,24,677,824,0,0,82.16,236,417,"梓和村",NULL
720,530,19,549,653,0,0,84.07,156,374,"梓和村",NULL
721,659,18,677,796,0,0,85.05,222,437,"梓和村",NULL
722,941,42,983,1124,0,0,87.46,285,656,"梓平村",NULL
723,875,23,898,1055,0,0,85.12,303,572,"中崙村",NULL
724,760,42,802,935,0,0,85.78,234,526,"同安村",NULL
725,913,37,950,1156,0,0,82.18,263,650,"大舍村",NULL
726,947,28,975,1189,0,0,82,343,604,"大舍村",NULL
727,860,32,892,1105,0,0,80.72,319,541,"大舍村",NULL
728,896,41,937,1131,0,0,82.85,311,585,"赤崁村",NULL
729,603,26,629,750,0,0,83.87,214,389,"赤崁村",NULL
730,1102,34,1136,1379,0,0,82.38,346,756,"赤東村",NULL
731,747,32,779,968,0,0,80.48,257,490,"赤東村",NULL
732,529,19,548,687,0,0,79.77,242,287,"赤西村",NULL
733,889,21,910,1113,0,0,81.76,284,605,"禮蚵村",NULL
734,936,31,967,1222,0,0,79.13,317,619,"禮蚵村",NULL
735,820,33,853,1111,0,0,76.78,295,525,"智蚵村",NULL
736,1074,19,1093,1322,0,0,82.68,436,638,"智蚵村",NULL
737,1307,51,1358,1707,0,0,79.55,572,735,"信蚵村",NULL
738,981,27,1008,1174,0,0,85.86,393,588,"茄苳村",NULL
739,745,39,784,1016,0,0,77.17,287,458,"茄苳村",NULL
740,924,36,960,1121,0,0,85.64,320,604,"典寶村",NULL
741,1091,29,1120,1354,0,0,82.72,504,587,"典寶村",NULL
742,909,28,937,1172,0,0,79.95,397,512,"太平里",NULL
743,843,39,882,1150,0,0,76.7,378,465,"太平里",NULL
744,1027,26,1053,1316,0,0,80.02,469,558,"大德里",NULL
745,859,18,877,1133,0,0,77.41,440,419,"大德里",NULL
746,688,19,707,884,0,0,79.98,309,379,"湄洲里",NULL
747,453,12,465,573,0,0,81.15,221,232,"鼓山里",NULL
748,609,12,621,774,0,0,80.23,244,365,"新山里",NULL
749,563,16,579,760,0,0,76.18,210,353,"和平里",NULL
750,431,3,434,561,0,0,77.36,185,246,"竹峰里",NULL
751,684,26,710,904,0,0,78.54,273,411,"瑞吉里",NULL
752,784,28,812,1049,0,0,77.41,318,466,"瑞吉里",NULL
753,1249,13,1262,1615,0,0,78.14,530,719,"永和里",NULL
754,1095,35,1130,1440,0,0,78.47,425,670,"永和里",NULL
755,787,35,822,1057,0,0,77.77,294,493,"三協里",NULL
756,411,17,428,561,0,0,76.29,180,231,"三協里",NULL
757,213,19,232,292,0,0,79.45,91,122,"三協里",NULL
758,752,28,780,1014,0,0,76.92,323,429,"圓富里",NULL
759,602,27,629,850,0,0,74,299,303,"圓富里",NULL
760,794,35,829,1092,0,0,75.92,345,449,"中正里",NULL
761,329,13,342,441,0,0,77.55,229,100,"中正里",NULL
762,672,9,681,944,0,0,72.14,234,438,"大林里",NULL
763,389,20,409,533,0,0,76.74,218,171,"大林里",NULL
764,819,35,854,1003,0,0,85.14,243,576,"上洲里",NULL
765,705,22,727,897,0,0,81.05,172,533,"鯤洲里",NULL
766,1031,56,1087,1338,0,0,81.24,276,755,"大山里",NULL
767,748,42,790,930,0,0,84.95,187,561,"中洲里",NULL
768,1086,41,1127,1372,0,0,82.14,383,703,"南洲里",NULL
769,697,17,714,870,0,0,82.07,228,469,"新光里",NULL
770,933,48,981,1243,0,0,78.92,295,638,"南勝里",NULL
771,864,28,892,1118,0,0,79.79,347,517,"南勝里",NULL
772,712,19,731,920,0,0,79.46,271,441,"東平里",NULL
773,736,31,767,995,0,0,77.09,277,459,"東平里",NULL
774,490,27,517,659,0,0,78.45,193,297,"東昌里",NULL
775,296,7,303,378,0,0,80.16,176,120,"糖廠里",NULL
776,510,20,530,644,0,0,82.3,259,251,"廣福里",NULL
777,156,14,170,205,0,0,82.93,50,106,"中寮里",NULL
778,691,33,724,926,0,0,78.19,266,425,"中圳里",NULL
779,677,25,702,923,0,0,76.06,328,349,"中圳里",NULL
780,996,43,1039,1364,0,0,76.17,379,617,"東門里",NULL
781,1148,36,1184,1496,0,0,79.14,579,569,"泰安里",NULL
782,715,32,747,952,0,0,78.47,346,369,"合和里",NULL
783,996,28,1024,1309,0,0,78.23,518,478,"合和里",NULL
784,911,28,939,1192,0,0,78.78,393,518,"瀰濃里",NULL
785,754,32,786,1017,0,0,77.29,354,400,"瀰濃里",NULL
786,898,34,932,1173,0,0,79.45,361,537,"福安里",NULL
787,1035,11,1046,1369,0,0,76.41,455,580,"福安里",NULL
788,934,42,976,1272,0,0,76.73,373,561,"祿興里",NULL
789,929,39,968,1237,0,0,78.25,442,487,"祿興里",NULL
790,764,31,795,1018,0,0,78.09,379,385,"中壇里",NULL
791,749,32,781,1021,0,0,76.49,363,386,"中壇里",NULL
792,1151,37,1188,1492,0,0,79.62,644,507,"德興里",NULL
793,717,24,741,979,0,0,75.69,310,407,"清水里",NULL
794,561,24,585,741,0,0,78.95,252,309,"清水里",NULL
795,1065,44,1109,1410,0,0,78.65,513,552,"吉和里",NULL
796,739,36,775,996,0,0,77.81,340,399,"吉洋里",NULL
797,762,33,795,1005,0,0,79.1,282,480,"吉洋里",NULL
798,642,22,664,855,0,0,77.66,259,383,"吉東里",NULL
799,645,28,673,861,0,0,78.16,221,424,"吉東里",NULL
800,872,14,886,1143,0,0,77.52,380,492,"龍山里",NULL
801,799,16,815,1048,0,0,77.77,348,451,"龍山里",NULL
802,1070,13,1083,1374,0,0,78.82,335,735,"獅山里",NULL
803,781,18,799,1023,0,0,78.1,331,450,"獅山里",NULL
804,570,21,591,738,0,0,80.08,298,272,"龍肚里",NULL
805,638,42,680,870,0,0,78.16,270,368,"龍肚里",NULL
806,1079,43,1122,1416,0,0,79.24,404,675,"廣德里",NULL
807,912,34,946,1221,0,0,77.48,336,576,"興隆里",NULL
808,636,34,670,873,0,0,76.75,233,403,"廣林里",NULL
809,594,33,627,860,0,0,72.91,235,359,"廣林里",NULL
810,766,51,817,1140,0,0,71.67,314,452,"六龜村",NULL
811,847,34,881,1154,0,0,76.34,378,469,"義寶村",NULL
812,1007,63,1070,1604,0,0,66.71,369,638,"文武村",NULL
813,980,49,1029,1400,0,0,73.5,499,481,"中興村",NULL
814,610,36,646,914,0,0,70.68,223,387,"興龍村",NULL
815,595,26,621,821,0,0,75.64,265,330,"新威村",NULL
816,498,42,540,746,0,0,72.39,181,317,"新興村",NULL
817,455,27,482,632,0,0,76.27,175,280,"新寮村",NULL
818,251,19,270,353,0,0,76.49,104,147,"大津村",NULL
819,824,83,907,1377,0,0,65.87,217,607,"新發村",NULL
820,960,66,1026,1574,0,0,65.18,332,628,"荖濃村",NULL
821,774,33,807,1111,0,0,72.64,337,437,"寶來村",NULL
822,457,14,471,617,0,0,76.34,223,234,"東安村",NULL
823,842,31,873,1084,0,0,80.54,514,328,"西安村",NULL
824,627,36,663,836,0,0,79.31,347,280,"和安村",NULL
825,1212,50,1262,1622,0,0,77.81,632,580,"大田村",NULL
826,554,24,578,724,0,0,79.83,243,311,"寶隆村",NULL
827,527,37,564,736,0,0,76.63,255,272,"關山村",NULL
828,826,37,863,1168,0,0,73.89,384,442,"小林村",NULL
829,540,25,565,763,0,0,74.05,199,341,"杉林村",NULL
830,518,31,549,783,0,0,70.11,193,325,"木梓村",NULL
831,794,33,827,1119,0,0,73.91,293,501,"集來村",NULL
832,531,47,578,779,0,0,74.2,168,363,"集來村",NULL
833,794,58,852,1149,0,0,74.15,501,293,"新庄村",NULL
834,457,30,487,627,0,0,77.67,167,290,"新庄村",NULL
835,1046,48,1094,1520,0,0,71.97,564,482,"上平村",NULL
836,1228,58,1286,1769,0,0,72.7,604,624,"月眉村",NULL
837,944,45,989,1323,0,0,74.75,384,560,"月美村",NULL
838,568,22,590,794,0,0,74.31,184,384,"金竹村",NULL
839,720,39,759,1029,0,0,73.76,335,385,"溝坪村",NULL
840,338,25,363,489,0,0,74.23,161,177,"永興村",NULL
841,368,19,387,477,0,0,81.13,166,202,"永吉村",NULL
842,740,45,785,1044,0,0,75.19,307,433,"永富村",NULL
843,537,23,560,693,0,0,80.81,218,319,"觀亭村",NULL
844,843,35,878,1086,0,0,80.85,367,476,"觀亭村",NULL
845,459,30,489,598,0,0,81.77,218,241,"中埔村",NULL
846,264,18,282,366,0,0,77.05,102,162,"瑞山村",NULL
847,320,11,331,406,0,0,81.53,125,195,"內南村",NULL
848,597,47,644,787,0,0,81.83,262,335,"內東村",NULL
849,481,27,508,642,0,0,79.13,212,269,"光興村",NULL
850,367,21,388,502,0,0,77.29,135,232,"東埔村",NULL
851,898,34,932,1148,0,0,81.18,460,438,"內豊村",NULL
852,761,28,789,997,0,0,79.14,414,347,"內門村",NULL
853,382,17,399,509,0,0,78.39,156,226,"石坑村",NULL
854,512,24,536,688,0,0,77.91,228,284,"三平村",NULL
855,524,20,544,697,0,0,78.05,185,339,"木柵村",NULL
856,460,31,491,636,0,0,77.2,122,338,"內興村",NULL
857,412,11,423,536,0,0,78.92,364,48,"茂林村",NULL
858,225,6,231,292,0,0,79.11,209,16,"萬山村",NULL
859,310,8,318,429,0,0,74.13,289,21,"多納村",NULL
860,139,10,149,197,0,0,75.63,117,22,"寶山村",NULL
861,204,10,214,349,0,0,61.32,182,22,"寶山村",NULL
862,355,19,374,549,0,0,68.12,315,40,"建山村",NULL
863,344,10,354,518,0,0,68.34,290,54,"高中村",NULL
864,517,15,532,759,0,0,70.09,452,65,"桃源村",NULL
865,173,1,174,235,0,0,74.04,157,16,"勤和村",NULL
866,159,4,163,257,0,0,63.42,121,38,"復興村",NULL
867,171,1,172,248,0,0,69.35,126,45,"梅蘭村",NULL
868,189,2,191,242,0,0,78.93,169,20,"梅山村",NULL
869,351,17,368,529,0,0,69.57,252,99,"民族村",NULL
870,401,13,414,592,0,0,69.93,365,36,"民權村",NULL
871,776,7,783,1105,0,0,70.86,694,82,"民生村",NULL
1,1254,11,1265,1515,0,0,83.5,462,792,"大同里、端正里、武廟里",NULL
2,1183,22,1205,1517,0,0,79.43,515,668,"民權里、光榮里",NULL
3,839,13,852,1083,0,0,78.67,514,325,"泰安里、文明里",NULL
4,1081,26,1107,1417,0,0,78.12,444,637,"維新里",NULL
5,1099,30,1129,1427,0,0,79.12,438,661,"維新里",NULL
6,1182,20,1202,1462,0,0,82.22,377,805,"大埔里、必信里",NULL
7,690,20,710,860,0,0,82.56,223,467,"崇禮里、崇智里",NULL
8,696,19,715,874,0,0,81.81,257,439,"平和里",NULL
9,891,11,902,1081,0,0,83.44,354,537,"扶風里、安樂里",NULL
10,1031,17,1048,1293,0,0,81.05,340,691,"勝豐里、金泉里",NULL
11,1181,30,1211,1570,0,0,77.13,524,657,"橋南里",NULL
12,731,9,740,914,0,0,80.96,299,432,"橋北里",NULL
13,1406,20,1426,1713,0,0,83.25,776,630,"大連里",NULL
14,1515,25,1540,1854,0,0,83.06,832,683,"大連里",NULL
15,1491,19,1510,1823,0,0,82.83,842,649,"大連里",NULL
16,1404,13,1417,1717,0,0,82.53,763,641,"大連里",NULL
17,1365,19,1384,1684,0,0,82.19,694,671,"大連里",NULL
18,863,9,872,1098,0,0,79.42,429,434,"豐田里",NULL
19,1121,13,1134,1399,0,0,81.06,595,526,"豐田里",NULL
20,1154,27,1181,1453,0,0,81.28,573,581,"豐田里",NULL
21,985,11,996,1201,0,0,82.93,498,487,"豐榮里",NULL
22,999,13,1012,1255,0,0,80.64,450,549,"豐榮里",NULL
23,999,5,1004,1238,0,0,81.1,550,449,"豐源里",NULL
24,1042,15,1057,1301,0,0,81.25,517,525,"豐源里",NULL
25,964,10,974,1179,0,0,82.61,467,497,"豐源里",NULL
26,873,16,889,1089,0,0,81.63,417,456,"長春里",NULL
27,747,3,750,986,0,0,76.06,382,365,"長春里",NULL
28,681,14,695,816,0,0,85.17,229,452,"慶春里、楠樹里",NULL
29,1198,23,1221,1549,0,0,78.83,621,577,"瑞光里",NULL
30,1333,49,1382,1809,0,0,76.4,629,704,"瑞光里",NULL
31,1206,12,1218,1559,0,0,78.13,606,600,"瑞光里",NULL
32,1309,25,1334,1675,0,0,79.64,747,562,"瑞光里",NULL
33,813,18,831,989,0,0,84.02,183,630,"湖南里",NULL
34,1139,20,1159,1392,0,0,83.26,285,854,"湖西里",NULL
35,878,28,906,1113,0,0,81.4,245,633,"歸心里",NULL
36,1155,20,1175,1458,0,0,80.59,533,622,"清溪里",NULL
37,1186,13,1199,1486,0,0,80.69,607,579,"清溪里",NULL
38,1486,21,1507,1862,0,0,80.93,829,657,"大武里",NULL
39,1153,14,1167,1433,0,0,81.44,648,505,"大武里",NULL
40,1459,26,1485,1789,0,0,83.01,724,735,"大武里",NULL
41,1437,31,1468,1830,0,0,80.22,701,736,"大武里",NULL
42,1121,26,1147,1378,0,0,83.24,940,181,"凌雲里",NULL
43,1019,21,1040,1291,0,0,80.56,770,249,"永順里、永昌里",NULL
44,1146,27,1173,1419,0,0,82.66,1070,76,"鵬程里",NULL
45,758,15,773,921,0,0,83.93,230,528,"安鎮里",NULL
46,888,22,910,1082,0,0,84.1,330,558,"安鎮里",NULL
47,913,28,941,1166,0,0,80.7,387,526,"永光里",NULL
48,808,23,831,1022,0,0,81.31,239,569,"長安里",NULL
49,769,26,795,977,0,0,81.37,301,468,"長安里",NULL
50,1219,29,1248,1541,0,0,80.99,447,772,"前進里",NULL
51,984,20,1004,1229,0,0,81.69,320,664,"前進里",NULL
52,888,35,923,1088,0,0,84.83,223,665,"大洲里",NULL
53,709,10,719,909,0,0,79.1,415,294,"新興里",NULL
54,1168,12,1180,1387,0,0,85.08,379,789,"新興里",NULL
55,1200,21,1221,1482,0,0,82.39,391,809,"公館里",NULL
56,1149,26,1175,1426,0,0,82.4,456,693,"新生里",NULL
57,1220,24,1244,1557,0,0,79.9,709,511,"新生里",NULL
58,1419,32,1451,1781,0,0,81.47,522,897,"新生里",NULL
59,426,6,432,530,0,0,81.51,98,328,"頂宅里",NULL
60,867,15,882,1027,0,0,85.88,308,559,"頂柳里",NULL
61,1261,25,1286,1565,0,0,82.17,397,864,"大湖里",NULL
62,1123,38,1161,1408,0,0,82.46,402,721,"龍華里",NULL
63,754,16,770,981,0,0,78.49,350,404,"龍華里",NULL
64,1108,41,1149,1370,0,0,83.87,295,813,"玉成里",NULL
65,1288,23,1311,1684,0,0,77.85,459,829,"建國里、擇仁里",NULL
66,622,12,634,775,0,0,81.81,229,393,"萬年里",NULL
67,1074,27,1101,1375,0,0,80.07,368,706,"厚生里",NULL
68,1323,25,1348,1649,0,0,81.75,416,907,"厚生里",NULL
69,1341,29,1370,1720,0,0,79.65,772,569,"義勇里、一心里",NULL
70,580,14,594,789,0,0,75.29,222,358,"光華里",NULL
71,1084,13,1097,1393,0,0,78.75,430,654,"永安里",NULL
72,1243,33,1276,1592,0,0,80.15,492,751,"永安里",NULL
73,1449,21,1470,1848,0,0,79.55,690,759,"永安里",NULL
74,1444,14,1458,1825,0,0,79.89,677,767,"永安里",NULL
75,1186,19,1205,1462,0,0,82.42,545,641,"崇蘭里",NULL
76,1622,25,1647,2061,0,0,79.91,826,796,"崇蘭里",NULL
77,1058,15,1073,1344,0,0,79.84,664,394,"崇蘭里",NULL
78,1256,18,1274,1532,0,0,83.16,777,479,"崇蘭里",NULL
79,884,10,894,1052,0,0,84.98,616,268,"崇蘭里",NULL
80,1097,22,1119,1450,0,0,77.17,718,379,"潭墘里",NULL
81,1317,22,1339,1674,0,0,79.99,785,532,"潭墘里",NULL
82,1164,24,1188,1508,0,0,78.78,681,483,"潭墘里",NULL
83,1153,14,1167,1408,0,0,82.88,716,437,"潭墘里",NULL
84,1465,20,1485,1874,0,0,79.24,922,543,"潭墘里",NULL
85,901,12,913,1183,0,0,77.18,530,371,"永城里",NULL
86,856,20,876,1136,0,0,77.11,452,404,"永城里",NULL
87,1275,25,1300,1593,0,0,81.61,895,380,"空翔里",NULL
88,563,23,586,715,0,0,81.96,537,26,"大鵬里",NULL
89,1490,22,1512,1858,0,0,81.38,657,833,"廣興里",NULL
90,1120,22,1142,1694,0,0,67.41,670,450,"勝利里",NULL
91,1140,21,1161,1472,0,0,78.87,648,492,"勝利里",NULL
92,1183,15,1198,1488,0,0,80.51,712,471,"勝利里",NULL
93,813,20,833,1010,0,0,82.48,393,420,"斯文里",NULL
94,866,11,877,1089,0,0,80.53,470,396,"斯文里",NULL
95,1178,21,1199,1444,0,0,83.03,619,559,"華山里",NULL
96,1242,17,1259,1537,0,0,81.91,614,628,"華山里",NULL
97,1533,29,1562,1890,0,0,82.65,894,639,"華山里",NULL
98,1097,18,1115,1401,0,0,79.59,532,565,"溝美里",NULL
99,1117,13,1130,1408,0,0,80.26,609,508,"溝美里",NULL
100,1016,22,1038,1256,0,0,82.64,374,642,"三山里",NULL
101,699,14,713,856,0,0,83.29,208,491,"海豐里",NULL
102,802,23,825,1009,0,0,81.76,294,508,"仁義里",NULL
103,1119,26,1145,1437,0,0,79.68,820,299,"北興里",NULL
104,993,20,1013,1264,0,0,80.14,493,500,"北興里",NULL
105,1257,20,1277,1586,0,0,80.52,639,618,"北興里",NULL
106,1065,13,1078,1355,0,0,79.56,545,520,"北興里",NULL
107,1061,18,1079,1282,0,0,84.17,508,553,"北勢里",NULL
108,915,19,934,1130,0,0,82.65,371,544,"北勢里",NULL
109,1292,21,1313,1622,0,0,80.95,680,612,"中正里",NULL
110,1476,19,1495,1835,0,0,81.47,840,636,"中正里",NULL
111,752,12,764,960,0,0,79.58,397,355,"興樂里",NULL
112,1421,26,1447,1778,0,0,81.38,709,712,"明正里、太平里",NULL
113,1160,38,1198,1472,0,0,81.39,318,842,"信和里",NULL
114,726,18,744,954,0,0,77.99,213,513,"和興里",NULL
115,906,12,918,1139,0,0,80.6,422,484,"仁愛里",NULL
116,904,12,916,1118,0,0,81.93,430,474,"仁愛里",NULL
117,490,7,497,607,0,0,81.88,238,252,"潮州里",NULL
118,1745,36,1781,2279,0,0,78.15,762,983,"光華里",NULL
119,1315,25,1340,1769,0,0,75.75,641,674,"光華里",NULL
120,588,11,599,712,0,0,84.13,191,397,"同榮里",NULL
121,911,7,918,1155,0,0,79.48,348,563,"新生里",NULL
122,1122,22,1144,1456,0,0,78.57,448,674,"新榮里",NULL
123,647,23,670,808,0,0,82.92,170,477,"彭城里",NULL
124,1021,14,1035,1293,0,0,80.05,468,553,"三星里",NULL
125,1205,17,1222,1532,0,0,79.77,586,619,"三星里",NULL
126,1308,16,1324,1672,0,0,79.19,597,711,"三星里",NULL
127,1322,25,1347,1724,0,0,78.13,581,741,"三共里",NULL
128,1505,26,1531,1946,0,0,78.67,660,845,"三共里",NULL
129,1481,19,1500,1928,0,0,77.8,637,844,"三共里",NULL
130,1446,15,1461,1868,0,0,78.21,593,853,"三和里",NULL
131,947,21,968,1197,0,0,80.87,305,642,"五魁里",NULL
132,1411,12,1423,1797,0,0,79.19,470,941,"蓬萊里",NULL
133,1531,37,1568,2042,0,0,76.79,606,925,"八爺里",NULL
134,1575,36,1611,2047,0,0,78.7,665,910,"永春里",NULL
135,1237,30,1267,1618,0,0,78.31,571,666,"永春里",NULL
136,1255,26,1281,1622,0,0,78.98,556,699,"永春里",NULL
137,1086,11,1097,1428,0,0,76.82,533,553,"富春里",NULL
138,1033,10,1043,1325,0,0,78.72,364,669,"光春里",NULL
139,652,15,667,866,0,0,77.02,224,428,"興美里",NULL
140,426,19,445,593,0,0,75.04,198,228,"檨子里",NULL
141,1154,38,1192,1576,0,0,75.63,327,827,"九塊里",NULL
142,1241,40,1281,1563,0,0,81.96,457,784,"泗林里",NULL
143,1475,46,1521,1921,0,0,79.18,456,1019,"四春里",NULL
144,1183,50,1233,1596,0,0,77.26,399,784,"崙東里",NULL
145,889,17,906,1109,0,0,81.7,340,549,"新勝里",NULL
146,978,18,996,1224,0,0,81.37,337,641,"新勝里",NULL
147,465,12,477,579,0,0,82.38,147,318,"頂新里",NULL
148,349,6,355,447,0,0,79.42,121,228,"頂中里",NULL
149,595,12,607,777,0,0,78.12,213,382,"東和里",NULL
150,436,12,448,575,0,0,77.91,161,275,"興台里",NULL
151,974,30,1004,1278,0,0,78.56,365,609,"興東里",NULL
152,725,9,734,904,0,0,81.19,296,429,"興東里",NULL
153,1499,34,1533,1977,0,0,77.54,556,943,"興東里",NULL
154,1386,17,1403,1765,0,0,79.49,498,888,"興東里",NULL
155,596,13,609,733,0,0,83.08,183,413,"興農里",NULL
156,632,11,643,790,0,0,81.39,272,360,"中興里",NULL
157,974,30,1004,1273,0,0,78.87,358,616,"朝安里",NULL
158,497,5,502,607,0,0,82.7,171,326,"朝安里",NULL
159,685,20,705,882,0,0,79.93,246,439,"八德里",NULL
160,1055,25,1080,1368,0,0,78.95,371,684,"東隆里",NULL
161,579,12,591,743,0,0,79.54,192,387,"豐漁里",NULL
162,996,40,1036,1342,0,0,77.2,264,732,"盛漁里",NULL
163,641,17,658,819,0,0,80.34,187,454,"興漁里",NULL
164,880,17,897,1130,0,0,79.38,290,590,"興漁里",NULL
165,953,17,970,1223,0,0,79.31,318,635,"鎮海里",NULL
166,1073,18,1091,1390,0,0,78.49,275,798,"鎮海里",NULL
167,1231,36,1267,1630,0,0,77.73,394,837,"嘉蓮里",NULL
168,377,10,387,505,0,0,76.63,133,244,"南平里",NULL
169,963,20,983,1290,0,0,76.2,356,607,"南平里",NULL
170,809,29,838,1069,0,0,78.39,301,508,"船頭里",NULL
171,1051,27,1078,1337,0,0,80.63,386,665,"船頭里",NULL
172,1115,30,1145,1504,0,0,76.13,388,727,"船頭里",NULL
173,859,24,883,1092,0,0,80.86,164,695,"下廍里",NULL
174,580,15,595,734,0,0,81.06,185,395,"下廍里",NULL
175,1253,36,1289,1618,0,0,79.67,458,795,"大潭里",NULL
176,697,33,730,910,0,0,80.22,172,525,"興和里",NULL
177,584,11,595,763,0,0,77.98,436,148,"共和里",NULL
178,236,14,250,316,0,0,79.11,194,42,"大鵬里",NULL
179,707,20,727,993,0,0,73.21,377,330,"城南里",NULL
180,659,24,683,937,0,0,72.89,261,398,"城北里",NULL
181,778,22,800,1117,0,0,71.62,385,393,"城北里",NULL
182,852,11,863,1178,0,0,73.26,428,424,"城西里",NULL
183,842,16,858,1183,0,0,72.53,424,418,"山腳里",NULL
184,736,24,760,1082,0,0,70.24,312,424,"山腳里",NULL
185,856,25,881,1255,0,0,70.2,444,412,"山腳里",NULL
186,1023,23,1046,1462,0,0,71.55,542,481,"網紗里",NULL
187,795,36,831,1224,0,0,67.89,348,447,"網紗里",NULL
188,527,27,554,807,0,0,68.65,218,309,"仁壽里",NULL
189,314,20,334,479,0,0,69.73,86,228,"茄湖里",NULL
190,293,16,309,467,0,0,66.17,104,189,"頭溝里",NULL
191,612,38,650,920,0,0,70.65,225,387,"四溝里",NULL
192,504,17,521,725,0,0,71.86,214,290,"德和里",NULL
193,662,34,696,994,0,0,70.02,284,378,"龍水里",NULL
194,541,18,559,771,0,0,72.5,182,359,"山海里",NULL
195,505,29,534,759,0,0,70.36,155,350,"山海里",NULL
196,630,26,656,938,0,0,69.94,275,355,"大光里",NULL
197,590,43,633,937,0,0,67.56,300,290,"大光里",NULL
198,427,29,456,703,0,0,64.86,143,284,"水泉里",NULL
199,423,22,445,669,0,0,66.52,166,257,"水泉里",NULL
200,403,15,418,654,0,0,63.91,183,220,"南灣里",NULL
201,497,21,518,724,0,0,71.55,248,249,"南灣里",NULL
202,900,16,916,1257,0,0,72.87,402,498,"墾丁里",NULL
203,714,12,726,1041,0,0,69.74,233,481,"鵝鑾里",NULL
204,1155,31,1186,1455,0,0,81.51,463,692,"香社村",NULL
205,1413,73,1486,1821,0,0,81.6,507,906,"新庄村",NULL
206,740,31,771,935,0,0,82.46,400,340,"新鐘村",NULL
207,719,26,745,924,0,0,80.63,311,408,"新鐘村",NULL
208,436,12,448,521,0,0,85.99,218,218,"水仙村",NULL
209,890,41,931,1124,0,0,82.83,377,513,"興全村",NULL
210,648,17,665,828,0,0,80.31,207,441,"興安村",NULL
211,288,11,299,371,0,0,80.59,128,160,"甘棠村",NULL
212,614,24,638,769,0,0,82.96,262,352,"萬惠村",NULL
213,1406,37,1443,1799,0,0,80.21,564,842,"萬全村",NULL
214,1251,21,1272,1525,0,0,83.41,535,716,"萬全村",NULL
215,381,11,392,495,0,0,79.19,151,230,"萬後村",NULL
216,456,10,466,562,0,0,82.92,195,261,"萬安村",NULL
217,1022,26,1048,1255,0,0,83.51,423,599,"萬生村",NULL
218,785,27,812,1000,0,0,81.2,321,464,"寶厝村",NULL
219,834,19,853,1041,0,0,81.94,344,490,"寶厝村",NULL
220,1391,17,1408,1741,0,0,80.87,505,886,"四維村",NULL
221,1176,48,1224,1508,0,0,81.17,401,775,"竹林村",NULL
222,1121,35,1156,1381,0,0,83.71,424,697,"水泉村",NULL
223,758,19,777,902,0,0,86.14,203,555,"田厝村",NULL
224,1336,26,1362,1664,0,0,81.85,484,852,"崙頂村",NULL
225,1291,51,1342,1616,0,0,83.04,338,953,"廈北村",NULL
226,1088,28,1116,1397,0,0,79.89,364,724,"廈南村",NULL
227,798,30,828,1005,0,0,82.39,283,515,"後村村",NULL
228,1007,37,1044,1258,0,0,82.99,281,726,"灣內村",NULL
229,565,13,578,667,0,0,86.66,166,399,"上村村",NULL
230,887,31,918,1108,0,0,82.85,244,643,"加興村",NULL
231,980,29,1009,1209,0,0,83.46,428,552,"社口村",NULL
232,785,8,793,928,0,0,85.45,321,464,"磚寮村",NULL
233,659,16,675,818,0,0,82.52,209,450,"社皮村",NULL
234,793,16,809,990,0,0,81.72,296,497,"社皮村",NULL
235,1184,30,1214,1463,0,0,82.98,352,832,"社中村",NULL
236,1200,18,1218,1465,0,0,83.14,415,785,"社上村",NULL
237,757,18,775,943,0,0,82.18,240,517,"廣安村",NULL
238,864,18,882,1074,0,0,82.12,329,535,"廣安村",NULL
239,724,26,750,943,0,0,79.53,234,490,"進興村",NULL
240,1023,17,1040,1314,0,0,79.15,494,529,"進興村",NULL
241,921,33,954,1194,0,0,79.9,428,493,"新潭村",NULL
242,1269,26,1295,1618,0,0,80.04,583,686,"新潭村",NULL
243,1223,28,1251,1532,0,0,81.66,447,776,"潭頭村",NULL
244,480,19,499,614,0,0,81.27,194,286,"香楊村",NULL
245,1035,16,1051,1285,0,0,81.79,452,583,"香楊村",NULL
246,786,21,807,992,0,0,81.35,360,426,"長興村",NULL
247,1165,30,1195,1453,0,0,82.24,425,740,"崙上村",NULL
248,863,21,884,1077,0,0,82.08,296,567,"德榮村",NULL
249,618,15,633,782,0,0,80.95,173,445,"德和村",NULL
250,1121,23,1144,1459,0,0,78.41,425,696,"復興村",NULL
251,715,19,734,872,0,0,84.17,248,467,"德成村",NULL
252,865,21,886,1115,0,0,79.46,262,603,"德協村",NULL
253,975,23,998,1321,0,0,75.55,332,643,"繁榮村",NULL
254,1302,41,1343,1699,0,0,79.05,401,901,"繁昌村",NULL
255,849,24,873,1090,0,0,80.09,354,495,"繁隆村",NULL
256,994,18,1012,1228,0,0,82.41,321,673,"繁華村",NULL
257,757,27,784,1015,0,0,77.24,201,556,"繁華村",NULL
258,441,10,451,576,0,0,78.3,374,67,"榮華村",NULL
259,565,16,581,698,0,0,83.24,185,380,"新田村",NULL
260,922,13,935,1118,0,0,83.63,336,586,"新田村",NULL
261,688,7,695,835,0,0,83.23,229,459,"麟頂村",NULL
262,646,6,652,805,0,0,80.99,233,413,"麟蹄村",NULL
263,661,13,674,799,0,0,84.36,213,448,"麟蹄村",NULL
264,853,15,868,1054,0,0,82.35,302,551,"麟趾村",NULL
265,972,9,981,1189,0,0,82.51,337,635,"麟趾村",NULL
266,935,20,955,1116,0,0,85.57,315,620,"田中村",NULL
267,689,19,708,837,0,0,84.59,232,457,"田心村",NULL
268,558,7,565,689,0,0,82,189,369,"田道村",NULL
269,1298,32,1330,1568,0,0,84.82,320,978,"九清村",NULL
270,1027,31,1058,1266,0,0,83.57,280,747,"九塊村",NULL
271,1134,38,1172,1407,0,0,83.3,302,832,"九明村",NULL
272,831,28,859,1033,0,0,83.16,261,570,"大坵村",NULL
273,1009,32,1041,1228,0,0,84.77,332,677,"玉水村",NULL
274,1151,34,1185,1467,0,0,80.78,368,783,"玉泉村",NULL
275,521,9,530,622,0,0,85.21,183,338,"東寧村",NULL
276,1336,21,1357,1677,0,0,80.92,370,966,"東寧村",NULL
277,1062,19,1081,1306,0,0,82.77,375,687,"東寧村",NULL
278,1103,38,1141,1382,0,0,82.56,268,835,"三塊村",NULL
279,1024,21,1045,1250,0,0,83.6,291,733,"耆老村",NULL
280,1427,26,1453,1688,0,0,86.08,344,1083,"後庄村",NULL
281,1082,18,1100,1303,0,0,84.42,354,728,"洽興村",NULL
282,814,5,819,983,0,0,83.32,251,563,"玉田村",NULL
283,938,15,953,1195,0,0,79.75,289,649,"玉田村",NULL
284,1125,32,1157,1383,0,0,83.66,261,864,"塔樓村",NULL
285,1164,8,1172,1384,0,0,84.68,263,901,"潮厝村",NULL
286,946,15,961,1141,0,0,84.22,389,557,"大平村",NULL
287,644,12,656,803,0,0,81.69,206,438,"永春村",NULL
288,981,22,1003,1223,0,0,82.01,316,665,"春林村",NULL
289,721,17,738,883,0,0,83.58,242,479,"過江村",NULL
290,667,23,690,856,0,0,80.61,258,409,"過江村",NULL
291,984,22,1006,1212,0,0,83,288,696,"鐵店村",NULL
292,323,12,335,409,0,0,81.91,107,216,"茄苳村",NULL
293,995,26,1021,1177,0,0,86.75,235,760,"茄苳村",NULL
294,810,20,830,1004,0,0,82.67,206,604,"載興村",NULL
295,1036,32,1068,1308,0,0,81.65,270,766,"載興村",NULL
296,1152,38,1190,1485,0,0,80.13,384,768,"土庫村",NULL
297,391,14,405,500,0,0,81,362,29,"土庫村",NULL
298,667,27,694,855,0,0,81.17,227,440,"三廍村",NULL
299,723,33,756,900,0,0,84,265,458,"三廍村",NULL
300,624,19,643,820,0,0,78.41,200,424,"中和村",NULL
301,371,19,390,456,0,0,85.53,131,240,"瀰力村",NULL
302,1354,14,1368,1737,0,0,78.76,735,619,"鹽北村",NULL
303,779,27,806,1057,0,0,76.25,408,371,"鹽中村",NULL
304,925,33,958,1229,0,0,77.95,435,490,"鹽中村",NULL
305,1234,38,1272,1634,0,0,77.85,669,565,"鹽南村",NULL
306,708,36,744,917,0,0,81.13,445,263,"仕絨村",NULL
307,988,51,1039,1358,0,0,76.51,372,616,"高朗村",NULL
308,1006,36,1042,1340,0,0,77.76,401,605,"高朗村",NULL
309,1316,65,1381,1866,0,0,74.01,555,761,"振興村",NULL
310,661,21,682,877,0,0,77.77,333,328,"久愛村",NULL
311,1121,5,1126,1434,0,0,78.52,365,756,"新圍村",NULL
312,1154,8,1162,1452,0,0,80.03,299,855,"新圍村",NULL
313,1032,21,1053,1293,0,0,81.44,433,599,"新二村",NULL
314,1280,33,1313,1702,0,0,77.14,541,739,"新二村",NULL
315,777,21,798,979,0,0,81.51,312,465,"彭厝村",NULL
316,1148,42,1190,1476,0,0,80.62,412,736,"洛陽村",NULL
317,454,16,470,567,0,0,82.89,129,325,"永隆村",NULL
318,732,16,748,944,0,0,79.24,245,487,"高樹村",NULL
319,928,24,952,1234,0,0,77.15,222,706,"高樹村",NULL
320,1056,40,1096,1377,0,0,79.59,259,797,"長榮村",NULL
321,643,22,665,837,0,0,79.45,118,525,"東興村",NULL
322,472,13,485,611,0,0,79.38,157,315,"東振村",NULL
323,779,38,817,1013,0,0,80.65,263,516,"源泉村",NULL
324,891,37,928,1170,0,0,79.32,212,679,"建興村",NULL
325,508,23,531,686,0,0,77.41,179,329,"大埔村",NULL
326,622,31,653,815,0,0,80.12,127,495,"菜寮村",NULL
327,539,23,562,706,0,0,79.6,221,318,"司馬村",NULL
328,972,40,1012,1321,0,0,76.61,327,645,"舊寮村",NULL
329,1121,40,1161,1584,0,0,73.3,371,750,"新豐村",NULL
330,675,31,706,961,0,0,73.47,203,472,"泰山村",NULL
331,736,38,774,1018,0,0,76.03,252,484,"泰山村",NULL
332,947,39,986,1253,0,0,78.69,310,637,"南華村",NULL
333,754,28,782,966,0,0,80.95,183,571,"廣福村",NULL
334,805,40,845,1061,0,0,79.64,236,569,"廣興村",NULL
335,795,27,822,1032,0,0,79.65,226,569,"舊庄村",NULL
336,864,32,896,1121,0,0,79.93,276,588,"田子村",NULL
337,580,21,601,737,0,0,81.55,149,431,"鹽樹村",NULL
338,467,23,490,613,0,0,79.93,250,217,"鹽樹村",NULL
339,1142,29,1171,1477,0,0,79.28,331,811,"新南村",NULL
340,995,12,1007,1263,0,0,79.73,281,714,"萬巒村",NULL
341,610,11,621,790,0,0,78.61,164,446,"萬全村",NULL
342,1166,7,1173,1444,0,0,81.23,355,811,"萬和村",NULL
343,738,18,756,905,0,0,83.54,205,533,"鹿寮村",NULL
344,420,5,425,529,0,0,80.34,111,309,"硫黃村",NULL
345,919,30,949,1229,0,0,77.22,315,604,"泗溝村",NULL
346,901,27,928,1144,0,0,81.12,312,589,"五溝村",NULL
347,1225,18,1243,1554,0,0,79.99,406,819,"成德村",NULL
348,631,9,640,876,0,0,73.06,226,405,"赤山村",NULL
349,590,34,624,817,0,0,76.38,215,375,"赤山村",NULL
350,773,19,792,1010,0,0,78.42,249,524,"萬金村",NULL
351,719,24,743,928,0,0,80.06,218,501,"萬金村",NULL
352,1206,41,1247,1593,0,0,78.28,377,829,"佳佐村",NULL
353,1207,32,1239,1510,0,0,82.05,545,662,"佳和村",NULL
354,863,26,889,1157,0,0,76.84,237,626,"新厝村",NULL
355,499,18,517,634,0,0,81.55,247,252,"新置村",NULL
356,453,16,469,627,0,0,74.8,104,349,"新置村",NULL
357,1076,24,1100,1381,0,0,79.65,401,675,"內埔村",NULL
358,1518,9,1527,1945,0,0,78.51,599,919,"內埔村",NULL
359,823,22,845,1068,0,0,79.12,320,503,"內田村",NULL
360,1283,24,1307,1674,0,0,78.08,525,758,"內田村",NULL
361,1092,12,1104,1315,0,0,83.95,335,757,"興南村",NULL
362,456,17,473,591,0,0,80.03,128,328,"義亭村",NULL
363,812,22,834,1017,0,0,82.01,296,516,"美和村",NULL
364,836,24,860,1085,0,0,79.26,321,515,"美和村",NULL
365,683,11,694,836,0,0,83.01,189,494,"和興村",NULL
366,900,17,917,1125,0,0,81.51,435,465,"和興村",NULL
367,820,16,836,1045,0,0,80,290,530,"東寧村",NULL
368,1073,22,1095,1370,0,0,79.93,365,708,"東寧村",NULL
369,1320,17,1337,1682,0,0,79.49,574,746,"東寧村",NULL
370,935,23,958,1242,0,0,77.13,335,600,"豐田村",NULL
371,968,19,987,1232,0,0,80.11,329,639,"豐田村",NULL
372,720,4,724,876,0,0,82.65,246,474,"振豐村",NULL
373,614,20,634,758,0,0,83.64,229,385,"振豐村",NULL
374,623,15,638,789,0,0,80.86,221,402,"富田村",NULL
375,913,9,922,1123,0,0,82.1,223,690,"富田村",NULL
376,1246,27,1273,1587,0,0,80.21,377,869,"竹圍村",NULL
377,881,20,901,1124,0,0,80.16,259,622,"東勢村",NULL
378,1346,35,1381,1767,0,0,78.16,346,1000,"東勢村",NULL
379,732,23,755,924,0,0,81.71,214,518,"東片村",NULL
380,871,24,895,1103,0,0,81.14,262,609,"上樹村",NULL
381,843,34,877,1164,0,0,75.34,274,569,"老埤村",NULL
382,907,43,950,1243,0,0,76.43,253,654,"老埤村",NULL
383,1143,34,1177,1475,0,0,79.8,316,827,"中林村",NULL
384,1053,24,1077,1383,0,0,77.87,438,615,"龍泉村",NULL
385,840,35,875,1160,0,0,75.43,448,392,"龍泉村",NULL
386,124,4,128,174,0,0,73.56,112,12,"龍潭村",NULL
387,1066,28,1094,1419,0,0,77.1,631,435,"龍潭村",NULL
388,823,22,845,1070,0,0,78.97,489,334,"龍潭村",NULL
389,501,18,519,647,0,0,80.22,152,349,"建興村",NULL
390,409,56,465,953,0,0,48.79,390,19,"建興村",NULL
391,1090,20,1110,1369,0,0,81.08,313,777,"大新村",NULL
392,327,15,342,434,0,0,78.8,256,71,"大新村",NULL
393,947,13,960,1179,0,0,81.42,300,647,"黎明村",NULL
394,867,31,898,1113,0,0,80.68,316,551,"黎明村",NULL
395,902,29,931,1227,0,0,75.88,385,517,"隘寮村",NULL
396,662,7,669,862,0,0,77.61,308,354,"水門村",NULL
397,1172,10,1182,1458,0,0,81.07,435,737,"竹田村",NULL
398,685,18,703,862,0,0,81.55,173,512,"竹南村",NULL
399,561,7,568,687,0,0,82.68,195,366,"糶糴村",NULL
400,501,9,510,614,0,0,83.06,141,360,"履豐村",NULL
401,1077,28,1105,1335,0,0,82.77,364,713,"頭崙村",NULL
402,781,21,802,966,0,0,83.02,271,510,"二崙村",NULL
403,500,8,508,611,0,0,83.14,160,340,"美崙村",NULL
404,397,2,399,469,0,0,85.07,97,300,"南勢村",NULL
405,1066,22,1088,1336,0,0,81.44,388,678,"西勢村",NULL
406,962,17,979,1227,0,0,79.79,297,665,"西勢村",NULL
407,362,8,370,440,0,0,84.09,85,277,"福田村",NULL
408,498,8,506,606,0,0,83.5,184,314,"永豐村",NULL
409,558,9,567,681,0,0,83.26,148,410,"六巷村",NULL
410,798,29,827,1085,0,0,76.22,298,500,"泗洲村",NULL
411,903,28,931,1154,0,0,80.68,314,589,"大湖村",NULL
412,819,20,839,1022,0,0,82.09,387,432,"鳳明村",NULL
413,1212,34,1246,1628,0,0,76.54,518,694,"新埤村",NULL
414,269,7,276,341,0,0,80.94,126,143,"新埤村",NULL
415,599,29,628,811,0,0,77.44,219,380,"建功村",NULL
416,288,7,295,382,0,0,77.23,119,169,"建功村",NULL
417,787,23,810,1001,0,0,80.92,330,457,"打鐵村",NULL
418,571,17,588,759,0,0,77.47,233,338,"南豐村",NULL
419,525,24,549,701,0,0,78.32,244,281,"萬隆村",NULL
420,283,10,293,366,0,0,80.05,134,149,"萬隆村",NULL
421,456,20,476,652,0,0,73.01,208,248,"萬隆村",NULL
422,952,47,999,1368,0,0,73.03,350,602,"餉潭村",NULL
423,395,17,412,561,0,0,73.44,139,256,"箕湖村",NULL
424,414,18,432,544,0,0,79.41,227,187,"箕湖村",NULL
425,905,12,917,1236,0,0,74.19,467,438,"枋寮村",NULL
426,626,17,643,873,0,0,73.65,379,247,"新龍村",NULL
427,756,21,777,984,0,0,78.96,270,486,"保生村",NULL
428,510,21,531,675,0,0,78.67,188,322,"中寮村",NULL
429,699,26,725,907,0,0,79.93,284,415,"安樂村",NULL
430,691,19,710,920,0,0,77.17,296,395,"安樂村",NULL
431,921,31,952,1293,0,0,73.63,346,575,"隆山村",NULL
432,943,35,978,1317,0,0,74.26,392,551,"隆山村",NULL
433,961,30,991,1274,0,0,77.79,322,639,"隆山村",NULL
434,763,19,782,1001,0,0,78.12,275,488,"天時村",NULL
435,847,20,867,1092,0,0,79.4,322,525,"天時村",NULL
436,1311,21,1332,1650,0,0,80.73,476,835,"地利村",NULL
437,787,19,806,1055,0,0,76.4,331,456,"人和村",NULL
438,887,18,905,1161,0,0,77.95,345,542,"人和村",NULL
439,489,21,510,756,0,0,67.46,130,359,"內寮村",NULL
440,620,43,663,994,0,0,66.7,300,320,"新開村",NULL
441,1122,10,1132,1430,0,0,79.16,472,650,"東海村",NULL
442,1056,24,1080,1391,0,0,77.64,446,610,"東海村",NULL
443,484,15,499,634,0,0,78.71,204,280,"大庄村",NULL
444,685,22,707,964,0,0,73.34,292,393,"太源村",NULL
445,321,26,347,450,0,0,77.11,147,174,"玉泉村",NULL
446,738,32,770,900,0,0,85.56,248,490,"瓦窯村",NULL
447,576,18,594,724,0,0,82.04,171,405,"瓦窯村",NULL
448,875,11,886,1106,0,0,80.11,293,582,"仙吉村",NULL
449,1015,26,1041,1288,0,0,80.82,365,650,"仙吉村",NULL
450,782,27,809,996,0,0,81.22,220,562,"田洋村",NULL
451,818,27,845,1030,0,0,82.04,242,576,"田洋村",NULL
452,595,29,624,764,0,0,81.68,196,399,"港墘村",NULL
453,652,8,660,809,0,0,81.58,214,438,"內庄村",NULL
454,990,30,1020,1232,0,0,82.79,349,641,"新東村",NULL
455,786,23,809,997,0,0,81.14,313,473,"新東村",NULL
456,782,19,801,974,0,0,82.24,319,463,"新園村",NULL
457,829,27,856,1066,0,0,80.3,283,546,"新園村",NULL
458,858,27,885,1057,0,0,83.73,368,490,"港西村",NULL
459,889,32,921,1125,0,0,81.87,294,595,"港西村",NULL
460,751,20,771,968,0,0,79.65,221,530,"五房村",NULL
461,682,17,699,849,0,0,82.33,176,506,"五房村",NULL
462,813,44,857,1112,0,0,77.07,394,419,"五房村",NULL
463,1013,35,1048,1268,0,0,82.65,243,770,"烏龍村",NULL
464,800,13,813,1005,0,0,80.9,176,624,"興龍村",NULL
465,928,28,956,1167,0,0,81.92,235,693,"興龍村",NULL
466,755,23,778,927,0,0,83.93,124,631,"中洲村",NULL
467,618,15,633,794,0,0,79.72,143,475,"中洲村",NULL
468,1118,36,1154,1424,0,0,81.04,250,868,"南龍村",NULL
469,1073,34,1107,1418,0,0,78.07,226,847,"鹽埔村",NULL
470,1071,27,1098,1384,0,0,79.34,262,809,"鹽埔村",NULL
471,1004,18,1022,1300,0,0,78.62,262,742,"鹽埔村",NULL
472,829,13,842,1072,0,0,78.54,227,602,"共和村",NULL
473,886,27,913,1153,0,0,79.18,196,690,"共和村",NULL
474,1637,48,1685,2075,0,0,81.2,658,979,"崁頂村",NULL
475,1262,34,1296,1681,0,0,77.1,491,771,"園寮村",NULL
476,936,27,963,1155,0,0,83.38,304,632,"力社村",NULL
477,878,22,900,1137,0,0,79.16,268,610,"圍內村",NULL
478,729,26,755,924,0,0,81.71,235,494,"洲子村",NULL
479,1179,37,1216,1486,0,0,81.83,318,861,"北勢村",NULL
480,638,20,658,817,0,0,80.54,231,407,"越溪村",NULL
481,1356,56,1412,1776,0,0,79.5,326,1030,"港東村",NULL
482,1157,32,1189,1482,0,0,80.23,358,799,"林邊村",NULL
483,1247,39,1286,1650,0,0,77.94,422,825,"光林村",NULL
484,663,24,687,825,0,0,83.27,254,409,"中林村",NULL
485,1256,31,1287,1576,0,0,81.66,418,838,"仁和村",NULL
486,1226,26,1252,1529,0,0,81.88,380,846,"永樂村",NULL
487,1382,34,1416,1741,0,0,81.33,435,947,"永樂村",NULL
488,697,22,719,925,0,0,77.73,252,445,"田厝村",NULL
489,949,31,980,1353,0,0,72.43,362,587,"崎峰村",NULL
490,1410,43,1453,1938,0,0,74.97,501,909,"水利村",NULL
491,1200,32,1232,1522,0,0,80.95,441,759,"竹林村",NULL
492,1043,34,1077,1384,0,0,77.82,712,331,"竹林村",NULL
493,888,32,920,1147,0,0,80.21,254,634,"鎮安村",NULL
494,1403,34,1437,1777,0,0,80.87,531,872,"溪洲村",NULL
495,774,18,792,986,0,0,80.32,300,474,"溪南村",NULL
496,415,10,425,537,0,0,79.14,161,254,"仁里村",NULL
497,624,7,631,784,0,0,80.48,388,236,"溪北村",NULL
498,814,36,850,1056,0,0,80.49,338,476,"七塊村",NULL
499,796,11,807,1009,0,0,79.98,266,530,"萬華村",NULL
500,808,10,818,1021,0,0,80.12,320,488,"米崙村",NULL
501,875,26,901,1138,0,0,79.17,173,702,"壽元村",NULL
502,743,25,768,955,0,0,80.42,233,510,"同安村",NULL
503,467,19,486,590,0,0,82.37,137,330,"南安村",NULL
504,1147,39,1186,1513,0,0,78.39,417,730,"佳冬村",NULL
505,1227,30,1257,1603,0,0,78.42,497,730,"六根村",NULL
506,702,18,720,923,0,0,78.01,221,481,"賴家村",NULL
507,1280,25,1305,1683,0,0,77.54,418,862,"萬建村",NULL
508,1490,73,1563,1959,0,0,79.79,406,1084,"石光村",NULL
509,705,27,732,959,0,0,76.33,178,527,"玉光村",NULL
510,937,32,969,1268,0,0,76.42,345,592,"玉光村",NULL
511,880,34,914,1126,0,0,81.17,274,606,"昌隆村",NULL
512,635,22,657,850,0,0,77.29,197,438,"豐隆村",NULL
513,947,38,985,1196,0,0,82.36,277,670,"大同村",NULL
514,821,28,849,1042,0,0,81.48,232,589,"羌園村",NULL
515,875,30,905,1131,0,0,80.02,350,525,"燄溫村",NULL
516,810,31,841,1079,0,0,77.94,425,385,"塭豐村",NULL
517,914,32,946,1218,0,0,77.67,409,505,"塭豐村",NULL
518,1274,41,1315,2001,0,0,65.72,616,658,"本福村",NULL
519,700,29,729,1124,0,0,64.86,379,321,"中福村",NULL
520,526,22,548,916,0,0,59.83,350,176,"漁福村",NULL
521,847,45,892,1519,0,0,58.72,517,330,"大福村",NULL
522,614,32,646,1181,0,0,54.7,301,313,"南福村",NULL
523,592,33,625,1054,0,0,59.3,278,314,"天福村",NULL
524,809,46,855,1499,0,0,57.04,418,391,"上福村",NULL
525,473,15,488,792,0,0,61.62,258,215,"杉福村",NULL
526,317,16,333,447,0,0,74.5,115,202,"福興村",NULL
527,657,23,680,948,0,0,71.73,257,400,"福興村",NULL
528,442,15,457,588,0,0,77.72,122,320,"福安村",NULL
529,498,4,502,737,0,0,68.11,193,305,"田中村",NULL
530,531,21,552,777,0,0,71.04,211,320,"海口村",NULL
531,301,13,314,433,0,0,72.52,127,174,"統埔村",NULL
532,625,32,657,987,0,0,66.57,246,379,"溫泉村",NULL
533,432,27,459,666,0,0,68.92,141,291,"保力村",NULL
534,439,27,466,698,0,0,66.76,144,295,"保力村",NULL
535,320,9,329,424,0,0,77.59,96,224,"新街村",NULL
536,299,9,308,463,0,0,66.52,112,187,"埔墘村",NULL
537,333,14,347,509,0,0,68.17,142,191,"射寮村",NULL
538,308,31,339,494,0,0,68.62,122,186,"後灣村",NULL
539,962,51,1013,1460,0,0,69.38,419,543,"滿州村",NULL
540,904,40,944,1365,0,0,69.16,414,490,"永靖村",NULL
541,799,35,834,1186,0,0,70.32,281,518,"港口村",NULL
542,315,17,332,500,0,0,66.4,79,236,"響林村",NULL
543,246,8,254,382,0,0,66.49,82,164,"里德村",NULL
544,794,56,850,1333,0,0,63.77,454,340,"長樂村",NULL
545,165,8,173,272,0,0,63.6,61,104,"九棚村",NULL
546,229,1,230,357,0,0,64.43,98,131,"港仔村",NULL
547,700,31,731,912,0,0,80.15,249,451,"加祿村",NULL
548,708,29,737,916,0,0,80.46,351,357,"加祿村",NULL
549,404,21,425,596,0,0,71.31,204,200,"枋山村",NULL
550,336,4,340,465,0,0,73.12,161,175,"枋山村",NULL
551,663,43,706,1076,0,0,65.61,243,420,"楓港村",NULL
552,659,8,667,1005,0,0,66.37,233,426,"善餘村",NULL
553,944,22,966,1238,0,0,78.03,820,124,"三地村",NULL
554,200,3,203,268,0,0,75.75,178,22,"達來村",NULL
555,341,26,367,501,0,0,73.25,254,87,"德文村",NULL
556,342,14,356,473,0,0,75.26,300,42,"大社村",NULL
557,410,9,419,575,0,0,72.87,335,75,"賽嘉村",NULL
558,360,7,367,495,0,0,74.14,294,66,"口社村",NULL
559,216,1,217,298,0,0,72.82,185,31,"馬兒村",NULL
560,275,9,284,373,0,0,76.14,223,52,"安坡村",NULL
561,449,18,467,622,0,0,75.08,413,36,"青山村",NULL
562,427,14,441,559,0,0,78.89,376,51,"青葉村",NULL
563,104,1,105,137,0,0,76.64,73,31,"霧臺村",NULL
564,220,13,233,292,0,0,79.79,173,47,"霧臺村",NULL
565,465,12,477,603,0,0,79.1,414,51,"霧臺村",NULL
566,94,8,102,123,0,0,82.93,80,14,"吉露村",NULL
567,150,3,153,201,0,0,76.12,138,12,"阿禮村",NULL
568,285,12,297,394,0,0,75.38,218,67,"大武村",NULL
569,219,3,222,292,0,0,76.03,197,22,"佳暮村",NULL
570,250,1,251,335,0,0,74.93,152,98,"好茶村",NULL
571,219,1,220,305,0,0,72.13,169,50,"瑪家村",NULL
572,600,11,611,743,0,0,82.23,529,71,"北葉村",NULL
573,675,23,698,933,0,0,74.81,593,82,"涼山村",NULL
574,581,10,591,769,0,0,76.85,469,112,"佳義村",NULL
575,246,14,260,351,0,0,74.07,210,36,"排灣村",NULL
576,481,10,491,636,0,0,77.2,405,76,"三和村",NULL
577,405,2,407,495,0,0,82.22,361,44,"三和村",NULL
578,397,17,414,564,0,0,73.4,343,54,"三和村",NULL
579,434,8,442,531,0,0,83.24,407,27,"佳平村",NULL
580,130,6,136,160,0,0,85,112,18,"佳平村",NULL
581,613,26,639,825,0,0,77.45,562,51,"武潭村",NULL
582,362,5,367,464,0,0,79.09,230,132,"平和村",NULL
583,254,3,257,333,0,0,77.18,235,19,"佳興村",NULL
584,402,17,419,574,0,0,73,387,15,"泰武村",NULL
585,512,10,522,657,0,0,79.45,484,28,"萬安村",NULL
586,629,14,643,824,0,0,78.03,581,48,"來義村",NULL
587,243,4,247,310,0,0,79.68,226,17,"義林村",NULL
588,146,1,147,195,0,0,75.38,136,10,"義林村",NULL
589,320,2,322,393,0,0,81.93,307,13,"丹林村",NULL
590,191,0,191,239,0,0,79.92,163,28,"丹林村",NULL
591,732,23,755,1020,0,0,74.02,638,94,"古樓村",NULL
592,603,25,628,810,0,0,77.53,571,32,"文樂村",NULL
593,686,6,692,836,0,0,82.78,659,27,"望嘉村",NULL
594,860,35,895,1155,0,0,77.49,800,60,"南和村",NULL
595,506,30,536,772,0,0,69.43,458,48,"春日村",NULL
596,437,20,457,624,0,0,73.24,399,38,"古華村",NULL
597,222,9,231,312,0,0,74.04,214,8,"士文村",NULL
598,464,26,490,671,0,0,73.03,419,45,"歸崇村",NULL
599,615,38,653,839,0,0,77.83,554,61,"七佳村",NULL
600,323,6,329,426,0,0,77.23,309,14,"力里村",NULL
601,425,9,434,656,0,0,66.16,365,60,"楓林村",NULL
602,475,23,498,739,0,0,67.39,434,41,"丹路村",NULL
603,453,3,456,649,0,0,70.26,432,21,"草埔村",NULL
604,144,6,150,243,0,0,61.73,137,7,"內文村",NULL
605,166,0,166,250,0,0,66.4,151,15,"竹坑村",NULL
606,230,8,238,382,0,0,62.3,215,15,"獅子村",NULL
607,392,3,395,534,0,0,73.97,371,21,"內獅村",NULL
608,237,6,243,335,0,0,72.54,230,7,"南世村",NULL
609,709,28,737,1054,0,0,69.92,617,92,"石門村",NULL
610,184,8,192,278,0,0,69.06,157,27,"石門村",NULL
611,437,31,468,674,0,0,69.44,393,44,"牡丹村",NULL
612,258,8,266,396,0,0,67.17,206,52,"東源村",NULL
613,242,4,246,387,0,0,63.57,178,64,"旭海村",NULL
614,338,8,346,484,0,0,71.49,316,22,"高士村",NULL
615,307,27,334,543,0,0,61.51,272,35,"四林村",NULL
1,731,9,740,1016,0,0,72.83,473,258,"文化里",NULL
2,1131,13,1144,1471,0,0,77.77,608,523,"民族里",NULL
3,1212,19,1231,1664,0,0,73.98,732,480,"自強里",NULL
4,1473,17,1490,1970,0,0,75.63,919,554,"民生里",NULL
5,1181,13,1194,1609,0,0,74.21,713,468,"民生里",NULL
6,934,29,963,1313,0,0,73.34,524,410,"民生里",NULL
7,656,22,678,964,0,0,70.33,411,245,"寶桑里",NULL
8,871,9,880,1196,0,0,73.58,546,325,"民權里",NULL
9,482,17,499,729,0,0,68.45,354,128,"四維里",NULL
10,653,10,663,916,0,0,72.38,343,310,"中華里",NULL
11,520,6,526,752,0,0,69.95,302,218,"中華里",NULL
12,545,13,558,743,0,0,75.1,305,240,"仁愛里",NULL
13,448,16,464,581,0,0,79.86,251,197,"強國里",NULL
14,545,6,551,773,0,0,71.28,316,229,"大同里",NULL
15,575,13,588,846,0,0,69.5,285,290,"成功里",NULL
16,917,29,946,1371,0,0,69,548,369,"建國里",NULL
17,658,9,667,907,0,0,73.54,318,340,"中正里",NULL
18,724,12,736,951,0,0,77.39,368,356,"中山里",NULL
19,566,3,569,743,0,0,76.58,273,293,"興國里",NULL
20,301,5,306,442,0,0,69.23,130,171,"鐵花里",NULL
21,946,18,964,1278,0,0,75.43,611,335,"東海里",NULL
22,1296,28,1324,1764,0,0,75.06,805,491,"東海里",NULL
23,459,19,478,692,0,0,69.08,266,193,"復國里",NULL
24,356,8,364,504,0,0,72.22,224,132,"復興里",NULL
25,818,20,838,1191,0,0,70.36,446,372,"新興里",NULL
26,1059,14,1073,1581,0,0,67.87,631,428,"新生里",NULL
27,1413,28,1441,1972,0,0,73.07,949,464,"新生里",NULL
28,1310,23,1333,1898,0,0,70.23,861,449,"新生里",NULL
29,867,24,891,1228,0,0,72.56,542,325,"中心里",NULL
30,1109,17,1126,1462,0,0,77.02,698,411,"中心里",NULL
31,1040,22,1062,1406,0,0,75.53,701,339,"馬蘭里",NULL
32,1052,12,1064,1390,0,0,76.55,703,349,"馬蘭里",NULL
33,1302,19,1321,1841,0,0,71.75,882,420,"光明里",NULL
34,687,19,706,1094,0,0,64.53,439,248,"豐年里",NULL
35,886,30,916,1289,0,0,71.06,639,247,"豐年里",NULL
36,914,24,938,1326,0,0,70.74,525,389,"豐樂里",NULL
37,1057,23,1080,1453,0,0,74.33,593,464,"永樂里",NULL
38,838,19,857,1211,0,0,70.77,414,424,"康樂里",NULL
39,1003,23,1026,1429,0,0,71.8,700,303,"豐榮里",NULL
40,974,27,1001,1480,0,0,67.64,648,326,"豐榮里",NULL
41,1126,14,1140,1563,0,0,72.94,748,378,"豐榮里",NULL
42,1505,22,1527,2095,0,0,72.89,962,543,"豐榮里",NULL
43,998,24,1022,1495,0,0,68.36,658,340,"豐谷里",NULL
44,1020,33,1053,1516,0,0,69.46,653,367,"豐谷里",NULL
45,989,20,1009,1434,0,0,70.36,639,350,"豐谷里",NULL
46,1352,54,1406,2068,0,0,67.99,660,692,"豐里里",NULL
47,696,23,719,1015,0,0,70.84,276,420,"豐原里",NULL
48,989,50,1039,1537,0,0,67.6,664,325,"富岡里",NULL
49,551,16,567,866,0,0,65.47,340,211,"富豐里",NULL
50,721,27,748,1069,0,0,69.97,571,150,"南榮里",NULL
51,711,24,735,1191,0,0,61.71,452,259,"南榮里",NULL
52,751,20,771,1231,0,0,62.63,502,249,"岩灣里",NULL
53,1613,10,1623,2085,0,0,77.84,776,837,"卑南里",NULL
54,903,13,916,1296,0,0,70.68,622,281,"南王里",NULL
55,706,23,729,1071,0,0,68.07,489,217,"南王里",NULL
56,649,17,666,914,0,0,72.87,320,329,"豐田里",NULL
57,679,22,701,951,0,0,73.71,344,335,"豐田里",NULL
58,988,32,1020,1503,0,0,67.86,624,364,"新園里",NULL
59,879,30,909,1330,0,0,68.35,544,335,"建和里",NULL
60,648,23,671,914,0,0,73.41,318,330,"建興里",NULL
61,864,22,886,1288,0,0,68.79,570,294,"建業里",NULL
62,834,14,848,1163,0,0,72.91,521,313,"知本里",NULL
63,964,40,1004,1511,0,0,66.45,782,182,"建農里",NULL
64,318,14,332,606,0,0,54.79,254,64,"信義里",NULL
65,503,17,520,1059,0,0,49.1,415,88,"信義里",NULL
66,224,13,237,432,0,0,54.86,178,46,"信義里",NULL
67,406,13,419,854,0,0,49.06,323,83,"和平里",NULL
68,187,13,200,383,0,0,52.22,132,55,"忠仁里",NULL
69,792,19,811,1228,0,0,66.04,504,288,"忠仁里",NULL
70,1004,22,1026,1501,0,0,68.35,720,284,"忠仁里、忠智里",NULL
71,773,14,787,1132,0,0,69.52,528,245,"忠智里",NULL
72,659,16,675,1222,0,0,55.24,516,143,"三民里",NULL
73,861,38,899,1570,0,0,57.26,695,166,"三民里",NULL
74,315,5,320,598,0,0,53.51,209,106,"三仙里",NULL
75,519,24,543,1094,0,0,49.63,400,119,"三仙里",NULL
76,334,2,336,629,0,0,53.42,250,84,"忠孝里",NULL
77,284,12,296,540,0,0,54.81,208,76,"忠孝里",NULL
78,227,10,237,428,0,0,55.37,204,23,"博愛里",NULL
79,173,3,176,325,0,0,54.15,140,33,"博愛里",NULL
80,655,7,662,925,0,0,71.57,437,218,"里壟里",NULL
81,550,19,569,863,0,0,65.93,414,136,"里壟里",NULL
82,626,16,642,868,0,0,73.96,367,259,"中福里",NULL
83,571,22,593,941,0,0,63.02,359,212,"新福里",NULL
84,728,19,747,1101,0,0,67.85,501,227,"豐泉里",NULL
85,466,28,494,757,0,0,65.26,257,209,"月眉里",NULL
86,588,24,612,1005,0,0,60.9,449,139,"德高里",NULL
87,557,8,565,825,0,0,68.48,320,237,"德高里",NULL
88,319,15,334,597,0,0,55.95,246,73,"電光里",NULL
89,708,26,734,986,0,0,74.44,283,425,"賓朗村",NULL
90,801,25,826,1201,0,0,68.78,473,328,"賓朗村",NULL
91,158,6,164,238,0,0,68.91,48,110,"美農村",NULL
92,332,8,340,459,0,0,74.07,126,206,"美農村",NULL
93,222,7,229,329,0,0,69.6,96,126,"美農村",NULL
94,521,10,531,805,0,0,65.96,285,236,"初鹿村",NULL
95,410,4,414,576,0,0,71.88,217,193,"初鹿村",NULL
96,508,22,530,814,0,0,65.11,226,282,"明峰村",NULL
97,298,9,307,473,0,0,64.9,186,112,"明峰村",NULL
98,192,11,203,324,0,0,62.65,94,98,"嘉豐村",NULL
99,129,6,135,236,0,0,57.2,92,37,"嘉豐村",NULL
100,1038,17,1055,1434,0,0,73.57,625,413,"太平村",NULL
101,448,44,492,791,0,0,62.2,409,39,"太平村",NULL
102,658,10,668,953,0,0,70.09,445,213,"太平村",NULL
103,685,19,704,1020,0,0,69.02,507,178,"泰安村",NULL
104,668,20,688,959,0,0,71.74,525,143,"利嘉村",NULL
105,708,25,733,1108,0,0,66.16,635,73,"東興村",NULL
106,652,25,677,933,0,0,72.56,261,391,"溫泉村",NULL
107,125,2,127,185,0,0,68.65,33,92,"溫泉村",NULL
108,360,12,372,582,0,0,63.92,213,147,"富山村",NULL
109,243,7,250,356,0,0,70.22,101,142,"富源村",NULL
110,275,10,285,470,0,0,60.64,158,117,"利吉村",NULL
111,330,4,334,551,0,0,60.62,255,75,"鹿野村",NULL
112,378,9,387,605,0,0,63.97,197,181,"鹿野村",NULL
113,725,30,755,1116,0,0,67.65,310,415,"龍田村",NULL
114,620,15,635,1027,0,0,61.83,406,214,"永安村",NULL
115,247,5,252,394,0,0,63.96,190,57,"永安村",NULL
116,606,19,625,999,0,0,62.56,387,219,"瑞隆村",NULL
117,598,12,610,924,0,0,66.02,415,183,"瑞源村",NULL
118,410,14,424,731,0,0,58,267,143,"瑞和村",NULL
119,307,15,322,472,0,0,68.22,152,155,"瑞豐村",NULL
120,365,12,377,552,0,0,68.3,88,277,"瑞豐村",NULL
121,699,25,724,1078,0,0,67.16,450,249,"福原村",NULL
122,629,10,639,936,0,0,68.27,311,318,"福原村",NULL
123,373,13,386,603,0,0,64.01,203,170,"福文村",NULL
124,487,11,498,847,0,0,58.8,338,149,"福文村",NULL
125,449,15,464,736,0,0,63.04,257,192,"慶豐村",NULL
126,202,8,210,388,0,0,54.12,143,59,"大坡村",NULL
127,464,18,482,822,0,0,58.64,310,154,"大埔村",NULL
128,513,22,535,868,0,0,61.64,308,205,"新興村",NULL
129,254,12,266,410,0,0,64.88,127,127,"錦園村",NULL
130,216,4,220,369,0,0,59.62,66,150,"萬安村",NULL
131,283,12,295,454,0,0,64.98,185,98,"富興村",NULL
132,220,11,231,426,0,0,54.23,179,41,"振興村",NULL
133,193,13,206,350,0,0,58.86,96,97,"都蘭村",NULL
134,458,14,472,758,0,0,62.27,278,180,"都蘭村",NULL
135,701,29,730,1243,0,0,58.73,493,208,"都蘭村",NULL
136,629,27,656,1071,0,0,61.25,382,247,"興昌村",NULL
137,356,10,366,597,0,0,61.31,244,112,"隆昌村",NULL
138,586,12,598,1082,0,0,55.27,497,89,"東河村",NULL
139,816,27,843,1504,0,0,56.05,630,186,"泰源村",NULL
140,420,15,435,833,0,0,52.22,324,96,"北源村",NULL
141,222,7,229,421,0,0,54.39,172,50,"北源村",NULL
142,297,11,308,501,0,0,61.48,208,89,"北源村",NULL
143,150,4,154,261,0,0,59,105,45,"尚德村",NULL
144,324,4,328,674,0,0,48.66,234,90,"寧埔村",NULL
145,484,14,498,924,0,0,53.9,376,108,"寧埔村",NULL
146,599,10,609,1119,0,0,54.42,395,204,"竹湖村",NULL
147,740,30,770,1335,0,0,57.68,479,261,"長濱村",NULL
148,450,21,471,855,0,0,55.09,352,98,"長濱村",NULL
149,310,16,326,664,0,0,49.1,193,117,"忠勇村",NULL
150,400,12,412,786,0,0,52.42,300,100,"三間村",NULL
151,280,7,287,464,0,0,61.85,225,55,"三間村",NULL
152,139,4,143,277,0,0,51.62,104,35,"三間村、樟原村",NULL
153,437,15,452,740,0,0,61.08,324,113,"樟原村",NULL
154,795,28,823,1239,0,0,66.42,397,398,"美和村",NULL
155,424,11,435,637,0,0,68.29,199,225,"三和村",NULL
156,470,20,490,709,0,0,69.11,169,301,"華源村",NULL
157,381,12,393,590,0,0,66.61,218,163,"北里村",NULL
158,595,10,605,892,0,0,67.83,452,143,"大王村",NULL
159,541,13,554,815,0,0,67.98,247,294,"大王村",NULL
160,611,17,628,854,0,0,73.54,352,259,"泰和村",NULL
161,427,18,445,663,0,0,67.12,249,178,"泰和村",NULL
162,287,10,297,503,0,0,59.05,158,129,"香蘭村",NULL
163,225,13,238,375,0,0,63.47,157,68,"香蘭村",NULL
164,501,12,513,749,0,0,68.49,481,20,"金崙村",NULL
165,329,13,342,517,0,0,66.15,281,48,"金崙村",NULL
166,244,8,252,418,0,0,60.29,203,41,"金崙村",NULL
167,168,7,175,283,0,0,61.84,161,7,"多良村",NULL
168,401,3,404,681,0,0,59.32,343,58,"多良村",NULL
169,397,11,408,642,0,0,63.55,260,137,"南興村",NULL
170,1032,25,1057,1817,0,0,58.17,564,468,"尚武村",NULL
171,887,19,906,1539,0,0,58.87,618,269,"大武村",NULL
172,719,19,738,1144,0,0,64.51,667,52,"大鳥村",NULL
173,279,9,288,515,0,0,55.92,262,17,"大竹村",NULL
174,200,11,211,358,0,0,58.94,182,18,"大竹村",NULL
175,495,9,504,817,0,0,61.69,438,57,"南寮村",NULL
176,500,6,506,911,0,0,55.54,428,72,"中寮村",NULL
177,262,9,271,486,0,0,55.76,240,22,"公館村",NULL
178,90,2,92,143,0,0,64.34,85,5,"公館村",NULL
179,297,16,313,496,0,0,63.1,283,14,"加拿村",NULL
180,365,14,379,572,0,0,66.26,333,32,"崁頂村",NULL
181,544,15,559,910,0,0,61.43,487,57,"海端村",NULL
182,441,12,453,726,0,0,62.4,408,33,"廣原村",NULL
183,184,8,192,263,0,0,73,175,9,"霧鹿村",NULL
184,176,4,180,253,0,0,71.15,144,32,"利稻村",NULL
185,573,18,591,870,0,0,67.93,453,120,"桃源村",NULL
186,257,9,266,412,0,0,64.56,222,35,"紅葉村",NULL
187,184,2,186,270,0,0,68.89,168,16,"永康村",NULL
188,358,12,370,580,0,0,63.79,330,28,"武陵村",NULL
189,302,4,306,504,0,0,60.71,289,13,"鸞山村",NULL
190,57,6,63,90,0,0,70,26,31,"鸞山村",NULL
191,669,17,686,990,0,0,69.29,624,45,"嘉蘭村",NULL
192,354,0,354,481,0,0,73.6,328,26,"正興村",NULL
193,288,9,297,392,0,0,75.77,253,35,"新興村",NULL
194,210,4,214,287,0,0,74.56,207,3,"賓茂村",NULL
195,216,3,219,296,0,0,73.99,204,12,"歷坵村",NULL
196,200,8,208,319,0,0,65.2,166,34,"安朔村",NULL
197,209,7,216,343,0,0,62.97,186,23,"安朔村",NULL
198,148,0,148,236,0,0,62.71,137,11,"南田村",NULL
199,227,3,230,380,0,0,60.53,180,47,"森永村",NULL
200,231,12,243,361,0,0,67.31,204,27,"新化村",NULL
201,378,13,391,596,0,0,65.6,352,26,"台板村",NULL
202,477,2,479,807,0,0,59.36,457,20,"土板村",NULL
203,293,26,319,590,0,0,54.07,247,46,"椰油村",NULL
204,333,42,375,699,0,0,53.65,280,53,"紅頭村",NULL
205,353,32,385,755,0,0,50.99,271,82,"東清村",NULL
206,212,9,221,446,0,0,49.55,107,105,"朗島村",NULL
1,1099,16,1115,1429,0,0,78.03,810,289,"民德里",NULL
2,739,11,750,964,0,0,77.8,611,128,"民勤里",NULL
3,618,9,627,812,0,0,77.22,521,97,"民勤里",NULL
4,1003,14,1017,1264,0,0,80.46,817,186,"民勤里",NULL
5,703,9,712,964,0,0,73.86,562,141,"民意里",NULL
6,431,60,491,858,0,0,57.23,403,28,"民意里",NULL
7,566,21,587,828,0,0,70.89,539,27,"民意里",NULL
8,603,11,614,840,0,0,73.1,389,214,"民心里",NULL
9,667,15,682,895,0,0,76.2,533,134,"民享里",NULL
10,800,20,820,1079,0,0,76,625,175,"民享里",NULL
11,559,11,570,783,0,0,72.8,399,160,"民孝里",NULL
12,1343,31,1374,1777,0,0,77.32,1069,274,"民孝里",NULL
13,768,18,786,1030,0,0,76.31,510,258,"民運里",NULL
14,690,16,706,941,0,0,75.03,512,178,"民運里",NULL
15,1014,8,1022,1332,0,0,76.73,771,243,"民政里",NULL
16,1164,13,1177,1522,0,0,77.33,820,344,"民政里",NULL
17,1042,15,1057,1373,0,0,76.98,738,304,"民立里",NULL
18,450,6,456,611,0,0,74.63,333,117,"民樂里",NULL
19,504,10,514,665,0,0,77.29,295,209,"民有里",NULL
20,455,9,464,604,0,0,76.82,319,136,"民主里",NULL
21,293,5,298,382,0,0,78.01,223,70,"民治里",NULL
22,416,7,423,568,0,0,74.47,249,167,"民族里",NULL
23,1052,9,1061,1395,0,0,76.06,646,406,"民生里",NULL
24,360,2,362,473,0,0,76.53,269,91,"民權里",NULL
25,521,7,528,680,0,0,77.65,314,207,"主商里",NULL
26,724,16,740,986,0,0,75.05,474,250,"主勤里",NULL
27,477,2,479,633,0,0,75.67,269,208,"主工里",NULL
28,514,12,526,713,0,0,73.77,306,208,"主信里",NULL
29,793,14,807,1085,0,0,74.38,475,318,"主睦里、主義里",NULL
30,610,8,618,856,0,0,72.2,402,208,"主計里",NULL
31,690,14,704,930,0,0,75.7,449,241,"主和里",NULL
32,738,8,746,1032,0,0,72.29,430,308,"主和里",NULL
33,750,22,772,1012,0,0,76.28,430,320,"主和里",NULL
34,620,15,635,821,0,0,77.34,394,226,"主學里",NULL
35,663,15,678,880,0,0,77.05,405,258,"主學里",NULL
36,1017,11,1028,1375,0,0,74.76,691,326,"主農里",NULL
37,1172,10,1182,1543,0,0,76.6,736,436,"主農里",NULL
38,675,10,685,915,0,0,74.86,433,242,"主安里",NULL
39,1084,17,1101,1430,0,0,76.99,701,383,"主安里",NULL
40,912,14,926,1242,0,0,74.56,635,277,"主權里",NULL
41,844,19,863,1189,0,0,72.58,579,265,"主權里",NULL
42,801,12,813,1109,0,0,73.31,531,270,"主權里",NULL
43,796,6,802,1015,0,0,79.01,534,262,"主權里",NULL
44,916,12,928,1247,0,0,74.42,544,372,"主力里",NULL
45,905,10,915,1205,0,0,75.93,571,334,"主力里",NULL
46,1197,16,1213,1541,0,0,78.72,756,441,"國風里",NULL
47,1119,14,1133,1514,0,0,74.83,698,421,"國風里",NULL
48,579,7,586,737,0,0,79.51,335,244,"國威里",NULL
49,605,5,610,1000,0,0,61,383,222,"國威里",NULL
50,783,5,788,1054,0,0,74.76,536,247,"國治里",NULL
51,429,5,434,533,0,0,81.43,281,148,"國安里",NULL
52,945,26,971,1290,0,0,75.27,619,326,"國光里",NULL
53,614,19,633,826,0,0,76.63,404,210,"國防里",NULL
54,832,13,845,1174,0,0,71.98,506,326,"國華里",NULL
55,687,5,692,859,0,0,80.56,433,254,"國華里",NULL
56,845,12,857,1146,0,0,74.78,503,342,"國魂里",NULL
57,501,10,511,693,0,0,73.74,333,168,"國魂里",NULL
58,820,16,836,1151,0,0,72.63,472,348,"國聯里",NULL
59,750,6,756,1079,0,0,70.06,476,274,"國聯里",NULL
60,946,24,970,1366,0,0,71.01,689,257,"國盛里",NULL
61,954,3,957,1357,0,0,70.52,648,306,"國盛里",NULL
62,1034,19,1053,1343,0,0,78.41,659,375,"國強里",NULL
63,1066,17,1083,1434,0,0,75.52,687,379,"國富里",NULL
64,1257,23,1280,1684,0,0,76.01,828,429,"國富里",NULL
65,1178,12,1190,1543,0,0,77.12,756,422,"國富里",NULL
66,803,13,816,1093,0,0,74.66,491,312,"國裕里",NULL
67,947,17,964,1298,0,0,74.27,645,302,"國裕里",NULL
68,831,14,845,1160,0,0,72.84,585,246,"國裕里",NULL
69,716,13,729,931,0,0,78.3,472,244,"國慶里",NULL
70,1250,18,1268,1729,0,0,73.34,940,310,"國興里",NULL
71,1030,14,1044,1398,0,0,74.68,719,311,"國興里",NULL
72,909,29,938,1339,0,0,70.05,589,320,"國福里",NULL
73,280,9,289,377,0,0,76.66,167,113,"新城村",NULL
74,718,26,744,1037,0,0,71.75,454,264,"新城村",NULL
75,415,13,428,618,0,0,69.26,150,265,"順安村",NULL
76,231,1,232,299,0,0,77.59,97,134,"順安村",NULL
77,241,10,251,331,0,0,75.83,163,78,"康樂村",NULL
78,880,30,910,1249,0,0,72.86,570,310,"康樂村",NULL
79,560,17,577,803,0,0,71.86,386,174,"康樂村",NULL
80,548,13,561,797,0,0,70.39,459,89,"大漢村",NULL
81,898,29,927,1298,0,0,71.42,766,132,"大漢村",NULL
82,315,10,325,448,0,0,72.54,217,98,"大漢村",NULL
83,1142,10,1152,1639,0,0,70.29,787,355,"北埔村",NULL
84,1088,20,1108,1499,0,0,73.92,788,300,"北埔村",NULL
85,500,10,510,727,0,0,70.15,353,147,"佳林村",NULL
86,1018,23,1041,1372,0,0,75.87,855,163,"嘉里村",NULL
87,814,21,835,1095,0,0,76.26,577,237,"嘉里村",NULL
88,686,14,700,986,0,0,70.99,564,122,"嘉里村",NULL
89,587,22,609,782,0,0,77.88,496,91,"嘉新村",NULL
90,350,18,368,567,0,0,64.9,286,64,"嘉新村",NULL
91,444,17,461,629,0,0,73.29,373,71,"和平村",NULL
92,306,31,337,468,0,0,72.01,259,47,"和平村",NULL
93,819,36,855,1187,0,0,72.03,729,90,"崇德村",NULL
94,882,25,907,1289,0,0,70.36,680,202,"富世村",NULL
95,143,3,146,217,0,0,67.28,117,26,"富世村",NULL
96,1017,35,1052,1502,0,0,70.04,866,151,"秀林村",NULL
97,609,29,638,919,0,0,69.42,491,118,"景美村",NULL
98,355,12,367,541,0,0,67.84,292,63,"景美村",NULL
99,553,20,573,782,0,0,73.27,498,55,"佳民村",NULL
100,606,17,623,826,0,0,75.42,550,56,"水源村",NULL
101,761,16,777,995,0,0,78.09,711,50,"銅門村",NULL
102,437,23,460,601,0,0,76.54,401,36,"文蘭村",NULL
103,204,2,206,280,0,0,73.57,168,36,"文蘭村",NULL
104,1237,20,1257,1656,0,0,75.91,838,399,"永安村",NULL
105,1240,28,1268,1753,0,0,72.33,817,423,"永安村",NULL
106,1178,15,1193,1637,0,0,72.88,676,502,"太昌村",NULL
107,1011,25,1036,1441,0,0,71.89,742,269,"太昌村",NULL
108,1337,25,1362,1855,0,0,73.42,864,473,"慶豐村",NULL
109,1251,32,1283,1647,0,0,77.9,762,489,"慶豐村",NULL
110,1156,18,1174,1573,0,0,74.63,770,386,"慶豐村",NULL
111,1076,14,1090,1441,0,0,75.64,683,393,"吉安村",NULL
112,771,14,785,1148,0,0,68.38,552,219,"吉安村",NULL
113,881,20,901,1204,0,0,74.83,587,294,"吉安村",NULL
114,775,26,801,1101,0,0,72.75,507,268,"福興村",NULL
115,917,27,944,1253,0,0,75.34,510,407,"福興村",NULL
116,1097,42,1139,1508,0,0,75.53,595,502,"南華村",NULL
117,745,20,765,1120,0,0,68.3,607,138,"干城村",NULL
118,1185,44,1229,1694,0,0,72.55,750,435,"永興村",NULL
119,597,9,606,840,0,0,72.14,464,133,"永興村",NULL
120,924,15,939,1250,0,0,75.12,627,297,"稻香村",NULL
121,946,39,985,1348,0,0,73.07,611,335,"稻香村",NULL
122,1045,29,1074,1438,0,0,74.69,793,252,"南昌村",NULL
123,1239,17,1256,1710,0,0,73.45,856,383,"南昌村",NULL
124,1252,19,1271,1695,0,0,74.99,851,401,"宜昌村",NULL
125,1275,21,1296,1693,0,0,76.55,870,405,"宜昌村",NULL
126,1130,35,1165,1561,0,0,74.63,719,411,"北昌村",NULL
127,1174,16,1190,1524,0,0,78.08,744,430,"北昌村",NULL
128,1198,21,1219,1540,0,0,79.16,765,433,"北昌村",NULL
129,1122,19,1141,1482,0,0,76.99,744,378,"北昌村",NULL
130,1281,22,1303,1712,0,0,76.11,837,444,"勝安村",NULL
131,1559,21,1580,2020,0,0,78.22,937,622,"勝安村",NULL
132,926,16,942,1238,0,0,76.09,641,285,"仁里村",NULL
133,1059,21,1080,1387,0,0,77.87,735,324,"仁里村",NULL
134,955,18,973,1348,0,0,72.18,675,280,"仁里村",NULL
135,963,11,974,1299,0,0,74.98,636,327,"仁里村",NULL
136,1128,20,1148,1528,0,0,75.13,840,288,"東昌村",NULL
137,1242,17,1259,1692,0,0,74.41,931,311,"東昌村",NULL
138,892,27,919,1266,0,0,72.59,700,192,"東昌村",NULL
139,1235,34,1269,1818,0,0,69.8,827,408,"仁安村",NULL
140,1078,16,1094,1515,0,0,72.21,786,292,"仁和村",NULL
141,787,16,803,1137,0,0,70.62,489,298,"仁和村",NULL
142,812,31,843,1230,0,0,68.54,601,211,"仁和村",NULL
143,790,20,810,1072,0,0,75.56,690,100,"光華村",NULL
144,753,37,790,1105,0,0,71.49,505,248,"溪口村",NULL
145,237,6,243,340,0,0,71.47,144,93,"樹湖村",NULL
146,1313,51,1364,1920,0,0,71.04,784,529,"豐山村",NULL
147,892,34,926,1319,0,0,70.2,577,315,"豐裡村",NULL
148,561,19,580,841,0,0,68.97,371,190,"豐坪村",NULL
149,1137,35,1172,1581,0,0,74.13,755,382,"壽豐村",NULL
150,467,18,485,619,0,0,78.35,331,136,"共和村",NULL
151,563,4,567,753,0,0,75.3,446,117,"光榮村",NULL
152,599,19,618,865,0,0,71.45,366,233,"池南村",NULL
153,701,22,723,988,0,0,73.18,426,275,"平和村",NULL
154,247,3,250,343,0,0,72.89,151,96,"平和村",NULL
155,1468,52,1520,2084,0,0,72.94,905,563,"志學村",NULL
156,300,5,305,407,0,0,74.94,235,65,"志學村、池南村",NULL
157,124,7,131,189,0,0,69.31,91,33,"米棧村",NULL
158,67,3,70,98,0,0,71.43,51,16,"米棧村",NULL
159,559,10,569,803,0,0,70.86,454,105,"月眉村",NULL
160,380,9,389,574,0,0,67.77,271,109,"鹽寮村",NULL
161,493,24,517,768,0,0,67.32,343,150,"水璉村",NULL
162,91,1,92,133,0,0,69.17,72,19,"水璉村",NULL
163,845,15,860,1185,0,0,72.57,545,300,"鳳仁里",NULL
164,461,14,475,627,0,0,75.76,341,120,"鳳義里",NULL
165,518,8,526,696,0,0,75.57,357,161,"鳳禮里",NULL
166,846,6,852,1148,0,0,74.22,634,212,"鳳智里",NULL
167,525,22,547,878,0,0,62.3,426,99,"鳳信里",NULL
168,390,14,404,558,0,0,72.4,300,90,"鳳信里",NULL
169,224,12,236,355,0,0,66.48,173,51,"山興里",NULL
170,135,7,142,223,0,0,63.68,105,30,"山興里",NULL
171,480,31,511,759,0,0,67.33,278,202,"大榮里",NULL
172,428,6,434,623,0,0,69.66,288,140,"大榮里",NULL
173,412,16,428,633,0,0,67.61,213,199,"北林里",NULL
174,437,12,449,673,0,0,66.72,267,170,"南平里",NULL
175,631,31,662,876,0,0,75.57,460,171,"林榮里",NULL
176,753,34,787,1143,0,0,68.85,467,286,"長橋里",NULL
177,140,2,142,192,0,0,73.96,108,32,"森榮里",NULL
178,915,23,938,1346,0,0,69.69,570,345,"大華村",NULL
179,655,5,660,889,0,0,74.24,417,238,"大安村",NULL
180,654,29,683,1059,0,0,64.49,514,140,"大馬村",NULL
181,634,26,660,979,0,0,67.42,462,172,"大平村",NULL
182,719,21,740,1051,0,0,70.41,495,224,"大同村",NULL
183,120,4,124,248,0,0,50,104,16,"東富村",NULL
184,542,11,553,904,0,0,61.17,492,50,"東富村",NULL
185,367,9,376,592,0,0,63.51,322,45,"西富村",NULL
186,285,16,301,475,0,0,63.37,176,109,"西富村",NULL
187,544,12,556,883,0,0,62.97,454,90,"南富村",NULL
188,566,17,583,903,0,0,64.56,489,77,"北富村",NULL
189,371,8,379,517,0,0,73.31,302,69,"大進村",NULL
190,444,26,470,730,0,0,64.38,312,132,"大全村",NULL
191,88,5,93,124,0,0,75,59,29,"大全村",NULL
192,294,18,312,513,0,0,60.82,223,71,"大興村",NULL
193,242,11,253,386,0,0,65.54,134,108,"大富村",NULL
194,362,11,373,567,0,0,65.78,219,143,"大豐村",NULL
195,380,16,396,783,0,0,50.57,326,54,"靜浦村",NULL
196,474,23,497,835,0,0,59.52,342,132,"港口村",NULL
197,120,4,124,197,0,0,62.94,100,20,"豐濱村",NULL
198,770,36,806,1382,0,0,58.32,604,166,"豐濱村",NULL
199,248,1,249,445,0,0,55.96,207,41,"豐濱村",NULL
200,398,9,407,673,0,0,60.48,355,43,"新社村",NULL
201,196,11,207,346,0,0,59.83,175,21,"磯崎村",NULL
202,688,33,721,1041,0,0,69.26,630,58,"西林村",NULL
203,329,11,340,511,0,0,66.54,306,23,"見晴村",NULL
204,462,12,474,705,0,0,67.23,384,78,"萬榮村",NULL
205,385,13,398,598,0,0,66.56,348,37,"明利村",NULL
206,252,6,258,380,0,0,67.89,221,31,"馬遠村",NULL
207,368,10,378,628,0,0,60.19,328,40,"馬遠村",NULL
208,646,14,660,1076,0,0,61.34,597,49,"紅葉村",NULL
209,605,8,613,860,0,0,71.28,418,187,"瑞穗村",NULL
210,752,22,774,1137,0,0,68.07,473,279,"瑞穗村",NULL
211,579,7,586,836,0,0,70.1,362,217,"瑞美村",NULL
212,660,23,683,1015,0,0,67.29,415,245,"瑞美村",NULL
213,378,9,387,558,0,0,69.35,264,114,"瑞良村",NULL
214,654,29,683,1051,0,0,64.99,430,224,"瑞祥村",NULL
215,369,8,377,607,0,0,62.11,251,118,"瑞北村",NULL
216,613,26,639,1004,0,0,63.65,461,152,"舞鶴村",NULL
217,501,20,521,898,0,0,58.02,435,66,"鶴岡村",NULL
218,194,5,199,361,0,0,55.12,173,21,"奇美村",NULL
219,559,32,591,907,0,0,65.16,393,166,"富源村",NULL
220,555,39,594,1037,0,0,57.28,476,79,"富民村",NULL
221,403,17,420,704,0,0,59.66,188,215,"富興村",NULL
222,1369,25,1394,2030,0,0,68.67,956,413,"中城里",NULL
223,1081,27,1108,1582,0,0,70.04,691,390,"中城里",NULL
224,743,21,764,1054,0,0,72.49,477,266,"中城里",NULL
225,970,10,980,1352,0,0,72.49,599,371,"國武里",NULL
226,623,8,631,926,0,0,68.14,406,217,"啟模里",NULL
227,643,19,662,928,0,0,71.34,474,169,"啟模里",NULL
228,834,25,859,1169,0,0,73.48,653,181,"泰昌里",NULL
229,217,45,262,874,0,0,29.98,120,97,"泰昌里",NULL
230,65,14,79,583,0,0,13.55,57,8,"泰昌里",NULL
231,793,23,816,1216,0,0,67.11,598,195,"永昌里",NULL
232,832,36,868,1331,0,0,65.21,555,277,"源城里",NULL
233,402,28,430,828,0,0,51.93,338,64,"長良里",NULL
234,709,34,743,1179,0,0,63.02,607,102,"樂合里",NULL
235,331,8,339,572,0,0,59.27,242,89,"東豐里",NULL
236,598,26,624,1039,0,0,60.06,392,206,"觀音里",NULL
237,436,1,437,727,0,0,60.11,334,102,"觀音里",NULL
238,908,55,963,1765,0,0,54.56,696,212,"松浦里",NULL
239,549,34,583,1019,0,0,57.21,400,149,"春日里",NULL
240,458,14,472,803,0,0,58.78,414,44,"德武里",NULL
241,650,35,685,1044,0,0,65.61,342,308,"三民里",NULL
242,740,32,772,1202,0,0,64.23,465,275,"大禹里",NULL
243,348,3,351,566,0,0,62.01,251,97,"吳江村",NULL
244,707,29,736,1299,0,0,56.66,492,215,"東里村",NULL
245,412,24,436,763,0,0,57.14,280,132,"萬寧村",NULL
246,398,18,416,706,0,0,58.92,336,62,"新興村",NULL
247,712,23,735,1099,0,0,66.88,567,145,"竹田村",NULL
248,273,16,289,467,0,0,61.88,195,78,"羅山村",NULL
249,527,23,550,861,0,0,63.88,353,174,"石牌村",NULL
250,259,3,262,423,0,0,61.94,161,98,"明里村",NULL
251,1019,3,1022,1583,0,0,64.56,633,386,"富里村",NULL
252,299,0,299,526,0,0,56.84,205,94,"永豐村",NULL
253,405,33,438,719,0,0,60.92,325,80,"豐南村",NULL
254,349,15,364,568,0,0,64.08,244,105,"富南村",NULL
255,402,19,421,649,0,0,64.87,253,149,"學田村",NULL
256,311,7,318,501,0,0,63.47,291,20,"崙山村",NULL
257,285,6,291,467,0,0,62.31,259,26,"立山村",NULL
258,298,14,312,519,0,0,60.12,269,29,"立山村",NULL
259,199,7,206,301,0,0,68.44,191,8,"太平村",NULL
260,230,9,239,354,0,0,67.51,194,36,"太平村",NULL
261,387,8,395,654,0,0,60.4,354,33,"卓溪村",NULL
262,382,3,385,581,0,0,66.27,363,19,"卓清村",NULL
263,238,7,245,399,0,0,61.4,227,11,"卓清村",NULL
264,187,5,192,361,0,0,53.19,170,17,"古風村",NULL
265,276,6,282,441,0,0,63.95,259,17,"古風村",NULL
266,110,0,110,171,0,0,64.33,99,11,"古風村",NULL
1,230,5,235,313,0,0,75.08,213,17,"新復里",NULL
2,234,3,237,319,0,0,74.29,145,89,"復興里",NULL
3,389,11,400,533,0,0,75.05,203,186,"長安里",NULL
4,358,8,366,492,0,0,74.39,146,212,"中央里",NULL
5,615,7,622,859,0,0,72.41,266,349,"啟明里",NULL
6,716,12,728,990,0,0,73.54,319,397,"重慶里",NULL
7,531,10,541,715,0,0,75.66,328,203,"中興里",NULL
8,640,9,649,939,0,0,69.12,289,351,"光復里",NULL
9,656,6,662,908,0,0,72.91,403,253,"光復里",NULL
10,415,0,415,566,0,0,73.32,265,150,"光明里",NULL
11,419,13,432,615,0,0,70.24,297,122,"光明里",NULL
12,877,17,894,1190,0,0,75.13,553,324,"光榮里",NULL
13,827,14,841,1176,0,0,71.51,526,301,"光榮里",NULL
14,956,22,978,1431,0,0,68.34,489,467,"朝陽里",NULL
15,853,24,877,1258,0,0,69.71,436,417,"朝陽里",NULL
16,1331,31,1362,1930,0,0,70.57,804,527,"朝陽里",NULL
17,778,18,796,1127,0,0,70.63,415,363,"陽明里",NULL
18,818,14,832,1142,0,0,72.85,391,427,"陽明里",NULL
19,827,22,849,1138,0,0,74.6,441,386,"重光里",NULL
20,947,15,962,1370,0,0,70.22,559,388,"西衛里",NULL
21,1056,23,1079,1480,0,0,72.91,589,467,"西衛里",NULL
22,777,15,792,1051,0,0,75.36,423,354,"西文里",NULL
23,669,25,694,950,0,0,73.05,403,266,"西文里",NULL
24,820,10,830,1114,0,0,74.51,421,399,"東文里",NULL
25,637,6,643,900,0,0,71.44,356,281,"東文里",NULL
26,876,19,895,1227,0,0,72.94,450,426,"案山里",NULL
27,493,8,501,695,0,0,72.09,407,86,"光華里",NULL
28,404,4,408,574,0,0,71.08,195,209,"前寮里",NULL
29,1088,14,1102,1499,0,0,73.52,668,420,"石泉里",NULL
30,214,5,219,316,0,0,69.3,110,104,"菜園里",NULL
31,975,25,1000,1391,0,0,71.89,558,417,"東衛里",NULL
32,312,3,315,445,0,0,70.79,136,176,"安宅里",NULL
33,418,14,432,591,0,0,73.1,174,244,"興仁里",NULL
34,552,19,571,816,0,0,69.98,184,368,"烏崁里",NULL
35,284,12,296,391,0,0,75.7,100,184,"鐵線里",NULL
36,681,18,699,1072,0,0,65.21,246,435,"鎖港里",NULL
37,636,18,654,973,0,0,67.21,203,433,"鎖港里",NULL
38,913,34,947,1405,0,0,67.4,323,590,"山水里",NULL
39,125,5,130,176,0,0,73.86,82,43,"五德里",NULL
40,228,8,236,335,0,0,70.45,103,125,"井垵里",NULL
41,631,7,638,1071,0,0,59.57,373,258,"時裡里",NULL
42,757,24,781,1248,0,0,62.58,270,487,"風櫃里",NULL
43,235,9,244,619,0,0,39.42,129,106,"虎井里",NULL
44,82,1,83,204,0,0,40.69,52,30,"桶盤里",NULL
45,563,20,583,852,0,0,68.43,266,297,"湖西村",NULL
46,213,5,218,307,0,0,71.01,106,107,"湖東村",NULL
47,126,4,130,206,0,0,63.11,59,67,"青螺村",NULL
48,170,1,171,242,0,0,70.66,85,85,"白坑村",NULL
49,390,11,401,604,0,0,66.39,120,270,"南寮村",NULL
50,208,3,211,277,0,0,76.17,78,130,"北寮村",NULL
51,358,20,378,553,0,0,68.35,118,240,"紅羅村",NULL
52,286,15,301,453,0,0,66.45,132,154,"西溪村",NULL
53,296,10,306,426,0,0,71.83,122,174,"成功村",NULL
54,72,3,75,113,0,0,66.37,33,39,"東石村",NULL
55,498,19,517,719,0,0,71.91,134,364,"沙港村",NULL
56,100,1,101,169,0,0,59.76,45,55,"中西村",NULL
57,184,8,192,298,0,0,64.43,90,94,"鼎灣村",NULL
58,172,2,174,232,0,0,75,67,105,"潭邊村",NULL
59,125,0,125,175,0,0,71.43,70,55,"許家村",NULL
60,132,7,139,193,0,0,72.02,78,54,"城北村",NULL
61,70,5,75,114,0,0,65.79,41,29,"太武村",NULL
62,436,15,451,635,0,0,71.02,235,201,"隘門村",NULL
63,555,23,578,876,0,0,65.98,195,360,"林投村",NULL
64,340,18,358,537,0,0,66.67,122,218,"尖山村",NULL
65,524,15,539,801,0,0,67.29,211,313,"龍門村",NULL
66,509,13,522,746,0,0,69.97,212,297,"龍門村",NULL
67,406,14,420,640,0,0,65.63,141,265,"果葉村",NULL
68,295,12,307,449,0,0,68.37,136,159,"中屯村",NULL
69,364,8,372,537,0,0,69.27,159,205,"講美村",NULL
70,55,3,58,92,0,0,63.04,32,23,"城前村",NULL
71,78,0,78,109,0,0,71.56,51,27,"鎮海村",NULL
72,155,2,157,245,0,0,64.08,86,69,"港子村",NULL
73,121,5,126,214,0,0,58.88,54,67,"岐頭村",NULL
74,105,2,107,146,0,0,73.29,54,51,"小赤村",NULL
75,856,27,883,1344,0,0,65.7,432,424,"赤崁村",NULL
76,166,3,169,282,0,0,59.93,72,94,"瓦硐村",NULL
77,392,13,405,642,0,0,63.08,158,234,"後寮村",NULL
78,421,9,430,683,0,0,62.96,206,215,"通梁村",NULL
79,609,15,624,1214,0,0,51.4,132,477,"吉貝村",NULL
80,445,4,449,986,0,0,45.54,341,104,"鳥嶼村",NULL
81,120,1,121,213,0,0,56.81,87,33,"員貝村",NULL
82,92,4,96,180,0,0,53.33,30,62,"大倉村",NULL
83,148,8,156,254,0,0,61.42,85,63,"橫礁村",NULL
84,223,17,240,394,0,0,60.91,95,128,"合界村",NULL
85,441,18,459,769,0,0,59.69,158,283,"竹灣村",NULL
86,143,2,145,266,0,0,54.51,131,12,"小門村",NULL
87,353,11,364,605,0,0,60.17,162,191,"大池村",NULL
88,85,1,86,126,0,0,68.25,32,53,"二崁村",NULL
89,326,12,338,512,0,0,66.02,174,152,"池東村",NULL
90,119,4,123,202,0,0,60.89,50,69,"池西村",NULL
91,330,14,344,595,0,0,57.82,95,235,"赤馬村",NULL
92,715,21,736,1193,0,0,61.69,243,472,"內垵村",NULL
93,464,10,474,795,0,0,59.62,316,148,"外垵村",NULL
94,574,9,583,980,0,0,59.49,421,153,"外垵村",NULL
95,222,10,232,424,0,0,54.72,114,108,"東安村",NULL
96,157,6,163,314,0,0,51.91,94,63,"西安村",NULL
97,83,9,92,224,0,0,41.07,35,48,"中社村",NULL
98,135,11,146,288,0,0,50.69,62,73,"水垵村",NULL
99,238,16,254,570,0,0,44.56,60,178,"將軍村",NULL
100,238,23,261,592,0,0,44.09,36,202,"將軍村",NULL
101,96,3,99,274,0,0,36.13,21,75,"東吉村",NULL
102,105,6,111,320,0,0,34.69,29,76,"東坪村",NULL
103,50,0,50,166,0,0,30.12,18,32,"西坪村",NULL
104,101,8,109,222,0,0,49.1,85,16,"花嶼村",NULL
105,98,6,104,220,0,0,47.27,76,22,"東湖村",NULL
106,218,14,232,413,0,0,56.17,162,56,"西湖村",NULL
107,202,14,216,450,0,0,48,162,40,"中和村",NULL
108,134,7,141,264,0,0,53.41,93,41,"平和村",NULL
109,107,4,111,248,0,0,44.76,68,39,"海豐村",NULL
110,409,22,431,807,0,0,53.41,329,80,"南港村",NULL
1,470,12,482,570,0,0,84.56,190,280,"長潭里",NULL
2,1657,31,1688,2210,0,0,76.38,933,724,"砂子里",NULL
3,766,9,775,1032,0,0,75.1,480,286,"砂子里",NULL
4,1156,40,1196,1545,0,0,77.41,388,768,"八斗里",NULL
5,991,38,1029,1350,0,0,76.22,484,507,"碧砂里",NULL
6,1354,22,1376,1881,0,0,73.15,875,479,"新富里",NULL
7,1044,11,1055,1384,0,0,76.23,666,378,"新富里",NULL
8,519,12,531,749,0,0,70.89,367,152,"新富里",NULL
9,495,13,508,749,0,0,67.82,309,186,"新豐里",NULL
10,861,11,872,1196,0,0,72.91,566,295,"新豐里",NULL
11,1117,10,1127,1469,0,0,76.72,773,344,"新豐里",NULL
12,1158,28,1186,1525,0,0,77.77,616,542,"平寮里",NULL
13,1431,47,1478,1961,0,0,75.37,694,737,"社寮里",NULL
14,751,19,770,1087,0,0,70.84,567,184,"和憲里",NULL
15,987,25,1012,1392,0,0,72.7,679,308,"海濱里",NULL
16,911,32,943,1249,0,0,75.5,570,341,"正濱里",NULL
17,685,22,707,919,0,0,76.93,411,274,"中正里",NULL
18,762,24,786,1168,0,0,67.29,459,303,"中正里",NULL
19,1085,26,1111,1469,0,0,75.63,724,361,"中濱里",NULL
20,957,23,980,1231,0,0,79.61,679,278,"建國里",NULL
21,809,21,830,1044,0,0,79.5,619,190,"建國里",NULL
22,1577,49,1626,2110,0,0,77.06,1076,501,"砂灣里",NULL
23,1186,25,1211,1516,0,0,79.88,742,444,"真砂里",NULL
24,1161,24,1185,1505,0,0,78.74,759,402,"正砂里",NULL
25,752,6,758,959,0,0,79.04,539,213,"正砂里",NULL
26,1070,8,1078,1331,0,0,80.99,686,384,"中砂里",NULL
27,973,28,1001,1305,0,0,76.7,597,376,"入船里",NULL
28,1141,19,1160,1471,0,0,78.86,725,416,"正船里",NULL
29,1013,34,1047,1338,0,0,78.25,649,364,"中船里",NULL
30,1000,23,1023,1277,0,0,80.11,519,481,"港通里",NULL
31,896,24,920,1187,0,0,77.51,525,371,"義重里",NULL
32,1125,34,1159,1475,0,0,78.58,646,479,"正義里",NULL
33,831,10,841,1050,0,0,80.1,469,362,"信義里",NULL
34,649,13,662,818,0,0,80.93,370,279,"德義里",NULL
35,941,16,957,1158,0,0,82.64,571,370,"仁壽里",NULL
36,971,16,987,1202,0,0,82.11,644,327,"仁義里",NULL
37,778,14,792,996,0,0,79.52,540,238,"義昭里",NULL
38,948,27,975,1173,0,0,83.12,605,343,"義幸里",NULL
39,963,30,993,1203,0,0,82.54,632,331,"義幸里",NULL
40,679,12,691,833,0,0,82.95,381,298,"義民里",NULL
41,1010,15,1025,1259,0,0,81.41,657,353,"義和里",NULL
42,546,6,552,684,0,0,80.7,348,198,"智慧里",NULL
43,545,10,555,706,0,0,78.61,260,285,"智誠里",NULL
44,780,4,784,1027,0,0,76.34,422,358,"智誠里",NULL
45,1167,21,1188,1478,0,0,80.38,742,425,"禮儀里",NULL
46,1216,33,1249,1555,0,0,80.32,827,389,"禮東里",NULL
47,986,9,995,1220,0,0,81.56,662,324,"信綠里",NULL
48,860,11,871,1130,0,0,77.08,565,295,"信綠里",NULL
49,743,16,759,946,0,0,80.23,496,247,"東信里",NULL
50,1912,25,1937,2462,0,0,78.68,1348,564,"東信里",NULL
51,1442,35,1477,1840,0,0,80.27,956,486,"東光里",NULL
52,1110,27,1137,1524,0,0,74.61,729,381,"東明里",NULL
53,1450,29,1479,1849,0,0,79.99,1049,401,"東明里",NULL
54,1031,11,1042,1314,0,0,79.3,686,345,"東安里",NULL
55,1086,23,1109,1382,0,0,80.25,717,369,"東安里",NULL
56,1501,24,1525,1958,0,0,77.89,943,558,"孝賢里",NULL
57,1479,28,1507,1845,0,0,81.68,1023,456,"孝賢里",NULL
58,1206,31,1237,1613,0,0,76.69,727,479,"孝德里",NULL
59,1716,24,1740,2368,0,0,73.48,1125,591,"孝德里",NULL
60,1796,44,1840,2491,0,0,73.87,1084,712,"孝深里",NULL
61,665,19,684,915,0,0,74.75,407,258,"孝岡里",NULL
62,1318,33,1351,1757,0,0,76.89,700,618,"林泉里",NULL
63,755,18,773,955,0,0,80.94,400,355,"花崗里",NULL
64,1232,22,1254,1544,0,0,81.22,678,554,"虹橋里",NULL
65,1405,29,1434,1754,0,0,81.76,820,585,"水錦里",NULL
66,902,18,920,1145,0,0,80.35,497,405,"智仁里",NULL
67,857,24,881,1113,0,0,79.16,500,357,"智仁里",NULL
68,856,16,872,1091,0,0,79.93,443,413,"和明里",NULL
69,777,8,785,1013,0,0,77.49,400,377,"忠勇里",NULL
70,847,18,865,1080,0,0,80.09,433,414,"玉田里",NULL
71,778,24,802,1014,0,0,79.09,377,401,"仁德里",NULL
72,956,13,969,1210,0,0,80.08,521,435,"博愛里",NULL
73,421,12,433,524,0,0,82.63,227,194,"博愛里",NULL
74,654,14,668,875,0,0,76.34,300,354,"福仁里",NULL
75,796,26,822,1037,0,0,79.27,372,424,"誠仁里",NULL
76,1147,13,1160,1471,0,0,78.86,563,584,"吉仁里",NULL
77,1047,27,1074,1399,0,0,76.77,558,489,"吉仁里",NULL
78,661,17,678,882,0,0,76.87,316,345,"育仁里",NULL
79,550,13,563,724,0,0,77.76,252,298,"英仁里",NULL
80,505,17,522,666,0,0,78.38,286,219,"英仁里",NULL
81,631,4,635,864,0,0,73.5,303,328,"龍門里",NULL
82,1012,28,1040,1372,0,0,75.8,551,461,"德厚里",NULL
83,778,18,796,975,0,0,81.64,370,408,"曲水里",NULL
84,738,19,757,954,0,0,79.35,386,352,"崇文里",NULL
85,793,30,823,1041,0,0,79.06,397,396,"文安里",NULL
86,569,7,576,712,0,0,80.9,358,211,"兆連里",NULL
87,897,26,923,1185,0,0,77.89,507,390,"獅球里",NULL
88,891,37,928,1197,0,0,77.53,446,445,"書院里",NULL
89,1041,30,1071,1265,0,0,84.66,851,190,"朝棟里",NULL
90,1212,35,1247,1606,0,0,77.65,743,469,"朝棟里",NULL
91,893,14,907,1155,0,0,78.53,508,385,"光華里",NULL
92,913,12,925,1143,0,0,80.93,517,396,"光華里",NULL
93,590,23,613,770,0,0,79.61,347,243,"明德里",NULL
94,542,14,556,669,0,0,83.11,297,245,"同風里",NULL
95,706,4,710,858,0,0,82.75,289,417,"文昌里",NULL
96,589,12,601,722,0,0,83.24,296,293,"新店里",NULL
97,599,18,617,788,0,0,78.3,274,325,"新建里",NULL
98,872,29,901,1121,0,0,80.37,440,432,"安民里",NULL
99,770,27,797,991,0,0,80.42,394,376,"安平里",NULL
100,856,16,872,1117,0,0,78.07,409,447,"中山里",NULL
101,735,7,742,985,0,0,75.33,402,333,"民治里",NULL
102,1004,37,1041,1312,0,0,79.34,591,413,"中興里",NULL
103,611,12,623,837,0,0,74.43,393,218,"仁正里",NULL
104,1104,26,1130,1452,0,0,77.82,567,537,"健民里",NULL
105,921,32,953,1238,0,0,76.98,549,372,"通化里",NULL
106,516,21,537,723,0,0,74.27,324,192,"居仁里",NULL
107,558,17,575,772,0,0,74.48,295,263,"居仁里",NULL
108,717,19,736,953,0,0,77.23,436,281,"通明里",NULL
109,812,35,847,1071,0,0,79.08,435,377,"通明里",NULL
110,494,16,510,674,0,0,75.67,324,170,"和平里",NULL
111,561,21,582,758,0,0,76.78,276,285,"仙洞里",NULL
112,699,23,722,960,0,0,75.21,363,336,"太白里",NULL
113,686,8,694,896,0,0,77.46,378,308,"協和里",NULL
114,597,19,616,763,0,0,80.73,325,272,"協和里",NULL
115,779,24,803,1132,0,0,70.94,451,328,"文化里",NULL
116,1321,37,1358,1706,0,0,79.6,785,536,"德安里",NULL
117,1176,24,1200,1469,0,0,81.69,676,500,"德安里",NULL
118,1393,31,1424,1730,0,0,82.31,858,535,"德和里",NULL
119,1107,8,1115,1299,0,0,85.84,765,342,"德和里",NULL
120,1397,32,1429,1770,0,0,80.73,842,555,"德和里",NULL
121,1126,23,1149,1483,0,0,77.48,678,448,"中和里",NULL
122,630,14,644,828,0,0,77.78,369,261,"中和里",NULL
123,1755,29,1784,2328,0,0,76.63,1179,576,"中和里",NULL
124,1845,38,1883,2565,0,0,73.41,1089,756,"和慶里",NULL
125,1800,31,1831,2398,0,0,76.36,1101,699,"和慶里",NULL
126,1240,41,1281,1669,0,0,76.75,643,597,"西康里",NULL
127,725,29,754,998,0,0,75.55,403,322,"西定里",NULL
128,777,18,795,996,0,0,79.82,413,364,"西華里",NULL
129,646,15,661,852,0,0,77.58,359,287,"西榮里",NULL
130,1059,49,1108,1467,0,0,75.53,590,469,"新西里",NULL
131,1027,33,1060,1353,0,0,78.34,608,419,"西川里",NULL
132,929,34,963,1243,0,0,77.47,520,409,"定國里",NULL
133,1015,28,1043,1306,0,0,79.86,519,496,"定邦里",NULL
134,767,22,789,1034,0,0,76.31,366,401,"慈仁里",NULL
135,1141,31,1172,1498,0,0,78.24,665,476,"干城里",NULL
136,575,37,612,804,0,0,76.12,306,269,"干城里",NULL
137,1139,31,1170,1537,0,0,76.12,561,578,"永康里",NULL
138,360,12,372,466,0,0,79.83,197,163,"永康里",NULL
139,721,12,733,912,0,0,80.37,374,347,"安和里",NULL
140,513,18,531,653,0,0,81.32,250,263,"樂一里",NULL
141,1471,40,1511,1958,0,0,77.17,691,780,"嘉仁里",NULL
142,1044,29,1073,1354,0,0,79.25,515,529,"嘉仁里",NULL
143,1231,22,1253,1565,0,0,80.06,765,466,"三民里",NULL
144,1156,30,1186,1514,0,0,78.34,716,440,"三民里",NULL
145,1683,18,1701,2112,0,0,80.54,1092,591,"三民里",NULL
146,1360,21,1381,1648,0,0,83.8,838,522,"四維里",NULL
147,815,21,836,997,0,0,83.85,511,304,"四維里",NULL
148,1250,23,1273,1548,0,0,82.24,787,463,"四維里",NULL
149,1579,23,1602,1958,0,0,81.82,1025,554,"五福里",NULL
150,1139,30,1169,1526,0,0,76.61,713,426,"五福里",NULL
151,1338,24,1362,1724,0,0,79,849,489,"六合里",NULL
152,1412,35,1447,1834,0,0,78.9,894,518,"六合里",NULL
153,1160,26,1186,1470,0,0,80.68,679,481,"七賢里",NULL
154,1080,36,1116,1395,0,0,80,628,452,"七賢里",NULL
155,1581,17,1598,1907,0,0,83.8,1121,460,"長樂里",NULL
156,593,9,602,737,0,0,81.68,387,206,"長樂里",NULL
157,1082,36,1118,1540,0,0,72.6,652,430,"鶯歌里",NULL
158,1020,7,1027,1301,0,0,78.94,633,387,"鶯歌里",NULL
159,1989,31,2020,2505,0,0,80.64,1262,727,"鶯安里",NULL
160,1660,28,1688,2240,0,0,75.36,1009,651,"興寮里",NULL
161,973,19,992,1279,0,0,77.56,606,367,"興寮里",NULL
162,1432,34,1466,1903,0,0,77.04,837,595,"外寮里",NULL
163,1113,27,1140,1443,0,0,79,682,431,"外寮里",NULL
164,1568,16,1584,2048,0,0,77.34,932,636,"新崙里",NULL
165,792,19,811,1050,0,0,77.24,431,361,"新崙里",NULL
166,910,25,935,1220,0,0,76.64,554,356,"武崙里",NULL
167,1706,33,1739,2173,0,0,80.03,1101,605,"武崙里",NULL
168,1000,23,1023,1315,0,0,77.79,585,415,"中崙里",NULL
169,1363,33,1396,1860,0,0,75.05,854,509,"內寮里",NULL
170,1248,35,1283,1717,0,0,74.72,717,531,"內寮里",NULL
171,1070,25,1095,1375,0,0,79.64,604,466,"八西里",NULL
172,479,18,497,637,0,0,78.02,255,224,"八中里",NULL
173,542,15,557,713,0,0,78.12,307,235,"八堵里",NULL
174,448,15,463,625,0,0,74.08,227,221,"八南里",NULL
175,1331,21,1352,1737,0,0,77.84,856,475,"過港里",NULL
176,1198,31,1229,1572,0,0,78.18,776,422,"過港里",NULL
177,1070,18,1088,1305,0,0,83.37,646,424,"暖暖里",NULL
178,712,22,734,952,0,0,77.1,391,321,"暖暖里",NULL
179,760,16,776,962,0,0,80.67,448,312,"暖同里",NULL
180,999,18,1017,1312,0,0,77.52,634,365,"暖同里",NULL
181,284,11,295,397,0,0,74.31,159,125,"暖東里",NULL
182,1561,25,1586,2000,0,0,79.3,906,655,"暖西里",NULL
183,1264,26,1290,1654,0,0,77.99,752,512,"暖西里",NULL
184,857,21,878,1081,0,0,81.22,574,283,"碇內里",NULL
185,882,27,909,1201,0,0,75.69,631,251,"碇內里",NULL
186,639,18,657,778,0,0,84.45,609,30,"碇和里",NULL
187,1169,18,1187,1541,0,0,77.03,722,447,"碇和里",NULL
188,1147,19,1166,1594,0,0,73.15,751,396,"碇祥里",NULL
189,1434,23,1457,1858,0,0,78.42,961,473,"碇祥里",NULL
190,1948,32,1980,2530,0,0,78.26,1219,729,"碇安里",NULL
191,1425,31,1456,1908,0,0,76.31,954,471,"碇安里",NULL
192,1174,27,1201,1470,0,0,81.7,669,505,"長興里",NULL
193,1135,24,1159,1471,0,0,78.79,713,422,"長興里",NULL
194,622,15,637,808,0,0,78.84,387,235,"長興里",NULL
195,841,12,853,1112,0,0,76.71,463,378,"正光里",NULL
196,861,29,890,1103,0,0,80.69,483,378,"正光里",NULL
197,967,23,990,1196,0,0,82.78,535,432,"正明里",NULL
198,622,9,631,789,0,0,79.97,376,246,"正明里",NULL
199,1378,38,1416,1766,0,0,80.18,943,435,"富民里",NULL
200,1503,27,1530,1860,0,0,82.26,883,620,"富民里",NULL
201,767,19,786,974,0,0,80.7,455,312,"永平里",NULL
202,849,17,866,1075,0,0,80.56,535,314,"永平里",NULL
203,917,18,935,1184,0,0,78.97,576,341,"永安里",NULL
204,666,17,683,871,0,0,78.42,388,278,"永安里",NULL
205,235,2,237,296,0,0,80.07,131,104,"八德里",NULL
206,1004,19,1023,1245,0,0,82.17,543,461,"八德里",NULL
207,730,9,739,934,0,0,79.12,404,326,"自強里",NULL
208,628,10,638,794,0,0,80.35,348,280,"泰安里",NULL
209,1219,7,1226,1546,0,0,79.3,715,504,"泰安里",NULL
210,746,34,780,958,0,0,81.42,430,316,"泰安里",NULL
211,1077,36,1113,1431,0,0,77.78,601,476,"六堵里",NULL
212,1173,23,1196,1538,0,0,77.76,615,558,"堵南里",NULL
213,1474,22,1496,2001,0,0,74.76,882,592,"堵南里",NULL
214,2270,46,2316,3095,0,0,74.83,1195,1075,"堵北里",NULL
215,1106,21,1127,1410,0,0,79.93,575,531,"百福里",NULL
216,1249,25,1274,1622,0,0,78.55,636,613,"百福里",NULL
217,1272,20,1292,1641,0,0,78.73,722,550,"百福里",NULL
218,919,21,940,1210,0,0,77.69,507,412,"實踐里",NULL
219,747,15,762,969,0,0,78.64,396,351,"實踐里",NULL
220,956,27,983,1250,0,0,78.64,529,427,"實踐里",NULL
221,346,3,349,453,0,0,77.04,152,194,"瑪南里",NULL
222,220,15,235,307,0,0,76.55,119,101,"瑪東里",NULL
223,277,12,289,360,0,0,80.28,113,164,"瑪西里",NULL
224,1095,23,1118,1380,0,0,81.01,621,474,"友一里",NULL
225,352,19,371,445,0,0,83.37,153,199,"友二里",NULL
1,731,18,749,1207,0,0,62.05,404,327,"育賢里",NULL
2,738,22,760,953,0,0,79.75,558,180,"親仁里",NULL
3,637,10,647,820,0,0,78.9,522,115,"親仁里",NULL
4,568,18,586,715,0,0,81.96,237,331,"東門里",NULL
5,577,10,587,758,0,0,77.44,246,331,"成功里",NULL
6,345,8,353,467,0,0,75.59,170,175,"榮光里",NULL
7,377,10,387,505,0,0,76.63,175,202,"中正里",NULL
8,764,10,774,975,0,0,79.38,475,289,"錦華里",NULL
9,572,13,585,747,0,0,78.31,474,98,"錦華里",NULL
10,943,18,961,1176,0,0,81.72,589,354,"文華里",NULL
11,792,16,808,963,0,0,83.9,438,354,"文華里",NULL
12,1141,14,1155,1397,0,0,82.68,677,464,"文華里",NULL
13,1014,17,1031,1281,0,0,80.48,617,397,"復中里",NULL
14,998,15,1013,1236,0,0,81.96,572,426,"復中里",NULL
15,1064,21,1085,1316,0,0,82.45,568,496,"復中里",NULL
16,925,17,942,1142,0,0,82.49,510,415,"復興里",NULL
17,969,21,990,1215,0,0,81.48,621,348,"復興里",NULL
18,1002,20,1022,1225,0,0,83.43,579,423,"復興里",NULL
19,1056,32,1088,1297,0,0,83.89,494,562,"三民里",NULL
20,1145,23,1168,1405,0,0,83.13,624,521,"三民里",NULL
21,1018,14,1032,1225,0,0,84.24,570,448,"三民里",NULL
22,794,19,813,997,0,0,81.54,468,326,"東園里",NULL
23,1266,23,1289,1613,0,0,79.91,718,548,"東園里",NULL
24,739,13,752,965,0,0,77.93,469,270,"公園里",NULL
25,1072,28,1100,1291,0,0,85.21,637,435,"公園里",NULL
26,965,18,983,1206,0,0,81.51,497,468,"建華里",NULL
27,771,20,791,951,0,0,83.18,399,372,"建華里",NULL
28,705,22,727,901,0,0,80.69,405,300,"東山里",NULL
29,837,10,847,1012,0,0,83.7,510,327,"東山里",NULL
30,802,10,812,990,0,0,82.02,542,260,"東山里",NULL
31,937,15,952,1199,0,0,79.4,637,300,"綠水里",NULL
32,1183,21,1204,1503,0,0,80.11,740,443,"綠水里",NULL
33,1146,23,1169,1405,0,0,83.2,786,360,"綠水里",NULL
34,857,11,868,1063,0,0,81.66,412,445,"東勢里",NULL
35,705,16,721,871,0,0,82.78,412,293,"光復里",NULL
36,769,36,805,973,0,0,82.73,334,435,"光復里",NULL
37,1195,18,1213,1493,0,0,81.25,536,659,"前溪里",NULL
38,736,30,766,955,0,0,80.21,347,389,"水源里",NULL
39,1150,56,1206,1478,0,0,81.6,446,704,"前溪里",NULL
40,1250,44,1294,1579,0,0,81.95,571,679,"水源里",NULL
41,652,32,684,849,0,0,80.57,344,308,"千甲里",NULL
42,717,31,748,902,0,0,82.93,417,300,"千甲里",NULL
43,1041,30,1071,1333,0,0,80.35,661,380,"豐功里",NULL
44,969,23,992,1218,0,0,81.44,700,269,"豐功里",NULL
45,99,4,103,168,0,0,61.31,90,9,"偉功里",NULL
46,1949,48,1997,2353,0,0,84.87,1745,204,"武功里",NULL
47,560,17,577,655,0,0,88.09,455,105,"武功里",NULL
48,1267,54,1321,1584,0,0,83.4,1042,225,"軍功里",NULL
49,1357,25,1382,1651,0,0,83.71,1036,321,"軍功里",NULL
50,679,19,698,857,0,0,81.45,559,120,"立功里",NULL
51,714,7,721,912,0,0,79.06,651,63,"建功里",NULL
52,727,17,744,872,0,0,85.32,550,177,"建功里",NULL
53,582,14,596,687,0,0,86.75,520,62,"建功里",NULL
54,948,16,964,1254,0,0,76.87,730,218,"光明里",NULL
55,417,1,418,526,0,0,79.47,269,148,"光明里",NULL
56,1198,17,1215,1493,0,0,81.38,845,353,"光明里",NULL
57,807,21,828,972,0,0,85.19,479,328,"龍山里",NULL
58,602,11,613,749,0,0,81.84,415,187,"龍山里",NULL
59,860,15,875,1051,0,0,83.25,554,306,"龍山里",NULL
60,1143,29,1172,1369,0,0,85.61,757,386,"科園里",NULL
61,1055,11,1066,1266,0,0,84.2,780,275,"科園里",NULL
62,1148,19,1167,1335,0,0,87.42,761,387,"科園里",NULL
63,949,18,967,1133,0,0,85.35,631,318,"科園里",NULL
64,955,31,986,1203,0,0,81.96,493,462,"埔頂里",NULL
65,848,5,853,1044,0,0,81.7,414,434,"埔頂里",NULL
66,1163,33,1196,1443,0,0,82.88,693,470,"新莊里",NULL
67,1153,27,1180,1433,0,0,82.34,728,425,"新莊里",NULL
68,936,12,948,1139,0,0,83.23,664,272,"新莊里",NULL
69,870,26,896,1087,0,0,82.43,590,280,"關東里",NULL
70,949,34,983,1209,0,0,81.31,670,279,"關東里",NULL
71,1122,32,1154,1392,0,0,82.9,736,386,"關東里",NULL
72,1179,30,1209,1481,0,0,81.63,756,423,"金山里",NULL
73,1179,43,1222,1497,0,0,81.63,903,276,"金山里",NULL
74,1106,20,1126,1394,0,0,80.77,798,308,"金山里",NULL
75,1367,34,1401,1695,0,0,82.65,943,424,"仙水里",NULL
76,1352,21,1373,1621,0,0,84.7,828,524,"仙水里",NULL
77,702,20,722,871,0,0,82.89,436,266,"仙宮里",NULL
78,468,5,473,601,0,0,78.7,200,268,"關帝里",NULL
79,541,11,552,701,0,0,78.74,230,311,"南門里",NULL
80,729,9,738,911,0,0,81.01,283,446,"南市里",NULL
81,1004,30,1034,1292,0,0,80.03,454,550,"福德里",NULL
82,1220,26,1246,1602,0,0,77.78,581,639,"振興里",NULL
83,1240,13,1253,1560,0,0,80.32,712,528,"振興里",NULL
84,1009,26,1035,1328,0,0,77.94,578,431,"振興里",NULL
85,789,7,796,972,0,0,81.89,355,434,"新興里",NULL
86,873,22,895,1096,0,0,81.66,451,422,"新興里",NULL
87,795,19,814,1010,0,0,80.59,366,429,"新興里",NULL
88,637,20,657,858,0,0,76.57,283,354,"寺前里",NULL
89,656,17,673,806,0,0,83.5,240,416,"竹蓮里",NULL
90,586,25,611,766,0,0,79.77,351,235,"下竹里",NULL
91,750,24,774,956,0,0,80.96,368,382,"頂竹里",NULL
92,791,9,800,985,0,0,81.22,407,384,"頂竹里",NULL
93,840,17,857,1055,0,0,81.23,404,436,"頂竹里",NULL
94,501,15,516,656,0,0,78.66,208,293,"南大里",NULL
95,681,19,700,850,0,0,82.35,363,318,"南大里",NULL
96,461,17,478,585,0,0,81.71,272,189,"新光里",NULL
97,1164,46,1210,1508,0,0,80.24,598,566,"新光里",NULL
98,958,16,974,1182,0,0,82.4,470,488,"新光里",NULL
99,1176,14,1190,1477,0,0,80.57,618,558,"光鎮里",NULL
100,1250,29,1279,1551,0,0,82.46,669,581,"光鎮里",NULL
101,1035,19,1054,1307,0,0,80.64,574,461,"高峰里",NULL
102,821,19,840,1086,0,0,77.35,370,451,"高峰里",NULL
103,1061,29,1090,1373,0,0,79.39,618,443,"高峰里",NULL
104,948,18,966,1179,0,0,81.93,548,400,"高峰里",NULL
105,1397,18,1415,1732,0,0,81.7,774,623,"湖濱里",NULL
106,932,16,948,1182,0,0,80.2,457,475,"湖濱里",NULL
107,946,20,966,1201,0,0,80.43,499,447,"柴橋里",NULL
108,941,14,955,1145,0,0,83.41,615,326,"柴橋里",NULL
109,984,14,998,1146,0,0,87.09,625,359,"柴橋里",NULL
110,821,20,841,1063,0,0,79.12,501,320,"明湖里",NULL
111,847,18,865,1050,0,0,82.38,546,301,"明湖里",NULL
112,853,12,865,1158,0,0,74.7,567,286,"明湖里",NULL
113,408,14,422,521,0,0,81,188,220,"西門里",NULL
114,647,12,659,808,0,0,81.56,273,374,"潛園里",NULL
115,412,17,429,523,0,0,82.03,136,276,"中央里",NULL
116,410,13,423,550,0,0,76.91,193,217,"石坊里",NULL
117,606,15,621,761,0,0,81.6,237,369,"仁德里",NULL
118,925,32,957,1154,0,0,82.93,364,561,"崇禮里",NULL
119,1003,21,1024,1238,0,0,82.71,440,563,"興南里",NULL
120,911,9,920,1133,0,0,81.2,526,385,"育英里",NULL
121,813,25,838,1046,0,0,80.11,425,388,"育英里",NULL
122,987,16,1003,1210,0,0,82.89,488,499,"育英里",NULL
123,983,28,1011,1304,0,0,77.53,574,409,"台溪里",NULL
124,600,34,634,850,0,0,74.59,439,161,"曲溪里",NULL
125,739,14,753,900,0,0,83.67,379,360,"曲溪里",NULL
126,745,33,778,982,0,0,79.23,453,292,"曲溪里",NULL
127,393,58,451,602,0,0,74.92,387,6,"曲溪里",NULL
128,1118,31,1149,1396,0,0,82.31,545,573,"曲溪里",NULL
129,1010,35,1045,1345,0,0,77.7,415,595,"西雅里",NULL
130,965,14,979,1189,0,0,82.34,446,519,"西雅里",NULL
131,519,14,533,683,0,0,78.04,284,235,"客雅里",NULL
132,756,17,773,961,0,0,80.44,580,176,"客雅里",NULL
133,1007,32,1039,1295,0,0,80.23,427,580,"客雅里",NULL
134,757,24,781,961,0,0,81.27,274,483,"南勢里",NULL
135,1119,17,1136,1377,0,0,82.5,396,723,"南勢里",NULL
136,866,20,886,1066,0,0,83.11,345,521,"南勢里",NULL
137,701,15,716,845,0,0,84.73,675,26,"大鵬里",NULL
138,559,21,580,676,0,0,85.8,543,16,"大鵬里",NULL
139,663,19,682,838,0,0,81.38,405,258,"大同里",NULL
140,540,7,547,664,0,0,82.38,212,328,"中山里",NULL
141,454,13,467,588,0,0,79.42,171,283,"中興里",NULL
142,1038,19,1057,1312,0,0,80.56,496,542,"新民里",NULL
143,919,24,943,1167,0,0,80.81,386,533,"長和里",NULL
144,729,10,739,924,0,0,79.98,269,460,"北門里",NULL
145,944,26,970,1201,0,0,80.77,383,561,"民富里",NULL
146,1122,27,1149,1447,0,0,79.41,501,621,"民富里",NULL
147,1024,24,1048,1366,0,0,76.72,528,496,"民富里",NULL
148,1066,20,1086,1323,0,0,82.09,512,554,"磐石里",NULL
149,1203,24,1227,1522,0,0,80.62,556,647,"磐石里",NULL
150,965,21,986,1201,0,0,82.1,481,484,"磐石里",NULL
151,996,21,1017,1274,0,0,79.83,493,503,"新雅里",NULL
152,996,35,1031,1251,0,0,82.41,367,629,"新雅里",NULL
153,918,9,927,1133,0,0,81.82,430,488,"新雅里",NULL
154,1270,31,1301,1553,0,0,83.77,568,702,"文雅里",NULL
155,1312,22,1334,1624,0,0,82.14,707,605,"文雅里",NULL
156,971,24,995,1248,0,0,79.73,538,433,"水田里",NULL
157,1132,23,1155,1415,0,0,81.63,575,557,"水田里",NULL
158,728,11,739,919,0,0,80.41,369,359,"光田里",NULL
159,906,18,924,1102,0,0,83.85,475,431,"光田里",NULL
160,1034,24,1058,1512,0,0,69.97,558,476,"光華里",NULL
161,1233,26,1259,1512,0,0,83.27,759,474,"光華里",NULL
162,912,20,932,1126,0,0,82.77,492,420,"金華里",NULL
163,824,6,830,1009,0,0,82.26,524,300,"金華里",NULL
164,1237,17,1254,1529,0,0,82.01,634,603,"金華里",NULL
165,870,16,886,1118,0,0,79.25,489,381,"湳雅里",NULL
166,1141,24,1165,1413,0,0,82.45,698,443,"湳雅里",NULL
167,1123,26,1149,1352,0,0,84.99,557,566,"金雅里",NULL
168,1229,18,1247,1524,0,0,81.82,666,563,"湳中里",NULL
169,1092,11,1103,1295,0,0,85.17,709,383,"湳中里",NULL
170,1287,16,1303,1555,0,0,83.79,900,387,"湳中里",NULL
171,1274,27,1301,1582,0,0,82.24,733,541,"舊社里",NULL
172,1178,23,1201,1495,0,0,80.33,681,497,"舊社里",NULL
173,1341,35,1376,1625,0,0,84.68,607,734,"舊社里",NULL
174,1196,12,1208,1479,0,0,81.68,770,426,"金竹里",NULL
175,1168,28,1196,1477,0,0,80.97,704,464,"金竹里",NULL
176,1079,19,1098,1324,0,0,82.93,639,440,"金竹里",NULL
177,1310,25,1335,1585,0,0,84.23,1165,145,"武陵里",NULL
178,1008,24,1032,1291,0,0,79.94,543,465,"福林里",NULL
179,1357,24,1381,1663,0,0,83.04,765,592,"福林里",NULL
180,846,6,852,1057,0,0,80.61,465,381,"境福里",NULL
181,871,13,884,1099,0,0,80.44,423,448,"境福里",NULL
182,1233,31,1264,1527,0,0,82.78,645,588,"境福里",NULL
183,1031,31,1062,1280,0,0,82.97,406,625,"士林里",NULL
184,624,16,640,770,0,0,83.12,553,71,"士林里",NULL
185,738,24,762,886,0,0,86,558,180,"士林里",NULL
186,677,21,698,882,0,0,79.14,244,433,"古賢里",NULL
187,815,15,830,1060,0,0,78.3,393,422,"南寮里",NULL
188,788,32,820,1075,0,0,76.28,441,347,"南寮里",NULL
189,1231,35,1266,1674,0,0,75.63,551,680,"南寮里",NULL
190,1367,44,1411,1765,0,0,79.94,633,734,"康樂里",NULL
191,1140,24,1164,1477,0,0,78.81,488,652,"中寮里",NULL
192,1297,33,1330,1682,0,0,79.07,598,699,"海濱里",NULL
193,943,27,970,1195,0,0,81.17,359,584,"港北里",NULL
194,420,3,423,555,0,0,76.22,207,213,"舊港里",NULL
195,1335,34,1369,1697,0,0,80.67,628,707,"頂埔里",NULL
196,1061,21,1082,1328,0,0,81.48,678,383,"頂埔里",NULL
197,797,12,809,1002,0,0,80.74,393,404,"頂福里",NULL
198,1334,30,1364,1699,0,0,80.28,730,604,"頂福里",NULL
199,1014,20,1034,1270,0,0,81.42,486,528,"中埔里",NULL
200,925,15,940,1123,0,0,83.7,457,468,"中埔里",NULL
201,933,26,959,1126,0,0,85.17,378,555,"牛埔里",NULL
202,1026,22,1048,1309,0,0,80.06,615,411,"牛埔里",NULL
203,1005,33,1038,1301,0,0,79.78,441,564,"埔前里",NULL
204,920,27,947,1141,0,0,83,339,581,"埔前里",NULL
205,783,31,814,1007,0,0,80.83,264,519,"樹下里",NULL
206,658,15,673,835,0,0,80.6,167,491,"樹下里",NULL
207,1254,49,1303,1603,0,0,81.29,434,820,"浸水里",NULL
208,996,30,1026,1225,0,0,83.76,526,470,"虎林里",NULL
209,658,11,669,810,0,0,82.59,300,358,"虎林里",NULL
210,1069,25,1094,1330,0,0,82.26,465,604,"虎山里",NULL
211,1093,24,1117,1465,0,0,76.25,510,583,"虎山里",NULL
212,1513,44,1557,1969,0,0,79.08,640,873,"虎山里",NULL
213,783,18,801,985,0,0,81.32,276,507,"港南里",NULL
214,675,27,702,890,0,0,78.88,310,365,"港南里",NULL
215,514,21,535,688,0,0,77.76,286,228,"東香里",NULL
216,1342,21,1363,1627,0,0,83.77,855,487,"東香里",NULL
217,650,23,673,825,0,0,81.58,288,362,"香村里",NULL
218,961,33,994,1229,0,0,80.88,542,419,"香村里",NULL
219,1150,34,1184,1465,0,0,80.82,532,618,"香山里",NULL
220,1000,36,1036,1313,0,0,78.9,465,535,"香山里",NULL
221,829,12,841,1001,0,0,84.02,313,516,"大庄里",NULL
222,832,25,857,1036,0,0,82.72,370,462,"大庄里",NULL
223,794,46,840,1009,0,0,83.25,351,443,"美山里",NULL
224,614,24,638,807,0,0,79.06,284,330,"朝山里",NULL
225,712,21,733,917,0,0,79.93,338,374,"朝山里",NULL
226,794,37,831,1025,0,0,81.07,362,432,"海山里",NULL
227,687,23,710,907,0,0,78.28,350,337,"海山里",NULL
228,930,20,950,1173,0,0,80.99,395,535,"鹽水里",NULL
229,934,24,958,1201,0,0,79.77,469,465,"內湖里",NULL
230,858,16,874,1105,0,0,79.1,405,453,"內湖里",NULL
231,923,32,955,1206,0,0,79.19,486,437,"內湖里",NULL
232,611,30,641,794,0,0,80.73,204,407,"南港里",NULL
233,1052,25,1077,1350,0,0,79.78,596,456,"中隘里",NULL
234,474,8,482,631,0,0,76.39,242,232,"南隘里",NULL
235,588,21,609,732,0,0,83.2,289,299,"大湖里",NULL
236,611,32,643,815,0,0,78.9,270,341,"茄苳里",NULL
1,744,12,756,947,0,0,79.83,373,371,"綠川里",NULL
2,844,17,861,1025,0,0,84,365,479,"綠川里",NULL
3,1385,29,1414,1779,0,0,79.48,629,756,"繼光里",NULL
4,1325,25,1350,1710,0,0,78.95,605,720,"公園里",NULL
5,1033,20,1053,1304,0,0,80.75,482,551,"光復里",NULL
6,865,26,891,1156,0,0,77.08,474,391,"光復里",NULL
7,1067,27,1094,1380,0,0,79.28,500,567,"大墩里",NULL
8,828,9,837,1034,0,0,80.95,346,482,"大墩里",NULL
9,1429,40,1469,1875,0,0,78.35,667,762,"柳川里",NULL
10,650,7,657,836,0,0,78.59,306,344,"大誠里",NULL
11,936,16,952,1198,0,0,79.47,445,491,"大誠里",NULL
12,1426,39,1465,1868,0,0,78.43,676,750,"中華里",NULL
13,759,4,763,1077,0,0,70.84,340,419,"新庄里",NULL
14,894,23,917,1146,0,0,80.02,425,469,"新庄里",NULL
15,914,14,928,1161,0,0,79.93,412,502,"新庄里",NULL
16,925,13,938,1134,0,0,82.72,396,529,"振興里",NULL
17,915,19,934,1166,0,0,80.1,372,543,"振興里",NULL
18,886,16,902,1104,0,0,81.7,325,561,"振興里",NULL
19,928,23,951,1157,0,0,82.2,360,568,"東橋里",NULL
20,879,18,897,1110,0,0,80.81,353,526,"東橋里",NULL
21,866,21,887,1113,0,0,79.69,278,588,"東橋里",NULL
22,1017,37,1054,1311,0,0,80.4,427,590,"東興里",NULL
23,1341,19,1360,1628,0,0,83.54,570,771,"東興里",NULL
24,704,19,723,907,0,0,79.71,376,328,"泉源里",NULL
25,807,23,830,1004,0,0,82.67,319,488,"泉源里",NULL
26,1094,21,1115,1375,0,0,81.09,361,733,"干城里",NULL
27,800,20,820,1082,0,0,75.79,409,391,"干城里",NULL
28,1104,30,1134,1454,0,0,77.99,457,647,"旱溪里",NULL
29,727,14,741,900,0,0,82.33,341,386,"旱溪里",NULL
30,709,22,731,915,0,0,79.89,263,446,"樂成里",NULL
31,773,16,789,979,0,0,80.59,310,463,"樂成里",NULL
32,967,15,982,1150,0,0,85.39,346,621,"東門里",NULL
33,1084,14,1098,1335,0,0,82.25,410,674,"東門里",NULL
34,856,20,876,1037,0,0,84.47,266,590,"東門里",NULL
35,984,18,1002,1206,0,0,83.08,378,606,"東門里",NULL
36,1074,30,1104,1387,0,0,79.6,483,591,"十甲里",NULL
37,1124,26,1150,1357,0,0,84.75,442,682,"十甲里",NULL
38,1036,23,1059,1287,0,0,82.28,468,568,"東英里",NULL
39,1000,17,1017,1215,0,0,83.7,499,501,"東英里",NULL
40,1131,27,1158,1426,0,0,81.21,433,698,"東英里",NULL
41,1192,17,1209,1441,0,0,83.9,639,553,"東南里",NULL
42,575,13,588,726,0,0,80.99,324,251,"東南里",NULL
43,931,11,942,1171,0,0,80.44,445,486,"東南里",NULL
44,1208,14,1222,1529,0,0,79.92,599,609,"東勢里",NULL
45,1051,26,1077,1339,0,0,80.43,599,452,"東勢里",NULL
46,1010,22,1032,1268,0,0,81.39,545,465,"合作里",NULL
47,1036,22,1058,1309,0,0,80.83,668,368,"合作里",NULL
48,976,34,1010,1198,0,0,84.31,925,51,"富仁里",NULL
49,755,21,776,1015,0,0,76.45,493,262,"富仁里",NULL
50,763,14,777,994,0,0,78.17,444,319,"富仁里",NULL
51,782,19,801,987,0,0,81.16,546,236,"富臺里",NULL
52,544,8,552,698,0,0,79.08,435,109,"富臺里",NULL
53,907,22,929,1093,0,0,85,307,600,"東信里",NULL
54,910,6,916,1104,0,0,82.97,333,577,"東信里",NULL
55,1024,17,1041,1246,0,0,83.55,457,567,"東信里",NULL
56,830,15,845,1015,0,0,83.25,348,482,"東信里",NULL
57,734,18,752,878,0,0,85.65,268,466,"東信里",NULL
58,1492,28,1520,2087,0,0,72.83,946,546,"三民里",NULL
59,1320,26,1346,1766,0,0,76.22,717,603,"平和里",NULL
60,1500,22,1522,1952,0,0,77.97,981,519,"利民里",NULL
61,1042,10,1052,1342,0,0,78.39,582,460,"公民里",NULL
62,1024,17,1041,1289,0,0,80.76,523,501,"公民里",NULL
63,1279,23,1302,1578,0,0,82.51,578,701,"公民里",NULL
64,1409,26,1435,1782,0,0,80.53,762,647,"廣民里",NULL
65,925,13,938,1128,0,0,83.16,491,434,"東昇里",NULL
66,930,15,945,1146,0,0,82.46,550,380,"東昇里",NULL
67,935,8,943,1157,0,0,81.5,587,348,"民生里",NULL
68,775,13,788,947,0,0,83.21,399,376,"民生里",NULL
69,1112,13,1125,1367,0,0,82.3,551,561,"昇平里",NULL
70,1484,21,1505,1817,0,0,82.83,735,749,"昇平里",NULL
71,1287,24,1311,1707,0,0,76.8,643,644,"昇平里",NULL
72,1455,26,1481,1827,0,0,81.06,678,777,"藍興里",NULL
73,1054,21,1075,1297,0,0,82.88,527,527,"藍興里",NULL
74,1170,23,1193,1491,0,0,80.01,586,584,"公館里",NULL
75,1283,24,1307,1552,0,0,84.21,548,735,"公館里",NULL
76,1293,25,1318,1678,0,0,78.55,646,647,"公館里",NULL
77,728,21,749,943,0,0,79.43,301,427,"和龍里",NULL
78,949,14,963,1227,0,0,78.48,418,531,"和龍里",NULL
79,1166,31,1197,1492,0,0,80.23,608,558,"民龍里",NULL
80,781,9,790,968,0,0,81.61,403,378,"民龍里",NULL
81,1077,15,1092,1376,0,0,79.36,516,561,"安龍里",NULL
82,862,19,881,1126,0,0,78.24,370,492,"安龍里",NULL
83,1050,14,1064,1299,0,0,81.91,518,532,"吉龍里",NULL
84,1179,18,1197,1481,0,0,80.82,635,544,"吉龍里",NULL
85,1136,10,1146,1410,0,0,81.28,642,494,"吉龍里",NULL
86,935,39,974,1233,0,0,78.99,526,409,"吉龍里",NULL
87,1147,28,1175,1480,0,0,79.39,555,592,"後龍里",NULL
88,1188,13,1201,1552,0,0,77.38,519,669,"後龍里",NULL
89,1216,22,1238,1506,0,0,82.2,576,640,"中興里",NULL
90,1368,30,1398,1718,0,0,81.37,614,754,"中興里",NULL
91,1227,20,1247,1554,0,0,80.24,627,600,"忠明里",NULL
92,1133,17,1150,1410,0,0,81.56,530,603,"忠明里",NULL
93,1281,8,1289,1603,0,0,80.41,558,723,"忠明里",NULL
94,1329,8,1337,1645,0,0,81.28,663,666,"公正里",NULL
95,1378,19,1397,1687,0,0,82.81,749,629,"公正里",NULL
96,1039,14,1053,1281,0,0,82.2,562,477,"公正里",NULL
97,1487,19,1506,1849,0,0,81.45,759,728,"公平里",NULL
98,1426,28,1454,1875,0,0,77.55,782,644,"公平里",NULL
99,1167,23,1190,1495,0,0,79.6,616,551,"公德里",NULL
100,1407,20,1427,1765,0,0,80.85,755,652,"公德里",NULL
101,1059,21,1080,1324,0,0,81.57,440,619,"公益里",NULL
102,1136,26,1162,1407,0,0,82.59,563,573,"公益里",NULL
103,1118,22,1140,1408,0,0,80.97,516,602,"土庫里",NULL
104,1248,27,1275,1597,0,0,79.84,616,632,"土庫里",NULL
105,1259,22,1281,1554,0,0,82.43,697,562,"土庫里",NULL
106,1497,24,1521,1920,0,0,79.22,769,728,"忠誠里",NULL
107,1305,21,1326,1620,0,0,81.85,663,642,"忠誠里",NULL
108,1289,12,1301,1582,0,0,82.24,616,673,"忠誠里",NULL
109,845,9,854,1036,0,0,82.43,494,351,"大忠里",NULL
110,1462,27,1489,1810,0,0,82.27,684,778,"大忠里",NULL
111,1282,23,1305,1627,0,0,80.21,694,588,"吉龍里",NULL
112,929,17,946,1189,0,0,79.56,495,434,"吉龍里",NULL
113,847,19,866,1068,0,0,81.09,447,400,"長春里",NULL
114,899,19,918,1170,0,0,78.46,427,472,"長春里",NULL
115,1105,16,1121,1366,0,0,82.06,545,560,"長榮里",NULL
116,989,15,1004,1180,0,0,85.08,461,528,"長榮里",NULL
117,1334,23,1357,1693,0,0,80.15,622,712,"城隍里",NULL
118,1381,34,1415,1686,0,0,83.93,626,755,"城隍里",NULL
119,1494,32,1526,1906,0,0,80.06,665,829,"國光里",NULL
120,1370,25,1395,1669,0,0,83.58,620,750,"國光里",NULL
121,1228,18,1246,1561,0,0,79.82,588,640,"南門里",NULL
122,1346,19,1365,1663,0,0,82.08,668,678,"南門里",NULL
123,917,16,933,1129,0,0,82.64,450,467,"德義里",NULL
124,1081,20,1101,1379,0,0,79.84,580,501,"德義里",NULL
125,901,21,922,1170,0,0,78.8,440,461,"積善里",NULL
126,1242,24,1266,1528,0,0,82.85,554,688,"積善里",NULL
127,1141,24,1165,1407,0,0,82.8,531,610,"江川里",NULL
128,621,12,633,777,0,0,81.47,318,303,"江川里",NULL
129,1184,19,1203,1675,0,0,71.82,587,597,"新榮里",NULL
130,1145,11,1156,1561,0,0,74.06,667,478,"新榮里",NULL
131,1412,30,1442,1769,0,0,81.51,635,777,"福興里",NULL
132,1367,29,1396,1656,0,0,84.3,723,644,"福興里",NULL
133,1188,28,1216,1532,0,0,79.37,648,540,"福平里",NULL
134,1182,30,1212,1482,0,0,81.78,542,640,"福平里",NULL
135,1080,22,1102,1353,0,0,81.45,459,621,"福平里",NULL
136,1394,23,1417,1816,0,0,78.03,805,589,"福順里",NULL
137,1103,32,1135,1416,0,0,80.16,553,550,"福順里",NULL
138,879,17,896,1126,0,0,79.57,370,509,"和平里",NULL
139,935,14,949,1193,0,0,79.55,508,427,"和平里",NULL
140,1242,20,1262,1526,0,0,82.7,523,719,"平和里",NULL
141,1193,28,1221,1471,0,0,83,545,648,"平和里",NULL
142,1291,21,1312,1699,0,0,77.22,789,502,"南和里",NULL
143,1005,13,1018,1223,0,0,83.24,557,448,"南和里",NULL
144,849,11,860,1057,0,0,81.36,483,366,"南和里",NULL
145,1155,25,1180,1391,0,0,84.83,608,547,"永興里",NULL
146,1154,31,1185,1491,0,0,79.48,607,547,"永興里",NULL
147,1182,12,1194,1481,0,0,80.62,682,500,"永興里",NULL
148,1225,30,1255,1589,0,0,78.98,558,667,"永和里",NULL
149,1173,27,1200,1497,0,0,80.16,603,570,"永和里",NULL
150,1390,20,1410,1768,0,0,79.75,736,654,"樹義里",NULL
151,1362,20,1382,1639,0,0,84.32,594,768,"樹義里",NULL
152,1307,26,1333,1594,0,0,83.63,754,553,"樹義里",NULL
153,1368,20,1388,1741,0,0,79.72,730,638,"樹義里",NULL
154,1501,16,1517,1813,0,0,83.67,815,686,"工學里",NULL
155,1534,35,1569,1930,0,0,81.3,805,729,"工學里",NULL
156,1199,26,1225,1526,0,0,80.28,624,575,"樹德里",NULL
157,1347,14,1361,1709,0,0,79.64,816,531,"樹德里",NULL
158,1249,21,1270,1607,0,0,79.03,643,606,"樹德里",NULL
159,1246,28,1274,1539,0,0,82.78,632,614,"西川里",NULL
160,1145,16,1161,1452,0,0,79.96,606,539,"西川里",NULL
161,1447,30,1477,1825,0,0,80.93,744,703,"崇倫里",NULL
162,1209,22,1231,1475,0,0,83.46,510,699,"崇倫里",NULL
163,1294,23,1317,1647,0,0,79.96,555,739,"中正里",NULL
164,1265,35,1300,1687,0,0,77.06,478,787,"六合里",NULL
165,1432,30,1462,1903,0,0,76.83,626,806,"光大里",NULL
166,1210,28,1238,1531,0,0,80.86,858,352,"文莊里",NULL
167,893,25,918,1167,0,0,78.66,479,414,"文莊里",NULL
168,997,35,1032,1334,0,0,77.36,475,522,"大湖里",NULL
169,721,22,743,922,0,0,80.59,287,434,"大湖里",NULL
170,994,21,1015,1311,0,0,77.42,438,556,"五常里",NULL
171,745,16,761,942,0,0,80.79,423,322,"錦平里",NULL
172,678,8,686,923,0,0,74.32,267,411,"錦平里",NULL
173,913,21,934,1193,0,0,78.29,592,321,"新興里",NULL
174,591,12,603,807,0,0,74.72,321,270,"新興里",NULL
175,990,8,998,1253,0,0,79.65,514,476,"新北里",NULL
176,728,13,741,1006,0,0,73.66,370,358,"新北里",NULL
177,875,11,886,1086,0,0,81.58,755,120,"樂英里",NULL
178,896,21,917,1140,0,0,80.44,786,110,"樂英里",NULL
179,547,21,568,744,0,0,76.34,375,172,"樂英里",NULL
180,1470,28,1498,1842,0,0,81.32,781,689,"錦村里",NULL
181,911,14,925,1145,0,0,80.79,492,419,"錦村里",NULL
182,1182,26,1208,1463,0,0,82.57,508,674,"建成里",NULL
183,1021,18,1039,1338,0,0,77.65,601,420,"建成里",NULL
184,914,19,933,1218,0,0,76.6,558,356,"建成里",NULL
185,1406,23,1429,1798,0,0,79.48,782,624,"建德里",NULL
186,1193,26,1219,1519,0,0,80.25,646,547,"建德里",NULL
187,1003,27,1030,1310,0,0,78.63,547,456,"錦洲里",NULL
188,1114,18,1132,1382,0,0,81.91,667,447,"錦洲里",NULL
189,1256,18,1274,1666,0,0,76.47,805,451,"錦祥里",NULL
190,998,22,1020,1310,0,0,77.86,585,413,"錦祥里",NULL
191,1370,28,1398,1775,0,0,78.76,763,607,"金華里",NULL
192,1019,23,1042,1358,0,0,76.73,631,388,"金龍里",NULL
193,1086,21,1107,1429,0,0,77.47,595,491,"金龍里",NULL
194,1080,17,1097,1424,0,0,77.04,575,505,"金龍里",NULL
195,1284,27,1311,1736,0,0,75.52,690,594,"邱厝里",NULL
196,1093,23,1116,1422,0,0,78.48,583,510,"建興里",NULL
197,1035,15,1050,1320,0,0,79.55,569,466,"建興里",NULL
198,972,18,990,1217,0,0,81.35,491,481,"建興里",NULL
199,961,15,976,1253,0,0,77.89,537,424,"建興里",NULL
200,1329,23,1352,1688,0,0,80.09,729,600,"頂厝里",NULL
201,1280,22,1302,1635,0,0,79.63,728,552,"頂厝里",NULL
202,1173,37,1210,1492,0,0,81.1,638,535,"崇德里",NULL
203,1021,25,1046,1352,0,0,77.37,559,462,"崇德里",NULL
204,1465,29,1494,2271,0,0,65.79,892,573,"賴厝里",NULL
205,1013,19,1032,1347,0,0,76.61,618,395,"賴厝里",NULL
206,723,8,731,909,0,0,80.42,428,295,"賴福里",NULL
207,1140,30,1170,1482,0,0,78.95,568,572,"賴福里",NULL
208,1295,30,1325,1656,0,0,80.01,797,498,"賴興里",NULL
209,1112,20,1132,1372,0,0,82.51,628,484,"賴興里",NULL
210,1287,33,1320,1713,0,0,77.06,723,564,"賴旺里",NULL
211,1457,25,1482,1843,0,0,80.41,824,633,"賴旺里",NULL
212,1416,22,1438,1803,0,0,79.76,846,570,"賴明里",NULL
213,1178,9,1187,1454,0,0,81.64,656,522,"賴明里",NULL
214,868,20,888,1087,0,0,81.69,491,377,"梅川里",NULL
215,943,16,959,1199,0,0,79.98,564,379,"梅川里",NULL
216,982,27,1009,1274,0,0,79.2,432,550,"賴村里",NULL
217,1019,25,1044,1355,0,0,77.05,544,475,"賴村里",NULL
218,968,18,986,1218,0,0,80.95,487,481,"賴村里",NULL
219,1177,30,1207,1500,0,0,80.47,643,534,"育德里",NULL
220,1353,34,1387,1774,0,0,78.18,817,536,"育德里",NULL
221,1081,23,1104,1345,0,0,82.08,581,500,"淡溝里",NULL
222,1090,26,1116,1350,0,0,82.67,524,566,"淡溝里",NULL
223,891,12,903,1115,0,0,80.99,511,380,"淡溝里",NULL
224,1299,29,1328,1600,0,0,83,529,770,"健行里",NULL
225,944,26,970,1164,0,0,83.33,501,443,"健行里",NULL
226,1160,28,1188,1479,0,0,80.32,591,569,"健行里",NULL
227,1069,24,1093,1422,0,0,76.86,559,510,"健行里",NULL
228,928,16,944,1126,0,0,83.84,431,497,"明德里",NULL
229,1206,22,1228,1487,0,0,82.58,640,566,"明德里",NULL
230,1353,15,1368,1659,0,0,82.46,765,588,"明德里",NULL
231,1076,20,1096,1347,0,0,81.37,531,545,"明新里",NULL
232,987,16,1003,1294,0,0,77.51,584,403,"明新里",NULL
233,1769,26,1795,2342,0,0,76.64,967,802,"長青里",NULL
234,1163,9,1172,1458,0,0,80.38,630,533,"長青里",NULL
235,918,14,932,1166,0,0,79.93,527,391,"長青里",NULL
236,1234,13,1247,1555,0,0,80.19,780,454,"立人里",NULL
237,1066,14,1080,1368,0,0,78.95,686,380,"立人里",NULL
238,950,28,978,1206,0,0,81.09,454,496,"中達里",NULL
239,1026,21,1047,1263,0,0,82.9,523,503,"中達里",NULL
240,1085,12,1097,1298,0,0,84.51,474,611,"西安里",NULL
241,962,18,980,1217,0,0,80.53,468,494,"西安里",NULL
242,968,15,983,1194,0,0,82.33,550,418,"西安里",NULL
243,1179,9,1188,1484,0,0,80.05,685,494,"至善里",NULL
244,1128,12,1140,1427,0,0,79.89,639,489,"至善里",NULL
245,1326,22,1348,1642,0,0,82.1,870,456,"西平里",NULL
246,1174,17,1191,1525,0,0,78.1,643,531,"西平里",NULL
247,1299,18,1317,1555,0,0,84.69,1024,275,"西平里",NULL
248,1549,45,1594,1877,0,0,84.92,658,891,"西墩里",NULL
249,1369,21,1390,1739,0,0,79.93,695,674,"西墩里",NULL
250,950,19,969,1161,0,0,83.46,434,516,"潮洋里",NULL
251,918,10,928,1119,0,0,82.93,440,478,"潮洋里",NULL
252,783,6,789,944,0,0,83.58,226,557,"龍潭里",NULL
253,1413,22,1435,1730,0,0,82.95,834,579,"惠來里",NULL
254,1457,17,1474,1724,0,0,85.5,810,647,"惠來里",NULL
255,1317,21,1338,1653,0,0,80.94,849,468,"惠來里",NULL
256,1304,27,1331,1643,0,0,81.01,767,537,"上石里",NULL
257,1223,27,1250,1605,0,0,77.88,781,442,"上石里",NULL
258,1018,9,1027,1289,0,0,79.67,551,467,"上安里",NULL
259,1199,13,1212,1471,0,0,82.39,692,507,"上安里",NULL
260,1363,25,1388,1682,0,0,82.52,751,612,"上德里",NULL
261,1532,20,1552,1880,0,0,82.55,910,622,"上德里",NULL
262,1033,19,1052,1340,0,0,78.51,597,436,"逢甲里",NULL
263,1051,13,1064,1313,0,0,81.04,572,479,"逢甲里",NULL
264,945,22,967,1202,0,0,80.45,512,433,"逢甲里",NULL
265,958,23,981,1209,0,0,81.14,487,471,"逢福里",NULL
266,1196,18,1214,1466,0,0,82.81,790,406,"逢福里",NULL
267,1153,37,1190,1445,0,0,82.35,676,477,"逢福里",NULL
268,1124,10,1134,1454,0,0,77.99,634,490,"何厝里",NULL
269,915,26,941,1140,0,0,82.54,416,499,"何厝里",NULL
270,1282,17,1299,1622,0,0,80.09,634,648,"何明里",NULL
271,1231,20,1251,1539,0,0,81.29,650,581,"何明里",NULL
272,1334,21,1355,1644,0,0,82.42,768,566,"何南里",NULL
273,1357,24,1381,1693,0,0,81.57,775,582,"何南里",NULL
274,1216,21,1237,1532,0,0,80.74,605,611,"何成里",NULL
275,1497,25,1522,1925,0,0,79.06,841,656,"何成里",NULL
276,1556,29,1585,1925,0,0,82.34,901,655,"何成里",NULL
277,1060,19,1079,1672,0,0,64.53,494,566,"何安里",NULL
278,1018,19,1037,1272,0,0,81.53,492,526,"何安里",NULL
279,1018,19,1037,1284,0,0,80.76,510,508,"何安里",NULL
280,1325,16,1341,1663,0,0,80.64,691,634,"何仁里",NULL
281,1212,12,1224,1529,0,0,80.05,596,616,"何仁里",NULL
282,1289,26,1315,1676,0,0,78.46,663,626,"何仁里",NULL
283,1232,15,1247,1513,0,0,82.42,660,572,"何德里",NULL
284,1150,17,1167,1414,0,0,82.53,659,491,"何德里",NULL
285,930,9,939,1163,0,0,80.74,517,413,"何福里",NULL
286,1007,17,1024,1231,0,0,83.18,501,506,"何福里",NULL
287,936,17,953,1167,0,0,81.66,478,458,"何福里",NULL
288,1214,17,1231,1520,0,0,80.99,625,589,"何源里",NULL
289,1312,12,1324,1630,0,0,81.23,718,594,"何源里",NULL
290,1375,21,1396,1733,0,0,80.55,866,509,"何源里",NULL
291,1338,30,1368,1685,0,0,81.19,543,795,"大河里",NULL
292,1343,28,1371,1655,0,0,82.84,679,664,"大河里",NULL
293,795,30,825,986,0,0,83.67,683,112,"大石里",NULL
0,2136,46,2182,2710,0,0,80.52,1156,980,"大福里",NULL
0,3192,51,3243,3972,0,0,81.65,1902,1290,"大鵬里",NULL
0,3873,95,3968,4753,0,0,83.48,2147,1726,"港尾里",NULL
0,1766,36,1802,2147,0,0,83.93,673,1093,"廣福里",NULL
0,1996,80,2076,2599,0,0,79.88,928,1068,"林厝里",NULL
0,4250,108,4358,5449,0,0,79.98,2193,2057,"永安里",NULL
0,1520,18,1538,1916,0,0,80.27,774,746,"福安里",NULL
0,2862,43,2905,3566,0,0,81.46,1658,1204,"福雅里",NULL
0,3070,52,3122,3823,0,0,81.66,1875,1195,"福林里",NULL
0,1633,32,1665,2108,0,0,78.98,1092,541,"福瑞里",NULL
0,1306,22,1328,1765,0,0,75.24,753,553,"福聯里",NULL
0,2476,64,2540,3060,0,0,83.01,1060,1416,"福和里",NULL
0,1843,19,1862,2275,0,0,81.85,1013,830,"福中里",NULL
0,2451,25,2476,3138,0,0,78.9,1412,1039,"福恩里",NULL
0,2502,56,2558,3154,0,0,81.1,1079,1423,"協和里",NULL
0,4056,76,4132,4944,0,0,83.58,1918,2138,"南屯里",NULL
0,5083,106,5189,6345,0,0,81.78,2356,2727,"豐樂里",NULL
0,3310,91,3401,4031,0,0,84.37,1459,1851,"楓樹里",NULL
0,3150,79,3229,3843,0,0,84.02,1393,1757,"中和里",NULL
0,1256,31,1287,1532,0,0,84.01,428,828,"鎮平里",NULL
0,2513,68,2581,3177,0,0,81.24,1058,1455,"永定里",NULL
0,3678,108,3786,4608,0,0,82.16,2129,1549,"春社里",NULL
0,1970,69,2039,2477,0,0,82.32,1769,201,"春安里",NULL
0,3802,70,3872,4775,0,0,81.09,1950,1852,"文山里",NULL
0,2442,35,2477,3040,0,0,81.48,1202,1240,"寶山里",NULL
0,1037,30,1067,1279,0,0,83.42,320,717,"新生里",NULL
0,3341,46,3387,4078,0,0,83.06,2052,1289,"三義里",NULL
0,3601,47,3648,4372,0,0,83.44,2214,1387,"三和里",NULL
0,3548,57,3605,4312,0,0,83.6,1887,1661,"三厝里",NULL
0,3253,39,3292,3979,0,0,82.73,2045,1208,"黎明里",NULL
0,2092,31,2123,2629,0,0,80.75,1128,964,"文心里",NULL
0,3294,54,3348,4047,0,0,82.73,1608,1686,"田心里",NULL
0,2129,34,2163,2633,0,0,82.15,1113,1016,"向心里",NULL
0,3053,45,3098,3816,0,0,81.18,1714,1339,"同心里",NULL
0,2546,44,2590,3157,0,0,82.04,1305,1241,"大興里",NULL
0,2975,34,3009,3623,0,0,83.05,1496,1479,"大同里",NULL
0,1878,32,1910,2365,0,0,80.76,1053,825,"大誠里",NULL
0,3830,60,3890,4751,0,0,81.88,2172,1658,"大業里",NULL
0,2820,50,2870,3447,0,0,83.26,1508,1312,"溝墘里",NULL
0,3515,39,3554,4283,0,0,82.98,2014,1501,"惠中里",NULL
0,2394,29,2423,3027,0,0,80.05,1411,983,"北屯里",NULL
0,2558,30,2588,3204,0,0,80.77,1327,1231,"北京里",NULL
0,2506,57,2563,3137,0,0,81.7,1381,1125,"北興里",NULL
0,4412,74,4486,5546,0,0,80.89,2424,1988,"三光里",NULL
0,3744,55,3799,4735,0,0,80.23,2082,1662,"三和里",NULL
0,3230,53,3283,4144,0,0,79.22,1811,1419,"平興里",NULL
0,3442,56,3498,4315,0,0,81.07,1935,1507,"平田里",NULL
0,2836,52,2888,3622,0,0,79.73,1591,1245,"平昌里",NULL
0,2740,46,2786,3479,0,0,80.08,1571,1169,"平陽里",NULL
0,3392,66,3458,4328,0,0,79.9,1738,1654,"平安里",NULL
0,2698,43,2741,3456,0,0,79.31,1618,1080,"平和里",NULL
0,2578,49,2627,3242,0,0,81.03,1475,1103,"陳平里",NULL
0,1872,22,1894,2301,0,0,82.31,1060,812,"平順里",NULL
0,2542,37,2579,3264,0,0,79.01,1411,1131,"平心里",NULL
0,2024,28,2052,2504,0,0,81.95,1203,821,"平福里",NULL
0,3549,48,3597,4480,0,0,80.29,1916,1633,"平德里",NULL
0,2872,69,2941,3740,0,0,78.64,1402,1470,"東光里",NULL
0,4180,101,4281,5106,0,0,83.84,1862,2318,"舊社里",NULL
0,4677,98,4775,5809,0,0,82.2,2160,2517,"水景里",NULL
0,5008,156,5164,6240,0,0,82.76,2241,2767,"軍功里",NULL
0,3787,81,3868,4672,0,0,82.79,1608,2179,"和平里",NULL
0,1294,33,1327,1563,0,0,84.9,424,870,"東山里",NULL
0,1302,33,1335,1645,0,0,81.16,524,778,"廍子里",NULL
0,701,22,723,903,0,0,80.07,298,403,"民政里",NULL
0,654,4,658,799,0,0,82.35,243,411,"民德里",NULL
0,1338,38,1376,1696,0,0,81.13,572,766,"大坑里",NULL
0,4109,58,4167,5091,0,0,81.85,2391,1718,"松竹里",NULL
0,3949,64,4013,5032,0,0,79.75,2148,1801,"松和里",NULL
0,3022,40,3062,3756,0,0,81.52,1594,1428,"松安里",NULL
0,2859,44,2903,3633,0,0,79.91,1560,1299,"松強里",NULL
0,2966,82,3048,3692,0,0,82.56,1642,1324,"松勇里",NULL
0,3185,43,3228,3979,0,0,81.13,1946,1239,"松茂里",NULL
0,3535,59,3594,4683,0,0,76.75,1794,1741,"仁和里",NULL
0,4378,84,4462,5310,0,0,84.03,2523,1855,"仁美里",NULL
0,1622,44,1666,2005,0,0,83.09,956,666,"四民里",NULL
0,4479,94,4573,5511,0,0,82.98,2623,1856,"同榮里",NULL
0,5235,92,5327,6449,0,0,82.6,3180,2055,"后庄里",NULL
0,2495,41,2536,3112,0,0,81.49,1549,946,"忠平里",NULL
0,3399,51,3450,4172,0,0,82.69,2083,1316,"大德里",NULL
0,3494,93,3587,4451,0,0,80.59,2182,1312,"新平里",NULL
0,1441,32,1473,1813,0,0,81.25,1014,427,"仁愛里",NULL
0,4733,109,4842,5960,0,0,81.24,2560,2173,"水湳里",NULL
0,3312,60,3372,4201,0,0,80.27,1695,1617,"短竹里",NULL
0,1441,19,1460,1756,0,0,83.14,854,587,"東川里",NULL
0,491,20,511,648,0,0,78.86,158,333,"鹿寮里",NULL
0,2810,47,2857,3450,0,0,82.81,1377,1433,"盧厝里",NULL
0,705,16,721,897,0,0,80.38,379,326,"東平里",NULL
0,3043,50,3093,3797,0,0,81.46,1647,1396,"太平里",NULL
0,1841,22,1863,2323,0,0,80.2,1065,776,"王田里",NULL
0,2196,39,2235,2656,0,0,84.15,1165,1031,"長竹里",NULL
0,2855,61,2916,3540,0,0,82.37,1424,1431,"後庄里",NULL
0,2590,39,2629,3226,0,0,81.49,1350,1240,"新店里",NULL
0,3036,56,3092,3829,0,0,80.75,1784,1252,"圳頭里",NULL
0,871,23,894,1137,0,0,78.63,453,418,"東噴里",NULL
0,261,3,264,318,0,0,83.02,248,13,"希康里",NULL
0,371,2,373,452,0,0,82.52,167,204,"東山里",NULL
0,431,3,434,536,0,0,80.97,150,281,"東安里",NULL
0,414,4,418,511,0,0,81.8,149,265,"大街里",NULL
0,463,12,475,642,0,0,73.99,140,323,"祐民里",NULL
0,391,13,404,500,0,0,80.8,149,242,"東仁里",NULL
0,355,3,358,443,0,0,80.81,173,182,"內安里",NULL
0,1038,13,1051,1300,0,0,80.85,470,568,"雲霄里",NULL
0,482,6,488,613,0,0,79.61,158,324,"建國里",NULL
0,830,17,847,1036,0,0,81.76,324,506,"府路里",NULL
0,298,4,302,379,0,0,79.68,126,172,"鎮南里",NULL
0,794,12,806,1017,0,0,79.25,315,479,"神農里",NULL
0,524,9,533,655,0,0,81.37,243,281,"崇文里",NULL
0,577,5,582,730,0,0,79.73,258,319,"龍山里",NULL
0,588,12,600,729,0,0,82.3,271,317,"安平里",NULL
0,545,12,557,673,0,0,82.76,221,324,"文昌里",NULL
0,953,17,970,1194,0,0,81.24,859,94,"志航里",NULL
0,503,7,510,618,0,0,82.52,213,290,"蘭井里",NULL
0,849,27,876,1086,0,0,80.66,288,561,"光復里",NULL
0,1041,12,1053,1295,0,0,81.31,416,625,"初陽里",NULL
0,612,13,625,784,0,0,79.72,308,304,"震安里",NULL
0,1098,20,1118,1360,0,0,82.21,538,560,"新開里",NULL
0,1404,39,1443,1843,0,0,78.3,550,854,"宣信里",NULL
0,1036,25,1061,1305,0,0,81.3,397,639,"興南里",NULL
0,1206,15,1221,1555,0,0,78.52,560,646,"豐年里",NULL
0,2779,52,2831,3527,0,0,80.27,1270,1509,"芳草里",NULL
0,1658,35,1693,2069,0,0,81.83,715,943,"芳安里",NULL
0,1624,28,1652,2041,0,0,80.94,627,997,"頂寮里",NULL
0,3698,73,3771,4741,0,0,79.54,1672,2026,"安寮里",NULL
0,2516,33,2549,3212,0,0,79.36,1154,1362,"興村里",NULL
0,1671,32,1703,2161,0,0,78.81,771,900,"興安里",NULL
0,2570,42,2612,3209,0,0,81.4,1227,1343,"興仁里",NULL
0,693,8,701,877,0,0,79.93,249,444,"北城里",NULL
0,494,11,505,636,0,0,79.4,216,278,"仁武里",NULL
0,834,19,853,1069,0,0,79.79,398,436,"泰安里",NULL
0,1177,15,1192,1477,0,0,80.7,623,554,"檜村里",NULL
0,688,8,696,861,0,0,80.84,224,464,"社口里",NULL
0,386,7,393,488,0,0,80.53,126,260,"仁和里",NULL
0,2112,40,2152,2734,0,0,78.71,1040,1072,"中庄里",NULL
0,1745,36,1781,2183,0,0,81.58,839,906,"仁義里",NULL
0,2391,36,2427,3058,0,0,79.37,1048,1343,"後湖里",NULL
0,2085,50,2135,2648,0,0,80.63,801,1284,"荖藤里",NULL
0,3842,62,3904,4836,0,0,80.73,1819,2023,"頂庄里",NULL
0,780,12,792,1014,0,0,78.11,311,469,"書院里",NULL
0,480,12,492,622,0,0,79.1,248,232,"驛站里",NULL
0,382,6,388,481,0,0,80.67,129,253,"民安里",NULL
0,501,12,513,640,0,0,80.16,224,277,"菜園里",NULL
0,418,11,429,532,0,0,80.64,127,291,"集英里",NULL
0,624,17,641,800,0,0,80.13,208,416,"福松里",NULL
0,455,8,463,593,0,0,78.08,168,287,"義昌里",NULL
0,859,18,877,1103,0,0,79.51,344,515,"自治里",NULL
0,675,11,686,843,0,0,81.38,210,465,"大業里",NULL
0,650,7,657,813,0,0,80.81,283,367,"中庸里",NULL
0,419,11,430,531,0,0,80.98,147,272,"學圃里",NULL
0,665,6,671,818,0,0,82.03,304,361,"北杏里",NULL
0,419,7,426,531,0,0,80.23,154,265,"社內里",NULL
0,456,8,464,560,0,0,82.86,195,261,"民生里",NULL
0,330,6,336,423,0,0,79.43,118,212,"慶昇里",NULL
0,291,0,291,385,0,0,75.58,93,198,"通運里",NULL
0,492,7,499,625,0,0,79.84,198,294,"榮檜里",NULL
0,544,10,554,724,0,0,76.52,193,351,"功科里",NULL
0,501,13,514,629,0,0,81.72,174,327,"康莊里",NULL
0,4761,84,4845,6058,0,0,79.98,1937,2824,"福全里",NULL
0,749,11,760,945,0,0,80.42,300,449,"力行里",NULL
0,2742,60,2802,3516,0,0,79.69,1138,1604,"劉厝里",NULL
0,1588,26,1614,2016,0,0,80.06,697,891,"港坪里",NULL
0,1009,31,1040,1285,0,0,80.93,400,609,"頭港里",NULL
0,1085,13,1098,1309,0,0,83.88,367,718,"西平里",NULL
0,1375,58,1433,1815,0,0,78.95,422,953,"大溪里",NULL
0,2603,36,2639,3271,0,0,80.68,1121,1482,"磚窯里",NULL
0,1618,29,1647,2081,0,0,79.14,684,934,"新西里",NULL
0,600,8,608,779,0,0,78.05,305,295,"華明里",NULL
0,984,24,1008,1266,0,0,79.62,389,595,"導民里",NULL
0,796,22,818,1009,0,0,81.07,302,494,"培元里",NULL
0,1557,26,1583,1992,0,0,79.47,640,917,"垂楊里",NULL
0,3476,68,3544,4413,0,0,80.31,1512,1964,"車店里",NULL
0,3375,44,3419,4230,0,0,80.83,1535,1840,"福民里",NULL
0,5548,112,5660,6986,0,0,81.02,2179,3369,"湖內里",NULL
0,2654,45,2699,3337,0,0,80.88,1116,1538,"美源里",NULL
0,3309,69,3378,4167,0,0,81.07,1480,1829,"光路里",NULL
0,1796,26,1822,2283,0,0,79.81,760,1036,"育英里",NULL
0,967,28,995,1212,0,0,82.1,402,565,"自強里",NULL
0,988,26,1014,1255,0,0,80.8,366,622,"長安里",NULL
0,1581,23,1604,1972,0,0,81.34,582,999,"北榮里",NULL
0,1606,43,1649,2069,0,0,79.7,604,1002,"重興里",NULL
0,409,2,411,508,0,0,80.91,171,238,"慶昌里",NULL
0,479,18,497,643,0,0,77.29,126,353,"小湖里",NULL
0,1140,36,1176,1441,0,0,81.61,418,722,"竹文里",NULL
0,1026,22,1048,1363,0,0,76.89,382,644,"香湖里",NULL
0,1428,36,1464,1849,0,0,79.18,526,902,"湖邊里",NULL
0,3140,62,3202,4006,0,0,79.93,1222,1918,"竹圍里",NULL
0,7186,139,7325,9036,0,0,81.06,3015,4171,"保安里",NULL
0,2723,58,2781,3384,0,0,82.18,966,1757,"新厝里",NULL
0,1796,48,1844,2322,0,0,79.41,723,1073,"北湖里",NULL
0,899,25,924,1202,0,0,76.87,343,556,"下埤里",NULL
0,726,21,747,910,0,0,82.09,357,369,"竹村里",NULL
0,2717,25,2742,3754,0,0,73.04,1190,1527,"崇信里",NULL
0,2107,29,2136,2624,0,0,81.4,943,1164,"崇學里",NULL
0,3293,39,3332,3989,0,0,83.53,1700,1593,"崇德里",NULL
0,2752,38,2790,3427,0,0,81.41,1187,1565,"崇善里",NULL
0,1931,25,1956,2360,0,0,82.88,991,940,"崇成里",NULL
0,3591,49,3640,4416,0,0,82.43,1890,1701,"崇文里",NULL
0,1668,29,1697,2061,0,0,82.34,822,846,"東智里",NULL
0,3667,72,3739,4562,0,0,81.96,1892,1775,"大智里",NULL
0,2035,58,2093,2581,0,0,81.09,804,1231,"德高里",NULL
0,3038,46,3084,3872,0,0,79.65,1415,1623,"仁和里",NULL
0,2218,35,2253,2760,0,0,81.63,902,1316,"和平里",NULL
0,3653,70,3723,4560,0,0,81.64,1758,1895,"虎尾里",NULL
0,1521,18,1539,1792,0,0,85.88,814,707,"裕聖里",NULL
0,2560,39,2599,3199,0,0,81.24,1120,1440,"復興里",NULL
0,3407,47,3454,4217,0,0,81.91,1673,1734,"自強里",NULL
0,1714,35,1749,2135,0,0,81.92,809,905,"東聖里",NULL
0,4926,47,4973,5949,0,0,83.59,2462,2464,"關聖里",NULL
0,2153,45,2198,2660,0,0,82.63,912,1241,"後甲里",NULL
0,1558,41,1599,1918,0,0,83.37,1432,126,"復國里",NULL
0,1282,59,1341,1638,0,0,81.87,1198,84,"中興里",NULL
0,3424,63,3487,4235,0,0,82.34,1926,1498,"東光里",NULL
0,2616,48,2664,3278,0,0,81.27,1332,1284,"東明里",NULL
0,2650,19,2669,3219,0,0,82.91,1372,1278,"莊敬里",NULL
0,3326,61,3387,4156,0,0,81.5,1742,1584,"小東里",NULL
0,1224,28,1252,1492,0,0,83.91,678,546,"大學里",NULL
0,1665,42,1707,2170,0,0,78.66,850,815,"成大里",NULL
0,1639,21,1660,2153,0,0,77.1,687,952,"東門里",NULL
0,1802,30,1832,2248,0,0,81.49,901,901,"圍下里",NULL
0,2473,29,2502,3055,0,0,81.9,1203,1270,"中西里",NULL
0,1242,24,1266,1619,0,0,78.2,504,738,"東安里",NULL
0,2000,27,2027,2497,0,0,81.18,975,1025,"新東里",NULL
0,2202,50,2252,2733,0,0,82.4,1337,865,"崇誨里",NULL
0,1192,26,1218,1575,0,0,77.33,570,622,"衛國里",NULL
0,2388,32,2420,2923,0,0,82.79,1077,1311,"裕農里",NULL
0,3177,54,3231,3905,0,0,82.74,1313,1864,"富強里",NULL
0,1643,20,1663,2101,0,0,79.15,647,996,"富裕里",NULL
0,3208,102,3310,4222,0,0,78.4,1895,1313,"忠孝里",NULL
0,2338,26,2364,2873,0,0,82.28,1186,1152,"崇明里",NULL
0,1689,57,1746,2171,0,0,80.42,756,933,"大福里",NULL
0,1272,22,1294,1621,0,0,79.83,613,659,"大德里",NULL
0,962,12,974,1252,0,0,77.8,518,444,"路東里",NULL
0,2300,50,2350,2975,0,0,78.99,990,1310,"大同里",NULL
0,3382,44,3426,4275,0,0,80.14,1460,1922,"泉南里",NULL
0,2288,40,2328,2825,0,0,82.41,1086,1202,"龍山里",NULL
0,2725,56,2781,3303,0,0,84.2,1363,1362,"德光里",NULL
0,2614,41,2655,3225,0,0,82.33,1300,1314,"大恩里",NULL
0,1514,29,1543,1961,0,0,78.68,804,710,"大林里",NULL
0,3415,51,3466,4281,0,0,80.96,1527,1888,"大忠里",NULL
0,964,36,1000,1218,0,0,82.1,881,83,"新生里",NULL
0,1157,21,1178,1451,0,0,81.19,599,558,"竹溪里",NULL
0,772,34,806,1006,0,0,80.12,634,138,"明德里",NULL
0,907,23,930,1166,0,0,79.76,817,90,"興中里",NULL
0,970,32,1002,1279,0,0,78.34,840,130,"荔宅里",NULL
0,743,22,765,951,0,0,80.44,316,427,"大成里",NULL
0,2691,54,2745,3332,0,0,82.38,1179,1512,"田寮里",NULL
0,2068,38,2106,2597,0,0,81.09,850,1218,"新興里",NULL
0,1802,36,1838,2207,0,0,83.28,690,1112,"再興里",NULL
0,2049,39,2088,2523,0,0,82.76,672,1377,"廣州里",NULL
0,1896,31,1927,2371,0,0,81.27,762,1134,"新昌里",NULL
0,2494,55,2549,3082,0,0,82.71,976,1518,"文華里",NULL
0,3088,46,3134,3928,0,0,79.79,1229,1859,"文南里",NULL
0,3799,55,3854,4736,0,0,81.38,1508,2291,"金華里",NULL
0,2397,38,2435,2965,0,0,82.12,917,1480,"國宅里",NULL
0,1643,24,1667,2043,0,0,81.6,622,1021,"日新里",NULL
0,3289,51,3340,4109,0,0,81.28,1071,2218,"光明里",NULL
0,1552,39,1591,1917,0,0,82.99,597,955,"白雪里",NULL
0,2835,60,2895,3627,0,0,79.82,1057,1778,"明亮里",NULL
0,3283,64,3347,4131,0,0,81.02,1423,1860,"府南里",NULL
0,2636,42,2678,3246,0,0,82.5,874,1762,"明興里",NULL
0,2722,43,2765,3396,0,0,81.42,1134,1588,"郡南里",NULL
0,3344,62,3406,4044,0,0,84.22,1236,2108,"建南里",NULL
0,1618,37,1655,2340,0,0,70.73,644,974,"南都里",NULL
0,1930,27,1957,2454,0,0,79.75,796,1134,"南華里",NULL
0,3082,42,3124,3973,0,0,78.63,1232,1850,"開南里",NULL
0,1499,29,1528,1883,0,0,81.15,555,944,"彰南里",NULL
0,1456,46,1502,1877,0,0,80.02,474,982,"鯤鯓里",NULL
0,1797,25,1822,2208,0,0,82.52,420,1377,"喜北里",NULL
0,1170,11,1181,1453,0,0,81.28,205,965,"喜南里",NULL
0,1242,21,1263,1521,0,0,83.04,302,940,"喜東里",NULL
0,2166,42,2208,2672,0,0,82.63,564,1602,"省躬里",NULL
0,1590,35,1625,1991,0,0,81.62,460,1130,"永寧里",NULL
0,1408,39,1447,1775,0,0,81.52,367,1041,"松安里",NULL
0,1440,31,1471,1806,0,0,81.45,390,1050,"佛壇里",NULL
0,1582,44,1626,2049,0,0,79.36,462,1120,"同安里",NULL
0,1458,31,1489,1821,0,0,81.77,394,1064,"興農里",NULL
0,791,11,802,1003,0,0,79.96,381,410,"小西里",NULL
0,1021,21,1042,1275,0,0,81.73,627,394,"大南里",NULL
0,983,22,1005,1272,0,0,79.01,423,560,"銀同里",NULL
0,1262,25,1287,1579,0,0,81.51,660,602,"五妃里",NULL
0,1209,19,1228,1503,0,0,81.7,610,599,"郡王里",NULL
0,1904,38,1942,2376,0,0,81.73,850,1054,"仙草里",NULL
0,2084,23,2107,2562,0,0,82.24,1100,984,"法華里",NULL
0,1094,16,1110,1359,0,0,81.68,447,647,"福安里",NULL
0,1081,9,1090,1351,0,0,80.68,510,571,"進學里",NULL
0,1083,26,1109,1409,0,0,78.71,433,650,"建國里",NULL
0,1074,21,1095,1364,0,0,80.28,453,621,"青年里",NULL
0,1133,19,1152,1450,0,0,79.45,400,733,"永福里",NULL
0,1145,33,1178,1469,0,0,80.19,461,684,"永華里",NULL
0,1303,13,1316,1645,0,0,80,506,797,"天后里",NULL
0,1206,22,1228,1518,0,0,80.9,455,751,"三民里",NULL
0,1167,35,1202,1549,0,0,77.6,458,709,"赤嵌里",NULL
0,1161,14,1175,1463,0,0,80.31,443,718,"公正里",NULL
0,1599,28,1627,2065,0,0,78.79,541,1058,"萬昌里",NULL
0,1664,27,1691,2146,0,0,78.8,663,1001,"開山里",NULL
0,2828,41,2869,3480,0,0,82.44,1221,1607,"西賢里",NULL
0,2386,40,2426,3043,0,0,79.72,1139,1247,"西湖里",NULL
0,2201,32,2233,2705,0,0,82.55,738,1463,"光賢里",NULL
0,1017,27,1044,1265,0,0,82.53,321,696,"文賢里",NULL
0,1575,38,1613,2111,0,0,76.41,566,1009,"協和里",NULL
0,1419,27,1446,1863,0,0,77.62,550,869,"三合里",NULL
0,931,20,951,1195,0,0,79.58,398,533,"普濟里",NULL
0,1090,12,1102,1380,0,0,79.86,361,729,"水仙里",NULL
0,1306,26,1332,1635,0,0,81.47,422,884,"民權里",NULL
0,2305,46,2351,2920,0,0,80.51,952,1353,"藥王里",NULL
0,887,19,906,1107,0,0,81.84,341,546,"協進里",NULL
0,1069,25,1094,1340,0,0,81.64,425,644,"中正里",NULL
0,982,17,999,1285,0,0,77.74,416,566,"安海里",NULL
0,1879,32,1911,2397,0,0,79.72,821,1058,"大涼里",NULL
0,746,15,761,973,0,0,78.21,267,479,"民主里",NULL
0,1039,23,1062,1331,0,0,79.79,397,642,"保安里",NULL
0,966,33,999,1229,0,0,81.29,343,623,"郡西里",NULL
0,1443,27,1470,1809,0,0,81.26,478,965,"民生里",NULL
0,1016,13,1029,1284,0,0,80.14,373,643,"元安里",NULL
0,1784,53,1837,2299,0,0,79.9,728,1056,"開元里",NULL
0,1372,27,1399,1809,0,0,77.34,713,659,"元寶里",NULL
0,1133,33,1166,1411,0,0,82.64,516,617,"國興里",NULL
0,1671,25,1696,2074,0,0,81.77,719,952,"華興里",NULL
0,1838,26,1864,2224,0,0,83.81,882,956,"力行里",NULL
0,2270,39,2309,2833,0,0,81.5,1465,805,"重興里",NULL
0,1677,18,1695,2031,0,0,83.46,911,766,"東興里",NULL
0,1421,33,1454,1801,0,0,80.73,669,752,"新勝里",NULL
0,828,30,858,1039,0,0,82.58,707,121,"長榮里",NULL
0,1510,19,1529,1896,0,0,80.64,707,803,"振興里",NULL
0,1402,24,1426,1764,0,0,80.84,622,780,"仁愛里",NULL
0,959,24,983,1208,0,0,81.37,462,497,"勝安里",NULL
0,1645,22,1667,2018,0,0,82.61,901,744,"中樓里",NULL
0,2309,56,2365,2892,0,0,81.78,1130,1179,"永祥里",NULL
0,1657,50,1707,2048,0,0,83.35,676,981,"小康里",NULL
0,1145,32,1177,1438,0,0,81.85,721,424,"實踐里",NULL
0,525,16,541,685,0,0,78.98,331,194,"光武里",NULL
0,522,13,535,660,0,0,81.06,487,35,"大道里",NULL
0,958,30,988,1247,0,0,79.23,682,276,"大山里",NULL
0,715,22,737,929,0,0,79.33,415,300,"大仁里",NULL
0,1203,30,1233,1539,0,0,80.12,496,707,"興北里",NULL
0,1488,34,1522,1934,0,0,78.7,758,730,"公園里",NULL
0,1185,26,1211,1488,0,0,81.38,387,798,"正風里",NULL
0,1396,35,1431,1760,0,0,81.31,455,941,"延平里",NULL
0,1010,22,1032,1312,0,0,78.66,435,575,"興南里",NULL
0,1295,31,1326,1656,0,0,80.07,470,825,"玉皇里",NULL
0,2580,52,2632,3219,0,0,81.76,847,1733,"正覺里",NULL
0,1755,35,1790,2267,0,0,78.96,741,1014,"六甲里",NULL
0,1234,36,1270,1572,0,0,80.79,472,762,"國姓里",NULL
0,1109,29,1138,1484,0,0,76.68,403,706,"長德里",NULL
0,1054,26,1080,1352,0,0,79.88,410,644,"三德里",NULL
0,1017,17,1034,1533,0,0,67.45,381,636,"五福里",NULL
0,2810,29,2839,3486,0,0,81.44,1100,1710,"成功里",NULL
0,4131,47,4178,4997,0,0,83.61,1679,2452,"成德里",NULL
0,4210,78,4288,5300,0,0,80.91,1818,2392,"和順里",NULL
0,1077,11,1088,1350,0,0,80.59,383,694,"安民里",NULL
0,3228,54,3282,3969,0,0,82.69,1244,1984,"文元里",NULL
0,2242,33,2275,2735,0,0,83.18,853,1389,"文成里",NULL
0,1119,27,1146,1422,0,0,80.59,403,716,"裕民里",NULL
0,2427,46,2473,2953,0,0,83.75,830,1597,"大和里",NULL
0,3739,60,3799,4559,0,0,83.33,1440,2299,"大港里",NULL
0,3145,55,3200,3945,0,0,81.12,1221,1924,"大豐里",NULL
0,1941,20,1961,2350,0,0,83.45,806,1135,"賢北里",NULL
0,464,13,477,567,0,0,84.13,163,301,"東和里",NULL
0,2901,43,2944,3668,0,0,80.26,971,1930,"塭南里",NULL
0,3343,92,3435,4307,0,0,79.75,1124,2219,"州南里",NULL
0,2167,42,2209,2706,0,0,81.63,824,1343,"安順里",NULL
0,2645,48,2693,3294,0,0,81.75,952,1693,"州北里",NULL
0,2862,56,2918,3495,0,0,83.49,1093,1769,"新順里",NULL
0,2241,41,2282,2765,0,0,82.53,627,1614,"頂安里",NULL
0,3205,59,3264,4111,0,0,79.4,1041,2164,"安慶里",NULL
0,2063,45,2108,2533,0,0,83.22,781,1282,"溪北里",NULL
0,1538,32,1570,1924,0,0,81.6,554,984,"安和里",NULL
0,1730,38,1768,2190,0,0,80.73,496,1234,"安西里",NULL
0,2997,69,3066,3764,0,0,81.46,1144,1853,"溪頂里",NULL
0,2075,63,2138,2580,0,0,82.87,612,1463,"安東里",NULL
0,2784,40,2824,3618,0,0,78.05,1111,1673,"鳳凰里",NULL
0,2488,46,2534,3211,0,0,78.92,923,1565,"梅花里",NULL
0,2758,49,2807,3460,0,0,81.13,949,1809,"理想里",NULL
0,2368,44,2412,2994,0,0,80.56,882,1486,"大安里",NULL
0,1208,37,1245,1484,0,0,83.89,372,836,"原佃里",NULL
0,2568,67,2635,3296,0,0,79.95,778,1790,"長安里",NULL
0,841,4,845,1038,0,0,81.41,245,596,"公親里",NULL
0,1027,23,1050,1304,0,0,80.52,418,609,"布袋里",NULL
0,1319,50,1369,1683,0,0,81.34,432,887,"總頭里",NULL
0,1064,27,1091,1352,0,0,80.7,289,775,"南興里",NULL
0,1373,48,1421,1795,0,0,79.16,486,887,"學東里",NULL
0,681,24,705,825,0,0,85.45,211,470,"公塭里",NULL
0,1787,37,1824,2237,0,0,81.54,701,1086,"佃東里",NULL
0,1166,28,1194,1498,0,0,79.71,424,742,"佃西里",NULL
0,1939,42,1981,2433,0,0,81.42,694,1245,"淵西里",NULL
0,1818,41,1859,2310,0,0,80.48,656,1162,"海西里",NULL
0,2656,55,2711,3422,0,0,79.22,857,1799,"海東里",NULL
0,2886,46,2932,3886,0,0,75.45,970,1916,"溪心里",NULL
0,2327,60,2387,2963,0,0,80.56,811,1516,"淵東里",NULL
0,2138,40,2178,2724,0,0,79.96,733,1405,"淵中里",NULL
0,2283,45,2328,2810,0,0,82.85,732,1551,"溪墘里",NULL
0,3131,55,3186,3919,0,0,81.3,1009,2122,"海佃里",NULL
0,1367,23,1390,1661,0,0,83.68,449,918,"國安里",NULL
0,2278,17,2295,2762,0,0,83.09,906,1372,"溪東里",NULL
0,3208,81,3289,4145,0,0,79.35,1077,2131,"安富里",NULL
0,2708,52,2760,3384,0,0,81.56,828,1880,"幸福里",NULL
0,1611,28,1639,1972,0,0,83.11,557,1054,"海南里",NULL
0,1054,33,1087,1405,0,0,77.37,386,668,"城東里",NULL
0,1790,63,1853,2377,0,0,77.96,639,1151,"城南里",NULL
0,994,29,1023,1284,0,0,79.67,355,639,"青草里",NULL
0,813,32,845,1016,0,0,83.17,223,590,"城西里",NULL
0,936,34,970,1209,0,0,80.23,313,623,"城北里",NULL
0,757,13,770,893,0,0,86.23,332,425,"城中里",NULL
0,811,21,832,1026,0,0,81.09,239,572,"砂崙里",NULL
0,812,32,844,1071,0,0,78.8,372,440,"顯宮里",NULL
0,490,12,502,633,0,0,79.3,259,231,"鹿耳里",NULL
0,1136,36,1172,1432,0,0,81.84,455,681,"四草里",NULL
0,456,10,466,555,0,0,83.96,160,296,"鹽田里",NULL
0,2391,28,2419,2988,0,0,80.96,888,1503,"平安里",NULL
0,1558,39,1597,2166,0,0,73.73,512,1046,"石門里",NULL
0,1182,18,1200,1441,0,0,83.28,393,789,"港仔里",NULL
0,1233,26,1259,1526,0,0,82.5,445,788,"海頭里",NULL
0,1571,38,1609,1962,0,0,82.01,856,715,"西門里",NULL
0,1187,17,1204,1505,0,0,80,571,616,"金城里",NULL
0,410,7,417,520,0,0,80.19,147,263,"漁光里",NULL
0,1124,17,1141,1412,0,0,80.81,454,670,"億載里",NULL
0,2891,52,2943,3819,0,0,77.06,1277,1614,"平通里",NULL
0,3747,56,3803,4880,0,0,77.93,1870,1877,"育平里",NULL
0,2945,40,2985,3663,0,0,81.49,1369,1576,"華平里",NULL
0,2004,43,2047,2560,0,0,79.96,893,1111,"怡平里",NULL
0,2628,34,2662,3367,0,0,79.06,1285,1343,"國平里",NULL
0,2307,33,2340,2902,0,0,80.63,1046,1261,"建平里",NULL
0,2458,19,2477,3038,0,0,81.53,1064,1394,"文平里",NULL
0,1391,31,1422,2152,0,0,66.08,1275,116,"東門里",NULL
0,1538,52,1590,2452,0,0,64.85,1426,112,"南門里",NULL
0,2570,83,2653,4063,0,0,65.3,2408,162,"西門里",NULL
0,1068,28,1096,1733,0,0,63.24,1003,65,"北門里",NULL
0,856,53,909,1419,0,0,64.06,799,57,"賢庵里",NULL
0,501,23,524,788,0,0,66.5,481,20,"金水里",NULL
0,878,48,926,1438,0,0,64.39,848,30,"古城里",NULL
0,555,19,574,926,0,0,61.99,515,40,"珠沙里",NULL
0,734,57,791,1312,0,0,60.29,674,60,"古寧村",NULL
0,1034,71,1105,1645,0,0,67.17,975,59,"安美村",NULL
0,1006,47,1053,1614,0,0,65.24,938,68,"湖埔村",NULL
0,1042,47,1089,1675,0,0,65.01,983,59,"榜林村",NULL
0,858,10,868,1348,0,0,64.39,801,57,"盤山村",NULL
0,355,16,371,572,0,0,64.86,339,16,"后盤村",NULL
0,1409,28,1437,2121,0,0,67.75,1310,99,"新市里",NULL
0,975,6,981,1531,0,0,64.08,897,78,"山外里",NULL
0,431,4,435,664,0,0,65.51,397,34,"溪湖里",NULL
0,393,25,418,642,0,0,65.11,379,14,"蓮庵里",NULL
0,447,16,463,696,0,0,66.52,427,20,"料羅里",NULL
0,1285,36,1321,1976,0,0,66.85,1158,127,"新湖里",NULL
0,624,33,657,942,0,0,69.75,584,40,"正義里",NULL
0,827,16,843,1323,0,0,63.72,794,33,"瓊林里",NULL
0,1357,41,1398,2195,0,0,63.69,1279,78,"汶沙里",NULL
0,540,21,561,866,0,0,64.78,511,29,"何斗里",NULL
0,584,45,629,942,0,0,66.77,556,28,"浦山里",NULL
0,373,29,402,650,0,0,61.85,354,19,"西園里",NULL
0,463,31,494,809,0,0,61.06,445,18,"官嶼里",NULL
0,493,28,521,816,0,0,63.85,477,16,"三山里",NULL
0,323,15,338,498,0,0,67.87,311,12,"大洋里",NULL
0,556,11,567,882,0,0,64.29,528,28,"光前里",NULL
0,800,29,829,1314,0,0,63.09,767,33,"林湖村",NULL
0,329,4,333,574,0,0,58.01,319,10,"黃埔村",NULL
0,459,2,461,826,0,0,55.81,443,16,"西口村",NULL
0,308,21,329,579,0,0,56.82,304,4,"上林村",NULL
0,651,43,694,1104,0,0,62.86,617,34,"上岐村",NULL
0,60,0,60,106,0,0,56.6,54,6,"大坵村",NULL
0,61,0,61,160,0,0,38.13,57,4,"小坵村",NULL
0,860,25,885,1294,0,0,68.39,813,47,"介壽村",NULL
0,770,33,803,1164,0,0,68.99,714,56,"福沃村、復興村",NULL
0,894,27,921,1414,0,0,65.13,827,67,"仁愛村、馬祖村、津沙村、珠螺村、清水村、四維村",NULL
0,545,9,554,932,0,0,59.44,511,34,"后沃村、橋仔村、塘岐村",NULL
0,255,6,261,449,0,0,58.13,246,9,"白沙村、板里村、芹壁村",NULL
0,270,3,273,460,0,0,59.35,258,12,"青帆村、田沃村、西坵村",NULL
0,236,6,242,379,0,0,63.85,230,6,"大坪村、福正村",NULL
0,478,8,486,647,0,0,75.12,461,17,"中柳村、樂華村",NULL
294,1076,22,1098,1343,0,0,81.76,564,512,"大福里",NULL
295,1060,24,1084,1367,0,0,79.3,592,468,"大福里",NULL
296,1040,21,1061,1261,0,0,84.14,551,489,"大鵬里",NULL
297,1055,9,1064,1321,0,0,80.55,634,421,"大鵬里",NULL
298,1097,21,1118,1390,0,0,80.43,717,380,"大鵬里",NULL
299,898,29,927,1122,0,0,82.62,258,640,"港尾里",NULL
300,1131,28,1159,1357,0,0,85.41,598,533,"港尾里",NULL
301,1218,23,1241,1511,0,0,82.13,687,531,"港尾里",NULL
302,626,15,641,763,0,0,84.01,604,22,"港尾里",NULL
303,875,8,883,1062,0,0,83.15,370,505,"廣福里",NULL
304,891,28,919,1085,0,0,84.7,303,588,"廣福里",NULL
305,842,37,879,1124,0,0,78.2,335,507,"林厝里",NULL
306,1154,43,1197,1475,0,0,81.15,593,561,"林厝里",NULL
307,1011,45,1056,1314,0,0,80.37,366,645,"永安里",NULL
308,1158,31,1189,1449,0,0,82.06,586,572,"永安里",NULL
309,1116,21,1137,1463,0,0,77.72,680,436,"永安里",NULL
310,965,11,976,1223,0,0,79.8,561,404,"永安里",NULL
311,1520,18,1538,1916,0,0,80.27,774,746,"福安里",NULL
312,1488,24,1512,1816,0,0,83.26,838,650,"福雅里",NULL
313,1374,19,1393,1750,0,0,79.6,820,554,"福雅里",NULL
314,1034,21,1055,1290,0,0,81.78,623,411,"福林里",NULL
315,1006,10,1016,1244,0,0,81.67,628,378,"福林里",NULL
316,1030,21,1051,1289,0,0,81.54,624,406,"福林里",NULL
317,804,15,819,1052,0,0,77.85,523,281,"福瑞里",NULL
318,829,17,846,1056,0,0,80.11,569,260,"福瑞里",NULL
319,1306,22,1328,1765,0,0,75.24,753,553,"福聯里",NULL
320,1170,39,1209,1484,0,0,81.47,513,657,"福和里",NULL
321,1306,25,1331,1576,0,0,84.45,547,759,"福和里",NULL
322,933,12,945,1119,0,0,84.45,532,401,"福中里",NULL
323,910,7,917,1156,0,0,79.33,481,429,"福中里",NULL
324,1242,17,1259,1563,0,0,80.55,734,508,"福恩里",NULL
325,1209,8,1217,1575,0,0,77.27,678,531,"福恩里",NULL
326,881,30,911,1124,0,0,81.05,354,527,"協和里",NULL
327,643,15,658,808,0,0,81.44,209,434,"協和里",NULL
328,978,11,989,1222,0,0,80.93,516,462,"協和里",NULL
329,967,18,985,1163,0,0,84.69,383,584,"南屯里",NULL
330,1004,13,1017,1214,0,0,83.77,398,606,"南屯里",NULL
331,1013,22,1035,1252,0,0,82.67,506,507,"南屯里",NULL
332,1072,23,1095,1315,0,0,83.27,631,441,"南屯里",NULL
333,1362,26,1388,1625,0,0,85.42,729,633,"豐樂里",NULL
334,1329,33,1362,1577,0,0,86.37,593,736,"豐樂里",NULL
335,1245,24,1269,1513,0,0,83.87,569,676,"豐樂里",NULL
336,1147,23,1170,1630,0,0,71.78,465,682,"豐樂里",NULL
337,1083,24,1107,1313,0,0,84.31,457,626,"楓樹里",NULL
338,1134,39,1173,1396,0,0,84.03,476,658,"楓樹里",NULL
339,1093,28,1121,1322,0,0,84.8,526,567,"楓樹里",NULL
340,1054,28,1082,1336,0,0,80.99,445,609,"中和里",NULL
341,1145,20,1165,1366,0,0,85.29,547,598,"中和里",NULL
342,951,31,982,1141,0,0,86.06,401,550,"中和里",NULL
343,501,6,507,599,0,0,84.64,174,327,"鎮平里",NULL
344,755,25,780,933,0,0,83.6,254,501,"鎮平里",NULL
345,1242,33,1275,1583,0,0,80.54,559,683,"永定里",NULL
346,1271,35,1306,1594,0,0,81.93,499,772,"永定里",NULL
347,1132,29,1161,1397,0,0,83.11,584,548,"春社里",NULL
348,892,22,914,1123,0,0,81.39,462,430,"春社里",NULL
349,1070,45,1115,1325,0,0,84.15,670,400,"春社里",NULL
350,584,12,596,763,0,0,78.11,413,171,"春社里",NULL
351,945,32,977,1179,0,0,82.87,919,26,"春安里",NULL
352,1025,37,1062,1298,0,0,81.82,850,175,"春安里",NULL
353,1326,24,1350,1628,0,0,82.92,666,660,"文山里",NULL
354,1223,18,1241,1568,0,0,79.15,690,533,"文山里",NULL
355,1253,28,1281,1579,0,0,81.13,594,659,"文山里",NULL
356,1272,14,1286,1565,0,0,82.17,535,737,"寶山里",NULL
357,1170,21,1191,1475,0,0,80.75,667,503,"寶山里",NULL
358,1037,30,1067,1279,0,0,83.42,320,717,"新生里",NULL
359,1028,18,1046,1256,0,0,83.28,577,451,"三義里",NULL
360,1199,13,1212,1492,0,0,81.23,783,416,"三義里",NULL
361,1114,15,1129,1330,0,0,84.89,692,422,"三義里",NULL
362,1182,17,1199,1478,0,0,81.12,746,436,"三和里",NULL
363,1254,11,1265,1491,0,0,84.84,722,532,"三和里",NULL
364,1165,19,1184,1403,0,0,84.39,746,419,"三和里",NULL
365,1278,19,1297,1553,0,0,83.52,661,617,"三厝里",NULL
366,1140,19,1159,1374,0,0,84.35,587,553,"三厝里",NULL
367,1130,19,1149,1385,0,0,82.96,639,491,"三厝里",NULL
368,1134,7,1141,1359,0,0,83.96,752,382,"黎明里",NULL
369,1045,12,1057,1281,0,0,82.51,648,397,"黎明里",NULL
370,1074,20,1094,1339,0,0,81.7,645,429,"黎明里",NULL
371,1051,12,1063,1309,0,0,81.21,596,455,"文心里",NULL
372,1041,19,1060,1320,0,0,80.3,532,509,"文心里",NULL
373,1248,14,1262,1484,0,0,85.04,635,613,"田心里",NULL
374,971,19,990,1208,0,0,81.95,443,528,"田心里",NULL
375,1075,21,1096,1355,0,0,80.89,530,545,"田心里",NULL
376,1137,23,1160,1420,0,0,81.69,567,570,"向心里",NULL
377,992,11,1003,1213,0,0,82.69,546,446,"向心里",NULL
378,1078,17,1095,1396,0,0,78.44,680,398,"同心里",NULL
379,1001,11,1012,1211,0,0,83.57,544,457,"同心里",NULL
380,974,17,991,1209,0,0,81.97,490,484,"同心里",NULL
381,1320,23,1343,1627,0,0,82.54,688,632,"大興里",NULL
382,1226,21,1247,1530,0,0,81.5,617,609,"大興里",NULL
383,978,3,981,1194,0,0,82.16,527,451,"大同里",NULL
384,964,8,972,1161,0,0,83.72,488,476,"大同里",NULL
385,1033,23,1056,1268,0,0,83.28,481,552,"大同里",NULL
386,853,12,865,1060,0,0,81.6,492,361,"大誠里",NULL
387,1025,20,1045,1305,0,0,80.08,561,464,"大誠里",NULL
388,1326,16,1342,1612,0,0,83.25,783,543,"大業里",NULL
389,1232,18,1250,1513,0,0,82.62,706,526,"大業里",NULL
390,1272,26,1298,1626,0,0,79.83,683,589,"大業里",NULL
391,1299,29,1328,1626,0,0,81.67,720,579,"溝墘里",NULL
392,1521,21,1542,1821,0,0,84.68,788,733,"溝墘里",NULL
393,1151,11,1162,1363,0,0,85.25,629,522,"惠中里",NULL
394,1154,15,1169,1433,0,0,81.58,680,474,"惠中里",NULL
395,1210,13,1223,1487,0,0,82.25,705,505,"惠中里",NULL
396,1113,13,1126,1398,0,0,80.54,714,399,"北屯里",NULL
397,1281,16,1297,1629,0,0,79.62,697,584,"北屯里",NULL
398,1365,24,1389,1692,0,0,82.09,709,656,"北京里",NULL
399,1193,6,1199,1512,0,0,79.3,618,575,"北京里",NULL
400,1248,28,1276,1548,0,0,82.43,627,621,"北興里",NULL
401,1258,29,1287,1589,0,0,80.99,754,504,"北興里",NULL
402,1273,18,1291,1614,0,0,79.99,677,596,"三光里",NULL
403,1041,19,1060,1297,0,0,81.73,513,528,"三光里",NULL
404,916,12,928,1158,0,0,80.14,525,391,"三光里",NULL
405,1182,25,1207,1477,0,0,81.72,709,473,"三光里",NULL
406,1444,18,1462,1800,0,0,81.22,779,665,"三和里",NULL
407,1138,17,1155,1451,0,0,79.6,649,489,"三和里",NULL
408,1162,20,1182,1484,0,0,79.65,654,508,"三和里",NULL
409,932,14,946,1149,0,0,82.33,400,532,"平興里",NULL
410,872,13,885,1146,0,0,77.23,537,335,"平興里",NULL
411,1426,26,1452,1849,0,0,78.53,874,552,"平興里",NULL
412,1356,24,1380,1694,0,0,81.46,725,631,"平田里",NULL
413,1149,18,1167,1447,0,0,80.65,681,468,"平田里",NULL
414,937,14,951,1174,0,0,81.01,529,408,"平田里",NULL
415,1344,18,1362,1720,0,0,79.19,722,622,"平昌里",NULL
416,1492,34,1526,1902,0,0,80.23,869,623,"平昌里",NULL
417,1243,22,1265,1584,0,0,79.86,743,500,"平陽里",NULL
418,1497,24,1521,1895,0,0,80.26,828,669,"平陽里",NULL
419,1072,24,1096,1320,0,0,83.03,575,497,"平安里",NULL
420,1055,21,1076,1369,0,0,78.6,501,554,"平安里",NULL
421,1265,21,1286,1639,0,0,78.46,662,603,"平安里",NULL
422,1400,21,1421,1799,0,0,78.99,846,554,"平和里",NULL
423,1298,22,1320,1657,0,0,79.66,772,526,"平和里",NULL
424,1163,24,1187,1450,0,0,81.86,631,532,"陳平里",NULL
425,1415,25,1440,1792,0,0,80.36,844,571,"陳平里",NULL
426,804,7,811,1014,0,0,79.98,505,299,"平順里",NULL
427,1068,15,1083,1287,0,0,84.15,555,513,"平順里",NULL
428,1329,21,1350,1694,0,0,79.69,744,585,"平心里",NULL
429,1213,16,1229,1570,0,0,78.28,667,546,"平心里",NULL
430,1228,20,1248,1499,0,0,83.26,683,545,"平福里",NULL
431,796,8,804,1005,0,0,80,520,276,"平福里",NULL
432,1051,15,1066,1351,0,0,78.9,554,497,"平德里",NULL
433,1237,23,1260,1579,0,0,79.8,711,526,"平德里",NULL
434,1261,10,1271,1550,0,0,82,651,610,"平德里",NULL
435,796,24,820,1010,0,0,81.19,360,436,"東光里",NULL
436,1118,21,1139,1504,0,0,75.73,560,558,"東光里",NULL
437,958,24,982,1226,0,0,80.1,482,476,"東光里",NULL
438,1214,41,1255,1464,0,0,85.72,339,875,"舊社里",NULL
439,1037,19,1056,1285,0,0,82.18,556,481,"舊社里",NULL
440,1004,20,1024,1237,0,0,82.78,451,553,"舊社里",NULL
441,925,21,946,1120,0,0,84.46,516,409,"舊社里",NULL
442,1293,27,1320,1589,0,0,83.07,492,801,"水景里",NULL
443,1082,24,1106,1345,0,0,82.23,556,526,"水景里",NULL
444,1244,19,1263,1519,0,0,83.15,576,668,"水景里",NULL
445,1058,28,1086,1356,0,0,80.09,536,522,"水景里",NULL
446,1351,27,1378,1610,0,0,85.59,576,775,"軍功里",NULL
447,922,53,975,1197,0,0,81.45,289,633,"軍功里",NULL
448,800,26,826,1002,0,0,82.44,325,475,"軍功里",NULL
449,880,21,901,1108,0,0,81.32,521,359,"軍功里",NULL
450,1055,29,1084,1323,0,0,81.93,530,525,"軍功里",NULL
451,1287,29,1316,1574,0,0,83.61,502,785,"和平里",NULL
452,1289,27,1316,1581,0,0,83.24,559,730,"和平里",NULL
453,1211,25,1236,1517,0,0,81.48,547,664,"和平里",NULL
454,1294,33,1327,1563,0,0,84.9,424,870,"東山里",NULL
455,585,19,604,757,0,0,79.79,260,325,"廍子里",NULL
456,717,14,731,888,0,0,82.32,264,453,"廍子里",NULL
457,701,22,723,903,0,0,80.07,298,403,"民政里",NULL
458,654,4,658,799,0,0,82.35,243,411,"民德里",NULL
459,1338,38,1376,1696,0,0,81.13,572,766,"大坑里",NULL
460,1387,22,1409,1692,0,0,83.27,875,512,"松竹里",NULL
461,1310,22,1332,1653,0,0,80.58,726,584,"松竹里",NULL
462,1412,14,1426,1746,0,0,81.67,790,622,"松竹里",NULL
463,950,25,975,1191,0,0,81.86,506,444,"松和里",NULL
464,1015,15,1030,1316,0,0,78.27,546,469,"松和里",NULL
465,843,7,850,1041,0,0,81.65,486,357,"松和里",NULL
466,1141,17,1158,1484,0,0,78.03,610,531,"松和里",NULL
467,1084,10,1094,1310,0,0,83.51,511,573,"松安里",NULL
468,1026,21,1047,1318,0,0,79.44,587,439,"松安里",NULL
469,912,9,921,1128,0,0,81.65,496,416,"松安里",NULL
470,1296,29,1325,1713,0,0,77.35,702,594,"松強里",NULL
471,1563,15,1578,1920,0,0,82.19,858,705,"松強里",NULL
472,1441,46,1487,1784,0,0,83.35,788,653,"松勇里",NULL
473,1525,36,1561,1908,0,0,81.81,854,671,"松勇里",NULL
474,1033,7,1040,1294,0,0,80.37,667,366,"松茂里",NULL
475,1116,13,1129,1360,0,0,83.01,686,430,"松茂里",NULL
476,1036,23,1059,1325,0,0,79.92,593,443,"松茂里",NULL
477,1227,14,1241,1465,0,0,84.71,520,707,"仁和里",NULL
478,1382,28,1410,2076,0,0,67.92,785,597,"仁和里",NULL
479,926,17,943,1142,0,0,82.57,489,437,"仁和里",NULL
480,667,5,672,802,0,0,83.79,262,405,"仁美里",NULL
481,1213,23,1236,1474,0,0,83.85,624,589,"仁美里",NULL
482,1244,23,1267,1499,0,0,84.52,502,742,"仁美里",NULL
483,666,13,679,812,0,0,83.62,622,44,"仁美里",NULL
484,588,20,608,723,0,0,84.09,513,75,"仁美里",NULL
485,1181,28,1209,1460,0,0,82.81,540,641,"四民里",NULL
486,441,16,457,545,0,0,83.85,416,25,"四民里",NULL
487,1485,45,1530,1834,0,0,83.42,598,887,"同榮里",NULL
488,1461,32,1493,1797,0,0,83.08,1057,404,"同榮里",NULL
489,1533,17,1550,1880,0,0,82.45,968,565,"同榮里",NULL
490,1255,26,1281,1557,0,0,82.27,742,513,"后庄里",NULL
491,1473,30,1503,1768,0,0,85.01,853,620,"后庄里",NULL
492,1429,22,1451,1759,0,0,82.49,865,564,"后庄里",NULL
493,1078,14,1092,1365,0,0,80,720,358,"后庄里",NULL
494,1224,27,1251,1533,0,0,81.6,753,471,"忠平里",NULL
495,1271,14,1285,1579,0,0,81.38,796,475,"忠平里",NULL
496,987,10,997,1200,0,0,83.08,613,374,"大德里",NULL
497,1343,24,1367,1649,0,0,82.9,837,506,"大德里",NULL
498,1069,17,1086,1323,0,0,82.09,633,436,"大德里",NULL
499,1387,32,1419,1786,0,0,79.45,842,545,"新平里",NULL
500,1065,35,1100,1319,0,0,83.4,689,376,"新平里",NULL
501,1042,26,1068,1346,0,0,79.35,651,391,"新平里",NULL
502,678,14,692,842,0,0,82.19,603,75,"仁愛里",NULL
503,763,18,781,971,0,0,80.43,411,352,"仁愛里",NULL
504,1203,34,1237,1554,0,0,79.6,595,608,"水湳里",NULL
505,939,21,960,1169,0,0,82.12,519,420,"水湳里",NULL
506,1291,20,1311,1622,0,0,80.83,719,572,"水湳里",NULL
507,1300,34,1334,1615,0,0,82.6,727,573,"水湳里",NULL
1,1081,27,1108,1366,0,0,81.11,567,514,"短竹里",NULL
2,1082,13,1095,1372,0,0,79.81,510,572,"短竹里",NULL
3,1149,20,1169,1463,0,0,79.9,618,531,"短竹里",NULL
4,693,8,701,834,0,0,84.05,362,331,"東川里",NULL
5,748,11,759,922,0,0,82.32,492,256,"東川里",NULL
6,491,20,511,648,0,0,78.86,158,333,"鹿寮里",NULL
7,927,28,955,1160,0,0,82.33,411,516,"盧厝里",NULL
8,1071,10,1081,1300,0,0,83.15,556,515,"盧厝里",NULL
9,812,9,821,990,0,0,82.93,410,402,"盧厝里",NULL
10,705,16,721,897,0,0,80.38,379,326,"東平里",NULL
11,1143,18,1161,1427,0,0,81.36,612,531,"太平里",NULL
12,691,10,701,870,0,0,80.57,353,338,"太平里",NULL
13,520,13,533,647,0,0,82.38,309,211,"太平里",NULL
14,689,9,698,853,0,0,81.83,373,316,"太平里",NULL
15,974,11,985,1216,0,0,81,575,399,"王田里",NULL
16,867,11,878,1107,0,0,79.31,490,377,"王田里",NULL
17,842,19,861,1012,0,0,85.08,369,473,"長竹里",NULL
18,1354,20,1374,1644,0,0,83.58,796,558,"長竹里",NULL
19,1054,36,1090,1358,0,0,80.27,474,580,"後庄里",NULL
20,892,15,907,1079,0,0,84.06,446,446,"後庄里",NULL
21,909,10,919,1103,0,0,83.32,504,405,"後庄里",NULL
22,1085,11,1096,1322,0,0,82.9,552,533,"新店里",NULL
23,757,10,767,937,0,0,81.86,410,347,"新店里",NULL
24,748,18,766,967,0,0,79.21,388,360,"新店里",NULL
25,939,18,957,1178,0,0,81.24,604,335,"圳頭里",NULL
26,781,22,803,983,0,0,81.69,533,248,"圳頭里",NULL
27,1316,16,1332,1668,0,0,79.86,647,669,"圳頭里",NULL
28,871,23,894,1137,0,0,78.63,453,418,"東噴里",NULL
29,261,3,264,318,0,0,83.02,248,13,"希康里",NULL
30,371,2,373,452,0,0,82.52,167,204,"東山里",NULL
31,431,3,434,536,0,0,80.97,150,281,"東安里",NULL
32,414,4,418,511,0,0,81.8,149,265,"大街里",NULL
33,463,12,475,642,0,0,73.99,140,323,"祐民里",NULL
34,391,13,404,500,0,0,80.8,149,242,"東仁里",NULL
35,355,3,358,443,0,0,80.81,173,182,"內安里",NULL
36,510,6,516,637,0,0,81,224,286,"雲霄里",NULL
37,528,7,535,663,0,0,80.69,246,282,"雲霄里",NULL
38,482,6,488,613,0,0,79.61,158,324,"建國里",NULL
39,830,17,847,1036,0,0,81.76,324,506,"府路里",NULL
40,298,4,302,379,0,0,79.68,126,172,"鎮南里",NULL
41,794,12,806,1017,0,0,79.25,315,479,"神農里",NULL
42,524,9,533,655,0,0,81.37,243,281,"崇文里",NULL
43,577,5,582,730,0,0,79.73,258,319,"龍山里",NULL
44,588,12,600,729,0,0,82.3,271,317,"安平里",NULL
45,545,12,557,673,0,0,82.76,221,324,"文昌里",NULL
46,953,17,970,1194,0,0,81.24,859,94,"志航里",NULL
47,503,7,510,618,0,0,82.52,213,290,"蘭井里",NULL
48,849,27,876,1086,0,0,80.66,288,561,"光復里",NULL
49,1041,12,1053,1295,0,0,81.31,416,625,"初陽里",NULL
50,612,13,625,784,0,0,79.72,308,304,"震安里",NULL
51,527,13,540,643,0,0,83.98,265,262,"新開里",NULL
52,571,7,578,717,0,0,80.61,273,298,"新開里",NULL
53,692,22,714,930,0,0,76.77,275,417,"宣信里",NULL
54,712,17,729,913,0,0,79.85,275,437,"宣信里",NULL
55,1036,25,1061,1305,0,0,81.3,397,639,"興南里",NULL
56,572,6,578,737,0,0,78.43,317,255,"豐年里",NULL
57,634,9,643,818,0,0,78.61,243,391,"豐年里",NULL
58,1026,24,1050,1310,0,0,80.15,451,575,"芳草里",NULL
59,718,16,734,906,0,0,81.02,337,381,"芳草里",NULL
60,1035,12,1047,1311,0,0,79.86,482,553,"芳草里",NULL
61,1117,25,1142,1394,0,0,81.92,490,627,"芳安里",NULL
62,541,10,551,675,0,0,81.63,225,316,"芳安里",NULL
63,831,13,844,1049,0,0,80.46,309,522,"頂寮里",NULL
64,793,15,808,992,0,0,81.45,318,475,"頂寮里",NULL
65,706,15,721,899,0,0,80.2,314,392,"安寮里",NULL
66,821,13,834,1062,0,0,78.53,367,454,"安寮里",NULL
67,980,21,1001,1243,0,0,80.53,440,540,"安寮里",NULL
68,1191,24,1215,1537,0,0,79.05,551,640,"安寮里",NULL
69,1119,15,1134,1392,0,0,81.47,439,680,"興村里",NULL
70,1397,18,1415,1820,0,0,77.75,715,682,"興村里",NULL
71,846,14,860,1108,0,0,77.62,329,517,"興安里",NULL
72,825,18,843,1053,0,0,80.06,442,383,"興安里",NULL
73,1238,19,1257,1537,0,0,81.78,613,625,"興仁里",NULL
74,1332,23,1355,1672,0,0,81.04,614,718,"興仁里",NULL
75,693,8,701,877,0,0,79.93,249,444,"北城里",NULL
76,494,11,505,636,0,0,79.4,216,278,"仁武里",NULL
77,834,19,853,1069,0,0,79.79,398,436,"泰安里",NULL
78,658,6,664,828,0,0,80.19,350,308,"檜村里",NULL
79,519,9,528,649,0,0,81.36,273,246,"檜村里",NULL
80,688,8,696,861,0,0,80.84,224,464,"社口里",NULL
81,386,7,393,488,0,0,80.53,126,260,"仁和里",NULL
82,1098,20,1118,1452,0,0,77,532,566,"中庄里",NULL
83,1014,20,1034,1282,0,0,80.66,508,506,"中庄里",NULL
84,973,17,990,1190,0,0,83.19,488,485,"仁義里",NULL
85,772,19,791,993,0,0,79.66,351,421,"仁義里",NULL
86,1284,21,1305,1647,0,0,79.23,605,679,"後湖里",NULL
87,1107,15,1122,1411,0,0,79.52,443,664,"後湖里",NULL
88,736,18,754,910,0,0,82.86,228,508,"荖藤里",NULL
89,559,24,583,709,0,0,82.23,160,399,"荖藤里",NULL
90,790,8,798,1029,0,0,77.55,413,377,"荖藤里",NULL
91,966,22,988,1251,0,0,78.98,441,525,"頂庄里",NULL
92,1120,16,1136,1418,0,0,80.11,562,558,"頂庄里",NULL
93,776,8,784,970,0,0,80.82,327,449,"頂庄里",NULL
94,980,16,996,1197,0,0,83.21,489,491,"頂庄里",NULL
95,780,12,792,1014,0,0,78.11,311,469,"書院里",NULL
96,480,12,492,622,0,0,79.1,248,232,"驛站里",NULL
97,382,6,388,481,0,0,80.67,129,253,"民安里",NULL
98,501,12,513,640,0,0,80.16,224,277,"菜園里",NULL
99,418,11,429,532,0,0,80.64,127,291,"集英里",NULL
100,624,17,641,800,0,0,80.13,208,416,"福松里",NULL
101,455,8,463,593,0,0,78.08,168,287,"義昌里",NULL
102,859,18,877,1103,0,0,79.51,344,515,"自治里",NULL
103,675,11,686,843,0,0,81.38,210,465,"大業里",NULL
104,650,7,657,813,0,0,80.81,283,367,"中庸里",NULL
105,419,11,430,531,0,0,80.98,147,272,"學圃里",NULL
106,665,6,671,818,0,0,82.03,304,361,"北杏里",NULL
107,419,7,426,531,0,0,80.23,154,265,"社內里",NULL
108,456,8,464,560,0,0,82.86,195,261,"民生里",NULL
109,330,6,336,423,0,0,79.43,118,212,"慶昇里",NULL
110,291,0,291,385,0,0,75.58,93,198,"通運里",NULL
111,492,7,499,625,0,0,79.84,198,294,"榮檜里",NULL
112,544,10,554,724,0,0,76.52,193,351,"功科里",NULL
113,501,13,514,629,0,0,81.72,174,327,"康莊里",NULL
114,796,16,812,1023,0,0,79.37,277,519,"福全里",NULL
115,900,18,918,1156,0,0,79.41,334,566,"福全里",NULL
116,971,19,990,1228,0,0,80.62,427,544,"福全里",NULL
117,1001,16,1017,1260,0,0,80.71,395,606,"福全里",NULL
118,1093,15,1108,1391,0,0,79.65,504,589,"福全里",NULL
119,749,11,760,945,0,0,80.42,300,449,"力行里",NULL
120,865,12,877,1109,0,0,79.08,348,517,"劉厝里",NULL
121,1307,38,1345,1697,0,0,79.26,573,734,"劉厝里",NULL
122,570,10,580,710,0,0,81.69,217,353,"劉厝里",NULL
123,789,15,804,999,0,0,80.48,326,463,"港坪里",NULL
124,799,11,810,1017,0,0,79.65,371,428,"港坪里",NULL
125,1009,31,1040,1285,0,0,80.93,400,609,"頭港里",NULL
126,1085,13,1098,1309,0,0,83.88,367,718,"西平里",NULL
127,687,32,719,925,0,0,77.73,200,487,"大溪里",NULL
128,688,26,714,890,0,0,80.22,222,466,"大溪里",NULL
129,1028,15,1043,1328,0,0,78.54,381,647,"磚窯里",NULL
130,802,11,813,987,0,0,82.37,430,372,"磚窯里",NULL
131,773,10,783,956,0,0,81.9,310,463,"磚窯里",NULL
132,729,16,745,926,0,0,80.45,303,426,"新西里",NULL
133,889,13,902,1155,0,0,78.1,381,508,"新西里",NULL
134,600,8,608,779,0,0,78.05,305,295,"華明里",NULL
135,453,9,462,592,0,0,78.04,182,271,"導民里",NULL
136,531,15,546,674,0,0,81.01,207,324,"導民里",NULL
137,796,22,818,1009,0,0,81.07,302,494,"培元里",NULL
138,708,6,714,888,0,0,80.41,319,389,"垂楊里",NULL
139,849,20,869,1104,0,0,78.71,321,528,"垂楊里",NULL
140,1194,29,1223,1543,0,0,79.26,524,670,"車店里",NULL
141,1032,16,1048,1312,0,0,79.88,445,587,"車店里",NULL
142,1250,23,1273,1558,0,0,81.71,543,707,"車店里",NULL
143,1169,14,1183,1399,0,0,84.56,524,645,"福民里",NULL
144,1101,14,1115,1383,0,0,80.62,513,588,"福民里",NULL
145,1105,16,1121,1448,0,0,77.42,498,607,"福民里",NULL
146,1007,22,1029,1270,0,0,81.02,379,628,"湖內里",NULL
147,993,41,1034,1270,0,0,81.42,289,704,"湖內里",NULL
148,1454,15,1469,1808,0,0,81.25,667,787,"湖內里",NULL
149,1071,18,1089,1369,0,0,79.55,451,620,"湖內里",NULL
150,1023,16,1039,1269,0,0,81.88,393,630,"湖內里",NULL
151,829,20,849,1039,0,0,81.71,251,578,"美源里",NULL
152,1111,16,1127,1388,0,0,81.2,532,579,"美源里",NULL
153,714,9,723,910,0,0,79.45,333,381,"美源里",NULL
154,1031,13,1044,1311,0,0,79.63,474,557,"光路里",NULL
155,1181,27,1208,1472,0,0,82.07,517,664,"光路里",NULL
156,1097,29,1126,1384,0,0,81.36,489,608,"光路里",NULL
157,879,14,893,1130,0,0,79.03,369,510,"育英里",NULL
158,917,12,929,1153,0,0,80.57,391,526,"育英里",NULL
159,967,28,995,1212,0,0,82.1,402,565,"自強里",NULL
160,988,26,1014,1255,0,0,80.8,366,622,"長安里",NULL
161,757,10,767,946,0,0,81.08,280,477,"北榮里",NULL
162,824,13,837,1026,0,0,81.58,302,522,"北榮里",NULL
163,899,26,925,1169,0,0,79.13,359,540,"重興里",NULL
164,707,17,724,900,0,0,80.44,245,462,"重興里",NULL
165,409,2,411,508,0,0,80.91,171,238,"慶昌里",NULL
166,479,18,497,643,0,0,77.29,126,353,"小湖里",NULL
167,595,19,614,758,0,0,81,195,400,"竹文里",NULL
168,545,17,562,683,0,0,82.28,223,322,"竹文里",NULL
169,1026,22,1048,1363,0,0,76.89,382,644,"香湖里",NULL
170,710,18,728,922,0,0,78.96,225,485,"湖邊里",NULL
171,718,18,736,927,0,0,79.4,301,417,"湖邊里",NULL
172,800,22,822,1034,0,0,79.5,336,464,"竹圍里",NULL
173,895,8,903,1130,0,0,79.91,397,498,"竹圍里",NULL
174,666,23,689,858,0,0,80.3,191,475,"竹圍里",NULL
175,779,9,788,984,0,0,80.08,298,481,"竹圍里",NULL
176,1083,29,1112,1388,0,0,80.12,334,749,"保安里",NULL
177,1201,25,1226,1455,0,0,84.26,438,763,"保安里",NULL
178,1079,23,1102,1385,0,0,79.57,472,607,"保安里",NULL
179,1284,27,1311,1594,0,0,82.25,613,671,"保安里",NULL
180,1305,19,1324,1649,0,0,80.29,593,712,"保安里",NULL
181,1234,16,1250,1565,0,0,79.87,565,669,"保安里",NULL
182,890,18,908,1113,0,0,81.58,348,542,"新厝里",NULL
183,907,16,923,1138,0,0,81.11,317,590,"新厝里",NULL
184,926,24,950,1133,0,0,83.85,301,625,"新厝里",NULL
185,877,31,908,1134,0,0,80.07,359,518,"北湖里",NULL
186,919,17,936,1188,0,0,78.79,364,555,"北湖里",NULL
187,899,25,924,1202,0,0,76.87,343,556,"下埤里",NULL
188,726,21,747,910,0,0,82.09,357,369,"竹村里",NULL
1,1374,7,1381,1744,0,0,79.19,618,756,"崇信里",NULL
2,1343,18,1361,2010,0,0,67.71,572,771,"崇信里",NULL
3,1026,16,1042,1261,0,0,82.63,468,558,"崇學里",NULL
4,1081,13,1094,1363,0,0,80.26,475,606,"崇學里",NULL
5,1215,15,1230,1467,0,0,83.84,570,645,"崇德里",NULL
6,1015,13,1028,1245,0,0,82.57,553,462,"崇德里",NULL
7,1063,11,1074,1277,0,0,84.1,577,486,"崇德里",NULL
8,1470,17,1487,1797,0,0,82.75,593,877,"崇善里",NULL
9,1282,21,1303,1630,0,0,79.94,594,688,"崇善里",NULL
10,917,8,925,1136,0,0,81.43,458,459,"崇成里",NULL
11,1014,17,1031,1224,0,0,84.23,533,481,"崇成里",NULL
12,997,14,1011,1253,0,0,80.69,515,482,"崇文里",NULL
13,1172,13,1185,1419,0,0,83.51,634,538,"崇文里",NULL
14,1422,22,1444,1744,0,0,82.8,741,681,"崇文里",NULL
15,1668,29,1697,2061,0,0,82.34,822,846,"東智里",NULL
16,1318,18,1336,1644,0,0,81.27,655,663,"大智里",NULL
17,993,31,1024,1247,0,0,82.12,507,486,"大智里",NULL
18,1356,23,1379,1671,0,0,82.53,730,626,"大智里",NULL
19,1047,19,1066,1284,0,0,83.02,444,603,"德高里",NULL
20,988,39,1027,1297,0,0,79.18,360,628,"德高里",NULL
21,1477,27,1504,1853,0,0,81.17,609,868,"仁和里",NULL
22,1561,19,1580,2019,0,0,78.26,806,755,"仁和里",NULL
23,1054,19,1073,1348,0,0,79.6,421,633,"和平里",NULL
24,1164,16,1180,1412,0,0,83.57,481,683,"和平里",NULL
25,1188,28,1216,1466,0,0,82.95,616,572,"虎尾里",NULL
26,1137,23,1160,1394,0,0,83.21,449,688,"虎尾里",NULL
27,1328,19,1347,1700,0,0,79.24,693,635,"虎尾里",NULL
28,1521,18,1539,1792,0,0,85.88,814,707,"裕聖里",NULL
29,1320,14,1334,1664,0,0,80.17,590,730,"復興里",NULL
30,1240,25,1265,1535,0,0,82.41,530,710,"復興里",NULL
31,1104,16,1120,1377,0,0,81.34,581,523,"自強里",NULL
32,1107,16,1123,1358,0,0,82.7,554,553,"自強里",NULL
33,1196,15,1211,1482,0,0,81.71,538,658,"自強里",NULL
34,949,19,968,1162,0,0,83.3,429,520,"東聖里",NULL
35,765,16,781,973,0,0,80.27,380,385,"東聖里",NULL
36,1600,13,1613,2015,0,0,80.05,716,884,"關聖里",NULL
37,1713,18,1731,2025,0,0,85.48,909,804,"關聖里",NULL
38,1613,16,1629,1909,0,0,85.33,837,776,"關聖里",NULL
39,969,25,994,1222,0,0,81.34,415,554,"後甲里",NULL
40,1184,20,1204,1438,0,0,83.73,497,687,"後甲里",NULL
41,784,11,795,948,0,0,83.86,721,63,"復國里",NULL
42,774,30,804,970,0,0,82.89,711,63,"復國里",NULL
43,614,27,641,771,0,0,83.14,574,40,"中興里",NULL
44,668,32,700,867,0,0,80.74,624,44,"中興里",NULL
45,945,13,958,1180,0,0,81.19,492,453,"東光里",NULL
46,1483,30,1513,1821,0,0,83.09,928,555,"東光里",NULL
47,996,20,1016,1234,0,0,82.33,506,490,"東光里",NULL
48,1282,29,1311,1609,0,0,81.48,675,607,"東明里",NULL
49,1334,19,1353,1669,0,0,81.07,657,677,"東明里",NULL
50,1181,8,1189,1455,0,0,81.72,666,515,"莊敬里",NULL
51,1469,11,1480,1764,0,0,83.9,706,763,"莊敬里",NULL
52,1158,17,1175,1462,0,0,80.37,551,607,"小東里",NULL
53,1143,16,1159,1422,0,0,81.5,635,508,"小東里",NULL
54,1025,28,1053,1272,0,0,82.78,556,469,"小東里",NULL
55,1224,28,1252,1492,0,0,83.91,678,546,"大學里",NULL
56,1665,42,1707,2170,0,0,78.66,850,815,"成大里",NULL
57,1639,21,1660,2153,0,0,77.1,687,952,"東門里",NULL
58,1802,30,1832,2248,0,0,81.49,901,901,"圍下里",NULL
59,1207,13,1220,1509,0,0,80.85,561,646,"中西里",NULL
60,1266,16,1282,1546,0,0,82.92,642,624,"中西里",NULL
61,1242,24,1266,1619,0,0,78.2,504,738,"東安里",NULL
62,1030,10,1040,1271,0,0,81.83,508,522,"新東里",NULL
63,970,17,987,1226,0,0,80.51,467,503,"新東里",NULL
64,1161,26,1187,1462,0,0,81.19,836,325,"崇誨里",NULL
65,1041,24,1065,1271,0,0,83.79,501,540,"崇誨里",NULL
66,1192,26,1218,1575,0,0,77.33,570,622,"衛國里",NULL
67,1249,14,1263,1534,0,0,82.33,573,676,"裕農里",NULL
68,1139,18,1157,1389,0,0,83.3,504,635,"裕農里",NULL
69,1710,25,1735,2107,0,0,82.34,698,1012,"富強里",NULL
70,1467,29,1496,1798,0,0,83.2,615,852,"富強里",NULL
71,1643,20,1663,2101,0,0,79.15,647,996,"富裕里",NULL
72,1390,28,1418,1810,0,0,78.34,753,637,"忠孝里",NULL
73,1466,19,1485,1814,0,0,81.86,799,667,"忠孝里",NULL
74,352,55,407,598,0,0,68.06,343,9,"忠孝里",NULL
75,1214,17,1231,1533,0,0,80.3,590,624,"崇明里",NULL
76,1124,9,1133,1340,0,0,84.55,596,528,"崇明里",NULL
77,1689,57,1746,2171,0,0,80.42,756,933,"大福里",NULL
78,1272,22,1294,1621,0,0,79.83,613,659,"大德里",NULL
79,962,12,974,1252,0,0,77.8,518,444,"路東里",NULL
80,1485,36,1521,1930,0,0,78.81,637,848,"大同里",NULL
81,815,14,829,1045,0,0,79.33,353,462,"大同里",NULL
82,1697,15,1712,2114,0,0,80.98,745,952,"泉南里",NULL
83,1685,29,1714,2161,0,0,79.32,715,970,"泉南里",NULL
84,1093,14,1107,1331,0,0,83.17,550,543,"龍山里",NULL
85,1195,26,1221,1494,0,0,81.73,536,659,"龍山里",NULL
86,1632,29,1661,1977,0,0,84.02,844,788,"德光里",NULL
87,1093,27,1120,1326,0,0,84.46,519,574,"德光里",NULL
88,1254,18,1272,1538,0,0,82.7,641,613,"大恩里",NULL
89,1360,23,1383,1687,0,0,81.98,659,701,"大恩里",NULL
90,794,21,815,1038,0,0,78.52,414,380,"大林里",NULL
91,720,8,728,923,0,0,78.87,390,330,"大林里",NULL
92,931,20,951,1156,0,0,82.27,353,578,"大忠里",NULL
93,1171,9,1180,1480,0,0,79.73,557,614,"大忠里",NULL
94,1313,22,1335,1645,0,0,81.16,617,696,"大忠里",NULL
95,964,36,1000,1218,0,0,82.1,881,83,"新生里",NULL
96,1157,21,1178,1451,0,0,81.19,599,558,"竹溪里",NULL
97,772,34,806,1006,0,0,80.12,634,138,"明德里",NULL
98,907,23,930,1166,0,0,79.76,817,90,"興中里",NULL
99,970,32,1002,1279,0,0,78.34,840,130,"荔宅里",NULL
100,743,22,765,951,0,0,80.44,316,427,"大成里",NULL
101,592,9,601,734,0,0,81.88,265,327,"田寮里",NULL
102,858,27,885,1081,0,0,81.87,367,491,"田寮里",NULL
103,1241,18,1259,1517,0,0,82.99,547,694,"田寮里",NULL
104,920,19,939,1135,0,0,82.73,382,538,"新興里",NULL
105,1148,19,1167,1462,0,0,79.82,468,680,"新興里",NULL
106,897,20,917,1106,0,0,82.91,337,560,"再興里",NULL
107,905,16,921,1101,0,0,83.65,353,552,"再興里",NULL
108,1008,19,1027,1242,0,0,82.69,331,677,"廣州里",NULL
109,1041,20,1061,1281,0,0,82.83,341,700,"廣州里",NULL
110,956,9,965,1176,0,0,82.06,362,594,"新昌里",NULL
111,940,22,962,1195,0,0,80.5,400,540,"新昌里",NULL
112,1273,27,1300,1555,0,0,83.6,444,829,"文華里",NULL
113,1221,28,1249,1527,0,0,81.79,532,689,"文華里",NULL
114,1697,24,1721,2164,0,0,79.53,628,1069,"文南里",NULL
115,1391,22,1413,1764,0,0,80.1,601,790,"文南里",NULL
116,1185,18,1203,1472,0,0,81.73,511,674,"金華里",NULL
117,1299,22,1321,1651,0,0,80.01,530,769,"金華里",NULL
118,1315,15,1330,1613,0,0,82.46,467,848,"金華里",NULL
119,1272,20,1292,1558,0,0,82.93,478,794,"國宅里",NULL
120,1125,18,1143,1407,0,0,81.24,439,686,"國宅里",NULL
121,783,13,796,965,0,0,82.49,258,525,"日新里",NULL
122,860,11,871,1078,0,0,80.8,364,496,"日新里",NULL
123,1274,24,1298,1593,0,0,81.48,436,838,"光明里",NULL
124,1070,16,1086,1336,0,0,81.29,381,689,"光明里",NULL
125,945,11,956,1180,0,0,81.02,254,691,"光明里",NULL
126,779,19,798,958,0,0,83.3,294,485,"白雪里",NULL
127,773,20,793,959,0,0,82.69,303,470,"白雪里",NULL
128,1270,26,1296,1628,0,0,79.61,461,809,"明亮里",NULL
129,1565,34,1599,1999,0,0,79.99,596,969,"明亮里",NULL
130,1157,29,1186,1479,0,0,80.19,498,659,"府南里",NULL
131,991,18,1009,1236,0,0,81.63,385,606,"府南里",NULL
132,1135,17,1152,1416,0,0,81.36,540,595,"府南里",NULL
133,1277,28,1305,1550,0,0,84.19,431,846,"明興里",NULL
134,1359,14,1373,1696,0,0,80.96,443,916,"明興里",NULL
135,1394,33,1427,1723,0,0,82.82,643,751,"郡南里",NULL
136,1328,10,1338,1673,0,0,79.98,491,837,"郡南里",NULL
137,1104,20,1124,1330,0,0,84.51,392,712,"建南里",NULL
138,1217,22,1239,1473,0,0,84.11,455,762,"建南里",NULL
139,1023,20,1043,1241,0,0,84.05,389,634,"建南里",NULL
140,906,21,927,1406,0,0,65.93,357,549,"南都里",NULL
141,712,16,728,934,0,0,77.94,287,425,"南都里",NULL
142,921,9,930,1145,0,0,81.22,384,537,"南華里",NULL
143,1009,18,1027,1309,0,0,78.46,412,597,"南華里",NULL
144,1000,14,1014,1282,0,0,79.1,400,600,"開南里",NULL
145,963,17,980,1243,0,0,78.84,398,565,"開南里",NULL
146,1119,11,1130,1448,0,0,78.04,434,685,"開南里",NULL
147,734,16,750,928,0,0,80.82,286,448,"彰南里",NULL
148,765,13,778,955,0,0,81.47,269,496,"彰南里",NULL
149,780,28,808,1006,0,0,80.32,264,516,"鯤鯓里",NULL
150,676,18,694,871,0,0,79.68,210,466,"鯤鯓里",NULL
151,896,6,902,1118,0,0,80.68,251,645,"喜北里",NULL
152,901,19,920,1090,0,0,84.4,169,732,"喜北里",NULL
153,1170,11,1181,1453,0,0,81.28,205,965,"喜南里",NULL
154,1242,21,1263,1521,0,0,83.04,302,940,"喜東里",NULL
155,1117,18,1135,1379,0,0,82.31,281,836,"省躬里",NULL
156,1049,24,1073,1293,0,0,82.99,283,766,"省躬里",NULL
157,719,17,736,882,0,0,83.45,208,511,"永寧里",NULL
158,871,18,889,1109,0,0,80.16,252,619,"永寧里",NULL
159,1408,39,1447,1775,0,0,81.52,367,1041,"松安里",NULL
160,1440,31,1471,1806,0,0,81.45,390,1050,"佛壇里",NULL
161,1582,44,1626,2049,0,0,79.36,462,1120,"同安里",NULL
162,751,21,772,946,0,0,81.61,174,577,"興農里",NULL
163,707,10,717,875,0,0,81.94,220,487,"興農里",NULL
164,791,11,802,1003,0,0,79.96,381,410,"小西里",NULL
165,1021,21,1042,1275,0,0,81.73,627,394,"大南里",NULL
166,983,22,1005,1272,0,0,79.01,423,560,"銀同里",NULL
167,1262,25,1287,1579,0,0,81.51,660,602,"五妃里",NULL
168,1209,19,1228,1503,0,0,81.7,610,599,"郡王里",NULL
169,981,20,1001,1227,0,0,81.58,444,537,"仙草里",NULL
170,923,18,941,1149,0,0,81.9,406,517,"仙草里",NULL
171,1090,12,1102,1320,0,0,83.48,535,555,"法華里",NULL
172,994,11,1005,1242,0,0,80.92,565,429,"法華里",NULL
173,1094,16,1110,1359,0,0,81.68,447,647,"福安里",NULL
174,1081,9,1090,1351,0,0,80.68,510,571,"進學里",NULL
175,1083,26,1109,1409,0,0,78.71,433,650,"建國里",NULL
176,1074,21,1095,1364,0,0,80.28,453,621,"青年里",NULL
177,1133,19,1152,1450,0,0,79.45,400,733,"永福里",NULL
178,1145,33,1178,1469,0,0,80.19,461,684,"永華里",NULL
179,1303,13,1316,1645,0,0,80,506,797,"天后里",NULL
180,1206,22,1228,1518,0,0,80.9,455,751,"三民里",NULL
181,1167,35,1202,1549,0,0,77.6,458,709,"赤嵌里",NULL
182,1161,14,1175,1463,0,0,80.31,443,718,"公正里",NULL
183,1599,28,1627,2065,0,0,78.79,541,1058,"萬昌里",NULL
184,1664,27,1691,2146,0,0,78.8,663,1001,"開山里",NULL
185,1538,20,1558,1892,0,0,82.35,678,860,"西賢里",NULL
186,1290,21,1311,1588,0,0,82.56,543,747,"西賢里",NULL
187,914,14,928,1159,0,0,80.07,428,486,"西湖里",NULL
188,1472,26,1498,1884,0,0,79.51,711,761,"西湖里",NULL
189,1223,10,1233,1497,0,0,82.36,417,806,"光賢里",NULL
190,978,22,1000,1208,0,0,82.78,321,657,"光賢里",NULL
191,1017,27,1044,1265,0,0,82.53,321,696,"文賢里",NULL
192,1575,38,1613,2111,0,0,76.41,566,1009,"協和里",NULL
193,1419,27,1446,1863,0,0,77.62,550,869,"三合里",NULL
194,931,20,951,1195,0,0,79.58,398,533,"普濟里",NULL
195,1090,12,1102,1380,0,0,79.86,361,729,"水仙里",NULL
196,1306,26,1332,1635,0,0,81.47,422,884,"民權里",NULL
197,743,14,757,948,0,0,79.85,270,473,"藥王里",NULL
198,1562,32,1594,1972,0,0,80.83,682,880,"藥王里",NULL
199,887,19,906,1107,0,0,81.84,341,546,"協進里",NULL
200,1069,25,1094,1340,0,0,81.64,425,644,"中正里",NULL
201,982,17,999,1285,0,0,77.74,416,566,"安海里",NULL
202,684,14,698,912,0,0,76.54,321,363,"大涼里",NULL
203,1195,18,1213,1485,0,0,81.68,500,695,"大涼里",NULL
204,746,15,761,973,0,0,78.21,267,479,"民主里",NULL
205,1039,23,1062,1331,0,0,79.79,397,642,"保安里",NULL
206,966,33,999,1229,0,0,81.29,343,623,"郡西里",NULL
207,1443,27,1470,1809,0,0,81.26,478,965,"民生里",NULL
208,1016,13,1029,1284,0,0,80.14,373,643,"元安里",NULL
209,943,36,979,1219,0,0,80.31,367,576,"開元里",NULL
210,841,17,858,1080,0,0,79.44,361,480,"開元里",NULL
211,507,11,518,720,0,0,71.94,279,228,"元寶里",NULL
212,865,16,881,1089,0,0,80.9,434,431,"元寶里",NULL
213,1133,33,1166,1411,0,0,82.64,516,617,"國興里",NULL
214,829,6,835,1034,0,0,80.75,342,487,"華興里",NULL
215,842,19,861,1040,0,0,82.79,377,465,"華興里",NULL
216,916,17,933,1142,0,0,81.7,451,465,"力行里",NULL
217,922,9,931,1082,0,0,86.04,431,491,"力行里",NULL
218,1172,23,1195,1475,0,0,81.02,509,663,"重興里",NULL
219,1098,16,1114,1358,0,0,82.03,956,142,"重興里",NULL
220,819,10,829,1006,0,0,82.41,455,364,"東興里",NULL
221,858,8,866,1025,0,0,84.49,456,402,"東興里",NULL
222,722,24,746,913,0,0,81.71,289,433,"新勝里",NULL
223,699,9,708,888,0,0,79.73,380,319,"新勝里",NULL
224,828,30,858,1039,0,0,82.58,707,121,"長榮里",NULL
225,781,14,795,986,0,0,80.63,374,407,"振興里",NULL
226,729,5,734,910,0,0,80.66,333,396,"振興里",NULL
227,701,22,723,908,0,0,79.63,286,415,"仁愛里",NULL
228,701,2,703,856,0,0,82.13,336,365,"仁愛里",NULL
229,959,24,983,1208,0,0,81.37,462,497,"勝安里",NULL
230,760,11,771,909,0,0,84.82,518,242,"中樓里",NULL
231,885,11,896,1109,0,0,80.79,383,502,"中樓里",NULL
232,1237,27,1264,1532,0,0,82.51,546,691,"永祥里",NULL
233,1072,29,1101,1360,0,0,80.96,584,488,"永祥里",NULL
234,914,22,936,1116,0,0,83.87,344,570,"小康里",NULL
235,743,28,771,932,0,0,82.73,332,411,"小康里",NULL
236,1145,32,1177,1438,0,0,81.85,721,424,"實踐里",NULL
237,525,16,541,685,0,0,78.98,331,194,"光武里",NULL
238,522,13,535,660,0,0,81.06,487,35,"大道里",NULL
239,958,30,988,1247,0,0,79.23,682,276,"大山里",NULL
240,715,22,737,929,0,0,79.33,415,300,"大仁里",NULL
241,1203,30,1233,1539,0,0,80.12,496,707,"興北里",NULL
242,799,17,816,1035,0,0,78.84,438,361,"公園里",NULL
243,689,17,706,899,0,0,78.53,320,369,"公園里",NULL
244,1185,26,1211,1488,0,0,81.38,387,798,"正風里",NULL
245,667,23,690,844,0,0,81.75,216,451,"延平里",NULL
246,729,12,741,916,0,0,80.9,239,490,"延平里",NULL
247,1010,22,1032,1312,0,0,78.66,435,575,"興南里",NULL
248,1295,31,1326,1656,0,0,80.07,470,825,"玉皇里",NULL
249,870,19,889,1111,0,0,80.02,287,583,"正覺里",NULL
250,895,15,910,1102,0,0,82.58,305,590,"正覺里",NULL
251,815,18,833,1006,0,0,82.8,255,560,"正覺里",NULL
252,844,20,864,1107,0,0,78.05,378,466,"六甲里",NULL
253,911,15,926,1160,0,0,79.83,363,548,"六甲里",NULL
254,1234,36,1270,1572,0,0,80.79,472,762,"國姓里",NULL
255,1109,29,1138,1484,0,0,76.68,403,706,"長德里",NULL
256,1054,26,1080,1352,0,0,79.88,410,644,"三德里",NULL
257,1017,17,1034,1533,0,0,67.45,381,636,"五福里",NULL
258,1349,11,1360,1673,0,0,81.29,490,859,"成功里",NULL
259,1461,18,1479,1813,0,0,81.58,610,851,"成功里",NULL
260,1359,17,1376,1699,0,0,80.99,505,854,"成德里",NULL
261,1508,14,1522,1817,0,0,83.76,618,890,"成德里",NULL
262,1264,16,1280,1481,0,0,86.43,556,708,"成德里",NULL
263,1586,35,1621,2020,0,0,80.25,632,954,"和順里",NULL
264,1405,24,1429,1718,0,0,83.18,583,822,"和順里",NULL
265,1219,19,1238,1562,0,0,79.26,603,616,"和順里",NULL
266,1077,11,1088,1350,0,0,80.59,383,694,"安民里",NULL
267,1067,15,1082,1319,0,0,82.03,415,652,"文元里",NULL
268,1084,19,1103,1357,0,0,81.28,392,692,"文元里",NULL
269,1077,20,1097,1293,0,0,84.84,437,640,"文元里",NULL
270,1144,26,1170,1414,0,0,82.74,428,716,"文成里",NULL
271,1098,7,1105,1321,0,0,83.65,425,673,"文成里",NULL
272,1119,27,1146,1422,0,0,80.59,403,716,"裕民里",NULL
273,1229,22,1251,1491,0,0,83.9,406,823,"大和里",NULL
274,1198,24,1222,1462,0,0,83.58,424,774,"大和里",NULL
275,1074,14,1088,1278,0,0,85.13,349,725,"大港里",NULL
276,1197,26,1223,1508,0,0,81.1,403,794,"大港里",NULL
277,1468,20,1488,1773,0,0,83.93,688,780,"大港里",NULL
278,1337,20,1357,1667,0,0,81.4,494,843,"大豐里",NULL
279,1058,18,1076,1347,0,0,79.88,434,624,"大豐里",NULL
280,750,17,767,931,0,0,82.38,293,457,"大豐里",NULL
281,936,9,945,1147,0,0,82.39,397,539,"賢北里",NULL
282,1005,11,1016,1203,0,0,84.46,409,596,"賢北里",NULL
283,464,13,477,567,0,0,84.13,163,301,"東和里",NULL
284,1672,16,1688,2053,0,0,82.22,568,1104,"塭南里",NULL
285,1229,27,1256,1615,0,0,77.77,403,826,"塭南里",NULL
286,1266,20,1286,1621,0,0,79.33,378,888,"州南里",NULL
287,1104,33,1137,1428,0,0,79.62,402,702,"州南里",NULL
288,973,39,1012,1258,0,0,80.45,344,629,"州南里",NULL
289,1031,24,1055,1309,0,0,80.6,411,620,"安順里",NULL
290,1136,18,1154,1397,0,0,82.61,413,723,"安順里",NULL
291,1294,24,1318,1595,0,0,82.63,428,866,"州北里",NULL
292,1351,24,1375,1699,0,0,80.93,524,827,"州北里",NULL
293,1400,28,1428,1706,0,0,83.7,548,852,"新順里",NULL
294,1462,28,1490,1789,0,0,83.29,545,917,"新順里",NULL
295,973,24,997,1180,0,0,84.49,205,768,"頂安里",NULL
296,1268,17,1285,1585,0,0,81.07,422,846,"頂安里",NULL
297,2022,36,2058,2657,0,0,77.46,631,1391,"安慶里",NULL
298,1183,23,1206,1454,0,0,82.94,410,773,"安慶里",NULL
299,996,24,1020,1227,0,0,83.13,321,675,"溪北里",NULL
300,1067,21,1088,1306,0,0,83.31,460,607,"溪北里",NULL
301,1538,32,1570,1924,0,0,81.6,554,984,"安和里",NULL
302,1730,38,1768,2190,0,0,80.73,496,1234,"安西里",NULL
303,1739,47,1786,2172,0,0,82.23,640,1099,"溪頂里",NULL
304,1258,22,1280,1592,0,0,80.4,504,754,"溪頂里",NULL
305,1083,26,1109,1342,0,0,82.64,362,721,"安東里",NULL
306,992,37,1029,1238,0,0,83.12,250,742,"安東里",NULL
307,1396,16,1412,1807,0,0,78.14,574,822,"鳳凰里",NULL
308,1388,24,1412,1811,0,0,77.97,537,851,"鳳凰里",NULL
309,1198,21,1219,1544,0,0,78.95,435,763,"梅花里",NULL
310,1290,25,1315,1667,0,0,78.88,488,802,"梅花里",NULL
311,1337,23,1360,1691,0,0,80.43,467,870,"理想里",NULL
312,1421,26,1447,1769,0,0,81.8,482,939,"理想里",NULL
313,1187,19,1206,1509,0,0,79.92,447,740,"大安里",NULL
314,1181,25,1206,1485,0,0,81.21,435,746,"大安里",NULL
315,1208,37,1245,1484,0,0,83.89,372,836,"原佃里",NULL
316,1197,37,1234,1562,0,0,79,346,851,"長安里",NULL
317,1371,30,1401,1734,0,0,80.8,432,939,"長安里",NULL
318,841,4,845,1038,0,0,81.41,245,596,"公親里",NULL
319,1027,23,1050,1304,0,0,80.52,418,609,"布袋里",NULL
320,1319,50,1369,1683,0,0,81.34,432,887,"總頭里",NULL
321,1064,27,1091,1352,0,0,80.7,289,775,"南興里",NULL
322,1373,48,1421,1795,0,0,79.16,486,887,"學東里",NULL
323,681,24,705,825,0,0,85.45,211,470,"公塭里",NULL
324,840,26,866,1071,0,0,80.86,305,535,"佃東里",NULL
325,947,11,958,1166,0,0,82.16,396,551,"佃東里",NULL
326,1166,28,1194,1498,0,0,79.71,424,742,"佃西里",NULL
327,828,9,837,1036,0,0,80.79,298,530,"淵西里",NULL
328,1111,33,1144,1397,0,0,81.89,396,715,"淵西里",NULL
329,947,22,969,1183,0,0,81.91,347,600,"海西里",NULL
330,871,19,890,1127,0,0,78.97,309,562,"海西里",NULL
331,1397,37,1434,1817,0,0,78.92,439,958,"海東里",NULL
332,1259,18,1277,1605,0,0,79.56,418,841,"海東里",NULL
333,1943,24,1967,2712,0,0,72.53,669,1274,"溪心里",NULL
334,943,22,965,1174,0,0,82.2,301,642,"溪心里",NULL
335,1036,22,1058,1311,0,0,80.7,382,654,"淵東里",NULL
336,1291,38,1329,1652,0,0,80.45,429,862,"淵東里",NULL
337,1194,24,1218,1520,0,0,80.13,444,750,"淵中里",NULL
338,944,16,960,1204,0,0,79.73,289,655,"淵中里",NULL
339,1145,20,1165,1401,0,0,83.15,389,756,"溪墘里",NULL
340,1138,25,1163,1409,0,0,82.54,343,795,"溪墘里",NULL
341,1544,26,1570,1953,0,0,80.39,453,1091,"海佃里",NULL
342,1587,29,1616,1966,0,0,82.2,556,1031,"海佃里",NULL
343,1367,23,1390,1661,0,0,83.68,449,918,"國安里",NULL
344,697,3,700,827,0,0,84.64,272,425,"溪東里",NULL
345,1581,14,1595,1935,0,0,82.43,634,947,"溪東里",NULL
346,1533,39,1572,2005,0,0,78.4,530,1003,"安富里",NULL
347,1675,42,1717,2140,0,0,80.23,547,1128,"安富里",NULL
348,1167,23,1190,1473,0,0,80.79,356,811,"幸福里",NULL
349,1541,29,1570,1911,0,0,82.16,472,1069,"幸福里",NULL
350,795,20,815,1007,0,0,80.93,244,551,"海南里",NULL
351,816,8,824,965,0,0,85.39,313,503,"海南里",NULL
352,1054,33,1087,1405,0,0,77.37,386,668,"城東里",NULL
353,1195,47,1242,1621,0,0,76.62,393,802,"城南里",NULL
354,595,16,611,756,0,0,80.82,246,349,"城南里",NULL
355,994,29,1023,1284,0,0,79.67,355,639,"青草里",NULL
356,813,32,845,1016,0,0,83.17,223,590,"城西里",NULL
357,936,34,970,1209,0,0,80.23,313,623,"城北里",NULL
358,757,13,770,893,0,0,86.23,332,425,"城中里",NULL
359,386,8,394,468,0,0,84.19,98,288,"砂崙里",NULL
360,425,13,438,558,0,0,78.49,141,284,"砂崙里",NULL
361,812,32,844,1071,0,0,78.8,372,440,"顯宮里",NULL
362,490,12,502,633,0,0,79.3,259,231,"鹿耳里",NULL
363,1136,36,1172,1432,0,0,81.84,455,681,"四草里",NULL
364,456,10,466,555,0,0,83.96,160,296,"鹽田里",NULL
365,1135,16,1151,1449,0,0,79.43,441,694,"平安里",NULL
366,1256,12,1268,1539,0,0,82.39,447,809,"平安里",NULL
367,1558,39,1597,2166,0,0,73.73,512,1046,"石門里",NULL
368,1182,18,1200,1441,0,0,83.28,393,789,"港仔里",NULL
369,1233,26,1259,1526,0,0,82.5,445,788,"海頭里",NULL
370,1571,38,1609,1962,0,0,82.01,856,715,"西門里",NULL
371,1187,17,1204,1505,0,0,80,571,616,"金城里",NULL
372,410,7,417,520,0,0,80.19,147,263,"漁光里",NULL
373,1124,17,1141,1412,0,0,80.81,454,670,"億載里",NULL
374,1466,30,1496,1970,0,0,75.94,685,781,"平通里",NULL
375,1425,22,1447,1849,0,0,78.26,592,833,"平通里",NULL
376,1157,20,1177,1471,0,0,80.01,554,603,"育平里",NULL
377,1279,14,1293,1690,0,0,76.51,627,652,"育平里",NULL
378,1311,22,1333,1719,0,0,77.55,689,622,"育平里",NULL
379,1485,20,1505,1835,0,0,82.02,714,771,"華平里",NULL
380,1460,20,1480,1828,0,0,80.96,655,805,"華平里",NULL
381,953,21,974,1245,0,0,78.23,434,519,"怡平里",NULL
382,1051,22,1073,1315,0,0,81.6,459,592,"怡平里",NULL
383,1357,10,1367,1673,0,0,81.71,612,745,"國平里",NULL
384,1271,24,1295,1694,0,0,76.45,673,598,"國平里",NULL
385,1150,21,1171,1449,0,0,80.81,510,640,"建平里",NULL
386,1157,12,1169,1453,0,0,80.45,536,621,"建平里",NULL
387,1217,4,1221,1502,0,0,81.29,544,673,"文平里",NULL
388,1241,15,1256,1536,0,0,81.77,520,721,"文平里",NULL
1,646,12,658,1023,0,0,64.32,581,65,"東門里",NULL
2,745,19,764,1129,0,0,67.67,694,51,"東門里",NULL
3,633,29,662,1004,0,0,65.94,600,33,"南門里",NULL
4,905,23,928,1448,0,0,64.09,826,79,"南門里",NULL
5,712,30,742,1145,0,0,64.8,659,53,"西門里",NULL
6,767,23,790,1246,0,0,63.4,721,46,"西門里",NULL
7,1091,30,1121,1672,0,0,67.05,1028,63,"西門里",NULL
8,1068,28,1096,1733,0,0,63.24,1003,65,"北門里",NULL
9,856,53,909,1419,0,0,64.06,799,57,"賢庵里",NULL
10,501,23,524,788,0,0,66.5,481,20,"金水里",NULL
11,878,48,926,1438,0,0,64.39,848,30,"古城里",NULL
12,555,19,574,926,0,0,61.99,515,40,"珠沙里",NULL
13,734,57,791,1312,0,0,60.29,674,60,"古寧村",NULL
14,1034,71,1105,1645,0,0,67.17,975,59,"安美村",NULL
15,1006,47,1053,1614,0,0,65.24,938,68,"湖埔村",NULL
16,1042,47,1089,1675,0,0,65.01,983,59,"榜林村",NULL
17,858,10,868,1348,0,0,64.39,801,57,"盤山村",NULL
18,355,16,371,572,0,0,64.86,339,16,"后盤村",NULL
19,663,21,684,987,0,0,69.3,619,44,"新市里",NULL
20,746,7,753,1134,0,0,66.4,691,55,"新市里",NULL
21,975,6,981,1531,0,0,64.08,897,78,"山外里",NULL
22,431,4,435,664,0,0,65.51,397,34,"溪湖里",NULL
23,393,25,418,642,0,0,65.11,379,14,"蓮庵里",NULL
24,447,16,463,696,0,0,66.52,427,20,"料羅里",NULL
25,597,18,615,899,0,0,68.41,536,61,"新湖里",NULL
26,688,18,706,1077,0,0,65.55,622,66,"新湖里",NULL
27,624,33,657,942,0,0,69.75,584,40,"正義里",NULL
28,827,16,843,1323,0,0,63.72,794,33,"瓊林里",NULL
29,607,21,628,1029,0,0,61.03,572,35,"汶沙里",NULL
30,750,20,770,1166,0,0,66.04,707,43,"汶沙里",NULL
31,540,21,561,866,0,0,64.78,511,29,"何斗里",NULL
32,584,45,629,942,0,0,66.77,556,28,"浦山里",NULL
33,373,29,402,650,0,0,61.85,354,19,"西園里",NULL
34,463,31,494,809,0,0,61.06,445,18,"官嶼里",NULL
35,493,28,521,816,0,0,63.85,477,16,"三山里",NULL
36,323,15,338,498,0,0,67.87,311,12,"大洋里",NULL
37,556,11,567,882,0,0,64.29,528,28,"光前里",NULL
38,800,29,829,1314,0,0,63.09,767,33,"林湖村",NULL
39,329,4,333,574,0,0,58.01,319,10,"黃埔村",NULL
40,459,2,461,826,0,0,55.81,443,16,"西口村",NULL
41,308,21,329,579,0,0,56.82,304,4,"上林村",NULL
42,651,43,694,1104,0,0,62.86,617,34,"上岐村",NULL
43,60,0,60,106,0,0,56.6,54,6,"大坵村",NULL
44,61,0,61,160,0,0,38.13,57,4,"小坵村",NULL
1,860,25,885,1294,0,0,68.39,813,47,"介壽村",NULL
2,770,33,803,1164,0,0,68.99,714,56,"福沃村、復興村",NULL
3,894,27,921,1414,0,0,65.13,827,67,"仁愛村、馬祖村、津沙村、珠螺村、清水村、四維村",NULL
4,545,9,554,932,0,0,59.44,511,34,"后沃村、橋仔村、塘岐村",NULL
5,255,6,261,449,0,0,58.13,246,9,"白沙村、板里村、芹壁村",NULL
6,270,3,273,460,0,0,59.35,258,12,"青帆村、田沃村、西坵村",NULL
7,236,6,242,379,0,0,63.85,230,6,"大坪村、福正村",NULL
8,478,8,486,647,0,0,75.12,461,17,"中柳村、樂華村",NULL
